,의원A,의원B,가결,가결외,법안,초당
0,강기윤(姜起潤),강대식(姜大植),95,99,194,0
1,강기윤(姜起潤),강득구(姜得求),53,6,59,1
2,강기윤(姜起潤),강민국(姜旻局),71,54,125,0
3,강기윤(姜起潤),강민정(姜旼姃),27,3,30,1
4,강기윤(姜起潤),강병원(姜炳遠),53,5,58,1
5,강기윤(姜起潤),강선우(姜仙祐),52,5,57,1
6,강기윤(姜起潤),강성희(姜聖熙),0,0,0,1
7,강기윤(姜起潤),강은미(姜恩美),5,3,8,1
8,강기윤(姜起潤),강준현(康準鉉),53,6,59,1
9,강기윤(姜起潤),강훈식(姜勳植),52,4,56,1
10,강기윤(姜起潤),고민정(高旼廷),52,4,56,1
11,강기윤(姜起潤),고영인(高永寅),52,6,58,1
12,강기윤(姜起潤),고용진(高榕禛),52,5,57,1
13,강기윤(姜起潤),구자근(具滋根),160,311,471,0
14,강기윤(姜起潤),권명호(權明浩),154,301,455,0
15,강기윤(姜起潤),권성동(權性東),84,85,169,0
16,강기윤(姜起潤),권영세(權寧世),79,61,140,0
17,강기윤(姜起潤),권은희(權垠希),34,20,54,0
18,강기윤(姜起潤),권인숙(權仁淑),51,5,56,1
19,강기윤(姜起潤),권칠승(權七勝),52,4,56,1
20,강기윤(姜起潤),기동민(奇東旻),52,4,56,1
21,강기윤(姜起潤),김경만(金京萬),53,4,57,1
22,강기윤(姜起潤),김경협(金炅俠),51,4,55,1
23,강기윤(姜起潤),김교흥(金敎興),52,3,55,1
24,강기윤(姜起潤),김기현(金起炫),86,80,166,0
25,강기윤(姜起潤),김남국(金南局),44,1,45,1
26,강기윤(姜起潤),김도읍(金度邑),110,110,220,0
27,강기윤(姜起潤),김두관(金斗官),52,7,59,1
28,강기윤(姜起潤),김미애(金美愛),77,91,168,0
29,강기윤(姜起潤),김민기(金敏基),52,4,56,1
30,강기윤(姜起潤),김민석(金民錫),53,8,61,1
31,강기윤(姜起潤),김민철(金敏徹),52,4,56,1
32,강기윤(姜起潤),김병기(金炳基),52,4,56,1
33,강기윤(姜起潤),김병욱A(金炳旭),52,7,59,1
34,강기윤(姜起潤),김병욱B(金炳旭),86,129,215,0
35,강기윤(姜起潤),김병주(金柄周),53,4,57,1
36,강기윤(姜起潤),김상훈(金相勳),103,122,225,0
37,강기윤(姜起潤),김상희(金相姬),51,4,55,1
38,강기윤(姜起潤),김석기(金碩基),117,156,273,0
39,강기윤(姜起潤),김성원(金成願),117,176,293,0
40,강기윤(姜起潤),김성주(金成柱),52,5,57,1
41,강기윤(姜起潤),김성환(金星煥),52,4,56,1
42,강기윤(姜起潤),김수흥(金洙興),53,5,58,1
43,강기윤(姜起潤),김승남(金承南),52,5,57,1
44,강기윤(姜起潤),김승수(金承洙),84,120,204,0
45,강기윤(姜起潤),김승원(金勝源),52,7,59,1
46,강기윤(姜起潤),김영배(金永培),53,4,57,1
47,강기윤(姜起潤),김영선(金映宣),31,79,110,0
48,강기윤(姜起潤),김영식(金英植),125,181,306,0
49,강기윤(姜起潤),김영주(金榮珠),52,4,56,1
50,강기윤(姜起潤),김영진(金榮鎭),52,3,55,1
51,강기윤(姜起潤),김영호(金映豪),51,4,55,1
52,강기윤(姜起潤),김예지(金睿智),127,211,338,0
53,강기윤(姜起潤),김용민(金容民),52,4,56,1
54,강기윤(姜起潤),김용판(金用判),130,240,370,0
55,강기윤(姜起潤),김웅(金雄),66,41,107,0
56,강기윤(姜起潤),김원이(金元二),52,7,59,1
57,강기윤(姜起潤),김윤덕(金潤德),52,4,56,1
58,강기윤(姜起潤),김의겸(金宜謙),26,4,30,1
59,강기윤(姜起潤),김정재(金汀才),95,103,198,0
60,강기윤(姜起潤),김정호(金禎鎬),53,4,57,1
61,강기윤(姜起潤),김종민(金鐘民),52,5,57,1
62,강기윤(姜起潤),김주영(金周暎),51,5,56,1
63,강기윤(姜起潤),김진표(金振杓),27,0,27,1
64,강기윤(姜起潤),김철민(金哲玟),50,4,54,1
65,강기윤(姜起潤),김태년(金太年),49,4,53,1
66,강기윤(姜起潤),김태호(金台鎬),81,95,176,0
67,강기윤(姜起潤),김학용(金學容),32,37,69,0
68,강기윤(姜起潤),김한규(金翰奎),25,5,30,1
69,강기윤(姜起潤),김한정(金漢正),50,4,54,1
70,강기윤(姜起潤),김형동(金亨東),95,137,232,0
71,강기윤(姜起潤),김홍걸(金弘傑),16,9,25,1
72,강기윤(姜起潤),김회재(金會在),51,4,55,1
73,강기윤(姜起潤),김희곤(金熙坤),90,174,264,0
74,강기윤(姜起潤),김희국(金熙國),110,124,234,0
75,강기윤(姜起潤),남인순(南仁順),49,5,54,1
76,강기윤(姜起潤),노용호(魯容昊),29,30,59,0
77,강기윤(姜起潤),노웅래(盧雄來),50,3,53,1
78,강기윤(姜起潤),도종환(都鍾煥),50,4,54,1
79,강기윤(姜起潤),류성걸(柳性杰),74,71,145,0
80,강기윤(姜起潤),류호정(柳好貞),4,4,8,1
81,강기윤(姜起潤),맹성규(孟聖奎),51,4,55,1
82,강기윤(姜起潤),문정복(文貞福),49,8,57,1
83,강기윤(姜起潤),문진석(文振碩),50,4,54,1
84,강기윤(姜起潤),민병덕(閔炳德),50,4,54,1
85,강기윤(姜起潤),민형배(閔馨培),34,9,43,1
86,강기윤(姜起潤),민홍철(閔洪喆),50,5,55,1
87,강기윤(姜起潤),박광온(朴洸瑥),51,4,55,1
88,강기윤(姜起潤),박대수(朴大壽),99,216,315,0
89,강기윤(姜起潤),박대출(朴大出),78,59,137,0
90,강기윤(姜起潤),박덕흠(朴德欽),89,213,302,0
91,강기윤(姜起潤),박범계(朴範界),50,4,54,1
92,강기윤(姜起潤),박병석(朴炳錫),25,3,28,1
93,강기윤(姜起潤),박상혁(朴商赫),49,5,54,1
94,강기윤(姜起潤),박성민(朴聖敏),95,152,247,0
95,강기윤(姜起潤),박성준(朴省俊),50,5,55,1
96,강기윤(姜起潤),박성중(朴成重),103,165,268,0
97,강기윤(姜起潤),박수영(朴洙瑩),68,59,127,0
98,강기윤(姜起潤),박영순(朴英淳),51,4,55,1
99,강기윤(姜起潤),박완주(朴完柱),25,0,25,1
100,강기윤(姜起潤),박용진(朴用鎭),49,4,53,1
101,강기윤(姜起潤),박재호(朴在昊),51,5,56,1
102,강기윤(姜起潤),박정(朴釘),50,4,54,1
103,강기윤(姜起潤),박정하(朴正河),32,24,56,0
104,강기윤(姜起潤),박주민(朴柱民),50,4,54,1
105,강기윤(姜起潤),박진(朴振),69,71,140,0
106,강기윤(姜起潤),박찬대(朴贊大),50,4,54,1
107,강기윤(姜起潤),박형수(朴亨修),79,86,165,0
108,강기윤(姜起潤),박홍근(朴洪根),51,4,55,1
109,강기윤(姜起潤),배준영(裵俊英),72,80,152,0
110,강기윤(姜起潤),배진교(裵晋敎),5,2,7,1
111,강기윤(姜起潤),배현진(裵賢鎭),79,55,134,0
112,강기윤(姜起潤),백종헌(白宗憲),102,205,307,0
113,강기윤(姜起潤),백혜련(白惠蓮),51,4,55,1
114,강기윤(姜起潤),변재일(卞在一),50,5,55,1
115,강기윤(姜起潤),서동용(徐東榕),50,5,55,1
116,강기윤(姜起潤),서범수(徐範洙),94,176,270,0
117,강기윤(姜起潤),서병수(徐秉洙),83,125,208,0
118,강기윤(姜起潤),서삼석(徐參錫),49,7,56,1
119,강기윤(姜起潤),서영교(徐瑛敎),52,5,57,1
120,강기윤(姜起潤),서영석(徐暎錫),49,6,55,1
121,강기윤(姜起潤),서일준(徐一俊),90,116,206,0
122,강기윤(姜起潤),서정숙(徐正淑),83,80,163,0
123,강기윤(姜起潤),설훈(薛勳),52,5,57,1
124,강기윤(姜起潤),성일종(成一鍾),95,166,261,0
125,강기윤(姜起潤),소병철(蘇秉哲),50,5,55,1
126,강기윤(姜起潤),소병훈(蘇秉勳),50,5,55,1
127,강기윤(姜起潤),송갑석(宋甲錫),50,5,55,1
128,강기윤(姜起潤),송기헌(宋基憲),50,4,54,1
129,강기윤(姜起潤),송석준(宋錫俊),74,83,157,0
130,강기윤(姜起潤),송언석(宋彦錫),93,117,210,0
131,강기윤(姜起潤),송옥주(宋玉珠),50,4,54,1
132,강기윤(姜起潤),송재호(宋在祜),50,4,54,1
133,강기윤(姜起潤),신동근(申東根),50,3,53,1
134,강기윤(姜起潤),신영대(申榮大),50,9,59,1
135,강기윤(姜起潤),신원식(申源湜),68,63,131,0
136,강기윤(姜起潤),신정훈(辛正勳),51,5,56,1
137,강기윤(姜起潤),신현영(申賢榮),49,4,53,1
138,강기윤(姜起潤),심상정(沈相奵),5,2,7,1
139,강기윤(姜起潤),안규백(安圭伯),52,7,59,1
140,강기윤(姜起潤),안민석(安敏錫),51,3,54,1
141,강기윤(姜起潤),안병길(安炳吉),89,123,212,0
142,강기윤(姜起潤),안철수(安哲秀),27,39,66,0
143,강기윤(姜起潤),안호영(安浩永),50,5,55,1
144,강기윤(姜起潤),양경숙(梁敬淑),50,4,54,1
145,강기윤(姜起潤),양금희(梁琴喜),93,121,214,0
146,강기윤(姜起潤),양기대(梁基大),50,4,54,1
147,강기윤(姜起潤),양이원영(梁李媛瑛),45,4,49,1
148,강기윤(姜起潤),양정숙(梁貞淑),4,2,6,1
149,강기윤(姜起潤),양향자(梁香子),23,11,34,1
150,강기윤(姜起潤),어기구(魚基龜),50,5,55,1
151,강기윤(姜起潤),엄태영(嚴泰永),115,166,281,0
152,강기윤(姜起潤),오기형(吳奇炯),49,4,53,1
153,강기윤(姜起潤),오영환(吳永煥),49,8,57,1
154,강기윤(姜起潤),용혜인(龍慧仁),1,3,4,1
155,강기윤(姜起潤),우상호(禹相虎),50,4,54,1
156,강기윤(姜起潤),우원식(禹元植),49,4,53,1
157,강기윤(姜起潤),위성곤(魏聖坤),50,5,55,1
158,강기윤(姜起潤),유경준(兪京濬),79,99,178,0
159,강기윤(姜起潤),유기홍(柳基洪),50,4,54,1
160,강기윤(姜起潤),유동수(柳東秀),50,4,54,1
161,강기윤(姜起潤),유상범(劉相凡),83,76,159,0
162,강기윤(姜起潤),유의동(兪義東),65,51,116,0
163,강기윤(姜起潤),유정주(兪訂炷),49,4,53,1
164,강기윤(姜起潤),윤건영(尹建永),49,3,52,1
165,강기윤(姜起潤),윤관석(尹官石),41,0,41,1
166,강기윤(姜起潤),윤두현(尹斗鉉),86,89,175,0
167,강기윤(姜起潤),윤미향(尹美香),20,0,20,1
168,강기윤(姜起潤),윤상현(尹相現),53,91,144,0
169,강기윤(姜起潤),윤영덕(尹永德),49,5,54,1
170,강기윤(姜起潤),윤영석(尹永碩),112,190,302,0
171,강기윤(姜起潤),윤영찬(尹永燦),50,6,56,1
172,강기윤(姜起潤),윤재갑(尹才鉀),51,7,58,1
173,강기윤(姜起潤),윤재옥(尹在玉),67,56,123,0
174,강기윤(姜起潤),윤주경(尹柱卿),76,85,161,0
175,강기윤(姜起潤),윤준병(尹準炳),50,5,55,1
176,강기윤(姜起潤),윤창현(尹暢賢),93,106,199,0
177,강기윤(姜起潤),윤한홍(尹漢洪),84,110,194,0
178,강기윤(姜起潤),윤호중(尹昊重),51,4,55,1
179,강기윤(姜起潤),윤후덕(尹厚德),50,4,54,1
180,강기윤(姜起潤),이개호(李介昊),50,5,55,1
181,강기윤(姜起潤),이달곤(李達坤),74,121,195,0
182,강기윤(姜起潤),이동주(李東洲),49,4,53,1
183,강기윤(姜起潤),이만희(李晩熙),89,76,165,0
184,강기윤(姜起潤),이명수(李明洙),114,189,303,0
185,강기윤(姜起潤),이병훈(李炳勳),52,5,57,1
186,강기윤(姜起潤),이상민(李相珉),50,4,54,1
187,강기윤(姜起潤),이상헌(李相憲),52,8,60,1
188,강기윤(姜起潤),이성만(李成萬),41,0,41,1
189,강기윤(姜起潤),이소영(李素永),50,4,54,1
190,강기윤(姜起潤),이수진(李壽珍),50,5,55,1
191,강기윤(姜起潤),이수진(李秀眞),50,4,54,1
192,강기윤(姜起潤),이양수(李亮壽),75,64,139,0
193,강기윤(姜起潤),이용(李鏞),85,93,178,0
194,강기윤(姜起潤),이용빈(李龍彬),52,7,59,1
195,강기윤(姜起潤),이용선(李庸瑄),50,5,55,1
196,강기윤(姜起潤),이용우(李龍雨),50,4,54,1
197,강기윤(姜起潤),이용호(李容鎬),29,27,56,0
198,강기윤(姜起潤),이원욱(李元旭),51,4,55,1
199,강기윤(姜起潤),이원택(李源澤),50,5,55,1
200,강기윤(姜起潤),이은주(李恩周),5,2,7,1
201,강기윤(姜起潤),이인선(李仁善),34,42,76,0
202,강기윤(姜起潤),이인영(李仁榮),50,4,54,1
203,강기윤(姜起潤),이장섭(李將燮),50,4,54,1
204,강기윤(姜起潤),이재명(李在明),25,4,29,1
205,강기윤(姜起潤),이재정(李在汀),50,8,58,1
206,강기윤(姜起潤),이정문(李楨文),50,4,54,1
207,강기윤(姜起潤),이종배(李鍾培),105,131,236,0
208,강기윤(姜起潤),이종성(李鍾成),130,252,382,0
209,강기윤(姜起潤),이주환(李周桓),91,120,211,0
210,강기윤(姜起潤),이채익(李埰益),86,135,221,0
211,강기윤(姜起潤),이철규(李喆圭),81,90,171,0
212,강기윤(姜起潤),이탄희(李誕熙),50,4,54,1
213,강기윤(姜起潤),이태규(李泰珪),38,59,97,0
214,강기윤(姜起潤),이학영(李學永),49,6,55,1
215,강기윤(姜起潤),이해식(李海植),50,4,54,1
216,강기윤(姜起潤),이헌승(李憲昇),72,132,204,0
217,강기윤(姜起潤),이형석(李炯錫),49,4,53,1
218,강기윤(姜起潤),인재근(印在謹),49,6,55,1
219,강기윤(姜起潤),임병헌(林炳憲),37,112,149,0
220,강기윤(姜起潤),임오경(林五卿),50,4,54,1
221,강기윤(姜起潤),임이자(林利子),94,114,208,0
222,강기윤(姜起潤),임종성(林鍾聲),51,6,57,1
223,강기윤(姜起潤),임호선(林昊宣),50,5,55,1
224,강기윤(姜起潤),장경태(張耿態),50,4,54,1
225,강기윤(姜起潤),장동혁(張東赫),28,31,59,0
226,강기윤(姜起潤),장제원(張濟元),67,57,124,0
227,강기윤(姜起潤),장철민(張喆敏),50,4,54,1
228,강기윤(姜起潤),장혜영(張惠英),6,3,9,1
229,강기윤(姜起潤),전봉민(田奉珉),72,121,193,0
230,강기윤(姜起潤),전용기(田溶冀),51,4,55,1
231,강기윤(姜起潤),전재수(田載秀),50,4,54,1
232,강기윤(姜起潤),전주혜(全珠惠),66,46,112,0
233,강기윤(姜起潤),전해철(全海澈),52,4,56,1
234,강기윤(姜起潤),전혜숙(全惠淑),50,7,57,1
235,강기윤(姜起潤),정경희(丁慶姬),71,58,129,0
236,강기윤(姜起潤),정동만(鄭東萬),80,85,165,0
237,강기윤(姜起潤),정성호(鄭成湖),52,4,56,1
238,강기윤(姜起潤),정우택(鄭宇澤),35,54,89,0
239,강기윤(姜起潤),정운천(鄭雲天),104,153,257,0
240,강기윤(姜起潤),정일영(鄭日永),49,4,53,1
241,강기윤(姜起潤),정점식(鄭点植),67,56,123,0
242,강기윤(姜起潤),정진석(鄭鎭碩),74,70,144,0
243,강기윤(姜起潤),정청래(鄭淸來),49,4,53,1
244,강기윤(姜起潤),정춘숙(鄭春淑),50,4,54,1
245,강기윤(姜起潤),정태호(鄭泰浩),50,4,54,1
246,강기윤(姜起潤),정필모(鄭必模),50,4,54,1
247,강기윤(姜起潤),정희용(鄭熙溶),89,123,212,0
248,강기윤(姜起潤),조경태(趙慶泰),100,110,210,0
249,강기윤(姜起潤),조명희(曺明姬),89,168,257,0
250,강기윤(姜起潤),조수진(趙修眞),77,88,165,0
251,강기윤(姜起潤),조승래(趙承來),50,4,54,1
252,강기윤(姜起潤),조오섭(曺五燮),50,7,57,1
253,강기윤(姜起潤),조은희(趙恩禧),33,27,60,0
254,강기윤(姜起潤),조응천(趙應天),50,3,53,1
255,강기윤(姜起潤),조정식(趙正湜),49,3,52,1
256,강기윤(姜起潤),조정훈(趙廷訓),0,15,15,1
257,강기윤(姜起潤),조해진(曺海珍),68,65,133,0
258,강기윤(姜起潤),주철현(朱哲鉉),50,8,58,1
259,강기윤(姜起潤),주호영(朱豪英),68,53,121,0
260,강기윤(姜起潤),지성호(池成浩),82,120,202,0
261,강기윤(姜起潤),진선미(陳善美),50,5,55,1
262,강기윤(姜起潤),진성준(陳聲準),50,4,54,1
263,강기윤(姜起潤),천준호(千俊鎬),49,3,52,1
264,강기윤(姜起潤),최기상(崔基相),49,4,53,1
265,강기윤(姜起潤),최승재(崔承宰),91,104,195,0
266,강기윤(姜起潤),최연숙(崔姸淑),39,42,81,0
267,강기윤(姜起潤),최영희(崔英姬),33,63,96,0
268,강기윤(姜起潤),최인호(崔仁昊),51,4,55,1
269,강기윤(姜起潤),최재형(崔在亨),27,18,45,0
270,강기윤(姜起潤),최종윤(崔鍾允),50,4,54,1
271,강기윤(姜起潤),최춘식(崔春植),99,161,260,0
272,강기윤(姜起潤),최형두(崔炯斗),161,273,434,0
273,강기윤(姜起潤),최혜영(崔惠英),51,10,61,1
274,강기윤(姜起潤),추경호(秋慶鎬),111,160,271,0
275,강기윤(姜起潤),태영호(太永浩),123,192,315,0
276,강기윤(姜起潤),하영제(河榮帝),88,165,253,1
277,강기윤(姜起潤),하태경(河泰慶),63,39,102,0
278,강기윤(姜起潤),한기호(韓起鎬),67,69,136,0
279,강기윤(姜起潤),한무경(韓茂景),86,112,198,0
280,강기윤(姜起潤),한병도(韓秉道),50,5,55,1
281,강기윤(姜起潤),한정애(韓貞愛),50,5,55,1
282,강기윤(姜起潤),한준호(韓俊鎬),51,4,55,1
283,강기윤(姜起潤),허숙정(許淑湞),0,0,0,1
284,강기윤(姜起潤),허영(許榮),50,5,55,1
285,강기윤(姜起潤),허은아(許垠娥),81,58,139,0
286,강기윤(姜起潤),허종식(許琮植),50,4,54,1
287,강기윤(姜起潤),홍기원(洪起元),50,4,54,1
288,강기윤(姜起潤),홍문표(洪文杓),78,118,196,0
289,강기윤(姜起潤),홍석준(洪碩晙),75,83,158,0
290,강기윤(姜起潤),홍성국(洪性國),50,4,54,1
291,강기윤(姜起潤),홍영표(洪永杓),50,4,54,1
292,강기윤(姜起潤),홍익표(洪翼杓),50,4,54,1
293,강기윤(姜起潤),홍정민(洪貞敏),52,7,59,1
294,강기윤(姜起潤),황보승희(皇甫承希),81,102,183,1
295,강기윤(姜起潤),황운하(黃雲夏),50,5,55,1
296,강기윤(姜起潤),황희(黃熙),49,4,53,1
297,강대식(姜大植),강득구(姜得求),53,4,57,1
298,강대식(姜大植),강민국(姜旻局),83,82,165,0
299,강대식(姜大植),강민정(姜旼姃),27,6,33,1
300,강대식(姜大植),강병원(姜炳遠),52,5,57,1
301,강대식(姜大植),강선우(姜仙祐),52,6,58,1
302,강대식(姜大植),강성희(姜聖熙),0,0,0,1
303,강대식(姜大植),강은미(姜恩美),5,6,11,1
304,강대식(姜大植),강준현(康準鉉),52,5,57,1
305,강대식(姜大植),강훈식(姜勳植),55,5,60,1
306,강대식(姜大植),고민정(高旼廷),53,3,56,1
307,강대식(姜大植),고영인(高永寅),53,7,60,1
308,강대식(姜大植),고용진(高榕禛),52,5,57,1
309,강대식(姜大植),구자근(具滋根),103,148,251,0
310,강대식(姜大植),권명호(權明浩),102,190,292,0
311,강대식(姜大植),권성동(權性東),76,84,160,0
312,강대식(姜大植),권영세(權寧世),81,114,195,0
313,강대식(姜大植),권은희(權垠希),42,44,86,0
314,강대식(姜大植),권인숙(權仁淑),52,6,58,1
315,강대식(姜大植),권칠승(權七勝),53,5,58,1
316,강대식(姜大植),기동민(奇東旻),53,3,56,1
317,강대식(姜大植),김경만(金京萬),53,4,57,1
318,강대식(姜大植),김경협(金炅俠),51,4,55,1
319,강대식(姜大植),김교흥(金敎興),53,3,56,1
320,강대식(姜大植),김기현(金起炫),98,110,208,0
321,강대식(姜大植),김남국(金南局),45,3,48,1
322,강대식(姜大植),김도읍(金度邑),74,88,162,0
323,강대식(姜大植),김두관(金斗官),53,10,63,1
324,강대식(姜大植),김미애(金美愛),85,114,199,0
325,강대식(姜大植),김민기(金敏基),55,4,59,1
326,강대식(姜大植),김민석(金民錫),52,7,59,1
327,강대식(姜大植),김민철(金敏徹),53,9,62,1
328,강대식(姜大植),김병기(金炳基),55,4,59,1
329,강대식(姜大植),김병욱A(金炳旭),52,7,59,1
330,강대식(姜大植),김병욱B(金炳旭),113,222,335,0
331,강대식(姜大植),김병주(金柄周),59,4,63,1
332,강대식(姜大植),김상훈(金相勳),135,151,286,0
333,강대식(姜大植),김상희(金相姬),51,7,58,1
334,강대식(姜大植),김석기(金碩基),108,130,238,0
335,강대식(姜大植),김성원(金成願),110,166,276,0
336,강대식(姜大植),김성주(金成柱),52,10,62,1
337,강대식(姜大植),김성환(金星煥),52,4,56,1
338,강대식(姜大植),김수흥(金洙興),54,6,60,1
339,강대식(姜大植),김승남(金承南),52,4,56,1
340,강대식(姜大植),김승수(金承洙),117,185,302,0
341,강대식(姜大植),김승원(金勝源),53,4,57,1
342,강대식(姜大植),김영배(金永培),55,5,60,1
343,강대식(姜大植),김영선(金映宣),28,24,52,0
344,강대식(姜大植),김영식(金英植),123,190,313,0
345,강대식(姜大植),김영주(金榮珠),53,4,57,1
346,강대식(姜大植),김영진(金榮鎭),53,3,56,1
347,강대식(姜大植),김영호(金映豪),51,4,55,1
348,강대식(姜大植),김예지(金睿智),124,169,293,0
349,강대식(姜大植),김용민(金容民),52,4,56,1
350,강대식(姜大植),김용판(金用判),146,267,413,0
351,강대식(姜大植),김웅(金雄),71,71,142,0
352,강대식(姜大植),김원이(金元二),52,6,58,1
353,강대식(姜大植),김윤덕(金潤德),53,7,60,1
354,강대식(姜大植),김의겸(金宜謙),26,4,30,1
355,강대식(姜大植),김정재(金汀才),109,147,256,0
356,강대식(姜大植),김정호(金禎鎬),52,7,59,1
357,강대식(姜大植),김종민(金鐘民),52,12,64,1
358,강대식(姜大植),김주영(金周暎),52,8,60,1
359,강대식(姜大植),김진표(金振杓),28,1,29,1
360,강대식(姜大植),김철민(金哲玟),52,5,57,1
361,강대식(姜大植),김태년(金太年),50,5,55,1
362,강대식(姜大植),김태호(金台鎬),67,69,136,0
363,강대식(姜大植),김학용(金學容),50,75,125,0
364,강대식(姜大植),김한규(金翰奎),25,6,31,1
365,강대식(姜大植),김한정(金漢正),50,4,54,1
366,강대식(姜大植),김형동(金亨東),94,135,229,0
367,강대식(姜大植),김홍걸(金弘傑),15,5,20,1
368,강대식(姜大植),김회재(金會在),53,3,56,1
369,강대식(姜大植),김희곤(金熙坤),77,106,183,0
370,강대식(姜大植),김희국(金熙國),96,102,198,0
371,강대식(姜大植),남인순(南仁順),50,6,56,1
372,강대식(姜大植),노용호(魯容昊),39,44,83,0
373,강대식(姜大植),노웅래(盧雄來),52,7,59,1
374,강대식(姜大植),도종환(都鍾煥),50,6,56,1
375,강대식(姜大植),류성걸(柳性杰),83,90,173,0
376,강대식(姜大植),류호정(柳好貞),4,6,10,1
377,강대식(姜大植),맹성규(孟聖奎),50,6,56,1
378,강대식(姜大植),문정복(文貞福),49,7,56,1
379,강대식(姜大植),문진석(文振碩),51,4,55,1
380,강대식(姜大植),민병덕(閔炳德),50,7,57,1
381,강대식(姜大植),민형배(閔馨培),35,5,40,1
382,강대식(姜大植),민홍철(閔洪喆),51,7,58,1
383,강대식(姜大植),박광온(朴洸瑥),51,4,55,1
384,강대식(姜大植),박대수(朴大壽),99,190,289,0
385,강대식(姜大植),박대출(朴大出),81,82,163,0
386,강대식(姜大植),박덕흠(朴德欽),74,145,219,0
387,강대식(姜大植),박범계(朴範界),50,4,54,1
388,강대식(姜大植),박병석(朴炳錫),25,3,28,1
389,강대식(姜大植),박상혁(朴商赫),50,5,55,1
390,강대식(姜大植),박성민(朴聖敏),97,169,266,0
391,강대식(姜大植),박성준(朴省俊),53,6,59,1
392,강대식(姜大植),박성중(朴成重),75,93,168,0
393,강대식(姜大植),박수영(朴洙瑩),75,73,148,0
394,강대식(姜大植),박영순(朴英淳),51,4,55,1
395,강대식(姜大植),박완주(朴完柱),25,0,25,1
396,강대식(姜大植),박용진(朴用鎭),49,11,60,1
397,강대식(姜大植),박재호(朴在昊),51,5,56,1
398,강대식(姜大植),박정(朴釘),51,7,58,1
399,강대식(姜大植),박정하(朴正河),43,64,107,0
400,강대식(姜大植),박주민(朴柱民),50,4,54,1
401,강대식(姜大植),박진(朴振),82,94,176,0
402,강대식(姜大植),박찬대(朴贊大),50,4,54,1
403,강대식(姜大植),박형수(朴亨修),71,70,141,0
404,강대식(姜大植),박홍근(朴洪根),53,5,58,1
405,강대식(姜大植),배준영(裵俊英),94,120,214,0
406,강대식(姜大植),배진교(裵晋敎),7,5,12,1
407,강대식(姜大植),배현진(裵賢鎭),76,71,147,0
408,강대식(姜大植),백종헌(白宗憲),109,229,338,0
409,강대식(姜大植),백혜련(白惠蓮),52,5,57,1
410,강대식(姜大植),변재일(卞在一),52,5,57,1
411,강대식(姜大植),서동용(徐東榕),50,6,56,1
412,강대식(姜大植),서범수(徐範洙),83,111,194,0
413,강대식(姜大植),서병수(徐秉洙),82,87,169,0
414,강대식(姜大植),서삼석(徐參錫),50,5,55,1
415,강대식(姜大植),서영교(徐瑛敎),53,7,60,1
416,강대식(姜大植),서영석(徐暎錫),49,8,57,1
417,강대식(姜大植),서일준(徐一俊),112,175,287,0
418,강대식(姜大植),서정숙(徐正淑),88,119,207,0
419,강대식(姜大植),설훈(薛勳),50,8,58,1
420,강대식(姜大植),성일종(成一鍾),93,125,218,0
421,강대식(姜大植),소병철(蘇秉哲),52,6,58,1
422,강대식(姜大植),소병훈(蘇秉勳),51,4,55,1
423,강대식(姜大植),송갑석(宋甲錫),51,4,55,1
424,강대식(姜大植),송기헌(宋基憲),51,10,61,1
425,강대식(姜大植),송석준(宋錫俊),81,100,181,0
426,강대식(姜大植),송언석(宋彦錫),90,113,203,0
427,강대식(姜大植),송옥주(宋玉珠),50,4,54,1
428,강대식(姜大植),송재호(宋在祜),51,6,57,1
429,강대식(姜大植),신동근(申東根),50,3,53,1
430,강대식(姜大植),신영대(申榮大),50,4,54,1
431,강대식(姜大植),신원식(申源湜),96,174,270,0
432,강대식(姜大植),신정훈(辛正勳),52,4,56,1
433,강대식(姜大植),신현영(申賢榮),50,4,54,1
434,강대식(姜大植),심상정(沈相奵),6,4,10,1
435,강대식(姜大植),안규백(安圭伯),59,17,76,1
436,강대식(姜大植),안민석(安敏錫),51,4,55,1
437,강대식(姜大植),안병길(安炳吉),87,105,192,0
438,강대식(姜大植),안철수(安哲秀),30,37,67,0
439,강대식(姜大植),안호영(安浩永),50,4,54,1
440,강대식(姜大植),양경숙(梁敬淑),50,4,54,1
441,강대식(姜大植),양금희(梁琴喜),124,198,322,0
442,강대식(姜大植),양기대(梁基大),51,5,56,1
443,강대식(姜大植),양이원영(梁李媛瑛),45,6,51,1
444,강대식(姜大植),양정숙(梁貞淑),4,12,16,1
445,강대식(姜大植),양향자(梁香子),22,5,27,1
446,강대식(姜大植),어기구(魚基龜),50,5,55,1
447,강대식(姜大植),엄태영(嚴泰永),78,108,186,0
448,강대식(姜大植),오기형(吳奇炯),49,9,58,1
449,강대식(姜大植),오영환(吳永煥),51,7,58,1
450,강대식(姜大植),용혜인(龍慧仁),1,2,3,1
451,강대식(姜大植),우상호(禹相虎),51,4,55,1
452,강대식(姜大植),우원식(禹元植),50,4,54,1
453,강대식(姜大植),위성곤(魏聖坤),51,6,57,1
454,강대식(姜大植),유경준(兪京濬),122,193,315,0
455,강대식(姜大植),유기홍(柳基洪),50,6,56,1
456,강대식(姜大植),유동수(柳東秀),50,7,57,1
457,강대식(姜大植),유상범(劉相凡),75,90,165,0
458,강대식(姜大植),유의동(兪義東),80,161,241,0
459,강대식(姜大植),유정주(兪訂炷),49,4,53,1
460,강대식(姜大植),윤건영(尹建永),49,4,53,1
461,강대식(姜大植),윤관석(尹官石),41,0,41,1
462,강대식(姜大植),윤두현(尹斗鉉),104,177,281,0
463,강대식(姜大植),윤미향(尹美香),20,0,20,1
464,강대식(姜大植),윤상현(尹相現),39,39,78,0
465,강대식(姜大植),윤영덕(尹永德),49,6,55,1
466,강대식(姜大植),윤영석(尹永碩),70,57,127,0
467,강대식(姜大植),윤영찬(尹永燦),50,6,56,1
468,강대식(姜大植),윤재갑(尹才鉀),56,11,67,1
469,강대식(姜大植),윤재옥(尹在玉),86,96,182,0
470,강대식(姜大植),윤주경(尹柱卿),85,105,190,0
471,강대식(姜大植),윤준병(尹準炳),51,4,55,1
472,강대식(姜大植),윤창현(尹暢賢),100,135,235,0
473,강대식(姜大植),윤한홍(尹漢洪),95,105,200,0
474,강대식(姜大植),윤호중(尹昊重),52,4,56,1
475,강대식(姜大植),윤후덕(尹厚德),51,6,57,1
476,강대식(姜大植),이개호(李介昊),51,5,56,1
477,강대식(姜大植),이달곤(李達坤),68,81,149,0
478,강대식(姜大植),이동주(李東洲),49,4,53,1
479,강대식(姜大植),이만희(李晩熙),91,91,182,0
480,강대식(姜大植),이명수(李明洙),100,153,253,0
481,강대식(姜大植),이병훈(李炳勳),53,5,58,1
482,강대식(姜大植),이상민(李相珉),50,4,54,1
483,강대식(姜大植),이상헌(李相憲),52,4,56,1
484,강대식(姜大植),이성만(李成萬),42,1,43,1
485,강대식(姜大植),이소영(李素永),52,4,56,1
486,강대식(姜大植),이수진(李壽珍),51,5,56,1
487,강대식(姜大植),이수진(李秀眞),50,5,55,1
488,강대식(姜大植),이양수(李亮壽),86,108,194,0
489,강대식(姜大植),이용(李鏞),87,109,196,0
490,강대식(姜大植),이용빈(李龍彬),53,7,60,1
491,강대식(姜大植),이용선(李庸瑄),50,6,56,1
492,강대식(姜大植),이용우(李龍雨),49,10,59,1
493,강대식(姜大植),이용호(李容鎬),30,21,51,0
494,강대식(姜大植),이원욱(李元旭),51,4,55,1
495,강대식(姜大植),이원택(李源澤),50,4,54,1
496,강대식(姜大植),이은주(李恩周),7,6,13,1
497,강대식(姜大植),이인선(李仁善),31,86,117,0
498,강대식(姜大植),이인영(李仁榮),50,4,54,1
499,강대식(姜大植),이장섭(李將燮),50,6,56,1
500,강대식(姜大植),이재명(李在明),25,4,29,1
501,강대식(姜大植),이재정(李在汀),50,4,54,1
502,강대식(姜大植),이정문(李楨文),52,6,58,1
503,강대식(姜大植),이종배(李鍾培),95,101,196,0
504,강대식(姜大植),이종성(李鍾成),106,140,246,0
505,강대식(姜大植),이주환(李周桓),98,132,230,0
506,강대식(姜大植),이채익(李埰益),93,122,215,0
507,강대식(姜大植),이철규(李喆圭),82,86,168,0
508,강대식(姜大植),이탄희(李誕熙),51,4,55,1
509,강대식(姜大植),이태규(李泰珪),46,49,95,0
510,강대식(姜大植),이학영(李學永),49,4,53,1
511,강대식(姜大植),이해식(李海植),50,4,54,1
512,강대식(姜大植),이헌승(李憲昇),72,74,146,0
513,강대식(姜大植),이형석(李炯錫),50,4,54,1
514,강대식(姜大植),인재근(印在謹),51,6,57,1
515,강대식(姜大植),임병헌(林炳憲),42,49,91,0
516,강대식(姜大植),임오경(林五卿),50,4,54,1
517,강대식(姜大植),임이자(林利子),89,102,191,0
518,강대식(姜大植),임종성(林鍾聲),53,8,61,1
519,강대식(姜大植),임호선(林昊宣),52,8,60,1
520,강대식(姜大植),장경태(張耿態),51,5,56,1
521,강대식(姜大植),장동혁(張東赫),30,26,56,0
522,강대식(姜大植),장제원(張濟元),64,39,103,0
523,강대식(姜大植),장철민(張喆敏),51,6,57,1
524,강대식(姜大植),장혜영(張惠英),7,5,12,1
525,강대식(姜大植),전봉민(田奉珉),66,70,136,0
526,강대식(姜大植),전용기(田溶冀),50,5,55,1
527,강대식(姜大植),전재수(田載秀),50,4,54,1
528,강대식(姜大植),전주혜(全珠惠),89,128,217,0
529,강대식(姜大植),전해철(全海澈),50,4,54,1
530,강대식(姜大植),전혜숙(全惠淑),50,9,59,1
531,강대식(姜大植),정경희(丁慶姬),78,116,194,0
532,강대식(姜大植),정동만(鄭東萬),81,129,210,0
533,강대식(姜大植),정성호(鄭成湖),55,6,61,1
534,강대식(姜大植),정우택(鄭宇澤),50,59,109,0
535,강대식(姜大植),정운천(鄭雲天),80,72,152,0
536,강대식(姜大植),정일영(鄭日永),50,5,55,1
537,강대식(姜大植),정점식(鄭点植),70,59,129,0
538,강대식(姜大植),정진석(鄭鎭碩),79,97,176,0
539,강대식(姜大植),정청래(鄭淸來),49,4,53,1
540,강대식(姜大植),정춘숙(鄭春淑),51,5,56,1
541,강대식(姜大植),정태호(鄭泰浩),50,5,55,1
542,강대식(姜大植),정필모(鄭必模),50,4,54,1
543,강대식(姜大植),정희용(鄭熙溶),96,157,253,0
544,강대식(姜大植),조경태(趙慶泰),86,94,180,0
545,강대식(姜大植),조명희(曺明姬),112,157,269,0
546,강대식(姜大植),조수진(趙修眞),106,154,260,0
547,강대식(姜大植),조승래(趙承來),50,5,55,1
548,강대식(姜大植),조오섭(曺五燮),50,4,54,1
549,강대식(姜大植),조은희(趙恩禧),39,34,73,0
550,강대식(姜大植),조응천(趙應天),51,4,55,1
551,강대식(姜大植),조정식(趙正湜),49,3,52,1
552,강대식(姜大植),조정훈(趙廷訓),2,5,7,1
553,강대식(姜大植),조해진(曺海珍),68,52,120,0
554,강대식(姜大植),주철현(朱哲鉉),53,5,58,1
555,강대식(姜大植),주호영(朱豪英),68,69,137,0
556,강대식(姜大植),지성호(池成浩),93,133,226,0
557,강대식(姜大植),진선미(陳善美),50,4,54,1
558,강대식(姜大植),진성준(陳聲準),50,4,54,1
559,강대식(姜大植),천준호(千俊鎬),49,3,52,1
560,강대식(姜大植),최기상(崔基相),50,4,54,1
561,강대식(姜大植),최승재(崔承宰),91,122,213,0
562,강대식(姜大植),최연숙(崔姸淑),44,56,100,0
563,강대식(姜大植),최영희(崔英姬),34,49,83,0
564,강대식(姜大植),최인호(崔仁昊),53,4,57,1
565,강대식(姜大植),최재형(崔在亨),32,17,49,0
566,강대식(姜大植),최종윤(崔鍾允),52,6,58,1
567,강대식(姜大植),최춘식(崔春植),96,143,239,0
568,강대식(姜大植),최형두(崔炯斗),84,86,170,0
569,강대식(姜大植),최혜영(崔惠英),50,5,55,1
570,강대식(姜大植),추경호(秋慶鎬),128,164,292,0
571,강대식(姜大植),태영호(太永浩),100,155,255,0
572,강대식(姜大植),하영제(河榮帝),100,169,269,1
573,강대식(姜大植),하태경(河泰慶),67,64,131,0
574,강대식(姜大植),한기호(韓起鎬),84,103,187,0
575,강대식(姜大植),한무경(韓茂景),87,136,223,0
576,강대식(姜大植),한병도(韓秉道),50,5,55,1
577,강대식(姜大植),한정애(韓貞愛),50,6,56,1
578,강대식(姜大植),한준호(韓俊鎬),51,4,55,1
579,강대식(姜大植),허숙정(許淑湞),0,0,0,1
580,강대식(姜大植),허영(許榮),52,10,62,1
581,강대식(姜大植),허은아(許垠娥),81,100,181,0
582,강대식(姜大植),허종식(許琮植),50,10,60,1
583,강대식(姜大植),홍기원(洪起元),51,6,57,1
584,강대식(姜大植),홍문표(洪文杓),72,74,146,0
585,강대식(姜大植),홍석준(洪碩晙),104,104,208,0
586,강대식(姜大植),홍성국(洪性國),51,5,56,1
587,강대식(姜大植),홍영표(洪永杓),50,4,54,1
588,강대식(姜大植),홍익표(洪翼杓),51,4,55,1
589,강대식(姜大植),홍정민(洪貞敏),52,6,58,1
590,강대식(姜大植),황보승희(皇甫承希),91,145,236,1
591,강대식(姜大植),황운하(黃雲夏),51,5,56,1
592,강대식(姜大植),황희(黃熙),49,12,61,1
593,강득구(姜得求),강민국(姜旻局),52,4,56,1
594,강득구(姜得求),강민정(姜旼姃),103,258,361,0
595,강득구(姜得求),강병원(姜炳遠),110,137,247,0
596,강득구(姜得求),강선우(姜仙祐),103,126,229,0
597,강득구(姜得求),강성희(姜聖熙),5,2,7,1
598,강득구(姜得求),강은미(姜恩美),28,42,70,1
599,강득구(姜得求),강준현(康準鉉),111,114,225,0
600,강득구(姜得求),강훈식(姜勳植),100,92,192,0
601,강득구(姜得求),고민정(高旼廷),100,83,183,0
602,강득구(姜得求),고영인(高永寅),133,146,279,0
603,강득구(姜得求),고용진(高榕禛),93,91,184,0
604,강득구(姜得求),구자근(具滋根),51,4,55,1
605,강득구(姜得求),권명호(權明浩),51,4,55,1
606,강득구(姜得求),권성동(權性東),43,4,47,1
607,강득구(姜得求),권영세(權寧世),52,5,57,1
608,강득구(姜得求),권은희(權垠希),31,10,41,1
609,강득구(姜得求),권인숙(權仁淑),129,159,288,0
610,강득구(姜得求),권칠승(權七勝),96,92,188,0
611,강득구(姜得求),기동민(奇東旻),101,107,208,0
612,강득구(姜得求),김경만(金京萬),120,127,247,0
613,강득구(姜得求),김경협(金炅俠),96,76,172,0
614,강득구(姜得求),김교흥(金敎興),101,79,180,0
615,강득구(姜得求),김기현(金起炫),53,6,59,1
616,강득구(姜得求),김남국(金南局),112,144,256,1
617,강득구(姜得求),김도읍(金度邑),51,4,55,1
618,강득구(姜得求),김두관(金斗官),92,135,227,0
619,강득구(姜得求),김미애(金美愛),51,4,55,1
620,강득구(姜得求),김민기(金敏基),98,92,190,0
621,강득구(姜得求),김민석(金民錫),135,192,327,0
622,강득구(姜得求),김민철(金敏徹),126,187,313,0
623,강득구(姜得求),김병기(金炳基),99,89,188,0
624,강득구(姜得求),김병욱A(金炳旭),108,155,263,0
625,강득구(姜得求),김병욱B(金炳旭),45,5,50,1
626,강득구(姜得求),김병주(金柄周),95,72,167,0
627,강득구(姜得求),김상훈(金相勳),53,5,58,1
628,강득구(姜得求),김상희(金相姬),100,103,203,0
629,강득구(姜得求),김석기(金碩基),52,5,57,1
630,강득구(姜得求),김성원(金成願),52,8,60,1
631,강득구(姜得求),김성주(金成柱),102,116,218,0
632,강득구(姜得求),김성환(金星煥),101,134,235,0
633,강득구(姜得求),김수흥(金洙興),124,155,279,0
634,강득구(姜得求),김승남(金承南),103,141,244,0
635,강득구(姜得求),김승수(金承洙),53,8,61,1
636,강득구(姜得求),김승원(金勝源),144,232,376,0
637,강득구(姜得求),김영배(金永培),127,162,289,0
638,강득구(姜得求),김영선(金映宣),26,4,30,1
639,강득구(姜得求),김영식(金英植),53,4,57,1
640,강득구(姜得求),김영주(金榮珠),90,106,196,0
641,강득구(姜得求),김영진(金榮鎭),90,83,173,0
642,강득구(姜得求),김영호(金映豪),111,143,254,0
643,강득구(姜得求),김예지(金睿智),55,9,64,1
644,강득구(姜得求),김용민(金容民),102,132,234,0
645,강득구(姜得求),김용판(金用判),52,4,56,1
646,강득구(姜得求),김웅(金雄),51,4,55,1
647,강득구(姜得求),김원이(金元二),104,95,199,0
648,강득구(姜得求),김윤덕(金潤德),97,122,219,0
649,강득구(姜得求),김의겸(金宜謙),58,98,156,0
650,강득구(姜得求),김정재(金汀才),53,5,58,1
651,강득구(姜得求),김정호(金禎鎬),120,234,354,0
652,강득구(姜得求),김종민(金鐘民),86,84,170,0
653,강득구(姜得求),김주영(金周暎),117,141,258,0
654,강득구(姜得求),김진표(金振杓),52,57,109,1
655,강득구(姜得求),김철민(金哲玟),123,212,335,0
656,강득구(姜得求),김태년(金太年),83,76,159,0
657,강득구(姜得求),김태호(金台鎬),42,5,47,1
658,강득구(姜得求),김학용(金學容),26,7,33,1
659,강득구(姜得求),김한규(金翰奎),43,51,94,0
660,강득구(姜得求),김한정(金漢正),84,58,142,0
661,강득구(姜得求),김형동(金亨東),51,6,57,1
662,강득구(姜得求),김홍걸(金弘傑),61,152,213,0
663,강득구(姜得求),김회재(金會在),108,107,215,0
664,강득구(姜得求),김희곤(金熙坤),52,8,60,1
665,강득구(姜得求),김희국(金熙國),49,4,53,1
666,강득구(姜得求),남인순(南仁順),116,126,242,0
667,강득구(姜得求),노용호(魯容昊),25,4,29,1
668,강득구(姜得求),노웅래(盧雄來),110,85,195,0
669,강득구(姜得求),도종환(都鍾煥),104,118,222,0
670,강득구(姜得求),류성걸(柳性杰),49,4,53,1
671,강득구(姜得求),류호정(柳好貞),26,58,84,1
672,강득구(姜得求),맹성규(孟聖奎),113,100,213,0
673,강득구(姜得求),문정복(文貞福),102,118,220,0
674,강득구(姜得求),문진석(文振碩),107,131,238,0
675,강득구(姜得求),민병덕(閔炳德),123,246,369,0
676,강득구(姜得求),민형배(閔馨培),117,260,377,0
677,강득구(姜得求),민홍철(閔洪喆),83,88,171,0
678,강득구(姜得求),박광온(朴洸瑥),91,89,180,0
679,강득구(姜得求),박대수(朴大壽),49,6,55,1
680,강득구(姜得求),박대출(朴大出),50,4,54,1
681,강득구(姜得求),박덕흠(朴德欽),38,6,44,1
682,강득구(姜得求),박범계(朴範界),76,38,114,0
683,강득구(姜得求),박병석(朴炳錫),41,21,62,0
684,강득구(姜得求),박상혁(朴商赫),109,162,271,0
685,강득구(姜得求),박성민(朴聖敏),49,5,54,1
686,강득구(姜得求),박성준(朴省俊),138,162,300,0
687,강득구(姜得求),박성중(朴成重),49,4,53,1
688,강득구(姜得求),박수영(朴洙瑩),49,5,54,1
689,강득구(姜得求),박영순(朴英淳),108,127,235,0
690,강득구(姜得求),박완주(朴完柱),56,57,113,1
691,강득구(姜得求),박용진(朴用鎭),81,56,137,0
692,강득구(姜得求),박재호(朴在昊),90,64,154,0
693,강득구(姜得求),박정(朴釘),123,121,244,0
694,강득구(姜得求),박정하(朴正河),25,4,29,1
695,강득구(姜得求),박주민(朴柱民),92,92,184,0
696,강득구(姜得求),박진(朴振),50,5,55,1
697,강득구(姜得求),박찬대(朴贊大),104,144,248,0
698,강득구(姜得求),박형수(朴亨修),49,4,53,1
699,강득구(姜得求),박홍근(朴洪根),110,122,232,0
700,강득구(姜得求),배준영(裵俊英),49,5,54,1
701,강득구(姜得求),배진교(裵晋敎),23,36,59,1
702,강득구(姜得求),배현진(裵賢鎭),50,4,54,1
703,강득구(姜得求),백종헌(白宗憲),50,6,56,1
704,강득구(姜得求),백혜련(白惠蓮),99,80,179,0
705,강득구(姜得求),변재일(卞在一),81,69,150,0
706,강득구(姜得求),서동용(徐東榕),121,173,294,0
707,강득구(姜得求),서범수(徐範洙),53,6,59,1
708,강득구(姜得求),서병수(徐秉洙),50,4,54,1
709,강득구(姜得求),서삼석(徐參錫),100,73,173,0
710,강득구(姜得求),서영교(徐瑛敎),121,171,292,0
711,강득구(姜得求),서영석(徐暎錫),109,157,266,0
712,강득구(姜得求),서일준(徐一俊),50,5,55,1
713,강득구(姜得求),서정숙(徐正淑),49,5,54,1
714,강득구(姜得求),설훈(薛勳),86,81,167,0
715,강득구(姜得求),성일종(成一鍾),50,4,54,1
716,강득구(姜得求),소병철(蘇秉哲),100,74,174,0
717,강득구(姜得求),소병훈(蘇秉勳),101,110,211,0
718,강득구(姜得求),송갑석(宋甲錫),113,163,276,0
719,강득구(姜得求),송기헌(宋基憲),86,56,142,0
720,강득구(姜得求),송석준(宋錫俊),52,5,57,1
721,강득구(姜得求),송언석(宋彦錫),45,4,49,1
722,강득구(姜得求),송옥주(宋玉珠),110,133,243,0
723,강득구(姜得求),송재호(宋在祜),119,135,254,0
724,강득구(姜得求),신동근(申東根),94,82,176,0
725,강득구(姜得求),신영대(申榮大),90,71,161,0
726,강득구(姜得求),신원식(申源湜),49,4,53,1
727,강득구(姜得求),신정훈(辛正勳),126,236,362,0
728,강득구(姜得求),신현영(申賢榮),88,69,157,0
729,강득구(姜得求),심상정(沈相奵),24,62,86,1
730,강득구(姜得求),안규백(安圭伯),112,114,226,0
731,강득구(姜得求),안민석(安敏錫),95,112,207,0
732,강득구(姜得求),안병길(安炳吉),53,5,58,1
733,강득구(姜得求),안철수(安哲秀),26,5,31,1
734,강득구(姜得求),안호영(安浩永),97,87,184,0
735,강득구(姜得求),양경숙(梁敬淑),111,154,265,0
736,강득구(姜得求),양금희(梁琴喜),50,5,55,1
737,강득구(姜得求),양기대(梁基大),106,98,204,0
738,강득구(姜得求),양이원영(梁李媛瑛),110,136,246,0
739,강득구(姜得求),양정숙(梁貞淑),94,270,364,1
740,강득구(姜得求),양향자(梁香子),44,53,97,1
741,강득구(姜得求),어기구(魚基龜),91,62,153,0
742,강득구(姜得求),엄태영(嚴泰永),51,5,56,1
743,강득구(姜得求),오기형(吳奇炯),87,56,143,0
744,강득구(姜得求),오영환(吳永煥),153,285,438,0
745,강득구(姜得求),용혜인(龍慧仁),33,87,120,1
746,강득구(姜得求),우상호(禹相虎),80,44,124,0
747,강득구(姜得求),우원식(禹元植),105,92,197,0
748,강득구(姜得求),위성곤(魏聖坤),103,151,254,0
749,강득구(姜得求),유경준(兪京濬),50,5,55,1
750,강득구(姜得求),유기홍(柳基洪),89,91,180,0
751,강득구(姜得求),유동수(柳東秀),93,65,158,0
752,강득구(姜得求),유상범(劉相凡),49,4,53,1
753,강득구(姜得求),유의동(兪義東),52,5,57,1
754,강득구(姜得求),유정주(兪訂炷),136,198,334,0
755,강득구(姜得求),윤건영(尹建永),99,96,195,0
756,강득구(姜得求),윤관석(尹官石),84,75,159,1
757,강득구(姜得求),윤두현(尹斗鉉),49,5,54,1
758,강득구(姜得求),윤미향(尹美香),58,103,161,1
759,강득구(姜得求),윤상현(尹相現),31,6,37,1
760,강득구(姜得求),윤영덕(尹永德),124,168,292,0
761,강득구(姜得求),윤영석(尹永碩),50,6,56,1
762,강득구(姜得求),윤영찬(尹永燦),91,98,189,0
763,강득구(姜得求),윤재갑(尹才鉀),110,137,247,0
764,강득구(姜得求),윤재옥(尹在玉),52,5,57,1
765,강득구(姜得求),윤주경(尹柱卿),49,5,54,1
766,강득구(姜得求),윤준병(尹準炳),125,249,374,0
767,강득구(姜得求),윤창현(尹暢賢),49,4,53,1
768,강득구(姜得求),윤한홍(尹漢洪),50,4,54,1
769,강득구(姜得求),윤호중(尹昊重),81,62,143,0
770,강득구(姜得求),윤후덕(尹厚德),101,113,214,0
771,강득구(姜得求),이개호(李介昊),88,73,161,0
772,강득구(姜得求),이달곤(李達坤),52,7,59,1
773,강득구(姜得求),이동주(李東洲),107,162,269,0
774,강득구(姜得求),이만희(李晩熙),49,4,53,1
775,강득구(姜得求),이명수(李明洙),60,18,78,1
776,강득구(姜得求),이병훈(李炳勳),108,137,245,0
777,강득구(姜得求),이상민(李相珉),79,43,122,0
778,강득구(姜得求),이상헌(李相憲),102,122,224,0
779,강득구(姜得求),이성만(李成萬),115,195,310,1
780,강득구(姜得求),이소영(李素永),108,86,194,0
781,강득구(姜得求),이수진(李壽珍),132,255,387,0
782,강득구(姜得求),이수진(李秀眞),121,151,272,0
783,강득구(姜得求),이양수(李亮壽),51,5,56,1
784,강득구(姜得求),이용(李鏞),49,4,53,1
785,강득구(姜得求),이용빈(李龍彬),151,324,475,0
786,강득구(姜得求),이용선(李庸瑄),105,118,223,0
787,강득구(姜得求),이용우(李龍雨),100,99,199,0
788,강득구(姜得求),이용호(李容鎬),36,25,61,1
789,강득구(姜得求),이원욱(李元旭),107,187,294,0
790,강득구(姜得求),이원택(李源澤),97,101,198,0
791,강득구(姜得求),이은주(李恩周),29,36,65,1
792,강득구(姜得求),이인선(李仁善),25,4,29,1
793,강득구(姜得求),이인영(李仁榮),79,62,141,0
794,강득구(姜得求),이장섭(李將燮),90,102,192,0
795,강득구(姜得求),이재명(李在明),40,22,62,0
796,강득구(姜得求),이재정(李在汀),99,88,187,0
797,강득구(姜得求),이정문(李楨文),107,163,270,0
798,강득구(姜得求),이종배(李鍾培),50,6,56,1
799,강득구(姜得求),이종성(李鍾成),49,4,53,1
800,강득구(姜得求),이주환(李周桓),49,4,53,1
801,강득구(姜得求),이채익(李埰益),52,9,61,1
802,강득구(姜得求),이철규(李喆圭),50,4,54,1
803,강득구(姜得求),이탄희(李誕熙),108,103,211,0
804,강득구(姜得求),이태규(李泰珪),30,6,36,1
805,강득구(姜得求),이학영(李學永),100,114,214,0
806,강득구(姜得求),이해식(李海植),102,99,201,0
807,강득구(姜得求),이헌승(李憲昇),51,4,55,1
808,강득구(姜得求),이형석(李炯錫),116,121,237,0
809,강득구(姜得求),인재근(印在謹),102,91,193,0
810,강득구(姜得求),임병헌(林炳憲),25,4,29,1
811,강득구(姜得求),임오경(林五卿),98,95,193,0
812,강득구(姜得求),임이자(林利子),49,4,53,1
813,강득구(姜得求),임종성(林鍾聲),119,149,268,0
814,강득구(姜得求),임호선(林昊宣),109,215,324,0
815,강득구(姜得求),장경태(張耿態),117,170,287,0
816,강득구(姜得求),장동혁(張東赫),25,4,29,1
817,강득구(姜得求),장제원(張濟元),49,4,53,1
818,강득구(姜得求),장철민(張喆敏),104,110,214,0
819,강득구(姜得求),장혜영(張惠英),15,30,45,1
820,강득구(姜得求),전봉민(田奉珉),35,5,40,1
821,강득구(姜得求),전용기(田溶冀),103,142,245,0
822,강득구(姜得求),전재수(田載秀),87,104,191,0
823,강득구(姜得求),전주혜(全珠惠),51,4,55,1
824,강득구(姜得求),전해철(全海澈),82,86,168,0
825,강득구(姜得求),전혜숙(全惠淑),103,102,205,0
826,강득구(姜得求),정경희(丁慶姬),49,4,53,1
827,강득구(姜得求),정동만(鄭東萬),49,5,54,1
828,강득구(姜得求),정성호(鄭成湖),87,101,188,0
829,강득구(姜得求),정우택(鄭宇澤),25,5,30,1
830,강득구(姜得求),정운천(鄭雲天),49,5,54,1
831,강득구(姜得求),정일영(鄭日永),109,152,261,0
832,강득구(姜得求),정점식(鄭点植),50,4,54,1
833,강득구(姜得求),정진석(鄭鎭碩),52,7,59,1
834,강득구(姜得求),정청래(鄭淸來),111,101,212,0
835,강득구(姜得求),정춘숙(鄭春淑),105,122,227,0
836,강득구(姜得求),정태호(鄭泰浩),89,106,195,0
837,강득구(姜得求),정필모(鄭必模),98,108,206,0
838,강득구(姜得求),정희용(鄭熙溶),50,5,55,1
839,강득구(姜得求),조경태(趙慶泰),49,5,54,1
840,강득구(姜得求),조명희(曺明姬),50,6,56,1
841,강득구(姜得求),조수진(趙修眞),52,4,56,1
842,강득구(姜得求),조승래(趙承來),104,120,224,0
843,강득구(姜得求),조오섭(曺五燮),113,210,323,0
844,강득구(姜得求),조은희(趙恩禧),25,4,29,1
845,강득구(姜得求),조응천(趙應天),80,49,129,0
846,강득구(姜得求),조정식(趙正湜),84,59,143,0
847,강득구(姜得求),조정훈(趙廷訓),8,24,32,1
848,강득구(姜得求),조해진(曺海珍),52,5,57,1
849,강득구(姜得求),주철현(朱哲鉉),100,120,220,0
850,강득구(姜得求),주호영(朱豪英),49,4,53,1
851,강득구(姜得求),지성호(池成浩),49,4,53,1
852,강득구(姜得求),진선미(陳善美),83,52,135,0
853,강득구(姜得求),진성준(陳聲準),105,132,237,0
854,강득구(姜得求),천준호(千俊鎬),99,80,179,0
855,강득구(姜得求),최기상(崔基相),92,97,189,0
856,강득구(姜得求),최승재(崔承宰),50,4,54,1
857,강득구(姜得求),최연숙(崔姸淑),36,12,48,1
858,강득구(姜得求),최영희(崔英姬),25,6,31,1
859,강득구(姜得求),최인호(崔仁昊),90,84,174,0
860,강득구(姜得求),최재형(崔在亨),25,5,30,1
861,강득구(姜得求),최종윤(崔鍾允),122,169,291,0
862,강득구(姜得求),최춘식(崔春植),49,6,55,1
863,강득구(姜得求),최형두(崔炯斗),51,6,57,1
864,강득구(姜得求),최혜영(崔惠英),133,212,345,0
865,강득구(姜得求),추경호(秋慶鎬),49,4,53,1
866,강득구(姜得求),태영호(太永浩),49,4,53,1
867,강득구(姜得求),하영제(河榮帝),41,1,42,1
868,강득구(姜得求),하태경(河泰慶),51,4,55,1
869,강득구(姜得求),한기호(韓起鎬),50,6,56,1
870,강득구(姜得求),한무경(韓茂景),50,6,56,1
871,강득구(姜得求),한병도(韓秉道),124,157,281,0
872,강득구(姜得求),한정애(韓貞愛),86,87,173,0
873,강득구(姜得求),한준호(韓俊鎬),104,141,245,0
874,강득구(姜得求),허숙정(許淑湞),1,1,2,0
875,강득구(姜得求),허영(許榮),120,155,275,0
876,강득구(姜得求),허은아(許垠娥),49,4,53,1
877,강득구(姜得求),허종식(許琮植),112,145,257,0
878,강득구(姜得求),홍기원(洪起元),104,123,227,0
879,강득구(姜得求),홍문표(洪文杓),50,5,55,1
880,강득구(姜得求),홍석준(洪碩晙),50,4,54,1
881,강득구(姜得求),홍성국(洪性國),132,160,292,0
882,강득구(姜得求),홍영표(洪永杓),86,71,157,0
883,강득구(姜得求),홍익표(洪翼杓),93,90,183,0
884,강득구(姜得求),홍정민(洪貞敏),123,165,288,0
885,강득구(姜得求),황보승희(皇甫承希),48,4,52,1
886,강득구(姜得求),황운하(黃雲夏),105,145,250,0
887,강득구(姜得求),황희(黃熙),79,47,126,0
888,강민국(姜旻局),강민정(姜旼姃),27,3,30,1
889,강민국(姜旻局),강병원(姜炳遠),52,4,56,1
890,강민국(姜旻局),강선우(姜仙祐),52,4,56,1
891,강민국(姜旻局),강성희(姜聖熙),0,0,0,1
892,강민국(姜旻局),강은미(姜恩美),5,3,8,1
893,강민국(姜旻局),강준현(康準鉉),52,4,56,1
894,강민국(姜旻局),강훈식(姜勳植),53,5,58,1
895,강민국(姜旻局),고민정(高旼廷),52,3,55,1
896,강민국(姜旻局),고영인(高永寅),53,4,57,1
897,강민국(姜旻局),고용진(高榕禛),52,4,56,1
898,강민국(姜旻局),구자근(具滋根),87,86,173,0
899,강민국(姜旻局),권명호(權明浩),99,101,200,0
900,강민국(姜旻局),권성동(權性東),62,45,107,0
901,강민국(姜旻局),권영세(權寧世),68,54,122,0
902,강민국(姜旻局),권은희(權垠希),39,36,75,0
903,강민국(姜旻局),권인숙(權仁淑),51,4,55,1
904,강민국(姜旻局),권칠승(權七勝),53,4,57,1
905,강민국(姜旻局),기동민(奇東旻),52,3,55,1
906,강민국(姜旻局),김경만(金京萬),52,4,56,1
907,강민국(姜旻局),김경협(金炅俠),51,4,55,1
908,강민국(姜旻局),김교흥(金敎興),52,6,58,1
909,강민국(姜旻局),김기현(金起炫),83,79,162,0
910,강민국(姜旻局),김남국(金南局),43,0,43,1
911,강민국(姜旻局),김도읍(金度邑),68,65,133,0
912,강민국(姜旻局),김두관(金斗官),52,5,57,1
913,강민국(姜旻局),김미애(金美愛),73,69,142,0
914,강민국(姜旻局),김민기(金敏基),52,6,58,1
915,강민국(姜旻局),김민석(金民錫),52,6,58,1
916,강민국(姜旻局),김민철(金敏徹),53,8,61,1
917,강민국(姜旻局),김병기(金炳基),53,6,59,1
918,강민국(姜旻局),김병욱A(金炳旭),52,6,58,1
919,강민국(姜旻局),김병욱B(金炳旭),92,100,192,0
920,강민국(姜旻局),김병주(金柄周),53,3,56,1
921,강민국(姜旻局),김상훈(金相勳),75,69,144,0
922,강민국(姜旻局),김상희(金相姬),51,5,56,1
923,강민국(姜旻局),김석기(金碩基),85,94,179,0
924,강민국(姜旻局),김성원(金成願),81,83,164,0
925,강민국(姜旻局),김성주(金成柱),52,10,62,1
926,강민국(姜旻局),김성환(金星煥),52,4,56,1
927,강민국(姜旻局),김수흥(金洙興),53,4,57,1
928,강민국(姜旻局),김승남(金承南),52,4,56,1
929,강민국(姜旻局),김승수(金承洙),82,79,161,0
930,강민국(姜旻局),김승원(金勝源),52,5,57,1
931,강민국(姜旻局),김영배(金永培),54,6,60,1
932,강민국(姜旻局),김영선(金映宣),28,12,40,0
933,강민국(姜旻局),김영식(金英植),101,107,208,0
934,강민국(姜旻局),김영주(金榮珠),52,4,56,1
935,강민국(姜旻局),김영진(金榮鎭),52,4,56,1
936,강민국(姜旻局),김영호(金映豪),51,4,55,1
937,강민국(姜旻局),김예지(金睿智),79,78,157,0
938,강민국(姜旻局),김용민(金容民),52,4,56,1
939,강민국(姜旻局),김용판(金用判),91,103,194,0
940,강민국(姜旻局),김웅(金雄),68,54,122,0
941,강민국(姜旻局),김원이(金元二),52,4,56,1
942,강민국(姜旻局),김윤덕(金潤德),52,4,56,1
943,강민국(姜旻局),김의겸(金宜謙),26,4,30,1
944,강민국(姜旻局),김정재(金汀才),93,73,166,0
945,강민국(姜旻局),김정호(金禎鎬),52,9,61,1
946,강민국(姜旻局),김종민(金鐘民),52,11,63,1
947,강민국(姜旻局),김주영(金周暎),52,5,57,1
948,강민국(姜旻局),김진표(金振杓),26,0,26,1
949,강민국(姜旻局),김철민(金哲玟),50,3,53,1
950,강민국(姜旻局),김태년(金太年),50,5,55,1
951,강민국(姜旻局),김태호(金台鎬),59,52,111,0
952,강민국(姜旻局),김학용(金學容),31,25,56,0
953,강민국(姜旻局),김한규(金翰奎),25,6,31,1
954,강민국(姜旻局),김한정(金漢正),49,4,53,1
955,강민국(姜旻局),김형동(金亨東),87,75,162,0
956,강민국(姜旻局),김홍걸(金弘傑),16,6,22,1
957,강민국(姜旻局),김회재(金會在),51,3,54,1
958,강민국(姜旻局),김희곤(金熙坤),81,69,150,0
959,강민국(姜旻局),김희국(金熙國),67,41,108,0
960,강민국(姜旻局),남인순(南仁順),49,8,57,1
961,강민국(姜旻局),노용호(魯容昊),31,20,51,0
962,강민국(姜旻局),노웅래(盧雄來),51,6,57,1
963,강민국(姜旻局),도종환(都鍾煥),50,4,54,1
964,강민국(姜旻局),류성걸(柳性杰),70,55,125,0
965,강민국(姜旻局),류호정(柳好貞),4,7,11,1
966,강민국(姜旻局),맹성규(孟聖奎),50,4,54,1
967,강민국(姜旻局),문정복(文貞福),49,4,53,1
968,강민국(姜旻局),문진석(文振碩),50,5,55,1
969,강민국(姜旻局),민병덕(閔炳德),50,7,57,1
970,강민국(姜旻局),민형배(閔馨培),35,4,39,1
971,강민국(姜旻局),민홍철(閔洪喆),51,4,55,1
972,강민국(姜旻局),박광온(朴洸瑥),50,4,54,1
973,강민국(姜旻局),박대수(朴大壽),88,111,199,0
974,강민국(姜旻局),박대출(朴大出),67,82,149,0
975,강민국(姜旻局),박덕흠(朴德欽),55,60,115,0
976,강민국(姜旻局),박범계(朴範界),50,4,54,1
977,강민국(姜旻局),박병석(朴炳錫),25,3,28,1
978,강민국(姜旻局),박상혁(朴商赫),50,5,55,1
979,강민국(姜旻局),박성민(朴聖敏),94,145,239,0
980,강민국(姜旻局),박성준(朴省俊),50,7,57,1
981,강민국(姜旻局),박성중(朴成重),70,52,122,0
982,강민국(姜旻局),박수영(朴洙瑩),66,56,122,0
983,강민국(姜旻局),박영순(朴英淳),51,3,54,1
984,강민국(姜旻局),박완주(朴完柱),25,0,25,1
985,강민국(姜旻局),박용진(朴用鎭),49,10,59,1
986,강민국(姜旻局),박재호(朴在昊),51,5,56,1
987,강민국(姜旻局),박정(朴釘),50,4,54,1
988,강민국(姜旻局),박정하(朴正河),27,13,40,0
989,강민국(姜旻局),박주민(朴柱民),50,5,55,1
990,강민국(姜旻局),박진(朴振),75,62,137,0
991,강민국(姜旻局),박찬대(朴贊大),50,5,55,1
992,강민국(姜旻局),박형수(朴亨修),65,42,107,0
993,강민국(姜旻局),박홍근(朴洪根),51,5,56,1
994,강민국(姜旻局),배준영(裵俊英),76,73,149,0
995,강민국(姜旻局),배진교(裵晋敎),7,2,9,1
996,강민국(姜旻局),배현진(裵賢鎭),67,57,124,0
997,강민국(姜旻局),백종헌(白宗憲),78,93,171,0
998,강민국(姜旻局),백혜련(白惠蓮),50,6,56,1
999,강민국(姜旻局),변재일(卞在一),51,5,56,1
1000,강민국(姜旻局),서동용(徐東榕),50,4,54,1
1001,강민국(姜旻局),서범수(徐範洙),65,60,125,0
1002,강민국(姜旻局),서병수(徐秉洙),77,69,146,0
1003,강민국(姜旻局),서삼석(徐參錫),49,5,54,1
1004,강민국(姜旻局),서영교(徐瑛敎),50,6,56,1
1005,강민국(姜旻局),서영석(徐暎錫),49,4,53,1
1006,강민국(姜旻局),서일준(徐一俊),95,111,206,0
1007,강민국(姜旻局),서정숙(徐正淑),70,65,135,0
1008,강민국(姜旻局),설훈(薛勳),50,6,56,1
1009,강민국(姜旻局),성일종(成一鍾),83,64,147,0
1010,강민국(姜旻局),소병철(蘇秉哲),51,5,56,1
1011,강민국(姜旻局),소병훈(蘇秉勳),50,4,54,1
1012,강민국(姜旻局),송갑석(宋甲錫),50,4,54,1
1013,강민국(姜旻局),송기헌(宋基憲),50,4,54,1
1014,강민국(姜旻局),송석준(宋錫俊),65,55,120,0
1015,강민국(姜旻局),송언석(宋彦錫),73,61,134,0
1016,강민국(姜旻局),송옥주(宋玉珠),50,3,53,1
1017,강민국(姜旻局),송재호(宋在祜),50,4,54,1
1018,강민국(姜旻局),신동근(申東根),50,3,53,1
1019,강민국(姜旻局),신영대(申榮大),50,4,54,1
1020,강민국(姜旻局),신원식(申源湜),67,62,129,0
1021,강민국(姜旻局),신정훈(辛正勳),50,4,54,1
1022,강민국(姜旻局),신현영(申賢榮),49,4,53,1
1023,강민국(姜旻局),심상정(沈相奵),5,2,7,1
1024,강민국(姜旻局),안규백(安圭伯),52,5,57,1
1025,강민국(姜旻局),안민석(安敏錫),50,5,55,1
1026,강민국(姜旻局),안병길(安炳吉),76,92,168,0
1027,강민국(姜旻局),안철수(安哲秀),26,12,38,0
1028,강민국(姜旻局),안호영(安浩永),50,4,54,1
1029,강민국(姜旻局),양경숙(梁敬淑),50,4,54,1
1030,강민국(姜旻局),양금희(梁琴喜),93,110,203,0
1031,강민국(姜旻局),양기대(梁基大),50,5,55,1
1032,강민국(姜旻局),양이원영(梁李媛瑛),45,5,50,1
1033,강민국(姜旻局),양정숙(梁貞淑),1,5,6,1
1034,강민국(姜旻局),양향자(梁香子),21,4,25,1
1035,강민국(姜旻局),어기구(魚基龜),50,4,54,1
1036,강민국(姜旻局),엄태영(嚴泰永),63,56,119,0
1037,강민국(姜旻局),오기형(吳奇炯),49,9,58,1
1038,강민국(姜旻局),오영환(吳永煥),49,9,58,1
1039,강민국(姜旻局),용혜인(龍慧仁),1,4,5,1
1040,강민국(姜旻局),우상호(禹相虎),50,4,54,1
1041,강민국(姜旻局),우원식(禹元植),49,4,53,1
1042,강민국(姜旻局),위성곤(魏聖坤),50,6,56,1
1043,강민국(姜旻局),유경준(兪京濬),75,63,138,0
1044,강민국(姜旻局),유기홍(柳基洪),50,4,54,1
1045,강민국(姜旻局),유동수(柳東秀),50,6,56,1
1046,강민국(姜旻局),유상범(劉相凡),62,55,117,0
1047,강민국(姜旻局),유의동(兪義東),79,74,153,0
1048,강민국(姜旻局),유정주(兪訂炷),49,4,53,1
1049,강민국(姜旻局),윤건영(尹建永),49,3,52,1
1050,강민국(姜旻局),윤관석(尹官石),41,1,42,1
1051,강민국(姜旻局),윤두현(尹斗鉉),74,79,153,0
1052,강민국(姜旻局),윤미향(尹美香),20,0,20,1
1053,강민국(姜旻局),윤상현(尹相現),34,26,60,0
1054,강민국(姜旻局),윤영덕(尹永德),49,5,54,1
1055,강민국(姜旻局),윤영석(尹永碩),63,47,110,0
1056,강민국(姜旻局),윤영찬(尹永燦),50,4,54,1
1057,강민국(姜旻局),윤재갑(尹才鉀),50,5,55,1
1058,강민국(姜旻局),윤재옥(尹在玉),78,57,135,0
1059,강민국(姜旻局),윤주경(尹柱卿),71,64,135,0
1060,강민국(姜旻局),윤준병(尹準炳),50,4,54,1
1061,강민국(姜旻局),윤창현(尹暢賢),97,91,188,0
1062,강민국(姜旻局),윤한홍(尹漢洪),66,59,125,0
1063,강민국(姜旻局),윤호중(尹昊重),51,4,55,1
1064,강민국(姜旻局),윤후덕(尹厚德),51,5,56,1
1065,강민국(姜旻局),이개호(李介昊),50,4,54,1
1066,강민국(姜旻局),이달곤(李達坤),62,57,119,0
1067,강민국(姜旻局),이동주(李東洲),49,4,53,1
1068,강민국(姜旻局),이만희(李晩熙),66,66,132,0
1069,강민국(姜旻局),이명수(李明洙),76,84,160,0
1070,강민국(姜旻局),이병훈(李炳勳),52,6,58,1
1071,강민국(姜旻局),이상민(李相珉),50,4,54,1
1072,강민국(姜旻局),이상헌(李相憲),51,5,56,1
1073,강민국(姜旻局),이성만(李成萬),41,0,41,1
1074,강민국(姜旻局),이소영(李素永),50,4,54,1
1075,강민국(姜旻局),이수진(李壽珍),50,4,54,1
1076,강민국(姜旻局),이수진(李秀眞),50,5,55,1
1077,강민국(姜旻局),이양수(李亮壽),75,65,140,0
1078,강민국(姜旻局),이용(李鏞),76,65,141,0
1079,강민국(姜旻局),이용빈(李龍彬),51,8,59,1
1080,강민국(姜旻局),이용선(李庸瑄),50,4,54,1
1081,강민국(姜旻局),이용우(李龍雨),49,15,64,1
1082,강민국(姜旻局),이용호(李容鎬),28,15,43,0
1083,강민국(姜旻局),이원욱(李元旭),50,4,54,1
1084,강민국(姜旻局),이원택(李源澤),50,4,54,1
1085,강민국(姜旻局),이은주(李恩周),6,4,10,1
1086,강민국(姜旻局),이인선(李仁善),27,22,49,0
1087,강민국(姜旻局),이인영(李仁榮),50,4,54,1
1088,강민국(姜旻局),이장섭(李將燮),50,4,54,1
1089,강민국(姜旻局),이재명(李在明),25,4,29,1
1090,강민국(姜旻局),이재정(李在汀),50,4,54,1
1091,강민국(姜旻局),이정문(李楨文),51,4,55,1
1092,강민국(姜旻局),이종배(李鍾培),70,53,123,0
1093,강민국(姜旻局),이종성(李鍾成),84,118,202,0
1094,강민국(姜旻局),이주환(李周桓),82,80,162,0
1095,강민국(姜旻局),이채익(李埰益),65,60,125,0
1096,강민국(姜旻局),이철규(李喆圭),73,55,128,0
1097,강민국(姜旻局),이탄희(李誕熙),50,4,54,1
1098,강민국(姜旻局),이태규(李泰珪),36,29,65,0
1099,강민국(姜旻局),이학영(李學永),49,4,53,1
1100,강민국(姜旻局),이해식(李海植),50,4,54,1
1101,강민국(姜旻局),이헌승(李憲昇),72,80,152,0
1102,강민국(姜旻局),이형석(李炯錫),49,4,53,1
1103,강민국(姜旻局),인재근(印在謹),49,5,54,1
1104,강민국(姜旻局),임병헌(林炳憲),29,16,45,0
1105,강민국(姜旻局),임오경(林五卿),50,4,54,1
1106,강민국(姜旻局),임이자(林利子),89,77,166,0
1107,강민국(姜旻局),임종성(林鍾聲),51,6,57,1
1108,강민국(姜旻局),임호선(林昊宣),50,6,56,1
1109,강민국(姜旻局),장경태(張耿態),51,4,55,1
1110,강민국(姜旻局),장동혁(張東赫),28,18,46,0
1111,강민국(姜旻局),장제원(張濟元),59,30,89,0
1112,강민국(姜旻局),장철민(張喆敏),50,4,54,1
1113,강민국(姜旻局),장혜영(張惠英),6,5,11,1
1114,강민국(姜旻局),전봉민(田奉珉),59,68,127,0
1115,강민국(姜旻局),전용기(田溶冀),50,4,54,1
1116,강민국(姜旻局),전재수(田載秀),50,4,54,1
1117,강민국(姜旻局),전주혜(全珠惠),75,74,149,0
1118,강민국(姜旻局),전해철(全海澈),50,4,54,1
1119,강민국(姜旻局),전혜숙(全惠淑),50,5,55,1
1120,강민국(姜旻局),정경희(丁慶姬),63,55,118,0
1121,강민국(姜旻局),정동만(鄭東萬),89,106,195,0
1122,강민국(姜旻局),정성호(鄭成湖),52,7,59,1
1123,강민국(姜旻局),정우택(鄭宇澤),28,28,56,0
1124,강민국(姜旻局),정운천(鄭雲天),79,62,141,0
1125,강민국(姜旻局),정일영(鄭日永),50,7,57,1
1126,강민국(姜旻局),정점식(鄭点植),70,43,113,0
1127,강민국(姜旻局),정진석(鄭鎭碩),74,61,135,0
1128,강민국(姜旻局),정청래(鄭淸來),49,4,53,1
1129,강민국(姜旻局),정춘숙(鄭春淑),51,5,56,1
1130,강민국(姜旻局),정태호(鄭泰浩),50,4,54,1
1131,강민국(姜旻局),정필모(鄭必模),50,4,54,1
1132,강민국(姜旻局),정희용(鄭熙溶),80,64,144,0
1133,강민국(姜旻局),조경태(趙慶泰),66,54,120,0
1134,강민국(姜旻局),조명희(曺明姬),77,97,174,0
1135,강민국(姜旻局),조수진(趙修眞),63,57,120,0
1136,강민국(姜旻局),조승래(趙承來),50,4,54,1
1137,강민국(姜旻局),조오섭(曺五燮),50,4,54,1
1138,강민국(姜旻局),조은희(趙恩禧),29,19,48,0
1139,강민국(姜旻局),조응천(趙應天),51,4,55,1
1140,강민국(姜旻局),조정식(趙正湜),49,4,53,1
1141,강민국(姜旻局),조정훈(趙廷訓),0,2,2,1
1142,강민국(姜旻局),조해진(曺海珍),67,43,110,0
1143,강민국(姜旻局),주철현(朱哲鉉),51,4,55,1
1144,강민국(姜旻局),주호영(朱豪英),65,46,111,0
1145,강민국(姜旻局),지성호(池成浩),81,67,148,0
1146,강민국(姜旻局),진선미(陳善美),50,4,54,1
1147,강민국(姜旻局),진성준(陳聲準),50,4,54,1
1148,강민국(姜旻局),천준호(千俊鎬),49,3,52,1
1149,강민국(姜旻局),최기상(崔基相),49,4,53,1
1150,강민국(姜旻局),최승재(崔承宰),75,72,147,0
1151,강민국(姜旻局),최연숙(崔姸淑),33,40,73,0
1152,강민국(姜旻局),최영희(崔英姬),28,15,43,0
1153,강민국(姜旻局),최인호(崔仁昊),51,4,55,1
1154,강민국(姜旻局),최재형(崔在亨),27,12,39,0
1155,강민국(姜旻局),최종윤(崔鍾允),50,4,54,1
1156,강민국(姜旻局),최춘식(崔春植),67,80,147,0
1157,강민국(姜旻局),최형두(崔炯斗),71,55,126,0
1158,강민국(姜旻局),최혜영(崔惠英),50,4,54,1
1159,강민국(姜旻局),추경호(秋慶鎬),80,75,155,0
1160,강민국(姜旻局),태영호(太永浩),68,70,138,0
1161,강민국(姜旻局),하영제(河榮帝),65,83,148,1
1162,강민국(姜旻局),하태경(河泰慶),69,44,113,0
1163,강민국(姜旻局),한기호(韓起鎬),69,42,111,0
1164,강민국(姜旻局),한무경(韓茂景),94,97,191,0
1165,강민국(姜旻局),한병도(韓秉道),49,4,53,1
1166,강민국(姜旻局),한정애(韓貞愛),50,4,54,1
1167,강민국(姜旻局),한준호(韓俊鎬),50,4,54,1
1168,강민국(姜旻局),허숙정(許淑湞),0,0,0,1
1169,강민국(姜旻局),허영(許榮),50,4,54,1
1170,강민국(姜旻局),허은아(許垠娥),87,81,168,0
1171,강민국(姜旻局),허종식(許琮植),50,6,56,1
1172,강민국(姜旻局),홍기원(洪起元),50,4,54,1
1173,강민국(姜旻局),홍문표(洪文杓),63,44,107,0
1174,강민국(姜旻局),홍석준(洪碩晙),71,49,120,0
1175,강민국(姜旻局),홍성국(洪性國),50,6,56,1
1176,강민국(姜旻局),홍영표(洪永杓),50,4,54,1
1177,강민국(姜旻局),홍익표(洪翼杓),50,4,54,1
1178,강민국(姜旻局),홍정민(洪貞敏),51,5,56,1
1179,강민국(姜旻局),황보승희(皇甫承希),75,89,164,1
1180,강민국(姜旻局),황운하(黃雲夏),50,6,56,1
1181,강민국(姜旻局),황희(黃熙),49,11,60,1
1182,강민정(姜旼姃),강병원(姜炳遠),66,87,153,0
1183,강민정(姜旼姃),강선우(姜仙祐),68,77,145,0
1184,강민정(姜旼姃),강성희(姜聖熙),5,26,31,1
1185,강민정(姜旼姃),강은미(姜恩美),46,218,264,1
1186,강민정(姜旼姃),강준현(康準鉉),69,97,166,0
1187,강민정(姜旼姃),강훈식(姜勳植),63,83,146,0
1188,강민정(姜旼姃),고민정(高旼廷),62,86,148,0
1189,강민정(姜旼姃),고영인(高永寅),84,103,187,0
1190,강민정(姜旼姃),고용진(高榕禛),60,58,118,0
1191,강민정(姜旼姃),구자근(具滋根),27,6,33,1
1192,강민정(姜旼姃),권명호(權明浩),26,4,30,1
1193,강민정(姜旼姃),권성동(權性東),27,3,30,1
1194,강민정(姜旼姃),권영세(權寧世),28,9,37,1
1195,강민정(姜旼姃),권은희(權垠希),28,12,40,1
1196,강민정(姜旼姃),권인숙(權仁淑),82,181,263,0
1197,강민정(姜旼姃),권칠승(權七勝),62,96,158,0
1198,강민정(姜旼姃),기동민(奇東旻),73,144,217,0
1199,강민정(姜旼姃),김경만(金京萬),90,133,223,0
1200,강민정(姜旼姃),김경협(金炅俠),65,61,126,0
1201,강민정(姜旼姃),김교흥(金敎興),56,56,112,0
1202,강민정(姜旼姃),김기현(金起炫),27,4,31,1
1203,강민정(姜旼姃),김남국(金南局),59,160,219,1
1204,강민정(姜旼姃),김도읍(金度邑),26,3,29,1
1205,강민정(姜旼姃),김두관(金斗官),65,181,246,0
1206,강민정(姜旼姃),김미애(金美愛),28,4,32,1
1207,강민정(姜旼姃),김민기(金敏基),62,64,126,0
1208,강민정(姜旼姃),김민석(金民錫),75,136,211,0
1209,강민정(姜旼姃),김민철(金敏徹),73,136,209,0
1210,강민정(姜旼姃),김병기(金炳基),66,74,140,0
1211,강민정(姜旼姃),김병욱A(金炳旭),65,112,177,0
1212,강민정(姜旼姃),김병욱B(金炳旭),26,5,31,1
1213,강민정(姜旼姃),김병주(金柄周),56,69,125,0
1214,강민정(姜旼姃),김상훈(金相勳),28,7,35,1
1215,강민정(姜旼姃),김상희(金相姬),67,124,191,0
1216,강민정(姜旼姃),김석기(金碩基),27,6,33,1
1217,강민정(姜旼姃),김성원(金成願),27,6,33,1
1218,강민정(姜旼姃),김성주(金成柱),65,78,143,0
1219,강민정(姜旼姃),김성환(金星煥),69,107,176,0
1220,강민정(姜旼姃),김수흥(金洙興),72,94,166,0
1221,강민정(姜旼姃),김승남(金承南),72,127,199,0
1222,강민정(姜旼姃),김승수(金承洙),28,10,38,1
1223,강민정(姜旼姃),김승원(金勝源),136,364,500,0
1224,강민정(姜旼姃),김영배(金永培),88,151,239,0
1225,강민정(姜旼姃),김영선(金映宣),26,3,29,1
1226,강민정(姜旼姃),김영식(金英植),27,9,36,1
1227,강민정(姜旼姃),김영주(金榮珠),62,81,143,0
1228,강민정(姜旼姃),김영진(金榮鎭),50,51,101,0
1229,강민정(姜旼姃),김영호(金映豪),78,113,191,0
1230,강민정(姜旼姃),김예지(金睿智),29,22,51,1
1231,강민정(姜旼姃),김용민(金容民),78,264,342,0
1232,강민정(姜旼姃),김용판(金用判),28,6,34,1
1233,강민정(姜旼姃),김웅(金雄),27,4,31,1
1234,강민정(姜旼姃),김원이(金元二),75,127,202,0
1235,강민정(姜旼姃),김윤덕(金潤德),59,90,149,0
1236,강민정(姜旼姃),김의겸(金宜謙),57,216,273,0
1237,강민정(姜旼姃),김정재(金汀才),28,5,33,1
1238,강민정(姜旼姃),김정호(金禎鎬),94,325,419,0
1239,강민정(姜旼姃),김종민(金鐘民),54,100,154,0
1240,강민정(姜旼姃),김주영(金周暎),81,172,253,0
1241,강민정(姜旼姃),김진표(金振杓),21,52,73,1
1242,강민정(姜旼姃),김철민(金哲玟),84,134,218,0
1243,강민정(姜旼姃),김태년(金太年),51,47,98,0
1244,강민정(姜旼姃),김태호(金台鎬),27,4,31,1
1245,강민정(姜旼姃),김학용(金學容),25,3,28,1
1246,강민정(姜旼姃),김한규(金翰奎),57,93,150,0
1247,강민정(姜旼姃),김한정(金漢正),55,49,104,0
1248,강민정(姜旼姃),김형동(金亨東),27,5,32,1
1249,강민정(姜旼姃),김홍걸(金弘傑),44,199,243,0
1250,강민정(姜旼姃),김회재(金會在),82,102,184,0
1251,강민정(姜旼姃),김희곤(金熙坤),28,6,34,1
1252,강민정(姜旼姃),김희국(金熙國),25,3,28,1
1253,강민정(姜旼姃),남인순(南仁順),83,122,205,0
1254,강민정(姜旼姃),노용호(魯容昊),25,3,28,1
1255,강민정(姜旼姃),노웅래(盧雄來),75,95,170,0
1256,강민정(姜旼姃),도종환(都鍾煥),68,112,180,0
1257,강민정(姜旼姃),류성걸(柳性杰),25,5,30,1
1258,강민정(姜旼姃),류호정(柳好貞),57,264,321,1
1259,강민정(姜旼姃),맹성규(孟聖奎),64,84,148,0
1260,강민정(姜旼姃),문정복(文貞福),63,157,220,0
1261,강민정(姜旼姃),문진석(文振碩),70,103,173,0
1262,강민정(姜旼姃),민병덕(閔炳德),74,198,272,0
1263,강민정(姜旼姃),민형배(閔馨培),79,393,472,0
1264,강민정(姜旼姃),민홍철(閔洪喆),66,83,149,0
1265,강민정(姜旼姃),박광온(朴洸瑥),58,72,130,0
1266,강민정(姜旼姃),박대수(朴大壽),26,13,39,1
1267,강민정(姜旼姃),박대출(朴大出),26,3,29,1
1268,강민정(姜旼姃),박덕흠(朴德欽),31,10,41,1
1269,강민정(姜旼姃),박범계(朴範界),45,38,83,0
1270,강민정(姜旼姃),박병석(朴炳錫),41,20,61,0
1271,강민정(姜旼姃),박상혁(朴商赫),71,178,249,0
1272,강민정(姜旼姃),박성민(朴聖敏),26,5,31,1
1273,강민정(姜旼姃),박성준(朴省俊),91,121,212,0
1274,강민정(姜旼姃),박성중(朴成重),25,3,28,1
1275,강민정(姜旼姃),박수영(朴洙瑩),26,13,39,1
1276,강민정(姜旼姃),박영순(朴英淳),76,121,197,0
1277,강민정(姜旼姃),박완주(朴完柱),20,50,70,1
1278,강민정(姜旼姃),박용진(朴用鎭),48,75,123,0
1279,강민정(姜旼姃),박재호(朴在昊),58,82,140,0
1280,강민정(姜旼姃),박정(朴釘),74,88,162,0
1281,강민정(姜旼姃),박정하(朴正河),25,3,28,1
1282,강민정(姜旼姃),박주민(朴柱民),68,157,225,0
1283,강민정(姜旼姃),박진(朴振),26,4,30,1
1284,강민정(姜旼姃),박찬대(朴贊大),64,101,165,0
1285,강민정(姜旼姃),박형수(朴亨修),25,3,28,1
1286,강민정(姜旼姃),박홍근(朴洪根),74,125,199,0
1287,강민정(姜旼姃),배준영(裵俊英),25,5,30,1
1288,강민정(姜旼姃),배진교(裵晋敎),42,194,236,1
1289,강민정(姜旼姃),배현진(裵賢鎭),25,4,29,1
1290,강민정(姜旼姃),백종헌(白宗憲),27,5,32,1
1291,강민정(姜旼姃),백혜련(白惠蓮),57,53,110,0
1292,강민정(姜旼姃),변재일(卞在一),50,37,87,0
1293,강민정(姜旼姃),서동용(徐東榕),95,160,255,0
1294,강민정(姜旼姃),서범수(徐範洙),27,6,33,1
1295,강민정(姜旼姃),서병수(徐秉洙),27,6,33,1
1296,강민정(姜旼姃),서삼석(徐參錫),62,73,135,0
1297,강민정(姜旼姃),서영교(徐瑛敎),84,156,240,0
1298,강민정(姜旼姃),서영석(徐暎錫),75,108,183,0
1299,강민정(姜旼姃),서일준(徐一俊),26,5,31,1
1300,강민정(姜旼姃),서정숙(徐正淑),25,4,29,1
1301,강민정(姜旼姃),설훈(薛勳),57,68,125,0
1302,강민정(姜旼姃),성일종(成一鍾),27,13,40,1
1303,강민정(姜旼姃),소병철(蘇秉哲),64,76,140,0
1304,강민정(姜旼姃),소병훈(蘇秉勳),60,91,151,0
1305,강민정(姜旼姃),송갑석(宋甲錫),67,144,211,0
1306,강민정(姜旼姃),송기헌(宋基憲),50,39,89,0
1307,강민정(姜旼姃),송석준(宋錫俊),26,5,31,1
1308,강민정(姜旼姃),송언석(宋彦錫),25,3,28,1
1309,강민정(姜旼姃),송옥주(宋玉珠),71,147,218,0
1310,강민정(姜旼姃),송재호(宋在祜),93,174,267,0
1311,강민정(姜旼姃),신동근(申東根),53,67,120,0
1312,강민정(姜旼姃),신영대(申榮大),59,51,110,0
1313,강민정(姜旼姃),신원식(申源湜),25,3,28,1
1314,강민정(姜旼姃),신정훈(辛正勳),92,239,331,0
1315,강민정(姜旼姃),신현영(申賢榮),72,94,166,0
1316,강민정(姜旼姃),심상정(沈相奵),40,216,256,1
1317,강민정(姜旼姃),안규백(安圭伯),65,74,139,0
1318,강민정(姜旼姃),안민석(安敏錫),71,126,197,0
1319,강민정(姜旼姃),안병길(安炳吉),26,4,30,1
1320,강민정(姜旼姃),안철수(安哲秀),25,3,28,1
1321,강민정(姜旼姃),안호영(安浩永),63,117,180,0
1322,강민정(姜旼姃),양경숙(梁敬淑),71,150,221,0
1323,강민정(姜旼姃),양금희(梁琴喜),26,7,33,1
1324,강민정(姜旼姃),양기대(梁基大),59,79,138,0
1325,강민정(姜旼姃),양이원영(梁李媛瑛),96,177,273,0
1326,강민정(姜旼姃),양정숙(梁貞淑),109,407,516,1
1327,강민정(姜旼姃),양향자(梁香子),13,39,52,1
1328,강민정(姜旼姃),어기구(魚基龜),58,62,120,0
1329,강민정(姜旼姃),엄태영(嚴泰永),29,5,34,1
1330,강민정(姜旼姃),오기형(吳奇炯),51,66,117,0
1331,강민정(姜旼姃),오영환(吳永煥),123,272,395,0
1332,강민정(姜旼姃),용혜인(龍慧仁),34,200,234,1
1333,강민정(姜旼姃),우상호(禹相虎),48,41,89,0
1334,강민정(姜旼姃),우원식(禹元植),60,80,140,0
1335,강민정(姜旼姃),위성곤(魏聖坤),79,191,270,0
1336,강민정(姜旼姃),유경준(兪京濬),26,5,31,1
1337,강민정(姜旼姃),유기홍(柳基洪),63,81,144,0
1338,강민정(姜旼姃),유동수(柳東秀),56,40,96,0
1339,강민정(姜旼姃),유상범(劉相凡),26,3,29,1
1340,강민정(姜旼姃),유의동(兪義東),26,3,29,1
1341,강민정(姜旼姃),유정주(兪訂炷),106,291,397,0
1342,강민정(姜旼姃),윤건영(尹建永),63,147,210,0
1343,강민정(姜旼姃),윤관석(尹官石),43,52,95,1
1344,강민정(姜旼姃),윤두현(尹斗鉉),25,6,31,1
1345,강민정(姜旼姃),윤미향(尹美香),55,224,279,1
1346,강민정(姜旼姃),윤상현(尹相現),27,6,33,1
1347,강민정(姜旼姃),윤영덕(尹永德),102,305,407,0
1348,강민정(姜旼姃),윤영석(尹永碩),26,3,29,1
1349,강민정(姜旼姃),윤영찬(尹永燦),52,52,104,0
1350,강민정(姜旼姃),윤재갑(尹才鉀),96,179,275,0
1351,강민정(姜旼姃),윤재옥(尹在玉),26,3,29,1
1352,강민정(姜旼姃),윤주경(尹柱卿),26,7,33,1
1353,강민정(姜旼姃),윤준병(尹準炳),87,215,302,0
1354,강민정(姜旼姃),윤창현(尹暢賢),26,6,32,1
1355,강민정(姜旼姃),윤한홍(尹漢洪),26,3,29,1
1356,강민정(姜旼姃),윤호중(尹昊重),51,47,98,0
1357,강민정(姜旼姃),윤후덕(尹厚德),62,75,137,0
1358,강민정(姜旼姃),이개호(李介昊),60,74,134,0
1359,강민정(姜旼姃),이달곤(李達坤),28,5,33,1
1360,강민정(姜旼姃),이동주(李東洲),71,183,254,0
1361,강민정(姜旼姃),이만희(李晩熙),26,3,29,1
1362,강민정(姜旼姃),이명수(李明洙),27,25,52,1
1363,강민정(姜旼姃),이병훈(李炳勳),72,150,222,0
1364,강민정(姜旼姃),이상민(李相珉),47,44,91,0
1365,강민정(姜旼姃),이상헌(李相憲),67,125,192,0
1366,강민정(姜旼姃),이성만(李成萬),83,171,254,1
1367,강민정(姜旼姃),이소영(李素永),59,69,128,0
1368,강민정(姜旼姃),이수진(李壽珍),124,409,533,0
1369,강민정(姜旼姃),이수진(李秀眞),77,163,240,0
1370,강민정(姜旼姃),이양수(李亮壽),27,8,35,1
1371,강민정(姜旼姃),이용(李鏞),25,3,28,1
1372,강민정(姜旼姃),이용빈(李龍彬),106,236,342,0
1373,강민정(姜旼姃),이용선(李庸瑄),68,143,211,0
1374,강민정(姜旼姃),이용우(李龍雨),85,157,242,0
1375,강민정(姜旼姃),이용호(李容鎬),33,23,56,1
1376,강민정(姜旼姃),이원욱(李元旭),66,109,175,0
1377,강민정(姜旼姃),이원택(李源澤),74,90,164,0
1378,강민정(姜旼姃),이은주(李恩周),46,180,226,1
1379,강민정(姜旼姃),이인선(李仁善),25,3,28,1
1380,강민정(姜旼姃),이인영(李仁榮),48,37,85,0
1381,강민정(姜旼姃),이장섭(李將燮),59,89,148,0
1382,강민정(姜旼姃),이재명(李在明),41,30,71,0
1383,강민정(姜旼姃),이재정(李在汀),60,71,131,0
1384,강민정(姜旼姃),이정문(李楨文),68,111,179,0
1385,강민정(姜旼姃),이종배(李鍾培),26,6,32,1
1386,강민정(姜旼姃),이종성(李鍾成),25,9,34,1
1387,강민정(姜旼姃),이주환(李周桓),25,4,29,1
1388,강민정(姜旼姃),이채익(李埰益),29,5,34,1
1389,강민정(姜旼姃),이철규(李喆圭),26,5,31,1
1390,강민정(姜旼姃),이탄희(李誕熙),77,152,229,0
1391,강민정(姜旼姃),이태규(李泰珪),26,10,36,1
1392,강민정(姜旼姃),이학영(李學永),69,90,159,0
1393,강민정(姜旼姃),이해식(李海植),67,90,157,0
1394,강민정(姜旼姃),이헌승(李憲昇),26,3,29,1
1395,강민정(姜旼姃),이형석(李炯錫),82,135,217,0
1396,강민정(姜旼姃),인재근(印在謹),72,100,172,0
1397,강민정(姜旼姃),임병헌(林炳憲),25,4,29,1
1398,강민정(姜旼姃),임오경(林五卿),58,78,136,0
1399,강민정(姜旼姃),임이자(林利子),25,4,29,1
1400,강민정(姜旼姃),임종성(林鍾聲),77,120,197,0
1401,강민정(姜旼姃),임호선(林昊宣),85,184,269,0
1402,강민정(姜旼姃),장경태(張耿態),81,201,282,0
1403,강민정(姜旼姃),장동혁(張東赫),25,3,28,1
1404,강민정(姜旼姃),장제원(張濟元),25,3,28,1
1405,강민정(姜旼姃),장철민(張喆敏),68,109,177,0
1406,강민정(姜旼姃),장혜영(張惠英),40,184,224,1
1407,강민정(姜旼姃),전봉민(田奉珉),26,4,30,1
1408,강민정(姜旼姃),전용기(田溶冀),62,114,176,0
1409,강민정(姜旼姃),전재수(田載秀),54,87,141,0
1410,강민정(姜旼姃),전주혜(全珠惠),27,5,32,1
1411,강민정(姜旼姃),전해철(全海澈),48,48,96,0
1412,강민정(姜旼姃),전혜숙(全惠淑),71,118,189,0
1413,강민정(姜旼姃),정경희(丁慶姬),25,3,28,1
1414,강민정(姜旼姃),정동만(鄭東萬),25,7,32,1
1415,강민정(姜旼姃),정성호(鄭成湖),59,106,165,0
1416,강민정(姜旼姃),정우택(鄭宇澤),25,3,28,1
1417,강민정(姜旼姃),정운천(鄭雲天),26,4,30,1
1418,강민정(姜旼姃),정일영(鄭日永),68,125,193,0
1419,강민정(姜旼姃),정점식(鄭点植),26,3,29,1
1420,강민정(姜旼姃),정진석(鄭鎭碩),26,3,29,1
1421,강민정(姜旼姃),정청래(鄭淸來),56,59,115,0
1422,강민정(姜旼姃),정춘숙(鄭春淑),64,80,144,0
1423,강민정(姜旼姃),정태호(鄭泰浩),54,123,177,0
1424,강민정(姜旼姃),정필모(鄭必模),71,148,219,0
1425,강민정(姜旼姃),정희용(鄭熙溶),26,7,33,1
1426,강민정(姜旼姃),조경태(趙慶泰),25,4,29,1
1427,강민정(姜旼姃),조명희(曺明姬),25,5,30,1
1428,강민정(姜旼姃),조수진(趙修眞),26,3,29,1
1429,강민정(姜旼姃),조승래(趙承來),68,71,139,0
1430,강민정(姜旼姃),조오섭(曺五燮),75,195,270,0
1431,강민정(姜旼姃),조은희(趙恩禧),29,4,33,1
1432,강민정(姜旼姃),조응천(趙應天),45,31,76,0
1433,강민정(姜旼姃),조정식(趙正湜),49,46,95,0
1434,강민정(姜旼姃),조정훈(趙廷訓),14,54,68,1
1435,강민정(姜旼姃),조해진(曺海珍),28,7,35,1
1436,강민정(姜旼姃),주철현(朱哲鉉),86,186,272,0
1437,강민정(姜旼姃),주호영(朱豪英),25,4,29,1
1438,강민정(姜旼姃),지성호(池成浩),25,6,31,1
1439,강민정(姜旼姃),진선미(陳善美),59,54,113,0
1440,강민정(姜旼姃),진성준(陳聲準),70,132,202,0
1441,강민정(姜旼姃),천준호(千俊鎬),63,80,143,0
1442,강민정(姜旼姃),최기상(崔基相),66,112,178,0
1443,강민정(姜旼姃),최승재(崔承宰),27,6,33,1
1444,강민정(姜旼姃),최연숙(崔姸淑),30,19,49,1
1445,강민정(姜旼姃),최영희(崔英姬),25,3,28,1
1446,강민정(姜旼姃),최인호(崔仁昊),59,65,124,0
1447,강민정(姜旼姃),최재형(崔在亨),25,3,28,1
1448,강민정(姜旼姃),최종윤(崔鍾允),73,134,207,0
1449,강민정(姜旼姃),최춘식(崔春植),25,13,38,1
1450,강민정(姜旼姃),최형두(崔炯斗),26,8,34,1
1451,강민정(姜旼姃),최혜영(崔惠英),86,187,273,0
1452,강민정(姜旼姃),추경호(秋慶鎬),25,7,32,1
1453,강민정(姜旼姃),태영호(太永浩),25,10,35,1
1454,강민정(姜旼姃),하영제(河榮帝),18,2,20,1
1455,강민정(姜旼姃),하태경(河泰慶),26,4,30,1
1456,강민정(姜旼姃),한기호(韓起鎬),26,3,29,1
1457,강민정(姜旼姃),한무경(韓茂景),26,6,32,1
1458,강민정(姜旼姃),한병도(韓秉道),77,147,224,0
1459,강민정(姜旼姃),한정애(韓貞愛),50,84,134,0
1460,강민정(姜旼姃),한준호(韓俊鎬),71,158,229,0
1461,강민정(姜旼姃),허숙정(許淑湞),1,4,5,0
1462,강민정(姜旼姃),허영(許榮),81,117,198,0
1463,강민정(姜旼姃),허은아(許垠娥),25,4,29,1
1464,강민정(姜旼姃),허종식(許琮植),75,124,199,0
1465,강민정(姜旼姃),홍기원(洪起元),68,106,174,0
1466,강민정(姜旼姃),홍문표(洪文杓),27,13,40,1
1467,강민정(姜旼姃),홍석준(洪碩晙),26,4,30,1
1468,강민정(姜旼姃),홍성국(洪性國),82,118,200,0
1469,강민정(姜旼姃),홍영표(洪永杓),52,61,113,0
1470,강민정(姜旼姃),홍익표(洪翼杓),61,67,128,0
1471,강민정(姜旼姃),홍정민(洪貞敏),87,172,259,0
1472,강민정(姜旼姃),황보승희(皇甫承希),23,2,25,1
1473,강민정(姜旼姃),황운하(黃雲夏),98,233,331,0
1474,강민정(姜旼姃),황희(黃熙),49,40,89,0
1475,강병원(姜炳遠),강선우(姜仙祐),140,152,292,0
1476,강병원(姜炳遠),강성희(姜聖熙),4,4,8,1
1477,강병원(姜炳遠),강은미(姜恩美),17,19,36,1
1478,강병원(姜炳遠),강준현(康準鉉),109,82,191,0
1479,강병원(姜炳遠),강훈식(姜勳植),107,70,177,0
1480,강병원(姜炳遠),고민정(高旼廷),95,59,154,0
1481,강병원(姜炳遠),고영인(高永寅),116,121,237,0
1482,강병원(姜炳遠),고용진(高榕禛),107,84,191,0
1483,강병원(姜炳遠),구자근(具滋根),51,6,57,1
1484,강병원(姜炳遠),권명호(權明浩),51,4,55,1
1485,강병원(姜炳遠),권성동(權性東),43,4,47,1
1486,강병원(姜炳遠),권영세(權寧世),52,5,57,1
1487,강병원(姜炳遠),권은희(權垠希),29,6,35,1
1488,강병원(姜炳遠),권인숙(權仁淑),99,77,176,0
1489,강병원(姜炳遠),권칠승(權七勝),110,134,244,0
1490,강병원(姜炳遠),기동민(奇東旻),111,121,232,0
1491,강병원(姜炳遠),김경만(金京萬),124,121,245,0
1492,강병원(姜炳遠),김경협(金炅俠),117,91,208,0
1493,강병원(姜炳遠),김교흥(金敎興),95,66,161,0
1494,강병원(姜炳遠),김기현(金起炫),52,6,58,1
1495,강병원(姜炳遠),김남국(金南局),84,62,146,1
1496,강병원(姜炳遠),김도읍(金度邑),51,4,55,1
1497,강병원(姜炳遠),김두관(金斗官),93,93,186,0
1498,강병원(姜炳遠),김미애(金美愛),51,4,55,1
1499,강병원(姜炳遠),김민기(金敏基),106,93,199,0
1500,강병원(姜炳遠),김민석(金民錫),121,111,232,0
1501,강병원(姜炳遠),김민철(金敏徹),105,104,209,0
1502,강병원(姜炳遠),김병기(金炳基),100,118,218,0
1503,강병원(姜炳遠),김병욱A(金炳旭),116,101,217,0
1504,강병원(姜炳遠),김병욱B(金炳旭),44,5,49,1
1505,강병원(姜炳遠),김병주(金柄周),91,53,144,0
1506,강병원(姜炳遠),김상훈(金相勳),53,7,60,1
1507,강병원(姜炳遠),김상희(金相姬),99,66,165,0
1508,강병원(姜炳遠),김석기(金碩基),52,5,57,1
1509,강병원(姜炳遠),김성원(金成願),52,6,58,1
1510,강병원(姜炳遠),김성주(金成柱),111,90,201,0
1511,강병원(姜炳遠),김성환(金星煥),94,61,155,0
1512,강병원(姜炳遠),김수흥(金洙興),117,111,228,0
1513,강병원(姜炳遠),김승남(金承南),93,117,210,0
1514,강병원(姜炳遠),김승수(金承洙),52,7,59,1
1515,강병원(姜炳遠),김승원(金勝源),120,132,252,0
1516,강병원(姜炳遠),김영배(金永培),111,108,219,0
1517,강병원(姜炳遠),김영선(金映宣),26,4,30,1
1518,강병원(姜炳遠),김영식(金英植),51,7,58,1
1519,강병원(姜炳遠),김영주(金榮珠),101,81,182,0
1520,강병원(姜炳遠),김영진(金榮鎭),96,61,157,0
1521,강병원(姜炳遠),김영호(金映豪),96,73,169,0
1522,강병원(姜炳遠),김예지(金睿智),52,5,57,1
1523,강병원(姜炳遠),김용민(金容民),91,67,158,0
1524,강병원(姜炳遠),김용판(金用判),52,4,56,1
1525,강병원(姜炳遠),김웅(金雄),51,4,55,1
1526,강병원(姜炳遠),김원이(金元二),105,92,197,0
1527,강병원(姜炳遠),김윤덕(金潤德),105,84,189,0
1528,강병원(姜炳遠),김의겸(金宜謙),47,53,100,0
1529,강병원(姜炳遠),김정재(金汀才),53,5,58,1
1530,강병원(姜炳遠),김정호(金禎鎬),139,189,328,0
1531,강병원(姜炳遠),김종민(金鐘民),95,105,200,0
1532,강병원(姜炳遠),김주영(金周暎),100,91,191,0
1533,강병원(姜炳遠),김진표(金振杓),53,51,104,1
1534,강병원(姜炳遠),김철민(金哲玟),107,117,224,0
1535,강병원(姜炳遠),김태년(金太年),79,37,116,0
1536,강병원(姜炳遠),김태호(金台鎬),42,6,48,1
1537,강병원(姜炳遠),김학용(金學容),25,5,30,1
1538,강병원(姜炳遠),김한규(金翰奎),44,61,105,0
1539,강병원(姜炳遠),김한정(金漢正),78,57,135,0
1540,강병원(姜炳遠),김형동(金亨東),51,5,56,1
1541,강병원(姜炳遠),김홍걸(金弘傑),54,133,187,0
1542,강병원(姜炳遠),김회재(金會在),92,73,165,0
1543,강병원(姜炳遠),김희곤(金熙坤),50,6,56,1
1544,강병원(姜炳遠),김희국(金熙國),49,4,53,1
1545,강병원(姜炳遠),남인순(南仁順),97,76,173,0
1546,강병원(姜炳遠),노용호(魯容昊),25,4,29,1
1547,강병원(姜炳遠),노웅래(盧雄來),97,91,188,0
1548,강병원(姜炳遠),도종환(都鍾煥),96,92,188,0
1549,강병원(姜炳遠),류성걸(柳性杰),49,4,53,1
1550,강병원(姜炳遠),류호정(柳好貞),14,20,34,1
1551,강병원(姜炳遠),맹성규(孟聖奎),93,77,170,0
1552,강병원(姜炳遠),문정복(文貞福),82,44,126,0
1553,강병원(姜炳遠),문진석(文振碩),100,118,218,0
1554,강병원(姜炳遠),민병덕(閔炳德),106,140,246,0
1555,강병원(姜炳遠),민형배(閔馨培),80,120,200,0
1556,강병원(姜炳遠),민홍철(閔洪喆),80,69,149,0
1557,강병원(姜炳遠),박광온(朴洸瑥),89,67,156,0
1558,강병원(姜炳遠),박대수(朴大壽),50,6,56,1
1559,강병원(姜炳遠),박대출(朴大出),50,4,54,1
1560,강병원(姜炳遠),박덕흠(朴德欽),36,6,42,1
1561,강병원(姜炳遠),박범계(朴範界),79,38,117,0
1562,강병원(姜炳遠),박병석(朴炳錫),40,15,55,0
1563,강병원(姜炳遠),박상혁(朴商赫),120,134,254,0
1564,강병원(姜炳遠),박성민(朴聖敏),49,7,56,1
1565,강병원(姜炳遠),박성준(朴省俊),102,96,198,0
1566,강병원(姜炳遠),박성중(朴成重),49,5,54,1
1567,강병원(姜炳遠),박수영(朴洙瑩),49,5,54,1
1568,강병원(姜炳遠),박영순(朴英淳),96,81,177,0
1569,강병원(姜炳遠),박완주(朴完柱),47,37,84,1
1570,강병원(姜炳遠),박용진(朴用鎭),89,92,181,0
1571,강병원(姜炳遠),박재호(朴在昊),91,90,181,0
1572,강병원(姜炳遠),박정(朴釘),112,116,228,0
1573,강병원(姜炳遠),박정하(朴正河),25,4,29,1
1574,강병원(姜炳遠),박주민(朴柱民),80,61,141,0
1575,강병원(姜炳遠),박진(朴振),50,3,53,1
1576,강병원(姜炳遠),박찬대(朴贊大),88,54,142,0
1577,강병원(姜炳遠),박형수(朴亨修),49,5,54,1
1578,강병원(姜炳遠),박홍근(朴洪根),114,121,235,0
1579,강병원(姜炳遠),배준영(裵俊英),51,6,57,1
1580,강병원(姜炳遠),배진교(裵晋敎),17,22,39,1
1581,강병원(姜炳遠),배현진(裵賢鎭),49,4,53,1
1582,강병원(姜炳遠),백종헌(白宗憲),50,4,54,1
1583,강병원(姜炳遠),백혜련(白惠蓮),90,79,169,0
1584,강병원(姜炳遠),변재일(卞在一),88,60,148,0
1585,강병원(姜炳遠),서동용(徐東榕),102,93,195,0
1586,강병원(姜炳遠),서범수(徐範洙),51,7,58,1
1587,강병원(姜炳遠),서병수(徐秉洙),50,4,54,1
1588,강병원(姜炳遠),서삼석(徐參錫),96,80,176,0
1589,강병원(姜炳遠),서영교(徐瑛敎),103,84,187,0
1590,강병원(姜炳遠),서영석(徐暎錫),112,131,243,0
1591,강병원(姜炳遠),서일준(徐一俊),50,7,57,1
1592,강병원(姜炳遠),서정숙(徐正淑),49,4,53,1
1593,강병원(姜炳遠),설훈(薛勳),89,87,176,0
1594,강병원(姜炳遠),성일종(成一鍾),50,4,54,1
1595,강병원(姜炳遠),소병철(蘇秉哲),87,65,152,0
1596,강병원(姜炳遠),소병훈(蘇秉勳),95,86,181,0
1597,강병원(姜炳遠),송갑석(宋甲錫),100,105,205,0
1598,강병원(姜炳遠),송기헌(宋基憲),89,45,134,0
1599,강병원(姜炳遠),송석준(宋錫俊),51,7,58,1
1600,강병원(姜炳遠),송언석(宋彦錫),45,4,49,1
1601,강병원(姜炳遠),송옥주(宋玉珠),95,71,166,0
1602,강병원(姜炳遠),송재호(宋在祜),97,118,215,0
1603,강병원(姜炳遠),신동근(申東根),103,99,202,0
1604,강병원(姜炳遠),신영대(申榮大),86,60,146,0
1605,강병원(姜炳遠),신원식(申源湜),49,4,53,1
1606,강병원(姜炳遠),신정훈(辛正勳),116,151,267,0
1607,강병원(姜炳遠),신현영(申賢榮),91,63,154,0
1608,강병원(姜炳遠),심상정(沈相奵),17,28,45,1
1609,강병원(姜炳遠),안규백(安圭伯),90,77,167,0
1610,강병원(姜炳遠),안민석(安敏錫),92,95,187,0
1611,강병원(姜炳遠),안병길(安炳吉),51,5,56,1
1612,강병원(姜炳遠),안철수(安哲秀),25,4,29,1
1613,강병원(姜炳遠),안호영(安浩永),91,66,157,0
1614,강병원(姜炳遠),양경숙(梁敬淑),108,128,236,0
1615,강병원(姜炳遠),양금희(梁琴喜),50,4,54,1
1616,강병원(姜炳遠),양기대(梁基大),93,85,178,0
1617,강병원(姜炳遠),양이원영(梁李媛瑛),86,68,154,0
1618,강병원(姜炳遠),양정숙(梁貞淑),47,128,175,1
1619,강병원(姜炳遠),양향자(梁香子),48,46,94,1
1620,강병원(姜炳遠),어기구(魚基龜),85,49,134,0
1621,강병원(姜炳遠),엄태영(嚴泰永),51,5,56,1
1622,강병원(姜炳遠),오기형(吳奇炯),82,61,143,0
1623,강병원(姜炳遠),오영환(吳永煥),125,206,331,0
1624,강병원(姜炳遠),용혜인(龍慧仁),12,35,47,1
1625,강병원(姜炳遠),우상호(禹相虎),83,42,125,0
1626,강병원(姜炳遠),우원식(禹元植),94,73,167,0
1627,강병원(姜炳遠),위성곤(魏聖坤),119,148,267,0
1628,강병원(姜炳遠),유경준(兪京濬),49,4,53,1
1629,강병원(姜炳遠),유기홍(柳基洪),85,54,139,0
1630,강병원(姜炳遠),유동수(柳東秀),103,69,172,0
1631,강병원(姜炳遠),유상범(劉相凡),50,4,54,1
1632,강병원(姜炳遠),유의동(兪義東),50,5,55,1
1633,강병원(姜炳遠),유정주(兪訂炷),114,132,246,0
1634,강병원(姜炳遠),윤건영(尹建永),90,70,160,0
1635,강병원(姜炳遠),윤관석(尹官石),81,71,152,1
1636,강병원(姜炳遠),윤두현(尹斗鉉),49,4,53,1
1637,강병원(姜炳遠),윤미향(尹美香),50,46,96,1
1638,강병원(姜炳遠),윤상현(尹相現),30,4,34,1
1639,강병원(姜炳遠),윤영덕(尹永德),97,106,203,0
1640,강병원(姜炳遠),윤영석(尹永碩),51,6,57,1
1641,강병원(姜炳遠),윤영찬(尹永燦),104,97,201,0
1642,강병원(姜炳遠),윤재갑(尹才鉀),113,112,225,0
1643,강병원(姜炳遠),윤재옥(尹在玉),50,5,55,1
1644,강병원(姜炳遠),윤주경(尹柱卿),49,5,54,1
1645,강병원(姜炳遠),윤준병(尹準炳),110,158,268,0
1646,강병원(姜炳遠),윤창현(尹暢賢),49,4,53,1
1647,강병원(姜炳遠),윤한홍(尹漢洪),50,5,55,1
1648,강병원(姜炳遠),윤호중(尹昊重),80,62,142,0
1649,강병원(姜炳遠),윤후덕(尹厚德),109,93,202,0
1650,강병원(姜炳遠),이개호(李介昊),102,97,199,0
1651,강병원(姜炳遠),이달곤(李達坤),51,5,56,1
1652,강병원(姜炳遠),이동주(李東洲),102,138,240,0
1653,강병원(姜炳遠),이만희(李晩熙),49,4,53,1
1654,강병원(姜炳遠),이명수(李明洙),51,7,58,1
1655,강병원(姜炳遠),이병훈(李炳勳),94,95,189,0
1656,강병원(姜炳遠),이상민(李相珉),76,45,121,0
1657,강병원(姜炳遠),이상헌(李相憲),106,91,197,0
1658,강병원(姜炳遠),이성만(李成萬),83,81,164,1
1659,강병원(姜炳遠),이소영(李素永),88,45,133,0
1660,강병원(姜炳遠),이수진(李壽珍),106,147,253,0
1661,강병원(姜炳遠),이수진(李秀眞),128,138,266,0
1662,강병원(姜炳遠),이양수(李亮壽),52,5,57,1
1663,강병원(姜炳遠),이용(李鏞),49,5,54,1
1664,강병원(姜炳遠),이용빈(李龍彬),133,169,302,0
1665,강병원(姜炳遠),이용선(李庸瑄),101,81,182,0
1666,강병원(姜炳遠),이용우(李龍雨),103,104,207,0
1667,강병원(姜炳遠),이용호(李容鎬),38,26,64,1
1668,강병원(姜炳遠),이원욱(李元旭),97,74,171,0
1669,강병원(姜炳遠),이원택(李源澤),86,65,151,0
1670,강병원(姜炳遠),이은주(李恩周),15,20,35,1
1671,강병원(姜炳遠),이인선(李仁善),25,4,29,1
1672,강병원(姜炳遠),이인영(李仁榮),74,48,122,0
1673,강병원(姜炳遠),이장섭(李將燮),93,83,176,0
1674,강병원(姜炳遠),이재명(李在明),39,17,56,0
1675,강병원(姜炳遠),이재정(李在汀),82,56,138,0
1676,강병원(姜炳遠),이정문(李楨文),105,122,227,0
1677,강병원(姜炳遠),이종배(李鍾培),50,5,55,1
1678,강병원(姜炳遠),이종성(李鍾成),49,5,54,1
1679,강병원(姜炳遠),이주환(李周桓),49,4,53,1
1680,강병원(姜炳遠),이채익(李埰益),51,6,57,1
1681,강병원(姜炳遠),이철규(李喆圭),52,4,56,1
1682,강병원(姜炳遠),이탄희(李誕熙),100,72,172,0
1683,강병원(姜炳遠),이태규(李泰珪),28,4,32,1
1684,강병원(姜炳遠),이학영(李學永),97,95,192,0
1685,강병원(姜炳遠),이해식(李海植),103,118,221,0
1686,강병원(姜炳遠),이헌승(李憲昇),50,4,54,1
1687,강병원(姜炳遠),이형석(李炯錫),93,91,184,0
1688,강병원(姜炳遠),인재근(印在謹),95,94,189,0
1689,강병원(姜炳遠),임병헌(林炳憲),25,4,29,1
1690,강병원(姜炳遠),임오경(林五卿),94,93,187,0
1691,강병원(姜炳遠),임이자(林利子),49,4,53,1
1692,강병원(姜炳遠),임종성(林鍾聲),110,158,268,0
1693,강병원(姜炳遠),임호선(林昊宣),114,188,302,0
1694,강병원(姜炳遠),장경태(張耿態),101,99,200,0
1695,강병원(姜炳遠),장동혁(張東赫),25,4,29,1
1696,강병원(姜炳遠),장제원(張濟元),49,4,53,1
1697,강병원(姜炳遠),장철민(張喆敏),102,64,166,0
1698,강병원(姜炳遠),장혜영(張惠英),16,13,29,1
1699,강병원(姜炳遠),전봉민(田奉珉),35,6,41,1
1700,강병원(姜炳遠),전용기(田溶冀),99,106,205,0
1701,강병원(姜炳遠),전재수(田載秀),80,79,159,0
1702,강병원(姜炳遠),전주혜(全珠惠),51,5,56,1
1703,강병원(姜炳遠),전해철(全海澈),77,60,137,0
1704,강병원(姜炳遠),전혜숙(全惠淑),103,103,206,0
1705,강병원(姜炳遠),정경희(丁慶姬),49,4,53,1
1706,강병원(姜炳遠),정동만(鄭東萬),49,4,53,1
1707,강병원(姜炳遠),정성호(鄭成湖),101,107,208,0
1708,강병원(姜炳遠),정우택(鄭宇澤),25,4,29,1
1709,강병원(姜炳遠),정운천(鄭雲天),49,4,53,1
1710,강병원(姜炳遠),정일영(鄭日永),96,125,221,0
1711,강병원(姜炳遠),정점식(鄭点植),50,4,54,1
1712,강병원(姜炳遠),정진석(鄭鎭碩),50,5,55,1
1713,강병원(姜炳遠),정청래(鄭淸來),94,60,154,0
1714,강병원(姜炳遠),정춘숙(鄭春淑),116,113,229,0
1715,강병원(姜炳遠),정태호(鄭泰浩),94,80,174,0
1716,강병원(姜炳遠),정필모(鄭必模),88,79,167,0
1717,강병원(姜炳遠),정희용(鄭熙溶),50,5,55,1
1718,강병원(姜炳遠),조경태(趙慶泰),52,10,62,1
1719,강병원(姜炳遠),조명희(曺明姬),50,11,61,1
1720,강병원(姜炳遠),조수진(趙修眞),49,4,53,1
1721,강병원(姜炳遠),조승래(趙承來),114,107,221,0
1722,강병원(姜炳遠),조오섭(曺五燮),95,103,198,0
1723,강병원(姜炳遠),조은희(趙恩禧),25,5,30,1
1724,강병원(姜炳遠),조응천(趙應天),76,38,114,0
1725,강병원(姜炳遠),조정식(趙正湜),80,53,133,0
1726,강병원(姜炳遠),조정훈(趙廷訓),6,14,20,1
1727,강병원(姜炳遠),조해진(曺海珍),52,5,57,1
1728,강병원(姜炳遠),주철현(朱哲鉉),94,78,172,0
1729,강병원(姜炳遠),주호영(朱豪英),50,4,54,1
1730,강병원(姜炳遠),지성호(池成浩),49,4,53,1
1731,강병원(姜炳遠),진선미(陳善美),94,68,162,0
1732,강병원(姜炳遠),진성준(陳聲準),117,122,239,0
1733,강병원(姜炳遠),천준호(千俊鎬),91,75,166,0
1734,강병원(姜炳遠),최기상(崔基相),85,71,156,0
1735,강병원(姜炳遠),최승재(崔承宰),49,5,54,1
1736,강병원(姜炳遠),최연숙(崔姸淑),33,21,54,1
1737,강병원(姜炳遠),최영희(崔英姬),25,6,31,1
1738,강병원(姜炳遠),최인호(崔仁昊),95,78,173,0
1739,강병원(姜炳遠),최재형(崔在亨),25,4,29,1
1740,강병원(姜炳遠),최종윤(崔鍾允),119,123,242,0
1741,강병원(姜炳遠),최춘식(崔春植),49,6,55,1
1742,강병원(姜炳遠),최형두(崔炯斗),50,4,54,1
1743,강병원(姜炳遠),최혜영(崔惠英),114,111,225,0
1744,강병원(姜炳遠),추경호(秋慶鎬),49,4,53,1
1745,강병원(姜炳遠),태영호(太永浩),49,5,54,1
1746,강병원(姜炳遠),하영제(河榮帝),41,2,43,1
1747,강병원(姜炳遠),하태경(河泰慶),49,5,54,1
1748,강병원(姜炳遠),한기호(韓起鎬),50,5,55,1
1749,강병원(姜炳遠),한무경(韓茂景),49,4,53,1
1750,강병원(姜炳遠),한병도(韓秉道),103,91,194,0
1751,강병원(姜炳遠),한정애(韓貞愛),86,59,145,0
1752,강병원(姜炳遠),한준호(韓俊鎬),96,95,191,0
1753,강병원(姜炳遠),허숙정(許淑湞),1,2,3,0
1754,강병원(姜炳遠),허영(許榮),103,102,205,0
1755,강병원(姜炳遠),허은아(許垠娥),49,4,53,1
1756,강병원(姜炳遠),허종식(許琮植),115,124,239,0
1757,강병원(姜炳遠),홍기원(洪起元),93,83,176,0
1758,강병원(姜炳遠),홍문표(洪文杓),53,9,62,1
1759,강병원(姜炳遠),홍석준(洪碩晙),50,4,54,1
1760,강병원(姜炳遠),홍성국(洪性國),127,144,271,0
1761,강병원(姜炳遠),홍영표(洪永杓),87,70,157,0
1762,강병원(姜炳遠),홍익표(洪翼杓),91,81,172,0
1763,강병원(姜炳遠),홍정민(洪貞敏),115,100,215,0
1764,강병원(姜炳遠),황보승희(皇甫承希),46,2,48,1
1765,강병원(姜炳遠),황운하(黃雲夏),110,113,223,0
1766,강병원(姜炳遠),황희(黃熙),88,58,146,0
1767,강선우(姜仙祐),강성희(姜聖熙),5,3,8,1
1768,강선우(姜仙祐),강은미(姜恩美),18,37,55,1
1769,강선우(姜仙祐),강준현(康準鉉),115,111,226,0
1770,강선우(姜仙祐),강훈식(姜勳植),99,69,168,0
1771,강선우(姜仙祐),고민정(高旼廷),93,64,157,0
1772,강선우(姜仙祐),고영인(高永寅),140,117,257,0
1773,강선우(姜仙祐),고용진(高榕禛),95,78,173,0
1774,강선우(姜仙祐),구자근(具滋根),51,4,55,1
1775,강선우(姜仙祐),권명호(權明浩),51,4,55,1
1776,강선우(姜仙祐),권성동(權性東),43,4,47,1
1777,강선우(姜仙祐),권영세(權寧世),53,6,59,1
1778,강선우(姜仙祐),권은희(權垠希),30,7,37,1
1779,강선우(姜仙祐),권인숙(權仁淑),101,96,197,0
1780,강선우(姜仙祐),권칠승(權七勝),135,117,252,0
1781,강선우(姜仙祐),기동민(奇東旻),106,92,198,0
1782,강선우(姜仙祐),김경만(金京萬),161,174,335,0
1783,강선우(姜仙祐),김경협(金炅俠),113,72,185,0
1784,강선우(姜仙祐),김교흥(金敎興),112,81,193,0
1785,강선우(姜仙祐),김기현(金起炫),52,7,59,1
1786,강선우(姜仙祐),김남국(金南局),92,75,167,1
1787,강선우(姜仙祐),김도읍(金度邑),51,4,55,1
1788,강선우(姜仙祐),김두관(金斗官),93,84,177,0
1789,강선우(姜仙祐),김미애(金美愛),51,5,56,1
1790,강선우(姜仙祐),김민기(金敏基),118,94,212,0
1791,강선우(姜仙祐),김민석(金民錫),109,97,206,0
1792,강선우(姜仙祐),김민철(金敏徹),114,106,220,0
1793,강선우(姜仙祐),김병기(金炳基),96,105,201,0
1794,강선우(姜仙祐),김병욱A(金炳旭),124,104,228,0
1795,강선우(姜仙祐),김병욱B(金炳旭),44,5,49,1
1796,강선우(姜仙祐),김병주(金柄周),89,43,132,0
1797,강선우(姜仙祐),김상훈(金相勳),53,7,60,1
1798,강선우(姜仙祐),김상희(金相姬),111,107,218,0
1799,강선우(姜仙祐),김석기(金碩基),52,4,56,1
1800,강선우(姜仙祐),김성원(金成願),52,5,57,1
1801,강선우(姜仙祐),김성주(金成柱),147,139,286,0
1802,강선우(姜仙祐),김성환(金星煥),89,60,149,0
1803,강선우(姜仙祐),김수흥(金洙興),124,120,244,0
1804,강선우(姜仙祐),김승남(金承南),107,111,218,0
1805,강선우(姜仙祐),김승수(金承洙),53,8,61,1
1806,강선우(姜仙祐),김승원(金勝源),138,126,264,0
1807,강선우(姜仙祐),김영배(金永培),110,99,209,0
1808,강선우(姜仙祐),김영선(金映宣),26,4,30,1
1809,강선우(姜仙祐),김영식(金英植),52,5,57,1
1810,강선우(姜仙祐),김영주(金榮珠),97,63,160,0
1811,강선우(姜仙祐),김영진(金榮鎭),92,69,161,0
1812,강선우(姜仙祐),김영호(金映豪),103,69,172,0
1813,강선우(姜仙祐),김예지(金睿智),56,13,69,1
1814,강선우(姜仙祐),김용민(金容民),93,52,145,0
1815,강선우(姜仙祐),김용판(金用判),52,4,56,1
1816,강선우(姜仙祐),김웅(金雄),52,5,57,1
1817,강선우(姜仙祐),김원이(金元二),133,117,250,0
1818,강선우(姜仙祐),김윤덕(金潤德),117,137,254,0
1819,강선우(姜仙祐),김의겸(金宜謙),51,41,92,0
1820,강선우(姜仙祐),김정재(金汀才),53,5,58,1
1821,강선우(姜仙祐),김정호(金禎鎬),146,182,328,0
1822,강선우(姜仙祐),김종민(金鐘民),95,77,172,0
1823,강선우(姜仙祐),김주영(金周暎),117,120,237,0
1824,강선우(姜仙祐),김진표(金振杓),66,59,125,1
1825,강선우(姜仙祐),김철민(金哲玟),110,105,215,0
1826,강선우(姜仙祐),김태년(金太年),79,53,132,0
1827,강선우(姜仙祐),김태호(金台鎬),41,5,46,1
1828,강선우(姜仙祐),김학용(金學容),25,4,29,1
1829,강선우(姜仙祐),김한규(金翰奎),41,31,72,0
1830,강선우(姜仙祐),김한정(金漢正),82,49,131,0
1831,강선우(姜仙祐),김형동(金亨東),52,5,57,1
1832,강선우(姜仙祐),김홍걸(金弘傑),68,120,188,0
1833,강선우(姜仙祐),김회재(金會在),117,81,198,0
1834,강선우(姜仙祐),김희곤(金熙坤),51,4,55,1
1835,강선우(姜仙祐),김희국(金熙國),49,4,53,1
1836,강선우(姜仙祐),남인순(南仁順),153,161,314,0
1837,강선우(姜仙祐),노용호(魯容昊),25,4,29,1
1838,강선우(姜仙祐),노웅래(盧雄來),98,77,175,0
1839,강선우(姜仙祐),도종환(都鍾煥),102,79,181,0
1840,강선우(姜仙祐),류성걸(柳性杰),49,4,53,1
1841,강선우(姜仙祐),류호정(柳好貞),19,41,60,1
1842,강선우(姜仙祐),맹성규(孟聖奎),128,88,216,0
1843,강선우(姜仙祐),문정복(文貞福),95,66,161,0
1844,강선우(姜仙祐),문진석(文振碩),118,121,239,0
1845,강선우(姜仙祐),민병덕(閔炳德),108,124,232,0
1846,강선우(姜仙祐),민형배(閔馨培),88,107,195,0
1847,강선우(姜仙祐),민홍철(閔洪喆),101,99,200,0
1848,강선우(姜仙祐),박광온(朴洸瑥),99,77,176,0
1849,강선우(姜仙祐),박대수(朴大壽),50,7,57,1
1850,강선우(姜仙祐),박대출(朴大出),50,4,54,1
1851,강선우(姜仙祐),박덕흠(朴德欽),37,12,49,1
1852,강선우(姜仙祐),박범계(朴範界),80,34,114,0
1853,강선우(姜仙祐),박병석(朴炳錫),41,16,57,0
1854,강선우(姜仙祐),박상혁(朴商赫),114,138,252,0
1855,강선우(姜仙祐),박성민(朴聖敏),52,5,57,1
1856,강선우(姜仙祐),박성준(朴省俊),141,141,282,0
1857,강선우(姜仙祐),박성중(朴成重),49,4,53,1
1858,강선우(姜仙祐),박수영(朴洙瑩),49,5,54,1
1859,강선우(姜仙祐),박영순(朴英淳),105,77,182,0
1860,강선우(姜仙祐),박완주(朴完柱),51,52,103,1
1861,강선우(姜仙祐),박용진(朴用鎭),82,40,122,0
1862,강선우(姜仙祐),박재호(朴在昊),111,79,190,0
1863,강선우(姜仙祐),박정(朴釘),98,99,197,0
1864,강선우(姜仙祐),박정하(朴正河),25,4,29,1
1865,강선우(姜仙祐),박주민(朴柱民),83,59,142,0
1866,강선우(姜仙祐),박진(朴振),50,4,54,1
1867,강선우(姜仙祐),박찬대(朴贊大),100,72,172,0
1868,강선우(姜仙祐),박형수(朴亨修),49,5,54,1
1869,강선우(姜仙祐),박홍근(朴洪根),132,148,280,0
1870,강선우(姜仙祐),배준영(裵俊英),50,5,55,1
1871,강선우(姜仙祐),배진교(裵晋敎),17,29,46,1
1872,강선우(姜仙祐),배현진(裵賢鎭),49,5,54,1
1873,강선우(姜仙祐),백종헌(白宗憲),50,5,55,1
1874,강선우(姜仙祐),백혜련(白惠蓮),92,64,156,0
1875,강선우(姜仙祐),변재일(卞在一),103,63,166,0
1876,강선우(姜仙祐),서동용(徐東榕),101,88,189,0
1877,강선우(姜仙祐),서범수(徐範洙),51,4,55,1
1878,강선우(姜仙祐),서병수(徐秉洙),50,6,56,1
1879,강선우(姜仙祐),서삼석(徐參錫),96,83,179,0
1880,강선우(姜仙祐),서영교(徐瑛敎),98,113,211,0
1881,강선우(姜仙祐),서영석(徐暎錫),145,210,355,0
1882,강선우(姜仙祐),서일준(徐一俊),50,5,55,1
1883,강선우(姜仙祐),서정숙(徐正淑),49,6,55,1
1884,강선우(姜仙祐),설훈(薛勳),97,86,183,0
1885,강선우(姜仙祐),성일종(成一鍾),50,6,56,1
1886,강선우(姜仙祐),소병철(蘇秉哲),86,62,148,0
1887,강선우(姜仙祐),소병훈(蘇秉勳),116,129,245,0
1888,강선우(姜仙祐),송갑석(宋甲錫),116,102,218,0
1889,강선우(姜仙祐),송기헌(宋基憲),87,56,143,0
1890,강선우(姜仙祐),송석준(宋錫俊),52,9,61,1
1891,강선우(姜仙祐),송언석(宋彦錫),45,4,49,1
1892,강선우(姜仙祐),송옥주(宋玉珠),129,124,253,0
1893,강선우(姜仙祐),송재호(宋在祜),122,89,211,0
1894,강선우(姜仙祐),신동근(申東根),105,96,201,0
1895,강선우(姜仙祐),신영대(申榮大),90,87,177,0
1896,강선우(姜仙祐),신원식(申源湜),49,4,53,1
1897,강선우(姜仙祐),신정훈(辛正勳),132,159,291,0
1898,강선우(姜仙祐),신현영(申賢榮),89,51,140,0
1899,강선우(姜仙祐),심상정(沈相奵),18,31,49,1
1900,강선우(姜仙祐),안규백(安圭伯),113,127,240,0
1901,강선우(姜仙祐),안민석(安敏錫),91,67,158,0
1902,강선우(姜仙祐),안병길(安炳吉),50,4,54,1
1903,강선우(姜仙祐),안철수(安哲秀),25,4,29,1
1904,강선우(姜仙祐),안호영(安浩永),97,95,192,0
1905,강선우(姜仙祐),양경숙(梁敬淑),107,77,184,0
1906,강선우(姜仙祐),양금희(梁琴喜),50,6,56,1
1907,강선우(姜仙祐),양기대(梁基大),108,88,196,0
1908,강선우(姜仙祐),양이원영(梁李媛瑛),104,103,207,0
1909,강선우(姜仙祐),양정숙(梁貞淑),74,140,214,1
1910,강선우(姜仙祐),양향자(梁香子),54,49,103,1
1911,강선우(姜仙祐),어기구(魚基龜),86,64,150,0
1912,강선우(姜仙祐),엄태영(嚴泰永),50,4,54,1
1913,강선우(姜仙祐),오기형(吳奇炯),81,44,125,0
1914,강선우(姜仙祐),오영환(吳永煥),141,200,341,0
1915,강선우(姜仙祐),용혜인(龍慧仁),14,37,51,1
1916,강선우(姜仙祐),우상호(禹相虎),80,36,116,0
1917,강선우(姜仙祐),우원식(禹元植),88,92,180,0
1918,강선우(姜仙祐),위성곤(魏聖坤),104,123,227,0
1919,강선우(姜仙祐),유경준(兪京濬),49,5,54,1
1920,강선우(姜仙祐),유기홍(柳基洪),79,49,128,0
1921,강선우(姜仙祐),유동수(柳東秀),92,56,148,0
1922,강선우(姜仙祐),유상범(劉相凡),49,4,53,1
1923,강선우(姜仙祐),유의동(兪義東),50,5,55,1
1924,강선우(姜仙祐),유정주(兪訂炷),102,115,217,0
1925,강선우(姜仙祐),윤건영(尹建永),91,83,174,0
1926,강선우(姜仙祐),윤관석(尹官石),97,73,170,1
1927,강선우(姜仙祐),윤두현(尹斗鉉),49,5,54,1
1928,강선우(姜仙祐),윤미향(尹美香),71,102,173,1
1929,강선우(姜仙祐),윤상현(尹相現),30,5,35,1
1930,강선우(姜仙祐),윤영덕(尹永德),98,87,185,0
1931,강선우(姜仙祐),윤영석(尹永碩),50,5,55,1
1932,강선우(姜仙祐),윤영찬(尹永燦),99,78,177,0
1933,강선우(姜仙祐),윤재갑(尹才鉀),119,103,222,0
1934,강선우(姜仙祐),윤재옥(尹在玉),50,4,54,1
1935,강선우(姜仙祐),윤주경(尹柱卿),49,7,56,1
1936,강선우(姜仙祐),윤준병(尹準炳),120,192,312,0
1937,강선우(姜仙祐),윤창현(尹暢賢),49,5,54,1
1938,강선우(姜仙祐),윤한홍(尹漢洪),50,4,54,1
1939,강선우(姜仙祐),윤호중(尹昊重),83,68,151,0
1940,강선우(姜仙祐),윤후덕(尹厚德),97,69,166,0
1941,강선우(姜仙祐),이개호(李介昊),104,91,195,0
1942,강선우(姜仙祐),이달곤(李達坤),51,6,57,1
1943,강선우(姜仙祐),이동주(李東洲),99,114,213,0
1944,강선우(姜仙祐),이만희(李晩熙),50,4,54,1
1945,강선우(姜仙祐),이명수(李明洙),51,13,64,1
1946,강선우(姜仙祐),이병훈(李炳勳),106,120,226,0
1947,강선우(姜仙祐),이상민(李相珉),85,40,125,0
1948,강선우(姜仙祐),이상헌(李相憲),118,122,240,0
1949,강선우(姜仙祐),이성만(李成萬),110,98,208,1
1950,강선우(姜仙祐),이소영(李素永),88,61,149,0
1951,강선우(姜仙祐),이수진(李壽珍),127,145,272,0
1952,강선우(姜仙祐),이수진(李秀眞),139,159,298,0
1953,강선우(姜仙祐),이양수(李亮壽),51,7,58,1
1954,강선우(姜仙祐),이용(李鏞),49,4,53,1
1955,강선우(姜仙祐),이용빈(李龍彬),140,143,283,0
1956,강선우(姜仙祐),이용선(李庸瑄),106,95,201,0
1957,강선우(姜仙祐),이용우(李龍雨),114,76,190,0
1958,강선우(姜仙祐),이용호(李容鎬),36,32,68,1
1959,강선우(姜仙祐),이원욱(李元旭),113,95,208,0
1960,강선우(姜仙祐),이원택(李源澤),90,80,170,0
1961,강선우(姜仙祐),이은주(李恩周),28,39,67,1
1962,강선우(姜仙祐),이인선(李仁善),25,4,29,1
1963,강선우(姜仙祐),이인영(李仁榮),81,49,130,0
1964,강선우(姜仙祐),이장섭(李將燮),98,79,177,0
1965,강선우(姜仙祐),이재명(李在明),40,21,61,0
1966,강선우(姜仙祐),이재정(李在汀),87,46,133,0
1967,강선우(姜仙祐),이정문(李楨文),116,95,211,0
1968,강선우(姜仙祐),이종배(李鍾培),50,7,57,1
1969,강선우(姜仙祐),이종성(李鍾成),49,7,56,1
1970,강선우(姜仙祐),이주환(李周桓),49,5,54,1
1971,강선우(姜仙祐),이채익(李埰益),52,6,58,1
1972,강선우(姜仙祐),이철규(李喆圭),51,7,58,1
1973,강선우(姜仙祐),이탄희(李誕熙),107,76,183,0
1974,강선우(姜仙祐),이태규(李泰珪),30,7,37,1
1975,강선우(姜仙祐),이학영(李學永),115,135,250,0
1976,강선우(姜仙祐),이해식(李海植),122,121,243,0
1977,강선우(姜仙祐),이헌승(李憲昇),50,5,55,1
1978,강선우(姜仙祐),이형석(李炯錫),111,87,198,0
1979,강선우(姜仙祐),인재근(印在謹),141,171,312,0
1980,강선우(姜仙祐),임병헌(林炳憲),26,5,31,1
1981,강선우(姜仙祐),임오경(林五卿),93,81,174,0
1982,강선우(姜仙祐),임이자(林利子),49,4,53,1
1983,강선우(姜仙祐),임종성(林鍾聲),133,161,294,0
1984,강선우(姜仙祐),임호선(林昊宣),124,183,307,0
1985,강선우(姜仙祐),장경태(張耿態),99,98,197,0
1986,강선우(姜仙祐),장동혁(張東赫),25,4,29,1
1987,강선우(姜仙祐),장제원(張濟元),49,4,53,1
1988,강선우(姜仙祐),장철민(張喆敏),109,99,208,0
1989,강선우(姜仙祐),장혜영(張惠英),16,32,48,1
1990,강선우(姜仙祐),전봉민(田奉珉),35,6,41,1
1991,강선우(姜仙祐),전용기(田溶冀),104,127,231,0
1992,강선우(姜仙祐),전재수(田載秀),105,98,203,0
1993,강선우(姜仙祐),전주혜(全珠惠),51,5,56,1
1994,강선우(姜仙祐),전해철(全海澈),77,56,133,0
1995,강선우(姜仙祐),전혜숙(全惠淑),117,103,220,0
1996,강선우(姜仙祐),정경희(丁慶姬),49,4,53,1
1997,강선우(姜仙祐),정동만(鄭東萬),49,4,53,1
1998,강선우(姜仙祐),정성호(鄭成湖),93,85,178,0
1999,강선우(姜仙祐),정우택(鄭宇澤),26,5,31,1
2000,강선우(姜仙祐),정운천(鄭雲天),49,5,54,1
2001,강선우(姜仙祐),정일영(鄭日永),104,116,220,0
2002,강선우(姜仙祐),정점식(鄭点植),50,4,54,1
2003,강선우(姜仙祐),정진석(鄭鎭碩),50,5,55,1
2004,강선우(姜仙祐),정청래(鄭淸來),103,59,162,0
2005,강선우(姜仙祐),정춘숙(鄭春淑),131,114,245,0
2006,강선우(姜仙祐),정태호(鄭泰浩),101,86,187,0
2007,강선우(姜仙祐),정필모(鄭必模),104,69,173,0
2008,강선우(姜仙祐),정희용(鄭熙溶),51,6,57,1
2009,강선우(姜仙祐),조경태(趙慶泰),49,4,53,1
2010,강선우(姜仙祐),조명희(曺明姬),49,7,56,1
2011,강선우(姜仙祐),조수진(趙修眞),49,4,53,1
2012,강선우(姜仙祐),조승래(趙承來),133,112,245,0
2013,강선우(姜仙祐),조오섭(曺五燮),100,138,238,0
2014,강선우(姜仙祐),조은희(趙恩禧),25,4,29,1
2015,강선우(姜仙祐),조응천(趙應天),92,47,139,0
2016,강선우(姜仙祐),조정식(趙正湜),92,57,149,0
2017,강선우(姜仙祐),조정훈(趙廷訓),1,13,14,1
2018,강선우(姜仙祐),조해진(曺海珍),51,5,56,1
2019,강선우(姜仙祐),주철현(朱哲鉉),93,75,168,0
2020,강선우(姜仙祐),주호영(朱豪英),49,4,53,1
2021,강선우(姜仙祐),지성호(池成浩),49,4,53,1
2022,강선우(姜仙祐),진선미(陳善美),84,53,137,0
2023,강선우(姜仙祐),진성준(陳聲準),99,101,200,0
2024,강선우(姜仙祐),천준호(千俊鎬),89,74,163,0
2025,강선우(姜仙祐),최기상(崔基相),87,73,160,0
2026,강선우(姜仙祐),최승재(崔承宰),50,8,58,1
2027,강선우(姜仙祐),최연숙(崔姸淑),31,20,51,1
2028,강선우(姜仙祐),최영희(崔英姬),25,4,29,1
2029,강선우(姜仙祐),최인호(崔仁昊),105,89,194,0
2030,강선우(姜仙祐),최재형(崔在亨),25,4,29,1
2031,강선우(姜仙祐),최종윤(崔鍾允),168,167,335,0
2032,강선우(姜仙祐),최춘식(崔春植),49,4,53,1
2033,강선우(姜仙祐),최형두(崔炯斗),50,6,56,1
2034,강선우(姜仙祐),최혜영(崔惠英),152,184,336,0
2035,강선우(姜仙祐),추경호(秋慶鎬),49,5,54,1
2036,강선우(姜仙祐),태영호(太永浩),49,6,55,1
2037,강선우(姜仙祐),하영제(河榮帝),41,1,42,1
2038,강선우(姜仙祐),하태경(河泰慶),50,5,55,1
2039,강선우(姜仙祐),한기호(韓起鎬),52,6,58,1
2040,강선우(姜仙祐),한무경(韓茂景),50,6,56,1
2041,강선우(姜仙祐),한병도(韓秉道),111,111,222,0
2042,강선우(姜仙祐),한정애(韓貞愛),98,107,205,0
2043,강선우(姜仙祐),한준호(韓俊鎬),110,115,225,0
2044,강선우(姜仙祐),허숙정(許淑湞),1,1,2,0
2045,강선우(姜仙祐),허영(許榮),131,175,306,0
2046,강선우(姜仙祐),허은아(許垠娥),50,5,55,1
2047,강선우(姜仙祐),허종식(許琮植),162,158,320,0
2048,강선우(姜仙祐),홍기원(洪起元),105,91,196,0
2049,강선우(姜仙祐),홍문표(洪文杓),50,4,54,1
2050,강선우(姜仙祐),홍석준(洪碩晙),50,4,54,1
2051,강선우(姜仙祐),홍성국(洪性國),169,205,374,0
2052,강선우(姜仙祐),홍영표(洪永杓),85,61,146,0
2053,강선우(姜仙祐),홍익표(洪翼杓),95,96,191,0
2054,강선우(姜仙祐),홍정민(洪貞敏),111,95,206,0
2055,강선우(姜仙祐),황보승희(皇甫承希),47,2,49,1
2056,강선우(姜仙祐),황운하(黃雲夏),130,107,237,0
2057,강선우(姜仙祐),황희(黃熙),82,50,132,0
2058,강성희(姜聖熙),강은미(姜恩美),4,22,26,1
2059,강성희(姜聖熙),강준현(康準鉉),5,3,8,1
2060,강성희(姜聖熙),강훈식(姜勳植),4,2,6,1
2061,강성희(姜聖熙),고민정(高旼廷),5,3,8,1
2062,강성희(姜聖熙),고영인(高永寅),5,4,9,1
2063,강성희(姜聖熙),고용진(高榕禛),4,2,6,1
2064,강성희(姜聖熙),구자근(具滋根),0,0,0,1
2065,강성희(姜聖熙),권명호(權明浩),0,0,0,1
2066,강성희(姜聖熙),권성동(權性東),0,0,0,1
2067,강성희(姜聖熙),권영세(權寧世),0,0,0,1
2068,강성희(姜聖熙),권은희(權垠希),0,0,0,1
2069,강성희(姜聖熙),권인숙(權仁淑),5,4,9,1
2070,강성희(姜聖熙),권칠승(權七勝),5,3,8,1
2071,강성희(姜聖熙),기동민(奇東旻),4,4,8,1
2072,강성희(姜聖熙),김경만(金京萬),5,2,7,1
2073,강성희(姜聖熙),김경협(金炅俠),5,4,9,1
2074,강성희(姜聖熙),김교흥(金敎興),5,2,7,1
2075,강성희(姜聖熙),김기현(金起炫),0,0,0,1
2076,강성희(姜聖熙),김남국(金南局),5,3,8,1
2077,강성희(姜聖熙),김도읍(金度邑),0,0,0,1
2078,강성희(姜聖熙),김두관(金斗官),5,7,12,1
2079,강성희(姜聖熙),김미애(金美愛),0,0,0,1
2080,강성희(姜聖熙),김민기(金敏基),4,3,7,1
2081,강성희(姜聖熙),김민석(金民錫),5,4,9,1
2082,강성희(姜聖熙),김민철(金敏徹),4,2,6,1
2083,강성희(姜聖熙),김병기(金炳基),5,2,7,1
2084,강성희(姜聖熙),김병욱A(金炳旭),4,2,6,1
2085,강성희(姜聖熙),김병욱B(金炳旭),0,0,0,1
2086,강성희(姜聖熙),김병주(金柄周),5,2,7,1
2087,강성희(姜聖熙),김상훈(金相勳),0,0,0,1
2088,강성희(姜聖熙),김상희(金相姬),5,3,8,1
2089,강성희(姜聖熙),김석기(金碩基),0,0,0,1
2090,강성희(姜聖熙),김성원(金成願),0,0,0,1
2091,강성희(姜聖熙),김성주(金成柱),5,10,15,1
2092,강성희(姜聖熙),김성환(金星煥),5,4,9,1
2093,강성희(姜聖熙),김수흥(金洙興),5,3,8,1
2094,강성희(姜聖熙),김승남(金承南),4,8,12,1
2095,강성희(姜聖熙),김승수(金承洙),0,0,0,1
2096,강성희(姜聖熙),김승원(金勝源),5,2,7,1
2097,강성희(姜聖熙),김영배(金永培),4,3,7,1
2098,강성희(姜聖熙),김영선(金映宣),0,0,0,1
2099,강성희(姜聖熙),김영식(金英植),0,0,0,1
2100,강성희(姜聖熙),김영주(金榮珠),4,3,7,1
2101,강성희(姜聖熙),김영진(金榮鎭),5,3,8,1
2102,강성희(姜聖熙),김영호(金映豪),5,2,7,1
2103,강성희(姜聖熙),김예지(金睿智),0,4,4,1
2104,강성희(姜聖熙),김용민(金容民),5,4,9,1
2105,강성희(姜聖熙),김용판(金用判),0,0,0,1
2106,강성희(姜聖熙),김웅(金雄),0,0,0,1
2107,강성희(姜聖熙),김원이(金元二),5,4,9,1
2108,강성희(姜聖熙),김윤덕(金潤德),5,3,8,1
2109,강성희(姜聖熙),김의겸(金宜謙),5,5,10,1
2110,강성희(姜聖熙),김정재(金汀才),0,0,0,1
2111,강성희(姜聖熙),김정호(金禎鎬),5,5,10,1
2112,강성희(姜聖熙),김종민(金鐘民),4,6,10,1
2113,강성희(姜聖熙),김주영(金周暎),5,9,14,1
2114,강성희(姜聖熙),김진표(金振杓),0,0,0,1
2115,강성희(姜聖熙),김철민(金哲玟),4,2,6,1
2116,강성희(姜聖熙),김태년(金太年),4,4,8,1
2117,강성희(姜聖熙),김태호(金台鎬),0,0,0,1
2118,강성희(姜聖熙),김학용(金學容),0,0,0,1
2119,강성희(姜聖熙),김한규(金翰奎),5,4,9,1
2120,강성희(姜聖熙),김한정(金漢正),4,3,7,1
2121,강성희(姜聖熙),김형동(金亨東),0,0,0,1
2122,강성희(姜聖熙),김홍걸(金弘傑),5,8,13,1
2123,강성희(姜聖熙),김회재(金會在),4,3,7,1
2124,강성희(姜聖熙),김희곤(金熙坤),0,0,0,1
2125,강성희(姜聖熙),김희국(金熙國),0,0,0,1
2126,강성희(姜聖熙),남인순(南仁順),5,4,9,1
2127,강성희(姜聖熙),노용호(魯容昊),0,0,0,1
2128,강성희(姜聖熙),노웅래(盧雄來),5,3,8,1
2129,강성희(姜聖熙),도종환(都鍾煥),5,3,8,1
2130,강성희(姜聖熙),류성걸(柳性杰),0,0,0,1
2131,강성희(姜聖熙),류호정(柳好貞),4,31,35,1
2132,강성희(姜聖熙),맹성규(孟聖奎),5,2,7,1
2133,강성희(姜聖熙),문정복(文貞福),5,2,7,1
2134,강성희(姜聖熙),문진석(文振碩),5,3,8,1
2135,강성희(姜聖熙),민병덕(閔炳德),4,7,11,1
2136,강성희(姜聖熙),민형배(閔馨培),5,8,13,1
2137,강성희(姜聖熙),민홍철(閔洪喆),4,2,6,1
2138,강성희(姜聖熙),박광온(朴洸瑥),4,2,6,1
2139,강성희(姜聖熙),박대수(朴大壽),0,0,0,1
2140,강성희(姜聖熙),박대출(朴大出),0,0,0,1
2141,강성희(姜聖熙),박덕흠(朴德欽),0,0,0,1
2142,강성희(姜聖熙),박범계(朴範界),5,2,7,1
2143,강성희(姜聖熙),박병석(朴炳錫),4,2,6,1
2144,강성희(姜聖熙),박상혁(朴商赫),4,3,7,1
2145,강성희(姜聖熙),박성민(朴聖敏),0,0,0,1
2146,강성희(姜聖熙),박성준(朴省俊),5,3,8,1
2147,강성희(姜聖熙),박성중(朴成重),0,0,0,1
2148,강성희(姜聖熙),박수영(朴洙瑩),0,0,0,1
2149,강성희(姜聖熙),박영순(朴英淳),5,2,7,1
2150,강성희(姜聖熙),박완주(朴完柱),4,2,6,1
2151,강성희(姜聖熙),박용진(朴用鎭),4,4,8,1
2152,강성희(姜聖熙),박재호(朴在昊),5,3,8,1
2153,강성희(姜聖熙),박정(朴釘),4,2,6,1
2154,강성희(姜聖熙),박정하(朴正河),0,0,0,1
2155,강성희(姜聖熙),박주민(朴柱民),5,10,15,1
2156,강성희(姜聖熙),박진(朴振),0,0,0,1
2157,강성희(姜聖熙),박찬대(朴贊大),5,3,8,1
2158,강성희(姜聖熙),박형수(朴亨修),0,0,0,1
2159,강성희(姜聖熙),박홍근(朴洪根),4,3,7,1
2160,강성희(姜聖熙),배준영(裵俊英),0,0,0,1
2161,강성희(姜聖熙),배진교(裵晋敎),4,27,31,1
2162,강성희(姜聖熙),배현진(裵賢鎭),0,0,0,1
2163,강성희(姜聖熙),백종헌(白宗憲),0,0,0,1
2164,강성희(姜聖熙),백혜련(白惠蓮),4,3,7,1
2165,강성희(姜聖熙),변재일(卞在一),4,2,6,1
2166,강성희(姜聖熙),서동용(徐東榕),4,3,7,1
2167,강성희(姜聖熙),서범수(徐範洙),0,0,0,1
2168,강성희(姜聖熙),서병수(徐秉洙),0,0,0,1
2169,강성희(姜聖熙),서삼석(徐參錫),4,3,7,1
2170,강성희(姜聖熙),서영교(徐瑛敎),5,4,9,1
2171,강성희(姜聖熙),서영석(徐暎錫),5,5,10,1
2172,강성희(姜聖熙),서일준(徐一俊),0,0,0,1
2173,강성희(姜聖熙),서정숙(徐正淑),0,0,0,1
2174,강성희(姜聖熙),설훈(薛勳),4,3,7,1
2175,강성희(姜聖熙),성일종(成一鍾),0,0,0,1
2176,강성희(姜聖熙),소병철(蘇秉哲),4,4,8,1
2177,강성희(姜聖熙),소병훈(蘇秉勳),5,7,12,1
2178,강성희(姜聖熙),송갑석(宋甲錫),4,5,9,1
2179,강성희(姜聖熙),송기헌(宋基憲),4,3,7,1
2180,강성희(姜聖熙),송석준(宋錫俊),0,0,0,1
2181,강성희(姜聖熙),송언석(宋彦錫),0,0,0,1
2182,강성희(姜聖熙),송옥주(宋玉珠),4,9,13,1
2183,강성희(姜聖熙),송재호(宋在祜),5,3,8,1
2184,강성희(姜聖熙),신동근(申東根),4,3,7,1
2185,강성희(姜聖熙),신영대(申榮大),5,4,9,1
2186,강성희(姜聖熙),신원식(申源湜),0,0,0,1
2187,강성희(姜聖熙),신정훈(辛正勳),5,5,10,1
2188,강성희(姜聖熙),신현영(申賢榮),4,2,6,1
2189,강성희(姜聖熙),심상정(沈相奵),4,17,21,1
2190,강성희(姜聖熙),안규백(安圭伯),5,2,7,1
2191,강성희(姜聖熙),안민석(安敏錫),5,2,7,1
2192,강성희(姜聖熙),안병길(安炳吉),0,0,0,1
2193,강성희(姜聖熙),안철수(安哲秀),0,0,0,1
2194,강성희(姜聖熙),안호영(安浩永),5,5,10,1
2195,강성희(姜聖熙),양경숙(梁敬淑),5,3,8,1
2196,강성희(姜聖熙),양금희(梁琴喜),0,0,0,1
2197,강성희(姜聖熙),양기대(梁基大),4,2,6,1
2198,강성희(姜聖熙),양이원영(梁李媛瑛),5,3,8,1
2199,강성희(姜聖熙),양정숙(梁貞淑),5,21,26,1
2200,강성희(姜聖熙),양향자(梁香子),1,1,2,1
2201,강성희(姜聖熙),어기구(魚基龜),4,5,9,1
2202,강성희(姜聖熙),엄태영(嚴泰永),0,0,0,1
2203,강성희(姜聖熙),오기형(吳奇炯),4,3,7,1
2204,강성희(姜聖熙),오영환(吳永煥),4,4,8,1
2205,강성희(姜聖熙),용혜인(龍慧仁),5,26,31,1
2206,강성희(姜聖熙),우상호(禹相虎),4,2,6,1
2207,강성희(姜聖熙),우원식(禹元植),5,2,7,1
2208,강성희(姜聖熙),위성곤(魏聖坤),4,5,9,1
2209,강성희(姜聖熙),유경준(兪京濬),0,0,0,1
2210,강성희(姜聖熙),유기홍(柳基洪),4,4,8,1
2211,강성희(姜聖熙),유동수(柳東秀),5,2,7,1
2212,강성희(姜聖熙),유상범(劉相凡),0,0,0,1
2213,강성희(姜聖熙),유의동(兪義東),0,0,0,1
2214,강성희(姜聖熙),유정주(兪訂炷),5,9,14,1
2215,강성희(姜聖熙),윤건영(尹建永),5,3,8,1
2216,강성희(姜聖熙),윤관석(尹官石),3,3,6,1
2217,강성희(姜聖熙),윤두현(尹斗鉉),0,0,0,1
2218,강성희(姜聖熙),윤미향(尹美香),5,36,41,1
2219,강성희(姜聖熙),윤상현(尹相現),0,0,0,1
2220,강성희(姜聖熙),윤영덕(尹永德),5,7,12,1
2221,강성희(姜聖熙),윤영석(尹永碩),0,0,0,1
2222,강성희(姜聖熙),윤영찬(尹永燦),4,4,8,1
2223,강성희(姜聖熙),윤재갑(尹才鉀),5,3,8,1
2224,강성희(姜聖熙),윤재옥(尹在玉),0,0,0,1
2225,강성희(姜聖熙),윤주경(尹柱卿),0,0,0,1
2226,강성희(姜聖熙),윤준병(尹準炳),4,14,18,1
2227,강성희(姜聖熙),윤창현(尹暢賢),0,0,0,1
2228,강성희(姜聖熙),윤한홍(尹漢洪),0,0,0,1
2229,강성희(姜聖熙),윤호중(尹昊重),4,4,8,1
2230,강성희(姜聖熙),윤후덕(尹厚德),4,3,7,1
2231,강성희(姜聖熙),이개호(李介昊),5,2,7,1
2232,강성희(姜聖熙),이달곤(李達坤),0,0,0,1
2233,강성희(姜聖熙),이동주(李東洲),5,4,9,1
2234,강성희(姜聖熙),이만희(李晩熙),0,0,0,1
2235,강성희(姜聖熙),이명수(李明洙),0,0,0,1
2236,강성희(姜聖熙),이병훈(李炳勳),5,4,9,1
2237,강성희(姜聖熙),이상민(李相珉),4,5,9,1
2238,강성희(姜聖熙),이상헌(李相憲),5,2,7,1
2239,강성희(姜聖熙),이성만(李成萬),5,15,20,1
2240,강성희(姜聖熙),이소영(李素永),5,2,7,1
2241,강성희(姜聖熙),이수진(李壽珍),5,8,13,1
2242,강성희(姜聖熙),이수진(李秀眞),5,3,8,1
2243,강성희(姜聖熙),이양수(李亮壽),0,0,0,1
2244,강성희(姜聖熙),이용(李鏞),0,0,0,1
2245,강성희(姜聖熙),이용빈(李龍彬),5,3,8,1
2246,강성희(姜聖熙),이용선(李庸瑄),5,5,10,1
2247,강성희(姜聖熙),이용우(李龍雨),4,4,8,1
2248,강성희(姜聖熙),이용호(李容鎬),0,0,0,1
2249,강성희(姜聖熙),이원욱(李元旭),4,4,8,1
2250,강성희(姜聖熙),이원택(李源澤),5,4,9,1
2251,강성희(姜聖熙),이은주(李恩周),4,19,23,1
2252,강성희(姜聖熙),이인선(李仁善),0,0,0,1
2253,강성희(姜聖熙),이인영(李仁榮),4,3,7,1
2254,강성희(姜聖熙),이장섭(李將燮),5,4,9,1
2255,강성희(姜聖熙),이재명(李在明),5,2,7,1
2256,강성희(姜聖熙),이재정(李在汀),5,3,8,1
2257,강성희(姜聖熙),이정문(李楨文),5,3,8,1
2258,강성희(姜聖熙),이종배(李鍾培),0,0,0,1
2259,강성희(姜聖熙),이종성(李鍾成),0,0,0,1
2260,강성희(姜聖熙),이주환(李周桓),0,0,0,1
2261,강성희(姜聖熙),이채익(李埰益),0,0,0,1
2262,강성희(姜聖熙),이철규(李喆圭),0,0,0,1
2263,강성희(姜聖熙),이탄희(李誕熙),4,7,11,1
2264,강성희(姜聖熙),이태규(李泰珪),0,0,0,1
2265,강성희(姜聖熙),이학영(李學永),5,6,11,1
2266,강성희(姜聖熙),이해식(李海植),5,3,8,1
2267,강성희(姜聖熙),이헌승(李憲昇),0,0,0,1
2268,강성희(姜聖熙),이형석(李炯錫),5,3,8,1
2269,강성희(姜聖熙),인재근(印在謹),5,3,8,1
2270,강성희(姜聖熙),임병헌(林炳憲),0,0,0,1
2271,강성희(姜聖熙),임오경(林五卿),5,3,8,1
2272,강성희(姜聖熙),임이자(林利子),0,0,0,1
2273,강성희(姜聖熙),임종성(林鍾聲),5,7,12,1
2274,강성희(姜聖熙),임호선(林昊宣),5,3,8,1
2275,강성희(姜聖熙),장경태(張耿態),5,2,7,1
2276,강성희(姜聖熙),장동혁(張東赫),0,0,0,1
2277,강성희(姜聖熙),장제원(張濟元),0,0,0,1
2278,강성희(姜聖熙),장철민(張喆敏),4,3,7,1
2279,강성희(姜聖熙),장혜영(張惠英),4,29,33,1
2280,강성희(姜聖熙),전봉민(田奉珉),0,0,0,1
2281,강성희(姜聖熙),전용기(田溶冀),5,3,8,1
2282,강성희(姜聖熙),전재수(田載秀),4,3,7,1
2283,강성희(姜聖熙),전주혜(全珠惠),0,0,0,1
2284,강성희(姜聖熙),전해철(全海澈),4,3,7,1
2285,강성희(姜聖熙),전혜숙(全惠淑),4,2,6,1
2286,강성희(姜聖熙),정경희(丁慶姬),0,0,0,1
2287,강성희(姜聖熙),정동만(鄭東萬),0,0,0,1
2288,강성희(姜聖熙),정성호(鄭成湖),4,4,8,1
2289,강성희(姜聖熙),정우택(鄭宇澤),0,0,0,1
2290,강성희(姜聖熙),정운천(鄭雲天),0,0,0,1
2291,강성희(姜聖熙),정일영(鄭日永),5,4,9,1
2292,강성희(姜聖熙),정점식(鄭点植),0,0,0,1
2293,강성희(姜聖熙),정진석(鄭鎭碩),0,0,0,1
2294,강성희(姜聖熙),정청래(鄭淸來),5,2,7,1
2295,강성희(姜聖熙),정춘숙(鄭春淑),4,4,8,1
2296,강성희(姜聖熙),정태호(鄭泰浩),4,4,8,1
2297,강성희(姜聖熙),정필모(鄭必模),5,3,8,1
2298,강성희(姜聖熙),정희용(鄭熙溶),0,0,0,1
2299,강성희(姜聖熙),조경태(趙慶泰),0,0,0,1
2300,강성희(姜聖熙),조명희(曺明姬),0,0,0,1
2301,강성희(姜聖熙),조수진(趙修眞),0,0,0,1
2302,강성희(姜聖熙),조승래(趙承來),4,2,6,1
2303,강성희(姜聖熙),조오섭(曺五燮),4,5,9,1
2304,강성희(姜聖熙),조은희(趙恩禧),0,0,0,1
2305,강성희(姜聖熙),조응천(趙應天),4,2,6,1
2306,강성희(姜聖熙),조정식(趙正湜),5,2,7,1
2307,강성희(姜聖熙),조정훈(趙廷訓),0,0,0,1
2308,강성희(姜聖熙),조해진(曺海珍),0,0,0,1
2309,강성희(姜聖熙),주철현(朱哲鉉),5,6,11,1
2310,강성희(姜聖熙),주호영(朱豪英),0,0,0,1
2311,강성희(姜聖熙),지성호(池成浩),0,0,0,1
2312,강성희(姜聖熙),진선미(陳善美),4,3,7,1
2313,강성희(姜聖熙),진성준(陳聲準),5,3,8,1
2314,강성희(姜聖熙),천준호(千俊鎬),5,2,7,1
2315,강성희(姜聖熙),최기상(崔基相),5,3,8,1
2316,강성희(姜聖熙),최승재(崔承宰),0,0,0,1
2317,강성희(姜聖熙),최연숙(崔姸淑),0,5,5,1
2318,강성희(姜聖熙),최영희(崔英姬),0,0,0,1
2319,강성희(姜聖熙),최인호(崔仁昊),4,3,7,1
2320,강성희(姜聖熙),최재형(崔在亨),0,0,0,1
2321,강성희(姜聖熙),최종윤(崔鍾允),4,4,8,1
2322,강성희(姜聖熙),최춘식(崔春植),0,0,0,1
2323,강성희(姜聖熙),최형두(崔炯斗),0,0,0,1
2324,강성희(姜聖熙),최혜영(崔惠英),5,5,10,1
2325,강성희(姜聖熙),추경호(秋慶鎬),0,0,0,1
2326,강성희(姜聖熙),태영호(太永浩),0,0,0,1
2327,강성희(姜聖熙),하영제(河榮帝),0,0,0,1
2328,강성희(姜聖熙),하태경(河泰慶),0,0,0,1
2329,강성희(姜聖熙),한기호(韓起鎬),0,0,0,1
2330,강성희(姜聖熙),한무경(韓茂景),0,0,0,1
2331,강성희(姜聖熙),한병도(韓秉道),4,3,7,1
2332,강성희(姜聖熙),한정애(韓貞愛),5,7,12,1
2333,강성희(姜聖熙),한준호(韓俊鎬),5,3,8,1
2334,강성희(姜聖熙),허숙정(許淑湞),1,1,2,1
2335,강성희(姜聖熙),허영(許榮),5,5,10,1
2336,강성희(姜聖熙),허은아(許垠娥),0,0,0,1
2337,강성희(姜聖熙),허종식(許琮植),5,3,8,1
2338,강성희(姜聖熙),홍기원(洪起元),4,3,7,1
2339,강성희(姜聖熙),홍문표(洪文杓),0,0,0,1
2340,강성희(姜聖熙),홍석준(洪碩晙),0,0,0,1
2341,강성희(姜聖熙),홍성국(洪性國),5,4,9,1
2342,강성희(姜聖熙),홍영표(洪永杓),4,3,7,1
2343,강성희(姜聖熙),홍익표(洪翼杓),4,4,8,1
2344,강성희(姜聖熙),홍정민(洪貞敏),5,2,7,1
2345,강성희(姜聖熙),황보승희(皇甫承希),0,0,0,1
2346,강성희(姜聖熙),황운하(黃雲夏),5,3,8,1
2347,강성희(姜聖熙),황희(黃熙),5,2,7,1
2348,강은미(姜恩美),강준현(康準鉉),14,22,36,1
2349,강은미(姜恩美),강훈식(姜勳植),18,30,48,1
2350,강은미(姜恩美),고민정(高旼廷),19,24,43,1
2351,강은미(姜恩美),고영인(高永寅),22,47,69,1
2352,강은미(姜恩美),고용진(高榕禛),14,17,31,1
2353,강은미(姜恩美),구자근(具滋根),4,3,7,1
2354,강은미(姜恩美),권명호(權明浩),4,4,8,1
2355,강은미(姜恩美),권성동(權性東),5,3,8,1
2356,강은미(姜恩美),권영세(權寧世),6,4,10,1
2357,강은미(姜恩美),권은희(權垠希),8,15,23,1
2358,강은미(姜恩美),권인숙(權仁淑),29,84,113,1
2359,강은미(姜恩美),권칠승(權七勝),13,17,30,1
2360,강은미(姜恩美),기동민(奇東旻),19,44,63,1
2361,강은미(姜恩美),김경만(金京萬),20,42,62,1
2362,강은미(姜恩美),김경협(金炅俠),20,30,50,1
2363,강은미(姜恩美),김교흥(金敎興),14,13,27,1
2364,강은미(姜恩美),김기현(金起炫),6,6,12,1
2365,강은미(姜恩美),김남국(金南局),17,33,50,1
2366,강은미(姜恩美),김도읍(金度邑),4,3,7,1
2367,강은미(姜恩美),김두관(金斗官),19,55,74,1
2368,강은미(姜恩美),김미애(金美愛),6,4,10,1
2369,강은미(姜恩美),김민기(金敏基),17,13,30,1
2370,강은미(姜恩美),김민석(金民錫),22,45,67,1
2371,강은미(姜恩美),김민철(金敏徹),27,26,53,1
2372,강은미(姜恩美),김병기(金炳基),17,22,39,1
2373,강은미(姜恩美),김병욱A(金炳旭),14,24,38,1
2374,강은미(姜恩美),김병욱B(金炳旭),1,5,6,1
2375,강은미(姜恩美),김병주(金柄周),18,10,28,1
2376,강은미(姜恩美),김상훈(金相勳),6,8,14,1
2377,강은미(姜恩美),김상희(金相姬),18,38,56,1
2378,강은미(姜恩美),김석기(金碩基),5,3,8,1
2379,강은미(姜恩美),김성원(金成願),5,3,8,1
2380,강은미(姜恩美),김성주(金成柱),16,28,44,1
2381,강은미(姜恩美),김성환(金星煥),16,31,47,1
2382,강은미(姜恩美),김수흥(金洙興),18,22,40,1
2383,강은미(姜恩美),김승남(金承南),22,60,82,1
2384,강은미(姜恩美),김승수(金承洙),5,4,9,1
2385,강은미(姜恩美),김승원(金勝源),25,31,56,1
2386,강은미(姜恩美),김영배(金永培),22,43,65,1
2387,강은미(姜恩美),김영선(金映宣),0,5,5,1
2388,강은미(姜恩美),김영식(金英植),4,4,8,1
2389,강은미(姜恩美),김영주(金榮珠),15,23,38,1
2390,강은미(姜恩美),김영진(金榮鎭),11,15,26,1
2391,강은미(姜恩美),김영호(金映豪),15,16,31,1
2392,강은미(姜恩美),김예지(金睿智),9,27,36,1
2393,강은미(姜恩美),김용민(金容民),18,27,45,1
2394,강은미(姜恩美),김용판(金用判),5,8,13,1
2395,강은미(姜恩美),김웅(金雄),4,4,8,1
2396,강은미(姜恩美),김원이(金元二),24,54,78,1
2397,강은미(姜恩美),김윤덕(金潤德),19,20,39,1
2398,강은미(姜恩美),김의겸(金宜謙),12,43,55,1
2399,강은미(姜恩美),김정재(金汀才),6,4,10,1
2400,강은미(姜恩美),김정호(金禎鎬),21,68,89,1
2401,강은미(姜恩美),김종민(金鐘民),12,33,45,1
2402,강은미(姜恩美),김주영(金周暎),23,72,95,1
2403,강은미(姜恩美),김진표(金振杓),13,5,18,1
2404,강은미(姜恩美),김철민(金哲玟),19,31,50,1
2405,강은미(姜恩美),김태년(金太年),11,15,26,1
2406,강은미(姜恩美),김태호(金台鎬),6,4,10,1
2407,강은미(姜恩美),김학용(金學容),0,1,1,1
2408,강은미(姜恩美),김한규(金翰奎),7,16,23,1
2409,강은미(姜恩美),김한정(金漢正),12,14,26,1
2410,강은미(姜恩美),김형동(金亨東),7,9,16,1
2411,강은미(姜恩美),김홍걸(金弘傑),26,100,126,1
2412,강은미(姜恩美),김회재(金會在),21,19,40,1
2413,강은미(姜恩美),김희곤(金熙坤),5,3,8,1
2414,강은미(姜恩美),김희국(金熙國),4,3,7,1
2415,강은미(姜恩美),남인순(南仁順),28,57,85,1
2416,강은미(姜恩美),노용호(魯容昊),0,1,1,1
2417,강은미(姜恩美),노웅래(盧雄來),22,31,53,1
2418,강은미(姜恩美),도종환(都鍾煥),18,30,48,1
2419,강은미(姜恩美),류성걸(柳性杰),4,3,7,1
2420,강은미(姜恩美),류호정(柳好貞),85,362,447,0
2421,강은미(姜恩美),맹성규(孟聖奎),18,34,52,1
2422,강은미(姜恩美),문정복(文貞福),14,26,40,1
2423,강은미(姜恩美),문진석(文振碩),30,41,71,1
2424,강은미(姜恩美),민병덕(閔炳德),24,80,104,1
2425,강은미(姜恩美),민형배(閔馨培),40,105,145,1
2426,강은미(姜恩美),민홍철(閔洪喆),12,20,32,1
2427,강은미(姜恩美),박광온(朴洸瑥),18,23,41,1
2428,강은미(姜恩美),박대수(朴大壽),6,13,19,1
2429,강은미(姜恩美),박대출(朴大出),5,3,8,1
2430,강은미(姜恩美),박덕흠(朴德欽),4,11,15,1
2431,강은미(姜恩美),박범계(朴範界),11,9,20,1
2432,강은미(姜恩美),박병석(朴炳錫),6,5,11,1
2433,강은미(姜恩美),박상혁(朴商赫),17,40,57,1
2434,강은미(姜恩美),박성민(朴聖敏),4,5,9,1
2435,강은미(姜恩美),박성준(朴省俊),16,27,43,1
2436,강은미(姜恩美),박성중(朴成重),4,3,7,1
2437,강은미(姜恩美),박수영(朴洙瑩),4,13,17,1
2438,강은미(姜恩美),박영순(朴英淳),22,37,59,1
2439,강은미(姜恩美),박완주(朴完柱),12,20,32,1
2440,강은미(姜恩美),박용진(朴用鎭),14,42,56,1
2441,강은미(姜恩美),박재호(朴在昊),13,21,34,1
2442,강은미(姜恩美),박정(朴釘),16,25,41,1
2443,강은미(姜恩美),박정하(朴正河),0,1,1,1
2444,강은미(姜恩美),박주민(朴柱民),22,31,53,1
2445,강은미(姜恩美),박진(朴振),5,3,8,1
2446,강은미(姜恩美),박찬대(朴贊大),14,25,39,1
2447,강은미(姜恩美),박형수(朴亨修),4,3,7,1
2448,강은미(姜恩美),박홍근(朴洪根),19,48,67,1
2449,강은미(姜恩美),배준영(裵俊英),4,3,7,1
2450,강은미(姜恩美),배진교(裵晋敎),87,356,443,0
2451,강은미(姜恩美),배현진(裵賢鎭),4,5,9,1
2452,강은미(姜恩美),백종헌(白宗憲),5,4,9,1
2453,강은미(姜恩美),백혜련(白惠蓮),13,18,31,1
2454,강은미(姜恩美),변재일(卞在一),11,15,26,1
2455,강은미(姜恩美),서동용(徐東榕),26,45,71,1
2456,강은미(姜恩美),서범수(徐範洙),5,4,9,1
2457,강은미(姜恩美),서병수(徐秉洙),5,3,8,1
2458,강은미(姜恩美),서삼석(徐參錫),22,24,46,1
2459,강은미(姜恩美),서영교(徐瑛敎),21,40,61,1
2460,강은미(姜恩美),서영석(徐暎錫),20,41,61,1
2461,강은미(姜恩美),서일준(徐一俊),5,4,9,1
2462,강은미(姜恩美),서정숙(徐正淑),4,8,12,1
2463,강은미(姜恩美),설훈(薛勳),18,20,38,1
2464,강은미(姜恩美),성일종(成一鍾),5,6,11,1
2465,강은미(姜恩美),소병철(蘇秉哲),17,19,36,1
2466,강은미(姜恩美),소병훈(蘇秉勳),17,34,51,1
2467,강은미(姜恩美),송갑석(宋甲錫),29,60,89,1
2468,강은미(姜恩美),송기헌(宋基憲),13,10,23,1
2469,강은미(姜恩美),송석준(宋錫俊),5,3,8,1
2470,강은미(姜恩美),송언석(宋彦錫),3,1,4,1
2471,강은미(姜恩美),송옥주(宋玉珠),22,67,89,1
2472,강은미(姜恩美),송재호(宋在祜),18,42,60,1
2473,강은미(姜恩美),신동근(申東根),15,18,33,1
2474,강은미(姜恩美),신영대(申榮大),13,22,35,1
2475,강은미(姜恩美),신원식(申源湜),4,3,7,1
2476,강은미(姜恩美),신정훈(辛正勳),25,62,87,1
2477,강은미(姜恩美),신현영(申賢榮),18,14,32,1
2478,강은미(姜恩美),심상정(沈相奵),89,349,438,0
2479,강은미(姜恩美),안규백(安圭伯),17,21,38,1
2480,강은미(姜恩美),안민석(安敏錫),14,23,37,1
2481,강은미(姜恩美),안병길(安炳吉),5,3,8,1
2482,강은미(姜恩美),안철수(安哲秀),0,3,3,1
2483,강은미(姜恩美),안호영(安浩永),18,58,76,1
2484,강은미(姜恩美),양경숙(梁敬淑),19,41,60,1
2485,강은미(姜恩美),양금희(梁琴喜),5,6,11,1
2486,강은미(姜恩美),양기대(梁基大),16,19,35,1
2487,강은미(姜恩美),양이원영(梁李媛瑛),17,60,77,1
2488,강은미(姜恩美),양정숙(梁貞淑),53,200,253,1
2489,강은미(姜恩美),양향자(梁香子),19,28,47,1
2490,강은미(姜恩美),어기구(魚基龜),15,18,33,1
2491,강은미(姜恩美),엄태영(嚴泰永),6,6,12,1
2492,강은미(姜恩美),오기형(吳奇炯),12,11,23,1
2493,강은미(姜恩美),오영환(吳永煥),31,85,116,1
2494,강은미(姜恩美),용혜인(龍慧仁),43,172,215,1
2495,강은미(姜恩美),우상호(禹相虎),15,15,30,1
2496,강은미(姜恩美),우원식(禹元植),17,42,59,1
2497,강은미(姜恩美),위성곤(魏聖坤),17,45,62,1
2498,강은미(姜恩美),유경준(兪京濬),5,4,9,1
2499,강은미(姜恩美),유기홍(柳基洪),14,25,39,1
2500,강은미(姜恩美),유동수(柳東秀),13,19,32,1
2501,강은미(姜恩美),유상범(劉相凡),5,3,8,1
2502,강은미(姜恩美),유의동(兪義東),5,4,9,1
2503,강은미(姜恩美),유정주(兪訂炷),23,53,76,1
2504,강은미(姜恩美),윤건영(尹建永),13,18,31,1
2505,강은미(姜恩美),윤관석(尹官石),13,14,27,1
2506,강은미(姜恩美),윤두현(尹斗鉉),4,4,8,1
2507,강은미(姜恩美),윤미향(尹美香),30,130,160,1
2508,강은미(姜恩美),윤상현(尹相現),1,3,4,1
2509,강은미(姜恩美),윤영덕(尹永德),35,96,131,1
2510,강은미(姜恩美),윤영석(尹永碩),5,3,8,1
2511,강은미(姜恩美),윤영찬(尹永燦),13,16,29,1
2512,강은미(姜恩美),윤재갑(尹才鉀),36,65,101,1
2513,강은미(姜恩美),윤재옥(尹在玉),4,3,7,1
2514,강은미(姜恩美),윤주경(尹柱卿),4,6,10,1
2515,강은미(姜恩美),윤준병(尹準炳),20,64,84,1
2516,강은미(姜恩美),윤창현(尹暢賢),4,4,8,1
2517,강은미(姜恩美),윤한홍(尹漢洪),5,3,8,1
2518,강은미(姜恩美),윤호중(尹昊重),11,18,29,1
2519,강은미(姜恩美),윤후덕(尹厚德),16,33,49,1
2520,강은미(姜恩美),이개호(李介昊),15,22,37,1
2521,강은미(姜恩美),이달곤(李達坤),6,4,10,1
2522,강은미(姜恩美),이동주(李東洲),24,55,79,1
2523,강은미(姜恩美),이만희(李晩熙),4,3,7,1
2524,강은미(姜恩美),이명수(李明洙),5,18,23,1
2525,강은미(姜恩美),이병훈(李炳勳),25,59,84,1
2526,강은미(姜恩美),이상민(李相珉),12,21,33,1
2527,강은미(姜恩美),이상헌(李相憲),17,33,50,1
2528,강은미(姜恩美),이성만(李成萬),16,50,66,1
2529,강은미(姜恩美),이소영(李素永),19,30,49,1
2530,강은미(姜恩美),이수진(李壽珍),47,198,245,1
2531,강은미(姜恩美),이수진(李秀眞),19,40,59,1
2532,강은미(姜恩美),이양수(李亮壽),6,5,11,1
2533,강은미(姜恩美),이용(李鏞),4,4,8,1
2534,강은미(姜恩美),이용빈(李龍彬),41,126,167,1
2535,강은미(姜恩美),이용선(李庸瑄),21,67,88,1
2536,강은미(姜恩美),이용우(李龍雨),23,21,44,1
2537,강은미(姜恩美),이용호(李容鎬),6,16,22,1
2538,강은미(姜恩美),이원욱(李元旭),17,17,34,1
2539,강은미(姜恩美),이원택(李源澤),11,19,30,1
2540,강은미(姜恩美),이은주(李恩周),89,350,439,0
2541,강은미(姜恩美),이인선(李仁善),0,7,7,1
2542,강은미(姜恩美),이인영(李仁榮),10,16,26,1
2543,강은미(姜恩美),이장섭(李將燮),13,26,39,1
2544,강은미(姜恩美),이재명(李在明),5,11,16,1
2545,강은미(姜恩美),이재정(李在汀),17,21,38,1
2546,강은미(姜恩美),이정문(李楨文),18,30,48,1
2547,강은미(姜恩美),이종배(李鍾培),5,5,10,1
2548,강은미(姜恩美),이종성(李鍾成),5,5,10,1
2549,강은미(姜恩美),이주환(李周桓),4,4,8,1
2550,강은미(姜恩美),이채익(李埰益),8,6,14,1
2551,강은미(姜恩美),이철규(李喆圭),5,4,9,1
2552,강은미(姜恩美),이탄희(李誕熙),19,59,78,1
2553,강은미(姜恩美),이태규(李泰珪),6,11,17,1
2554,강은미(姜恩美),이학영(李學永),18,30,48,1
2555,강은미(姜恩美),이해식(李海植),17,27,44,1
2556,강은미(姜恩美),이헌승(李憲昇),7,3,10,1
2557,강은미(姜恩美),이형석(李炯錫),27,49,76,1
2558,강은미(姜恩美),인재근(印在謹),20,54,74,1
2559,강은미(姜恩美),임병헌(林炳憲),0,1,1,1
2560,강은미(姜恩美),임오경(林五卿),16,23,39,1
2561,강은미(姜恩美),임이자(林利子),4,3,7,1
2562,강은미(姜恩美),임종성(林鍾聲),22,42,64,1
2563,강은미(姜恩美),임호선(林昊宣),17,46,63,1
2564,강은미(姜恩美),장경태(張耿態),24,66,90,1
2565,강은미(姜恩美),장동혁(張東赫),0,1,1,1
2566,강은미(姜恩美),장제원(張濟元),4,3,7,1
2567,강은미(姜恩美),장철민(張喆敏),19,47,66,1
2568,강은미(姜恩美),장혜영(張惠英),84,340,424,0
2569,강은미(姜恩美),전봉민(田奉珉),1,2,3,1
2570,강은미(姜恩美),전용기(田溶冀),15,41,56,1
2571,강은미(姜恩美),전재수(田載秀),13,14,27,1
2572,강은미(姜恩美),전주혜(全珠惠),6,4,10,1
2573,강은미(姜恩美),전해철(全海澈),13,21,34,1
2574,강은미(姜恩美),전혜숙(全惠淑),18,36,54,1
2575,강은미(姜恩美),정경희(丁慶姬),4,3,7,1
2576,강은미(姜恩美),정동만(鄭東萬),4,3,7,1
2577,강은미(姜恩美),정성호(鄭成湖),20,41,61,1
2578,강은미(姜恩美),정우택(鄭宇澤),0,1,1,1
2579,강은미(姜恩美),정운천(鄭雲天),4,3,7,1
2580,강은미(姜恩美),정일영(鄭日永),16,17,33,1
2581,강은미(姜恩美),정점식(鄭点植),5,3,8,1
2582,강은미(姜恩美),정진석(鄭鎭碩),5,3,8,1
2583,강은미(姜恩美),정청래(鄭淸來),15,22,37,1
2584,강은미(姜恩美),정춘숙(鄭春淑),19,44,63,1
2585,강은미(姜恩美),정태호(鄭泰浩),16,31,47,1
2586,강은미(姜恩美),정필모(鄭必模),17,23,40,1
2587,강은미(姜恩美),정희용(鄭熙溶),5,5,10,1
2588,강은미(姜恩美),조경태(趙慶泰),4,4,8,1
2589,강은미(姜恩美),조명희(曺明姬),4,4,8,1
2590,강은미(姜恩美),조수진(趙修眞),4,3,7,1
2591,강은미(姜恩美),조승래(趙承來),15,13,28,1
2592,강은미(姜恩美),조오섭(曺五燮),44,106,150,1
2593,강은미(姜恩美),조은희(趙恩禧),2,3,5,1
2594,강은미(姜恩美),조응천(趙應天),11,5,16,1
2595,강은미(姜恩美),조정식(趙正湜),9,9,18,1
2596,강은미(姜恩美),조정훈(趙廷訓),10,52,62,1
2597,강은미(姜恩美),조해진(曺海珍),7,5,12,1
2598,강은미(姜恩美),주철현(朱哲鉉),25,34,59,1
2599,강은미(姜恩美),주호영(朱豪英),4,3,7,1
2600,강은미(姜恩美),지성호(池成浩),5,3,8,1
2601,강은미(姜恩美),진선미(陳善美),16,20,36,1
2602,강은미(姜恩美),진성준(陳聲準),21,43,64,1
2603,강은미(姜恩美),천준호(千俊鎬),15,33,48,1
2604,강은미(姜恩美),최기상(崔基相),14,16,30,1
2605,강은미(姜恩美),최승재(崔承宰),4,11,15,1
2606,강은미(姜恩美),최연숙(崔姸淑),9,27,36,1
2607,강은미(姜恩美),최영희(崔英姬),0,2,2,1
2608,강은미(姜恩美),최인호(崔仁昊),11,12,23,1
2609,강은미(姜恩美),최재형(崔在亨),0,1,1,1
2610,강은미(姜恩美),최종윤(崔鍾允),22,43,65,1
2611,강은미(姜恩美),최춘식(崔春植),6,12,18,1
2612,강은미(姜恩美),최형두(崔炯斗),7,6,13,1
2613,강은미(姜恩美),최혜영(崔惠英),26,70,96,1
2614,강은미(姜恩美),추경호(秋慶鎬),4,3,7,1
2615,강은미(姜恩美),태영호(太永浩),4,5,9,1
2616,강은미(姜恩美),하영제(河榮帝),5,3,8,1
2617,강은미(姜恩美),하태경(河泰慶),5,6,11,1
2618,강은미(姜恩美),한기호(韓起鎬),5,3,8,1
2619,강은미(姜恩美),한무경(韓茂景),4,4,8,1
2620,강은미(姜恩美),한병도(韓秉道),19,20,39,1
2621,강은미(姜恩美),한정애(韓貞愛),12,27,39,1
2622,강은미(姜恩美),한준호(韓俊鎬),21,32,53,1
2623,강은미(姜恩美),허숙정(許淑湞),1,1,2,1
2624,강은미(姜恩美),허영(許榮),20,30,50,1
2625,강은미(姜恩美),허은아(許垠娥),4,5,9,1
2626,강은미(姜恩美),허종식(許琮植),23,62,85,1
2627,강은미(姜恩美),홍기원(洪起元),20,26,46,1
2628,강은미(姜恩美),홍문표(洪文杓),5,3,8,1
2629,강은미(姜恩美),홍석준(洪碩晙),5,3,8,1
2630,강은미(姜恩美),홍성국(洪性國),19,28,47,1
2631,강은미(姜恩美),홍영표(洪永杓),13,21,34,1
2632,강은미(姜恩美),홍익표(洪翼杓),14,25,39,1
2633,강은미(姜恩美),홍정민(洪貞敏),21,29,50,1
2634,강은미(姜恩美),황보승희(皇甫承希),6,6,12,1
2635,강은미(姜恩美),황운하(黃雲夏),19,29,48,1
2636,강은미(姜恩美),황희(黃熙),12,12,24,1
2637,강준현(康準鉉),강훈식(姜勳植),101,74,175,0
2638,강준현(康準鉉),고민정(高旼廷),97,68,165,0
2639,강준현(康準鉉),고영인(高永寅),136,117,253,0
2640,강준현(康準鉉),고용진(高榕禛),95,90,185,0
2641,강준현(康準鉉),구자근(具滋根),51,5,56,1
2642,강준현(康準鉉),권명호(權明浩),51,5,56,1
2643,강준현(康準鉉),권성동(權性東),43,4,47,1
2644,강준현(康準鉉),권영세(權寧世),52,6,58,1
2645,강준현(康準鉉),권은희(權垠希),29,5,34,1
2646,강준현(康準鉉),권인숙(權仁淑),95,66,161,0
2647,강준현(康準鉉),권칠승(權七勝),93,83,176,0
2648,강준현(康準鉉),기동민(奇東旻),103,113,216,0
2649,강준현(康準鉉),김경만(金京萬),120,96,216,0
2650,강준현(康準鉉),김경협(金炅俠),96,57,153,0
2651,강준현(康準鉉),김교흥(金敎興),100,71,171,0
2652,강준현(康準鉉),김기현(金起炫),52,6,58,1
2653,강준현(康準鉉),김남국(金南局),88,66,154,1
2654,강준현(康準鉉),김도읍(金度邑),51,4,55,1
2655,강준현(康準鉉),김두관(金斗官),103,76,179,0
2656,강준현(康準鉉),김미애(金美愛),52,5,57,1
2657,강준현(康準鉉),김민기(金敏基),97,92,189,0
2658,강준현(康準鉉),김민석(金民錫),107,96,203,0
2659,강준현(康準鉉),김민철(金敏徹),104,100,204,0
2660,강준현(康準鉉),김병기(金炳基),100,88,188,0
2661,강준현(康準鉉),김병욱A(金炳旭),106,71,177,0
2662,강준현(康準鉉),김병욱B(金炳旭),44,4,48,1
2663,강준현(康準鉉),김병주(金柄周),95,47,142,0
2664,강준현(康準鉉),김상훈(金相勳),53,6,59,1
2665,강준현(康準鉉),김상희(金相姬),115,121,236,0
2666,강준현(康準鉉),김석기(金碩基),52,6,58,1
2667,강준현(康準鉉),김성원(金成願),52,10,62,1
2668,강준현(康準鉉),김성주(金成柱),112,107,219,0
2669,강준현(康準鉉),김성환(金星煥),93,68,161,0
2670,강준현(康準鉉),김수흥(金洙興),112,81,193,0
2671,강준현(康準鉉),김승남(金承南),92,98,190,0
2672,강준현(康準鉉),김승수(金承洙),54,8,62,1
2673,강준현(康準鉉),김승원(金勝源),129,119,248,0
2674,강준현(康準鉉),김영배(金永培),109,92,201,0
2675,강준현(康準鉉),김영선(金映宣),26,4,30,1
2676,강준현(康準鉉),김영식(金英植),52,5,57,1
2677,강준현(康準鉉),김영주(金榮珠),92,78,170,0
2678,강준현(康準鉉),김영진(金榮鎭),88,66,154,0
2679,강준현(康準鉉),김영호(金映豪),98,58,156,0
2680,강준현(康準鉉),김예지(金睿智),52,8,60,1
2681,강준현(康準鉉),김용민(金容民),94,71,165,0
2682,강준현(康準鉉),김용판(金用判),52,5,57,1
2683,강준현(康準鉉),김웅(金雄),51,10,61,1
2684,강준현(康準鉉),김원이(金元二),105,112,217,0
2685,강준현(康準鉉),김윤덕(金潤德),116,80,196,0
2686,강준현(康準鉉),김의겸(金宜謙),52,54,106,0
2687,강준현(康準鉉),김정재(金汀才),53,5,58,1
2688,강준현(康準鉉),김정호(金禎鎬),109,148,257,0
2689,강준현(康準鉉),김종민(金鐘民),85,82,167,0
2690,강준현(康準鉉),김주영(金周暎),122,145,267,0
2691,강준현(康準鉉),김진표(金振杓),55,32,87,1
2692,강준현(康準鉉),김철민(金哲玟),104,86,190,0
2693,강준현(康準鉉),김태년(金太年),79,62,141,0
2694,강준현(康準鉉),김태호(金台鎬),41,5,46,1
2695,강준현(康準鉉),김학용(金學容),25,8,33,1
2696,강준현(康準鉉),김한규(金翰奎),48,39,87,0
2697,강준현(康準鉉),김한정(金漢正),82,64,146,0
2698,강준현(康準鉉),김형동(金亨東),52,8,60,1
2699,강준현(康準鉉),김홍걸(金弘傑),52,102,154,0
2700,강준현(康準鉉),김회재(金會在),127,89,216,0
2701,강준현(康準鉉),김희곤(金熙坤),51,5,56,1
2702,강준현(康準鉉),김희국(金熙國),49,6,55,1
2703,강준현(康準鉉),남인순(南仁順),107,100,207,0
2704,강준현(康準鉉),노용호(魯容昊),25,8,33,1
2705,강준현(康準鉉),노웅래(盧雄來),102,73,175,0
2706,강준현(康準鉉),도종환(都鍾煥),92,71,163,0
2707,강준현(康準鉉),류성걸(柳性杰),49,4,53,1
2708,강준현(康準鉉),류호정(柳好貞),15,42,57,1
2709,강준현(康準鉉),맹성규(孟聖奎),98,77,175,0
2710,강준현(康準鉉),문정복(文貞福),112,76,188,0
2711,강준현(康準鉉),문진석(文振碩),119,104,223,0
2712,강준현(康準鉉),민병덕(閔炳德),126,162,288,0
2713,강준현(康準鉉),민형배(閔馨培),93,123,216,0
2714,강준현(康準鉉),민홍철(閔洪喆),82,70,152,0
2715,강준현(康準鉉),박광온(朴洸瑥),91,57,148,0
2716,강준현(康準鉉),박대수(朴大壽),49,8,57,1
2717,강준현(康準鉉),박대출(朴大出),50,6,56,1
2718,강준현(康準鉉),박덕흠(朴德欽),36,11,47,1
2719,강준현(康準鉉),박범계(朴範界),79,45,124,0
2720,강준현(康準鉉),박병석(朴炳錫),41,23,64,0
2721,강준현(康準鉉),박상혁(朴商赫),145,138,283,0
2722,강준현(康準鉉),박성민(朴聖敏),52,10,62,1
2723,강준현(康準鉉),박성준(朴省俊),110,145,255,0
2724,강준현(康準鉉),박성중(朴成重),49,4,53,1
2725,강준현(康準鉉),박수영(朴洙瑩),50,6,56,1
2726,강준현(康準鉉),박영순(朴英淳),127,93,220,0
2727,강준현(康準鉉),박완주(朴完柱),48,51,99,1
2728,강준현(康準鉉),박용진(朴用鎭),81,50,131,0
2729,강준현(康準鉉),박재호(朴在昊),93,66,159,0
2730,강준현(康準鉉),박정(朴釘),106,84,190,0
2731,강준현(康準鉉),박정하(朴正河),25,4,29,1
2732,강준현(康準鉉),박주민(朴柱民),83,55,138,0
2733,강준현(康準鉉),박진(朴振),50,5,55,1
2734,강준현(康準鉉),박찬대(朴贊大),88,58,146,0
2735,강준현(康準鉉),박형수(朴亨修),49,4,53,1
2736,강준현(康準鉉),박홍근(朴洪根),104,100,204,0
2737,강준현(康準鉉),배준영(裵俊英),49,5,54,1
2738,강준현(康準鉉),배진교(裵晋敎),16,21,37,1
2739,강준현(康準鉉),배현진(裵賢鎭),49,5,54,1
2740,강준현(康準鉉),백종헌(白宗憲),50,8,58,1
2741,강준현(康準鉉),백혜련(白惠蓮),89,77,166,0
2742,강준현(康準鉉),변재일(卞在一),87,57,144,0
2743,강준현(康準鉉),서동용(徐東榕),89,76,165,0
2744,강준현(康準鉉),서범수(徐範洙),51,5,56,1
2745,강준현(康準鉉),서병수(徐秉洙),50,4,54,1
2746,강준현(康準鉉),서삼석(徐參錫),101,80,181,0
2747,강준현(康準鉉),서영교(徐瑛敎),100,108,208,0
2748,강준현(康準鉉),서영석(徐暎錫),124,153,277,0
2749,강준현(康準鉉),서일준(徐一俊),50,6,56,1
2750,강준현(康準鉉),서정숙(徐正淑),49,12,61,1
2751,강준현(康準鉉),설훈(薛勳),82,54,136,0
2752,강준현(康準鉉),성일종(成一鍾),50,8,58,1
2753,강준현(康準鉉),소병철(蘇秉哲),87,69,156,0
2754,강준현(康準鉉),소병훈(蘇秉勳),113,89,202,0
2755,강준현(康準鉉),송갑석(宋甲錫),94,79,173,0
2756,강준현(康準鉉),송기헌(宋基憲),86,54,140,0
2757,강준현(康準鉉),송석준(宋錫俊),50,5,55,1
2758,강준현(康準鉉),송언석(宋彦錫),46,8,54,1
2759,강준현(康準鉉),송옥주(宋玉珠),98,81,179,0
2760,강준현(康準鉉),송재호(宋在祜),119,115,234,0
2761,강준현(康準鉉),신동근(申東根),90,81,171,0
2762,강준현(康準鉉),신영대(申榮大),89,61,150,0
2763,강준현(康準鉉),신원식(申源湜),49,4,53,1
2764,강준현(康準鉉),신정훈(辛正勳),123,153,276,0
2765,강준현(康準鉉),신현영(申賢榮),94,66,160,0
2766,강준현(康準鉉),심상정(沈相奵),17,21,38,1
2767,강준현(康準鉉),안규백(安圭伯),90,78,168,0
2768,강준현(康準鉉),안민석(安敏錫),83,61,144,0
2769,강준현(康準鉉),안병길(安炳吉),50,4,54,1
2770,강준현(康準鉉),안철수(安哲秀),25,5,30,1
2771,강준현(康準鉉),안호영(安浩永),84,66,150,0
2772,강준현(康準鉉),양경숙(梁敬淑),92,89,181,0
2773,강준현(康準鉉),양금희(梁琴喜),50,7,57,1
2774,강준현(康準鉉),양기대(梁基大),97,81,178,0
2775,강준현(康準鉉),양이원영(梁李媛瑛),82,74,156,0
2776,강준현(康準鉉),양정숙(梁貞淑),50,103,153,1
2777,강준현(康準鉉),양향자(梁香子),47,45,92,1
2778,강준현(康準鉉),어기구(魚基龜),92,52,144,0
2779,강준현(康準鉉),엄태영(嚴泰永),50,9,59,1
2780,강준현(康準鉉),오기형(吳奇炯),84,48,132,0
2781,강준현(康準鉉),오영환(吳永煥),134,201,335,0
2782,강준현(康準鉉),용혜인(龍慧仁),20,32,52,1
2783,강준현(康準鉉),우상호(禹相虎),78,36,114,0
2784,강준현(康準鉉),우원식(禹元植),94,67,161,0
2785,강준현(康準鉉),위성곤(魏聖坤),104,95,199,0
2786,강준현(康準鉉),유경준(兪京濬),49,5,54,1
2787,강준현(康準鉉),유기홍(柳基洪),83,56,139,0
2788,강준현(康準鉉),유동수(柳東秀),90,62,152,0
2789,강준현(康準鉉),유상범(劉相凡),50,5,55,1
2790,강준현(康準鉉),유의동(兪義東),49,4,53,1
2791,강준현(康準鉉),유정주(兪訂炷),119,116,235,0
2792,강준현(康準鉉),윤건영(尹建永),92,88,180,0
2793,강준현(康準鉉),윤관석(尹官石),84,71,155,1
2794,강준현(康準鉉),윤두현(尹斗鉉),49,4,53,1
2795,강준현(康準鉉),윤미향(尹美香),44,64,108,1
2796,강준현(康準鉉),윤상현(尹相現),30,10,40,1
2797,강준현(康準鉉),윤영덕(尹永德),103,94,197,0
2798,강준현(康準鉉),윤영석(尹永碩),50,6,56,1
2799,강준현(康準鉉),윤영찬(尹永燦),90,67,157,0
2800,강준현(康準鉉),윤재갑(尹才鉀),99,106,205,0
2801,강준현(康準鉉),윤재옥(尹在玉),49,4,53,1
2802,강준현(康準鉉),윤주경(尹柱卿),49,6,55,1
2803,강준현(康準鉉),윤준병(尹準炳),119,139,258,0
2804,강준현(康準鉉),윤창현(尹暢賢),49,7,56,1
2805,강준현(康準鉉),윤한홍(尹漢洪),50,5,55,1
2806,강준현(康準鉉),윤호중(尹昊重),81,73,154,0
2807,강준현(康準鉉),윤후덕(尹厚德),91,56,147,0
2808,강준현(康準鉉),이개호(李介昊),94,92,186,0
2809,강준현(康準鉉),이달곤(李達坤),51,6,57,1
2810,강준현(康準鉉),이동주(李東洲),97,88,185,0
2811,강준현(康準鉉),이만희(李晩熙),49,4,53,1
2812,강준현(康準鉉),이명수(李明洙),51,21,72,1
2813,강준현(康準鉉),이병훈(李炳勳),97,102,199,0
2814,강준현(康準鉉),이상민(李相珉),80,49,129,0
2815,강준현(康準鉉),이상헌(李相憲),89,107,196,0
2816,강준현(康準鉉),이성만(李成萬),99,94,193,1
2817,강준현(康準鉉),이소영(李素永),90,53,143,0
2818,강준현(康準鉉),이수진(李壽珍),117,105,222,0
2819,강준현(康準鉉),이수진(李秀眞),122,120,242,0
2820,강준현(康準鉉),이양수(李亮壽),51,5,56,1
2821,강준현(康準鉉),이용(李鏞),49,5,54,1
2822,강준현(康準鉉),이용빈(李龍彬),129,168,297,0
2823,강준현(康準鉉),이용선(李庸瑄),99,86,185,0
2824,강준현(康準鉉),이용우(李龍雨),135,113,248,0
2825,강준현(康準鉉),이용호(李容鎬),36,15,51,1
2826,강준현(康準鉉),이원욱(李元旭),89,94,183,0
2827,강준현(康準鉉),이원택(李源澤),93,77,170,0
2828,강준현(康準鉉),이은주(李恩周),24,41,65,1
2829,강준현(康準鉉),이인선(李仁善),25,8,33,1
2830,강준현(康準鉉),이인영(李仁榮),74,52,126,0
2831,강준현(康準鉉),이장섭(李將燮),96,81,177,0
2832,강준현(康準鉉),이재명(李在明),41,21,62,0
2833,강준현(康準鉉),이재정(李在汀),80,50,130,0
2834,강준현(康準鉉),이정문(李楨文),105,100,205,0
2835,강준현(康準鉉),이종배(李鍾培),50,8,58,1
2836,강준현(康準鉉),이종성(李鍾成),49,9,58,1
2837,강준현(康準鉉),이주환(李周桓),49,6,55,1
2838,강준현(康準鉉),이채익(李埰益),52,7,59,1
2839,강준현(康準鉉),이철규(李喆圭),52,5,57,1
2840,강준현(康準鉉),이탄희(李誕熙),101,62,163,0
2841,강준현(康準鉉),이태규(李泰珪),29,5,34,1
2842,강준현(康準鉉),이학영(李學永),116,107,223,0
2843,강준현(康準鉉),이해식(李海植),102,96,198,0
2844,강준현(康準鉉),이헌승(李憲昇),50,4,54,1
2845,강준현(康準鉉),이형석(李炯錫),97,101,198,0
2846,강준현(康準鉉),인재근(印在謹),105,120,225,0
2847,강준현(康準鉉),임병헌(林炳憲),26,4,30,1
2848,강준현(康準鉉),임오경(林五卿),97,78,175,0
2849,강준현(康準鉉),임이자(林利子),49,4,53,1
2850,강준현(康準鉉),임종성(林鍾聲),103,103,206,0
2851,강준현(康準鉉),임호선(林昊宣),134,210,344,0
2852,강준현(康準鉉),장경태(張耿態),130,107,237,0
2853,강준현(康準鉉),장동혁(張東赫),25,4,29,1
2854,강준현(康準鉉),장제원(張濟元),49,4,53,1
2855,강준현(康準鉉),장철민(張喆敏),90,74,164,0
2856,강준현(康準鉉),장혜영(張惠英),19,15,34,1
2857,강준현(康準鉉),전봉민(田奉珉),35,5,40,1
2858,강준현(康準鉉),전용기(田溶冀),98,90,188,0
2859,강준현(康準鉉),전재수(田載秀),85,53,138,0
2860,강준현(康準鉉),전주혜(全珠惠),51,7,58,1
2861,강준현(康準鉉),전해철(全海澈),77,57,134,0
2862,강준현(康準鉉),전혜숙(全惠淑),86,69,155,0
2863,강준현(康準鉉),정경희(丁慶姬),49,4,53,1
2864,강준현(康準鉉),정동만(鄭東萬),50,4,54,1
2865,강준현(康準鉉),정성호(鄭成湖),82,78,160,0
2866,강준현(康準鉉),정우택(鄭宇澤),25,5,30,1
2867,강준현(康準鉉),정운천(鄭雲天),49,4,53,1
2868,강준현(康準鉉),정일영(鄭日永),97,107,204,0
2869,강준현(康準鉉),정점식(鄭点植),50,4,54,1
2870,강준현(康準鉉),정진석(鄭鎭碩),50,6,56,1
2871,강준현(康準鉉),정청래(鄭淸來),86,55,141,0
2872,강준현(康準鉉),정춘숙(鄭春淑),93,98,191,0
2873,강준현(康準鉉),정태호(鄭泰浩),94,101,195,0
2874,강준현(康準鉉),정필모(鄭必模),103,88,191,0
2875,강준현(康準鉉),정희용(鄭熙溶),50,7,57,1
2876,강준현(康準鉉),조경태(趙慶泰),49,4,53,1
2877,강준현(康準鉉),조명희(曺明姬),49,6,55,1
2878,강준현(康準鉉),조수진(趙修眞),49,5,54,1
2879,강준현(康準鉉),조승래(趙承來),102,88,190,0
2880,강준현(康準鉉),조오섭(曺五燮),121,163,284,0
2881,강준현(康準鉉),조은희(趙恩禧),25,4,29,1
2882,강준현(康準鉉),조응천(趙應天),104,71,175,0
2883,강준현(康準鉉),조정식(趙正湜),77,44,121,0
2884,강준현(康準鉉),조정훈(趙廷訓),6,16,22,1
2885,강준현(康準鉉),조해진(曺海珍),51,5,56,1
2886,강준현(康準鉉),주철현(朱哲鉉),96,81,177,0
2887,강준현(康準鉉),주호영(朱豪英),50,4,54,1
2888,강준현(康準鉉),지성호(池成浩),49,8,57,1
2889,강준현(康準鉉),진선미(陳善美),101,54,155,0
2890,강준현(康準鉉),진성준(陳聲準),151,111,262,0
2891,강준현(康準鉉),천준호(千俊鎬),110,73,183,0
2892,강준현(康準鉉),최기상(崔基相),91,80,171,0
2893,강준현(康準鉉),최승재(崔承宰),49,10,59,1
2894,강준현(康準鉉),최연숙(崔姸淑),31,14,45,1
2895,강준현(康準鉉),최영희(崔英姬),25,5,30,1
2896,강준현(康準鉉),최인호(崔仁昊),97,61,158,0
2897,강준현(康準鉉),최재형(崔在亨),25,9,34,1
2898,강준현(康準鉉),최종윤(崔鍾允),99,120,219,0
2899,강준현(康準鉉),최춘식(崔春植),50,8,58,1
2900,강준현(康準鉉),최형두(崔炯斗),50,5,55,1
2901,강준현(康準鉉),최혜영(崔惠英),132,181,313,0
2902,강준현(康準鉉),추경호(秋慶鎬),49,3,52,1
2903,강준현(康準鉉),태영호(太永浩),49,9,58,1
2904,강준현(康準鉉),하영제(河榮帝),41,4,45,1
2905,강준현(康準鉉),하태경(河泰慶),50,4,54,1
2906,강준현(康準鉉),한기호(韓起鎬),50,4,54,1
2907,강준현(康準鉉),한무경(韓茂景),52,10,62,1
2908,강준현(康準鉉),한병도(韓秉道),101,121,222,0
2909,강준현(康準鉉),한정애(韓貞愛),81,62,143,0
2910,강준현(康準鉉),한준호(韓俊鎬),106,115,221,0
2911,강준현(康準鉉),허숙정(許淑湞),1,2,3,0
2912,강준현(康準鉉),허영(許榮),151,128,279,0
2913,강준현(康準鉉),허은아(許垠娥),49,5,54,1
2914,강준현(康準鉉),허종식(許琮植),111,109,220,0
2915,강준현(康準鉉),홍기원(洪起元),131,104,235,0
2916,강준현(康準鉉),홍문표(洪文杓),50,5,55,1
2917,강준현(康準鉉),홍석준(洪碩晙),50,8,58,1
2918,강준현(康準鉉),홍성국(洪性國),152,190,342,0
2919,강준현(康準鉉),홍영표(洪永杓),83,73,156,0
2920,강준현(康準鉉),홍익표(洪翼杓),95,87,182,0
2921,강준현(康準鉉),홍정민(洪貞敏),146,123,269,0
2922,강준현(康準鉉),황보승희(皇甫承希),45,6,51,1
2923,강준현(康準鉉),황운하(黃雲夏),124,102,226,0
2924,강준현(康準鉉),황희(黃熙),83,44,127,0
2925,강훈식(姜勳植),고민정(高旼廷),95,50,145,0
2926,강훈식(姜勳植),고영인(高永寅),94,81,175,0
2927,강훈식(姜勳植),고용진(高榕禛),105,65,170,0
2928,강훈식(姜勳植),구자근(具滋根),52,6,58,1
2929,강훈식(姜勳植),권명호(權明浩),53,8,61,1
2930,강훈식(姜勳植),권성동(權性東),44,5,49,1
2931,강훈식(姜勳植),권영세(權寧世),54,11,65,1
2932,강훈식(姜勳植),권은희(權垠希),30,5,35,1
2933,강훈식(姜勳植),권인숙(權仁淑),94,70,164,0
2934,강훈식(姜勳植),권칠승(權七勝),92,54,146,0
2935,강훈식(姜勳植),기동민(奇東旻),118,116,234,0
2936,강훈식(姜勳植),김경만(金京萬),119,86,205,0
2937,강훈식(姜勳植),김경협(金炅俠),101,63,164,0
2938,강훈식(姜勳植),김교흥(金敎興),93,55,148,0
2939,강훈식(姜勳植),김기현(金起炫),54,6,60,1
2940,강훈식(姜勳植),김남국(金南局),82,52,134,1
2941,강훈식(姜勳植),김도읍(金度邑),51,4,55,1
2942,강훈식(姜勳植),김두관(金斗官),96,73,169,0
2943,강훈식(姜勳植),김미애(金美愛),51,4,55,1
2944,강훈식(姜勳植),김민기(金敏基),95,65,160,0
2945,강훈식(姜勳植),김민석(金民錫),96,95,191,0
2946,강훈식(姜勳植),김민철(金敏徹),94,81,175,0
2947,강훈식(姜勳植),김병기(金炳基),100,59,159,0
2948,강훈식(姜勳植),김병욱A(金炳旭),103,99,202,0
2949,강훈식(姜勳植),김병욱B(金炳旭),44,6,50,1
2950,강훈식(姜勳植),김병주(金柄周),89,36,125,0
2951,강훈식(姜勳植),김상훈(金相勳),53,7,60,1
2952,강훈식(姜勳植),김상희(金相姬),96,79,175,0
2953,강훈식(姜勳植),김석기(金碩基),52,6,58,1
2954,강훈식(姜勳植),김성원(金成願),53,11,64,1
2955,강훈식(姜勳植),김성주(金成柱),96,76,172,0
2956,강훈식(姜勳植),김성환(金星煥),97,89,186,0
2957,강훈식(姜勳植),김수흥(金洙興),103,64,167,0
2958,강훈식(姜勳植),김승남(金承南),89,83,172,0
2959,강훈식(姜勳植),김승수(金承洙),52,9,61,1
2960,강훈식(姜勳植),김승원(金勝源),107,82,189,0
2961,강훈식(姜勳植),김영배(金永培),115,95,210,0
2962,강훈식(姜勳植),김영선(金映宣),26,4,30,1
2963,강훈식(姜勳植),김영식(金英植),52,10,62,1
2964,강훈식(姜勳植),김영주(金榮珠),89,67,156,0
2965,강훈식(姜勳植),김영진(金榮鎭),86,63,149,0
2966,강훈식(姜勳植),김영호(金映豪),91,68,159,0
2967,강훈식(姜勳植),김예지(金睿智),52,12,64,1
2968,강훈식(姜勳植),김용민(金容民),92,59,151,0
2969,강훈식(姜勳植),김용판(金用判),55,5,60,1
2970,강훈식(姜勳植),김웅(金雄),53,6,59,1
2971,강훈식(姜勳植),김원이(金元二),119,103,222,0
2972,강훈식(姜勳植),김윤덕(金潤德),127,129,256,0
2973,강훈식(姜勳植),김의겸(金宜謙),46,41,87,0
2974,강훈식(姜勳植),김정재(金汀才),54,5,59,1
2975,강훈식(姜勳植),김정호(金禎鎬),108,132,240,0
2976,강훈식(姜勳植),김종민(金鐘民),91,84,175,0
2977,강훈식(姜勳植),김주영(金周暎),107,96,203,0
2978,강훈식(姜勳植),김진표(金振杓),59,43,102,1
2979,강훈식(姜勳植),김철민(金哲玟),99,59,158,0
2980,강훈식(姜勳植),김태년(金太年),79,40,119,0
2981,강훈식(姜勳植),김태호(金台鎬),42,7,49,1
2982,강훈식(姜勳植),김학용(金學容),25,4,29,1
2983,강훈식(姜勳植),김한규(金翰奎),44,66,110,0
2984,강훈식(姜勳植),김한정(金漢正),82,46,128,0
2985,강훈식(姜勳植),김형동(金亨東),52,5,57,1
2986,강훈식(姜勳植),김홍걸(金弘傑),52,102,154,0
2987,강훈식(姜勳植),김회재(金會在),100,65,165,0
2988,강훈식(姜勳植),김희곤(金熙坤),50,5,55,1
2989,강훈식(姜勳植),김희국(金熙國),49,5,54,1
2990,강훈식(姜勳植),남인순(南仁順),93,69,162,0
2991,강훈식(姜勳植),노용호(魯容昊),26,4,30,1
2992,강훈식(姜勳植),노웅래(盧雄來),97,62,159,0
2993,강훈식(姜勳植),도종환(都鍾煥),100,77,177,0
2994,강훈식(姜勳植),류성걸(柳性杰),49,4,53,1
2995,강훈식(姜勳植),류호정(柳好貞),16,38,54,1
2996,강훈식(姜勳植),맹성규(孟聖奎),89,55,144,0
2997,강훈식(姜勳植),문정복(文貞福),81,44,125,0
2998,강훈식(姜勳植),문진석(文振碩),98,89,187,0
2999,강훈식(姜勳植),민병덕(閔炳德),95,98,193,0
3000,강훈식(姜勳植),민형배(閔馨培),87,97,184,0
3001,강훈식(姜勳植),민홍철(閔洪喆),82,55,137,0
3002,강훈식(姜勳植),박광온(朴洸瑥),89,52,141,0
3003,강훈식(姜勳植),박대수(朴大壽),53,9,62,1
3004,강훈식(姜勳植),박대출(朴大出),51,4,55,1
3005,강훈식(姜勳植),박덕흠(朴德欽),37,9,46,1
3006,강훈식(姜勳植),박범계(朴範界),82,37,119,0
3007,강훈식(姜勳植),박병석(朴炳錫),41,19,60,0
3008,강훈식(姜勳植),박상혁(朴商赫),109,121,230,0
3009,강훈식(姜勳植),박성민(朴聖敏),50,7,57,1
3010,강훈식(姜勳植),박성준(朴省俊),94,72,166,0
3011,강훈식(姜勳植),박성중(朴成重),51,5,56,1
3012,강훈식(姜勳植),박수영(朴洙瑩),50,5,55,1
3013,강훈식(姜勳植),박영순(朴英淳),99,81,180,0
3014,강훈식(姜勳植),박완주(朴完柱),49,47,96,1
3015,강훈식(姜勳植),박용진(朴用鎭),93,73,166,0
3016,강훈식(姜勳植),박재호(朴在昊),87,53,140,0
3017,강훈식(姜勳植),박정(朴釘),96,67,163,0
3018,강훈식(姜勳植),박정하(朴正河),26,4,30,1
3019,강훈식(姜勳植),박주민(朴柱民),81,58,139,0
3020,강훈식(姜勳植),박진(朴振),52,5,57,1
3021,강훈식(姜勳植),박찬대(朴贊大),89,56,145,0
3022,강훈식(姜勳植),박형수(朴亨修),49,4,53,1
3023,강훈식(姜勳植),박홍근(朴洪根),96,98,194,0
3024,강훈식(姜勳植),배준영(裵俊英),50,6,56,1
3025,강훈식(姜勳植),배진교(裵晋敎),15,25,40,1
3026,강훈식(姜勳植),배현진(裵賢鎭),51,5,56,1
3027,강훈식(姜勳植),백종헌(白宗憲),53,7,60,1
3028,강훈식(姜勳植),백혜련(白惠蓮),89,75,164,0
3029,강훈식(姜勳植),변재일(卞在一),91,59,150,0
3030,강훈식(姜勳植),서동용(徐東榕),88,63,151,0
3031,강훈식(姜勳植),서범수(徐範洙),51,5,56,1
3032,강훈식(姜勳植),서병수(徐秉洙),50,5,55,1
3033,강훈식(姜勳植),서삼석(徐參錫),96,63,159,0
3034,강훈식(姜勳植),서영교(徐瑛敎),97,118,215,0
3035,강훈식(姜勳植),서영석(徐暎錫),93,94,187,0
3036,강훈식(姜勳植),서일준(徐一俊),52,4,56,1
3037,강훈식(姜勳植),서정숙(徐正淑),49,5,54,1
3038,강훈식(姜勳植),설훈(薛勳),82,45,127,0
3039,강훈식(姜勳植),성일종(成一鍾),52,13,65,1
3040,강훈식(姜勳植),소병철(蘇秉哲),92,53,145,0
3041,강훈식(姜勳植),소병훈(蘇秉勳),88,59,147,0
3042,강훈식(姜勳植),송갑석(宋甲錫),121,143,264,0
3043,강훈식(姜勳植),송기헌(宋基憲),86,47,133,0
3044,강훈식(姜勳植),송석준(宋錫俊),50,5,55,1
3045,강훈식(姜勳植),송언석(宋彦錫),47,7,54,1
3046,강훈식(姜勳植),송옥주(宋玉珠),89,81,170,0
3047,강훈식(姜勳植),송재호(宋在祜),99,94,193,0
3048,강훈식(姜勳植),신동근(申東根),94,86,180,0
3049,강훈식(姜勳植),신영대(申榮大),99,71,170,0
3050,강훈식(姜勳植),신원식(申源湜),52,6,58,1
3051,강훈식(姜勳植),신정훈(辛正勳),122,146,268,0
3052,강훈식(姜勳植),신현영(申賢榮),86,60,146,0
3053,강훈식(姜勳植),심상정(沈相奵),15,29,44,1
3054,강훈식(姜勳植),안규백(安圭伯),84,62,146,0
3055,강훈식(姜勳植),안민석(安敏錫),89,60,149,0
3056,강훈식(姜勳植),안병길(安炳吉),50,4,54,1
3057,강훈식(姜勳植),안철수(安哲秀),26,4,30,1
3058,강훈식(姜勳植),안호영(安浩永),93,64,157,0
3059,강훈식(姜勳植),양경숙(梁敬淑),87,78,165,0
3060,강훈식(姜勳植),양금희(梁琴喜),52,6,58,1
3061,강훈식(姜勳植),양기대(梁基大),90,71,161,0
3062,강훈식(姜勳植),양이원영(梁李媛瑛),82,63,145,0
3063,강훈식(姜勳植),양정숙(梁貞淑),42,117,159,1
3064,강훈식(姜勳植),양향자(梁香子),43,36,79,1
3065,강훈식(姜勳植),어기구(魚基龜),86,50,136,0
3066,강훈식(姜勳植),엄태영(嚴泰永),52,5,57,1
3067,강훈식(姜勳植),오기형(吳奇炯),82,40,122,0
3068,강훈식(姜勳植),오영환(吳永煥),107,108,215,0
3069,강훈식(姜勳植),용혜인(龍慧仁),11,31,42,1
3070,강훈식(姜勳植),우상호(禹相虎),83,34,117,0
3071,강훈식(姜勳植),우원식(禹元植),90,67,157,0
3072,강훈식(姜勳植),위성곤(魏聖坤),101,102,203,0
3073,강훈식(姜勳植),유경준(兪京濬),51,7,58,1
3074,강훈식(姜勳植),유기홍(柳基洪),86,46,132,0
3075,강훈식(姜勳植),유동수(柳東秀),93,64,157,0
3076,강훈식(姜勳植),유상범(劉相凡),51,4,55,1
3077,강훈식(姜勳植),유의동(兪義東),49,4,53,1
3078,강훈식(姜勳植),유정주(兪訂炷),104,104,208,0
3079,강훈식(姜勳植),윤건영(尹建永),87,61,148,0
3080,강훈식(姜勳植),윤관석(尹官石),70,43,113,1
3081,강훈식(姜勳植),윤두현(尹斗鉉),50,5,55,1
3082,강훈식(姜勳植),윤미향(尹美香),38,55,93,1
3083,강훈식(姜勳植),윤상현(尹相現),31,4,35,1
3084,강훈식(姜勳植),윤영덕(尹永德),102,98,200,0
3085,강훈식(姜勳植),윤영석(尹永碩),50,5,55,1
3086,강훈식(姜勳植),윤영찬(尹永燦),94,57,151,0
3087,강훈식(姜勳植),윤재갑(尹才鉀),100,76,176,0
3088,강훈식(姜勳植),윤재옥(尹在玉),49,4,53,1
3089,강훈식(姜勳植),윤주경(尹柱卿),49,4,53,1
3090,강훈식(姜勳植),윤준병(尹準炳),108,105,213,0
3091,강훈식(姜勳植),윤창현(尹暢賢),50,7,57,1
3092,강훈식(姜勳植),윤한홍(尹漢洪),50,4,54,1
3093,강훈식(姜勳植),윤호중(尹昊重),83,50,133,0
3094,강훈식(姜勳植),윤후덕(尹厚德),103,80,183,0
3095,강훈식(姜勳植),이개호(李介昊),87,55,142,0
3096,강훈식(姜勳植),이달곤(李達坤),52,6,58,1
3097,강훈식(姜勳植),이동주(李東洲),96,106,202,0
3098,강훈식(姜勳植),이만희(李晩熙),50,5,55,1
3099,강훈식(姜勳植),이명수(李明洙),52,16,68,1
3100,강훈식(姜勳植),이병훈(李炳勳),100,80,180,0
3101,강훈식(姜勳植),이상민(李相珉),85,43,128,0
3102,강훈식(姜勳植),이상헌(李相憲),94,86,180,0
3103,강훈식(姜勳植),이성만(李成萬),85,90,175,1
3104,강훈식(姜勳植),이소영(李素永),99,92,191,0
3105,강훈식(姜勳植),이수진(李壽珍),100,104,204,0
3106,강훈식(姜勳植),이수진(李秀眞),94,75,169,0
3107,강훈식(姜勳植),이양수(李亮壽),55,5,60,1
3108,강훈식(姜勳植),이용(李鏞),50,8,58,1
3109,강훈식(姜勳植),이용빈(李龍彬),136,175,311,0
3110,강훈식(姜勳植),이용선(李庸瑄),92,93,185,0
3111,강훈식(姜勳植),이용우(李龍雨),94,78,172,0
3112,강훈식(姜勳植),이용호(李容鎬),32,15,47,1
3113,강훈식(姜勳植),이원욱(李元旭),97,112,209,0
3114,강훈식(姜勳植),이원택(李源澤),86,54,140,0
3115,강훈식(姜勳植),이은주(李恩周),16,24,40,1
3116,강훈식(姜勳植),이인선(李仁善),25,4,29,1
3117,강훈식(姜勳植),이인영(李仁榮),74,40,114,0
3118,강훈식(姜勳植),이장섭(李將燮),113,92,205,0
3119,강훈식(姜勳植),이재명(李在明),40,21,61,0
3120,강훈식(姜勳植),이재정(李在汀),78,52,130,0
3121,강훈식(姜勳植),이정문(李楨文),113,144,257,0
3122,강훈식(姜勳植),이종배(李鍾培),51,9,60,1
3123,강훈식(姜勳植),이종성(李鍾成),50,5,55,1
3124,강훈식(姜勳植),이주환(李周桓),51,5,56,1
3125,강훈식(姜勳植),이채익(李埰益),51,9,60,1
3126,강훈식(姜勳植),이철규(李喆圭),54,5,59,1
3127,강훈식(姜勳植),이탄희(李誕熙),95,73,168,0
3128,강훈식(姜勳植),이태규(李泰珪),30,10,40,1
3129,강훈식(姜勳植),이학영(李學永),96,112,208,0
3130,강훈식(姜勳植),이해식(李海植),94,59,153,0
3131,강훈식(姜勳植),이헌승(李憲昇),51,5,56,1
3132,강훈식(姜勳植),이형석(李炯錫),94,91,185,0
3133,강훈식(姜勳植),인재근(印在謹),100,93,193,0
3134,강훈식(姜勳植),임병헌(林炳憲),26,5,31,1
3135,강훈식(姜勳植),임오경(林五卿),92,59,151,0
3136,강훈식(姜勳植),임이자(林利子),49,4,53,1
3137,강훈식(姜勳植),임종성(林鍾聲),101,109,210,0
3138,강훈식(姜勳植),임호선(林昊宣),116,111,227,0
3139,강훈식(姜勳植),장경태(張耿態),98,117,215,0
3140,강훈식(姜勳植),장동혁(張東赫),25,5,30,1
3141,강훈식(姜勳植),장제원(張濟元),49,4,53,1
3142,강훈식(姜勳植),장철민(張喆敏),108,118,226,0
3143,강훈식(姜勳植),장혜영(張惠英),16,22,38,1
3144,강훈식(姜勳植),전봉민(田奉珉),35,5,40,1
3145,강훈식(姜勳植),전용기(田溶冀),99,99,198,0
3146,강훈식(姜勳植),전재수(田載秀),86,58,144,0
3147,강훈식(姜勳植),전주혜(全珠惠),53,7,60,1
3148,강훈식(姜勳植),전해철(全海澈),75,43,118,0
3149,강훈식(姜勳植),전혜숙(全惠淑),85,76,161,0
3150,강훈식(姜勳植),정경희(丁慶姬),50,4,54,1
3151,강훈식(姜勳植),정동만(鄭東萬),49,4,53,1
3152,강훈식(姜勳植),정성호(鄭成湖),84,60,144,0
3153,강훈식(姜勳植),정우택(鄭宇澤),26,6,32,1
3154,강훈식(姜勳植),정운천(鄭雲天),52,5,57,1
3155,강훈식(姜勳植),정일영(鄭日永),89,82,171,0
3156,강훈식(姜勳植),정점식(鄭点植),50,4,54,1
3157,강훈식(姜勳植),정진석(鄭鎭碩),50,6,56,1
3158,강훈식(姜勳植),정청래(鄭淸來),88,44,132,0
3159,강훈식(姜勳植),정춘숙(鄭春淑),127,131,258,0
3160,강훈식(姜勳植),정태호(鄭泰浩),98,78,176,0
3161,강훈식(姜勳植),정필모(鄭必模),92,74,166,0
3162,강훈식(姜勳植),정희용(鄭熙溶),51,7,58,1
3163,강훈식(姜勳植),조경태(趙慶泰),50,4,54,1
3164,강훈식(姜勳植),조명희(曺明姬),50,6,56,1
3165,강훈식(姜勳植),조수진(趙修眞),51,5,56,1
3166,강훈식(姜勳植),조승래(趙承來),104,79,183,0
3167,강훈식(姜勳植),조오섭(曺五燮),113,150,263,0
3168,강훈식(姜勳植),조은희(趙恩禧),26,4,30,1
3169,강훈식(姜勳植),조응천(趙應天),76,48,124,0
3170,강훈식(姜勳植),조정식(趙正湜),82,46,128,0
3171,강훈식(姜勳植),조정훈(趙廷訓),2,16,18,1
3172,강훈식(姜勳植),조해진(曺海珍),53,5,58,1
3173,강훈식(姜勳植),주철현(朱哲鉉),93,60,153,0
3174,강훈식(姜勳植),주호영(朱豪英),50,4,54,1
3175,강훈식(姜勳植),지성호(池成浩),52,5,57,1
3176,강훈식(姜勳植),진선미(陳善美),78,38,116,0
3177,강훈식(姜勳植),진성준(陳聲準),94,66,160,0
3178,강훈식(姜勳植),천준호(千俊鎬),81,43,124,0
3179,강훈식(姜勳植),최기상(崔基相),89,60,149,0
3180,강훈식(姜勳植),최승재(崔承宰),51,5,56,1
3181,강훈식(姜勳植),최연숙(崔姸淑),32,7,39,1
3182,강훈식(姜勳植),최영희(崔英姬),25,5,30,1
3183,강훈식(姜勳植),최인호(崔仁昊),90,66,156,0
3184,강훈식(姜勳植),최재형(崔在亨),25,5,30,1
3185,강훈식(姜勳植),최종윤(崔鍾允),94,76,170,0
3186,강훈식(姜勳植),최춘식(崔春植),50,6,56,1
3187,강훈식(姜勳植),최형두(崔炯斗),50,5,55,1
3188,강훈식(姜勳植),최혜영(崔惠英),101,99,200,0
3189,강훈식(姜勳植),추경호(秋慶鎬),50,3,53,1
3190,강훈식(姜勳植),태영호(太永浩),51,12,63,1
3191,강훈식(姜勳植),하영제(河榮帝),44,4,48,1
3192,강훈식(姜勳植),하태경(河泰慶),50,5,55,1
3193,강훈식(姜勳植),한기호(韓起鎬),51,4,55,1
3194,강훈식(姜勳植),한무경(韓茂景),51,5,56,1
3195,강훈식(姜勳植),한병도(韓秉道),99,104,203,0
3196,강훈식(姜勳植),한정애(韓貞愛),84,68,152,0
3197,강훈식(姜勳植),한준호(韓俊鎬),112,125,237,0
3198,강훈식(姜勳植),허숙정(許淑湞),1,2,3,0
3199,강훈식(姜勳植),허영(許榮),112,111,223,0
3200,강훈식(姜勳植),허은아(許垠娥),50,5,55,1
3201,강훈식(姜勳植),허종식(許琮植),88,74,162,0
3202,강훈식(姜勳植),홍기원(洪起元),100,73,173,0
3203,강훈식(姜勳植),홍문표(洪文杓),50,7,57,1
3204,강훈식(姜勳植),홍석준(洪碩晙),50,4,54,1
3205,강훈식(姜勳植),홍성국(洪性國),99,90,189,0
3206,강훈식(姜勳植),홍영표(洪永杓),82,53,135,0
3207,강훈식(姜勳植),홍익표(洪翼杓),101,68,169,0
3208,강훈식(姜勳植),홍정민(洪貞敏),103,110,213,0
3209,강훈식(姜勳植),황보승희(皇甫承希),49,5,54,1
3210,강훈식(姜勳植),황운하(黃雲夏),110,113,223,0
3211,강훈식(姜勳植),황희(黃熙),85,40,125,0
3212,고민정(高旼廷),고영인(高永寅),96,69,165,0
3213,고민정(高旼廷),고용진(高榕禛),96,49,145,0
3214,고민정(高旼廷),구자근(具滋根),51,3,54,1
3215,고민정(高旼廷),권명호(權明浩),51,3,54,1
3216,고민정(高旼廷),권성동(權性東),44,3,47,1
3217,고민정(高旼廷),권영세(權寧世),52,4,56,1
3218,고민정(高旼廷),권은희(權垠希),29,3,32,1
3219,고민정(高旼廷),권인숙(權仁淑),93,58,151,0
3220,고민정(高旼廷),권칠승(權七勝),85,49,134,0
3221,고민정(高旼廷),기동민(奇東旻),91,62,153,0
3222,고민정(高旼廷),김경만(金京萬),103,67,170,0
3223,고민정(高旼廷),김경협(金炅俠),87,62,149,0
3224,고민정(高旼廷),김교흥(金敎興),89,46,135,0
3225,고민정(高旼廷),김기현(金起炫),54,4,58,1
3226,고민정(高旼廷),김남국(金南局),88,71,159,1
3227,고민정(高旼廷),김도읍(金度邑),51,3,54,1
3228,고민정(高旼廷),김두관(金斗官),94,81,175,0
3229,고민정(高旼廷),김미애(金美愛),51,3,54,1
3230,고민정(高旼廷),김민기(金敏基),86,47,133,0
3231,고민정(高旼廷),김민석(金民錫),101,62,163,0
3232,고민정(高旼廷),김민철(金敏徹),92,74,166,0
3233,고민정(高旼廷),김병기(金炳基),86,54,140,0
3234,고민정(高旼廷),김병욱A(金炳旭),88,68,156,0
3235,고민정(高旼廷),김병욱B(金炳旭),44,3,47,1
3236,고민정(高旼廷),김병주(金柄周),85,50,135,0
3237,고민정(高旼廷),김상훈(金相勳),53,4,57,1
3238,고민정(高旼廷),김상희(金相姬),90,67,157,0
3239,고민정(高旼廷),김석기(金碩基),52,4,56,1
3240,고민정(高旼廷),김성원(金成願),53,4,57,1
3241,고민정(高旼廷),김성주(金成柱),92,58,150,0
3242,고민정(高旼廷),김성환(金星煥),97,55,152,0
3243,고민정(高旼廷),김수흥(金洙興),96,54,150,0
3244,고민정(高旼廷),김승남(金承南),87,73,160,0
3245,고민정(高旼廷),김승수(金承洙),53,5,58,1
3246,고민정(高旼廷),김승원(金勝源),111,86,197,0
3247,고민정(高旼廷),김영배(金永培),107,82,189,0
3248,고민정(高旼廷),김영선(金映宣),26,3,29,1
3249,고민정(高旼廷),김영식(金英植),51,3,54,1
3250,고민정(高旼廷),김영주(金榮珠),89,63,152,0
3251,고민정(高旼廷),김영진(金榮鎭),81,38,119,0
3252,고민정(高旼廷),김영호(金映豪),87,50,137,0
3253,고민정(高旼廷),김예지(金睿智),53,6,59,1
3254,고민정(高旼廷),김용민(金容民),100,73,173,0
3255,고민정(高旼廷),김용판(金用判),53,3,56,1
3256,고민정(高旼廷),김웅(金雄),51,3,54,1
3257,고민정(高旼廷),김원이(金元二),98,67,165,0
3258,고민정(高旼廷),김윤덕(金潤德),89,43,132,0
3259,고민정(高旼廷),김의겸(金宜謙),49,44,93,0
3260,고민정(高旼廷),김정재(金汀才),53,4,57,1
3261,고민정(高旼廷),김정호(金禎鎬),100,107,207,0
3262,고민정(高旼廷),김종민(金鐘民),82,54,136,0
3263,고민정(高旼廷),김주영(金周暎),98,79,177,0
3264,고민정(高旼廷),김진표(金振杓),45,40,85,1
3265,고민정(高旼廷),김철민(金哲玟),95,50,145,0
3266,고민정(高旼廷),김태년(金太年),78,40,118,0
3267,고민정(高旼廷),김태호(金台鎬),42,3,45,1
3268,고민정(高旼廷),김학용(金學容),25,3,28,1
3269,고민정(高旼廷),김한규(金翰奎),44,34,78,0
3270,고민정(高旼廷),김한정(金漢正),84,47,131,0
3271,고민정(高旼廷),김형동(金亨東),50,5,55,1
3272,고민정(高旼廷),김홍걸(金弘傑),31,69,100,0
3273,고민정(高旼廷),김회재(金會在),93,44,137,0
3274,고민정(高旼廷),김희곤(金熙坤),50,3,53,1
3275,고민정(高旼廷),김희국(金熙國),49,3,52,1
3276,고민정(高旼廷),남인순(南仁順),95,61,156,0
3277,고민정(高旼廷),노용호(魯容昊),26,3,29,1
3278,고민정(高旼廷),노웅래(盧雄來),91,61,152,0
3279,고민정(高旼廷),도종환(都鍾煥),90,59,149,0
3280,고민정(高旼廷),류성걸(柳性杰),49,3,52,1
3281,고민정(高旼廷),류호정(柳好貞),17,31,48,1
3282,고민정(高旼廷),맹성규(孟聖奎),83,41,124,0
3283,고민정(高旼廷),문정복(文貞福),88,53,141,0
3284,고민정(高旼廷),문진석(文振碩),96,88,184,0
3285,고민정(高旼廷),민병덕(閔炳德),92,97,189,0
3286,고민정(高旼廷),민형배(閔馨培),72,102,174,0
3287,고민정(高旼廷),민홍철(閔洪喆),77,52,129,0
3288,고민정(高旼廷),박광온(朴洸瑥),90,53,143,0
3289,고민정(高旼廷),박대수(朴大壽),52,6,58,1
3290,고민정(高旼廷),박대출(朴大出),51,3,54,1
3291,고민정(高旼廷),박덕흠(朴德欽),36,4,40,1
3292,고민정(高旼廷),박범계(朴範界),75,34,109,0
3293,고민정(高旼廷),박병석(朴炳錫),40,17,57,0
3294,고민정(高旼廷),박상혁(朴商赫),91,78,169,0
3295,고민정(高旼廷),박성민(朴聖敏),49,4,53,1
3296,고민정(高旼廷),박성준(朴省俊),85,59,144,0
3297,고민정(高旼廷),박성중(朴成重),49,3,52,1
3298,고민정(高旼廷),박수영(朴洙瑩),49,4,53,1
3299,고민정(高旼廷),박영순(朴英淳),89,61,150,0
3300,고민정(高旼廷),박완주(朴完柱),47,35,82,1
3301,고민정(高旼廷),박용진(朴用鎭),78,39,117,0
3302,고민정(高旼廷),박재호(朴在昊),84,49,133,0
3303,고민정(高旼廷),박정(朴釘),83,65,148,0
3304,고민정(高旼廷),박정하(朴正河),26,3,29,1
3305,고민정(高旼廷),박주민(朴柱民),91,60,151,0
3306,고민정(高旼廷),박진(朴振),50,4,54,1
3307,고민정(高旼廷),박찬대(朴贊大),92,51,143,0
3308,고민정(高旼廷),박형수(朴亨修),49,3,52,1
3309,고민정(高旼廷),박홍근(朴洪根),102,70,172,0
3310,고민정(高旼廷),배준영(裵俊英),49,3,52,1
3311,고민정(高旼廷),배진교(裵晋敎),19,22,41,1
3312,고민정(高旼廷),배현진(裵賢鎭),49,3,52,1
3313,고민정(高旼廷),백종헌(白宗憲),51,3,54,1
3314,고민정(高旼廷),백혜련(白惠蓮),82,44,126,0
3315,고민정(高旼廷),변재일(卞在一),81,38,119,0
3316,고민정(高旼廷),서동용(徐東榕),90,68,158,0
3317,고민정(高旼廷),서범수(徐範洙),50,4,54,1
3318,고민정(高旼廷),서병수(徐秉洙),50,4,54,1
3319,고민정(高旼廷),서삼석(徐參錫),97,68,165,0
3320,고민정(高旼廷),서영교(徐瑛敎),94,84,178,0
3321,고민정(高旼廷),서영석(徐暎錫),96,91,187,0
3322,고민정(高旼廷),서일준(徐一俊),51,3,54,1
3323,고민정(高旼廷),서정숙(徐正淑),49,4,53,1
3324,고민정(高旼廷),설훈(薛勳),84,53,137,0
3325,고민정(高旼廷),성일종(成一鍾),50,4,54,1
3326,고민정(高旼廷),소병철(蘇秉哲),89,60,149,0
3327,고민정(高旼廷),소병훈(蘇秉勳),85,58,143,0
3328,고민정(高旼廷),송갑석(宋甲錫),94,75,169,0
3329,고민정(高旼廷),송기헌(宋基憲),81,36,117,0
3330,고민정(高旼廷),송석준(宋錫俊),50,4,54,1
3331,고민정(高旼廷),송언석(宋彦錫),45,3,48,1
3332,고민정(高旼廷),송옥주(宋玉珠),85,59,144,0
3333,고민정(高旼廷),송재호(宋在祜),87,84,171,0
3334,고민정(高旼廷),신동근(申東根),81,50,131,0
3335,고민정(高旼廷),신영대(申榮大),94,43,137,0
3336,고민정(高旼廷),신원식(申源湜),50,3,53,1
3337,고민정(高旼廷),신정훈(辛正勳),96,119,215,0
3338,고민정(高旼廷),신현영(申賢榮),87,57,144,0
3339,고민정(高旼廷),심상정(沈相奵),16,25,41,1
3340,고민정(高旼廷),안규백(安圭伯),84,52,136,0
3341,고민정(高旼廷),안민석(安敏錫),80,46,126,0
3342,고민정(高旼廷),안병길(安炳吉),50,3,53,1
3343,고민정(高旼廷),안철수(安哲秀),26,3,29,1
3344,고민정(高旼廷),안호영(安浩永),83,45,128,0
3345,고민정(高旼廷),양경숙(梁敬淑),87,53,140,0
3346,고민정(高旼廷),양금희(梁琴喜),51,4,55,1
3347,고민정(高旼廷),양기대(梁基大),82,50,132,0
3348,고민정(高旼廷),양이원영(梁李媛瑛),82,61,143,0
3349,고민정(高旼廷),양정숙(梁貞淑),26,59,85,1
3350,고민정(高旼廷),양향자(梁香子),39,20,59,1
3351,고민정(高旼廷),어기구(魚基龜),82,40,122,0
3352,고민정(高旼廷),엄태영(嚴泰永),51,3,54,1
3353,고민정(高旼廷),오기형(吳奇炯),80,39,119,0
3354,고민정(高旼廷),오영환(吳永煥),123,130,253,0
3355,고민정(高旼廷),용혜인(龍慧仁),17,34,51,1
3356,고민정(高旼廷),우상호(禹相虎),80,36,116,0
3357,고민정(高旼廷),우원식(禹元植),96,63,159,0
3358,고민정(高旼廷),위성곤(魏聖坤),90,67,157,0
3359,고민정(高旼廷),유경준(兪京濬),49,3,52,1
3360,고민정(高旼廷),유기홍(柳基洪),83,46,129,0
3361,고민정(高旼廷),유동수(柳東秀),81,41,122,0
3362,고민정(高旼廷),유상범(劉相凡),51,3,54,1
3363,고민정(高旼廷),유의동(兪義東),49,3,52,1
3364,고민정(高旼廷),유정주(兪訂炷),102,91,193,0
3365,고민정(高旼廷),윤건영(尹建永),92,78,170,0
3366,고민정(高旼廷),윤관석(尹官石),67,34,101,1
3367,고민정(高旼廷),윤두현(尹斗鉉),50,4,54,1
3368,고민정(高旼廷),윤미향(尹美香),44,45,89,1
3369,고민정(高旼廷),윤상현(尹相現),31,3,34,1
3370,고민정(高旼廷),윤영덕(尹永德),102,94,196,0
3371,고민정(高旼廷),윤영석(尹永碩),50,4,54,1
3372,고민정(高旼廷),윤영찬(尹永燦),89,57,146,0
3373,고민정(高旼廷),윤재갑(尹才鉀),93,82,175,0
3374,고민정(高旼廷),윤재옥(尹在玉),49,3,52,1
3375,고민정(高旼廷),윤주경(尹柱卿),49,3,52,1
3376,고민정(高旼廷),윤준병(尹準炳),98,117,215,0
3377,고민정(高旼廷),윤창현(尹暢賢),49,3,52,1
3378,고민정(高旼廷),윤한홍(尹漢洪),50,3,53,1
3379,고민정(高旼廷),윤호중(尹昊重),82,47,129,0
3380,고민정(高旼廷),윤후덕(尹厚德),77,45,122,0
3381,고민정(高旼廷),이개호(李介昊),86,58,144,0
3382,고민정(高旼廷),이달곤(李達坤),52,6,58,1
3383,고민정(高旼廷),이동주(李東洲),93,65,158,0
3384,고민정(高旼廷),이만희(李晩熙),50,3,53,1
3385,고민정(高旼廷),이명수(李明洙),50,6,56,1
3386,고민정(高旼廷),이병훈(李炳勳),90,88,178,0
3387,고민정(高旼廷),이상민(李相珉),78,33,111,0
3388,고민정(高旼廷),이상헌(李相憲),83,63,146,0
3389,고민정(高旼廷),이성만(李成萬),77,51,128,1
3390,고민정(高旼廷),이소영(李素永),92,55,147,0
3391,고민정(高旼廷),이수진(李壽珍),100,90,190,0
3392,고민정(高旼廷),이수진(李秀眞),91,70,161,0
3393,고민정(高旼廷),이양수(李亮壽),52,3,55,1
3394,고민정(高旼廷),이용(李鏞),50,3,53,1
3395,고민정(高旼廷),이용빈(李龍彬),103,93,196,0
3396,고민정(高旼廷),이용선(李庸瑄),95,66,161,0
3397,고민정(高旼廷),이용우(李龍雨),99,67,166,0
3398,고민정(高旼廷),이용호(李容鎬),29,5,34,1
3399,고민정(高旼廷),이원욱(李元旭),83,57,140,0
3400,고민정(高旼廷),이원택(李源澤),86,51,137,0
3401,고민정(高旼廷),이은주(李恩周),19,21,40,1
3402,고민정(高旼廷),이인선(李仁善),25,3,28,1
3403,고민정(高旼廷),이인영(李仁榮),77,51,128,0
3404,고민정(高旼廷),이장섭(李將燮),87,47,134,0
3405,고민정(高旼廷),이재명(李在明),41,21,62,0
3406,고민정(高旼廷),이재정(李在汀),82,52,134,0
3407,고민정(高旼廷),이정문(李楨文),88,59,147,0
3408,고민정(高旼廷),이종배(李鍾培),51,4,55,1
3409,고민정(高旼廷),이종성(李鍾成),50,5,55,1
3410,고민정(高旼廷),이주환(李周桓),50,3,53,1
3411,고민정(高旼廷),이채익(李埰益),51,4,55,1
3412,고민정(高旼廷),이철규(李喆圭),51,3,54,1
3413,고민정(高旼廷),이탄희(李誕熙),89,62,151,0
3414,고민정(高旼廷),이태규(李泰珪),29,3,32,1
3415,고민정(高旼廷),이학영(李學永),89,47,136,0
3416,고민정(高旼廷),이해식(李海植),92,60,152,0
3417,고민정(高旼廷),이헌승(李憲昇),51,4,55,1
3418,고민정(高旼廷),이형석(李炯錫),92,61,153,0
3419,고민정(高旼廷),인재근(印在謹),86,57,143,0
3420,고민정(高旼廷),임병헌(林炳憲),25,3,28,1
3421,고민정(高旼廷),임오경(林五卿),88,63,151,0
3422,고민정(高旼廷),임이자(林利子),49,3,52,1
3423,고민정(高旼廷),임종성(林鍾聲),94,63,157,0
3424,고민정(高旼廷),임호선(林昊宣),107,94,201,0
3425,고민정(高旼廷),장경태(張耿態),100,93,193,0
3426,고민정(高旼廷),장동혁(張東赫),25,3,28,1
3427,고민정(高旼廷),장제원(張濟元),49,3,52,1
3428,고민정(高旼廷),장철민(張喆敏),84,55,139,0
3429,고민정(高旼廷),장혜영(張惠英),17,16,33,1
3430,고민정(高旼廷),전봉민(田奉珉),35,5,40,1
3431,고민정(高旼廷),전용기(田溶冀),94,72,166,0
3432,고민정(高旼廷),전재수(田載秀),80,43,123,0
3433,고민정(高旼廷),전주혜(全珠惠),52,3,55,1
3434,고민정(高旼廷),전해철(全海澈),76,42,118,0
3435,고민정(高旼廷),전혜숙(全惠淑),82,51,133,0
3436,고민정(高旼廷),정경희(丁慶姬),50,3,53,1
3437,고민정(高旼廷),정동만(鄭東萬),49,3,52,1
3438,고민정(高旼廷),정성호(鄭成湖),83,52,135,0
3439,고민정(高旼廷),정우택(鄭宇澤),26,3,29,1
3440,고민정(高旼廷),정운천(鄭雲天),50,3,53,1
3441,고민정(高旼廷),정일영(鄭日永),88,62,150,0
3442,고민정(高旼廷),정점식(鄭点植),50,3,53,1
3443,고민정(高旼廷),정진석(鄭鎭碩),50,4,54,1
3444,고민정(高旼廷),정청래(鄭淸來),83,45,128,0
3445,고민정(高旼廷),정춘숙(鄭春淑),90,48,138,0
3446,고민정(高旼廷),정태호(鄭泰浩),88,81,169,0
3447,고민정(高旼廷),정필모(鄭必模),93,82,175,0
3448,고민정(高旼廷),정희용(鄭熙溶),50,4,54,1
3449,고민정(高旼廷),조경태(趙慶泰),50,7,57,1
3450,고민정(高旼廷),조명희(曺明姬),50,5,55,1
3451,고민정(高旼廷),조수진(趙修眞),50,3,53,1
3452,고민정(高旼廷),조승래(趙承來),88,57,145,0
3453,고민정(高旼廷),조오섭(曺五燮),91,84,175,0
3454,고민정(高旼廷),조은희(趙恩禧),26,3,29,1
3455,고민정(高旼廷),조응천(趙應天),73,29,102,0
3456,고민정(高旼廷),조정식(趙正湜),77,39,116,0
3457,고민정(高旼廷),조정훈(趙廷訓),8,2,10,1
3458,고민정(高旼廷),조해진(曺海珍),52,4,56,1
3459,고민정(高旼廷),주철현(朱哲鉉),90,72,162,0
3460,고민정(高旼廷),주호영(朱豪英),49,3,52,1
3461,고민정(高旼廷),지성호(池成浩),50,4,54,1
3462,고민정(高旼廷),진선미(陳善美),83,42,125,0
3463,고민정(高旼廷),진성준(陳聲準),100,79,179,0
3464,고민정(高旼廷),천준호(千俊鎬),105,65,170,0
3465,고민정(高旼廷),최기상(崔基相),87,56,143,0
3466,고민정(高旼廷),최승재(崔承宰),50,4,54,1
3467,고민정(高旼廷),최연숙(崔姸淑),32,7,39,1
3468,고민정(高旼廷),최영희(崔英姬),25,4,29,1
3469,고민정(高旼廷),최인호(崔仁昊),82,50,132,0
3470,고민정(高旼廷),최재형(崔在亨),25,3,28,1
3471,고민정(高旼廷),최종윤(崔鍾允),96,102,198,0
3472,고민정(高旼廷),최춘식(崔春植),49,4,53,1
3473,고민정(高旼廷),최형두(崔炯斗),51,7,58,1
3474,고민정(高旼廷),최혜영(崔惠英),114,99,213,0
3475,고민정(高旼廷),추경호(秋慶鎬),49,3,52,1
3476,고민정(高旼廷),태영호(太永浩),49,4,53,1
3477,고민정(高旼廷),하영제(河榮帝),42,0,42,1
3478,고민정(高旼廷),하태경(河泰慶),51,4,55,1
3479,고민정(高旼廷),한기호(韓起鎬),51,3,54,1
3480,고민정(高旼廷),한무경(韓茂景),49,3,52,1
3481,고민정(高旼廷),한병도(韓秉道),93,65,158,0
3482,고민정(高旼廷),한정애(韓貞愛),80,42,122,0
3483,고민정(高旼廷),한준호(韓俊鎬),90,83,173,0
3484,고민정(高旼廷),허숙정(許淑湞),1,1,2,0
3485,고민정(高旼廷),허영(許榮),103,88,191,0
3486,고민정(高旼廷),허은아(許垠娥),49,3,52,1
3487,고민정(高旼廷),허종식(許琮植),95,73,168,0
3488,고민정(高旼廷),홍기원(洪起元),97,58,155,0
3489,고민정(高旼廷),홍문표(洪文杓),51,16,67,1
3490,고민정(高旼廷),홍석준(洪碩晙),50,3,53,1
3491,고민정(高旼廷),홍성국(洪性國),93,63,156,0
3492,고민정(高旼廷),홍영표(洪永杓),81,43,124,0
3493,고민정(高旼廷),홍익표(洪翼杓),85,53,138,0
3494,고민정(高旼廷),홍정민(洪貞敏),107,87,194,0
3495,고민정(高旼廷),황보승희(皇甫承希),46,0,46,1
3496,고민정(高旼廷),황운하(黃雲夏),102,68,170,0
3497,고민정(高旼廷),황희(黃熙),80,38,118,0
3498,고영인(高永寅),고용진(高榕禛),104,93,197,0
3499,고영인(高永寅),구자근(具滋根),51,5,56,1
3500,고영인(高永寅),권명호(權明浩),51,4,55,1
3501,고영인(高永寅),권성동(權性東),43,5,48,1
3502,고영인(高永寅),권영세(權寧世),54,12,66,1
3503,고영인(高永寅),권은희(權垠希),32,13,45,1
3504,고영인(高永寅),권인숙(權仁淑),133,121,254,0
3505,고영인(高永寅),권칠승(權七勝),130,147,277,0
3506,고영인(高永寅),기동민(奇東旻),106,92,198,0
3507,고영인(高永寅),김경만(金京萬),125,134,259,0
3508,고영인(高永寅),김경협(金炅俠),109,85,194,0
3509,고영인(高永寅),김교흥(金敎興),97,56,153,0
3510,고영인(高永寅),김기현(金起炫),52,6,58,1
3511,고영인(高永寅),김남국(金南局),111,119,230,1
3512,고영인(高永寅),김도읍(金度邑),51,4,55,1
3513,고영인(高永寅),김두관(金斗官),101,106,207,0
3514,고영인(高永寅),김미애(金美愛),52,4,56,1
3515,고영인(高永寅),김민기(金敏基),97,72,169,0
3516,고영인(高永寅),김민석(金民錫),129,130,259,0
3517,고영인(高永寅),김민철(金敏徹),120,139,259,0
3518,고영인(高永寅),김병기(金炳基),97,79,176,0
3519,고영인(高永寅),김병욱A(金炳旭),111,85,196,0
3520,고영인(高永寅),김병욱B(金炳旭),44,6,50,1
3521,고영인(高永寅),김병주(金柄周),92,51,143,0
3522,고영인(高永寅),김상훈(金相勳),54,6,60,1
3523,고영인(高永寅),김상희(金相姬),111,124,235,0
3524,고영인(高永寅),김석기(金碩基),54,8,62,1
3525,고영인(高永寅),김성원(金成願),52,6,58,1
3526,고영인(高永寅),김성주(金成柱),130,115,245,0
3527,고영인(高永寅),김성환(金星煥),92,70,162,0
3528,고영인(高永寅),김수흥(金洙興),108,103,211,0
3529,고영인(高永寅),김승남(金承南),123,157,280,0
3530,고영인(高永寅),김승수(金承洙),54,8,62,1
3531,고영인(高永寅),김승원(金勝源),134,146,280,0
3532,고영인(高永寅),김영배(金永培),127,185,312,0
3533,고영인(高永寅),김영선(金映宣),26,4,30,1
3534,고영인(高永寅),김영식(金英植),53,5,58,1
3535,고영인(高永寅),김영주(金榮珠),93,83,176,0
3536,고영인(高永寅),김영진(金榮鎭),83,52,135,0
3537,고영인(高永寅),김영호(金映豪),93,65,158,0
3538,고영인(高永寅),김예지(金睿智),55,8,63,1
3539,고영인(高永寅),김용민(金容民),111,92,203,0
3540,고영인(高永寅),김용판(金用判),52,5,57,1
3541,고영인(高永寅),김웅(金雄),51,5,56,1
3542,고영인(高永寅),김원이(金元二),111,111,222,0
3543,고영인(高永寅),김윤덕(金潤德),104,78,182,0
3544,고영인(高永寅),김의겸(金宜謙),46,49,95,0
3545,고영인(高永寅),김정재(金汀才),55,11,66,1
3546,고영인(高永寅),김정호(金禎鎬),136,180,316,0
3547,고영인(高永寅),김종민(金鐘民),91,85,176,0
3548,고영인(高永寅),김주영(金周暎),120,116,236,0
3549,고영인(高永寅),김진표(金振杓),56,59,115,1
3550,고영인(高永寅),김철민(金哲玟),133,143,276,0
3551,고영인(高永寅),김태년(金太年),81,66,147,0
3552,고영인(高永寅),김태호(金台鎬),43,6,49,1
3553,고영인(高永寅),김학용(金學容),25,5,30,1
3554,고영인(高永寅),김한규(金翰奎),43,37,80,0
3555,고영인(高永寅),김한정(金漢正),84,57,141,0
3556,고영인(高永寅),김형동(金亨東),51,8,59,1
3557,고영인(高永寅),김홍걸(金弘傑),77,143,220,0
3558,고영인(高永寅),김회재(金會在),119,94,213,0
3559,고영인(高永寅),김희곤(金熙坤),51,10,61,1
3560,고영인(高永寅),김희국(金熙國),49,5,54,1
3561,고영인(高永寅),남인순(南仁順),136,139,275,0
3562,고영인(高永寅),노용호(魯容昊),25,4,29,1
3563,고영인(高永寅),노웅래(盧雄來),118,117,235,0
3564,고영인(高永寅),도종환(都鍾煥),102,89,191,0
3565,고영인(高永寅),류성걸(柳性杰),49,4,53,1
3566,고영인(高永寅),류호정(柳好貞),20,44,64,1
3567,고영인(高永寅),맹성규(孟聖奎),125,101,226,0
3568,고영인(高永寅),문정복(文貞福),94,52,146,0
3569,고영인(高永寅),문진석(文振碩),113,86,199,0
3570,고영인(高永寅),민병덕(閔炳德),129,211,340,0
3571,고영인(高永寅),민형배(閔馨培),94,120,214,0
3572,고영인(高永寅),민홍철(閔洪喆),91,66,157,0
3573,고영인(高永寅),박광온(朴洸瑥),95,112,207,0
3574,고영인(高永寅),박대수(朴大壽),50,7,57,1
3575,고영인(高永寅),박대출(朴大出),50,4,54,1
3576,고영인(高永寅),박덕흠(朴德欽),37,9,46,1
3577,고영인(高永寅),박범계(朴範界),81,39,120,0
3578,고영인(高永寅),박병석(朴炳錫),40,16,56,0
3579,고영인(高永寅),박상혁(朴商赫),113,107,220,0
3580,고영인(高永寅),박성민(朴聖敏),50,7,57,1
3581,고영인(高永寅),박성준(朴省俊),139,124,263,0
3582,고영인(高永寅),박성중(朴成重),49,6,55,1
3583,고영인(高永寅),박수영(朴洙瑩),49,7,56,1
3584,고영인(高永寅),박영순(朴英淳),103,98,201,0
3585,고영인(高永寅),박완주(朴完柱),49,52,101,1
3586,고영인(高永寅),박용진(朴用鎭),88,54,142,0
3587,고영인(高永寅),박재호(朴在昊),102,76,178,0
3588,고영인(高永寅),박정(朴釘),121,116,237,0
3589,고영인(高永寅),박정하(朴正河),25,4,29,1
3590,고영인(高永寅),박주민(朴柱民),93,85,178,0
3591,고영인(高永寅),박진(朴振),50,3,53,1
3592,고영인(高永寅),박찬대(朴贊大),93,71,164,0
3593,고영인(高永寅),박형수(朴亨修),49,6,55,1
3594,고영인(高永寅),박홍근(朴洪根),139,130,269,0
3595,고영인(高永寅),배준영(裵俊英),50,4,54,1
3596,고영인(高永寅),배진교(裵晋敎),24,38,62,1
3597,고영인(高永寅),배현진(裵賢鎭),49,4,53,1
3598,고영인(高永寅),백종헌(白宗憲),51,6,57,1
3599,고영인(高永寅),백혜련(白惠蓮),99,70,169,0
3600,고영인(高永寅),변재일(卞在一),84,49,133,0
3601,고영인(高永寅),서동용(徐東榕),145,157,302,0
3602,고영인(高永寅),서범수(徐範洙),50,6,56,1
3603,고영인(高永寅),서병수(徐秉洙),50,4,54,1
3604,고영인(高永寅),서삼석(徐參錫),101,82,183,0
3605,고영인(高永寅),서영교(徐瑛敎),118,115,233,0
3606,고영인(高永寅),서영석(徐暎錫),158,171,329,0
3607,고영인(高永寅),서일준(徐一俊),51,6,57,1
3608,고영인(高永寅),서정숙(徐正淑),51,10,61,1
3609,고영인(高永寅),설훈(薛勳),87,60,147,0
3610,고영인(高永寅),성일종(成一鍾),51,6,57,1
3611,고영인(高永寅),소병철(蘇秉哲),89,75,164,0
3612,고영인(高永寅),소병훈(蘇秉勳),103,99,202,0
3613,고영인(高永寅),송갑석(宋甲錫),106,142,248,0
3614,고영인(高永寅),송기헌(宋基憲),80,51,131,0
3615,고영인(高永寅),송석준(宋錫俊),51,5,56,1
3616,고영인(高永寅),송언석(宋彦錫),45,5,50,1
3617,고영인(高永寅),송옥주(宋玉珠),112,89,201,0
3618,고영인(高永寅),송재호(宋在祜),110,107,217,0
3619,고영인(高永寅),신동근(申東根),105,98,203,0
3620,고영인(高永寅),신영대(申榮大),88,80,168,0
3621,고영인(高永寅),신원식(申源湜),49,5,54,1
3622,고영인(高永寅),신정훈(辛正勳),142,179,321,0
3623,고영인(高永寅),신현영(申賢榮),96,81,177,0
3624,고영인(高永寅),심상정(沈相奵),18,36,54,1
3625,고영인(高永寅),안규백(安圭伯),117,100,217,0
3626,고영인(高永寅),안민석(安敏錫),104,79,183,0
3627,고영인(高永寅),안병길(安炳吉),50,4,54,1
3628,고영인(高永寅),안철수(安哲秀),25,5,30,1
3629,고영인(高永寅),안호영(安浩永),87,96,183,0
3630,고영인(高永寅),양경숙(梁敬淑),108,108,216,0
3631,고영인(高永寅),양금희(梁琴喜),50,8,58,1
3632,고영인(高永寅),양기대(梁基大),101,93,194,0
3633,고영인(高永寅),양이원영(梁李媛瑛),125,111,236,0
3634,고영인(高永寅),양정숙(梁貞淑),88,177,265,1
3635,고영인(高永寅),양향자(梁香子),46,56,102,1
3636,고영인(高永寅),어기구(魚基龜),87,59,146,0
3637,고영인(高永寅),엄태영(嚴泰永),52,4,56,1
3638,고영인(高永寅),오기형(吳奇炯),88,68,156,0
3639,고영인(高永寅),오영환(吳永煥),161,193,354,0
3640,고영인(高永寅),용혜인(龍慧仁),29,42,71,1
3641,고영인(高永寅),우상호(禹相虎),87,50,137,0
3642,고영인(高永寅),우원식(禹元植),104,86,190,0
3643,고영인(高永寅),위성곤(魏聖坤),94,105,199,0
3644,고영인(高永寅),유경준(兪京濬),49,5,54,1
3645,고영인(高永寅),유기홍(柳基洪),80,60,140,0
3646,고영인(高永寅),유동수(柳東秀),101,66,167,0
3647,고영인(高永寅),유상범(劉相凡),49,4,53,1
3648,고영인(高永寅),유의동(兪義東),49,4,53,1
3649,고영인(高永寅),유정주(兪訂炷),147,162,309,0
3650,고영인(高永寅),윤건영(尹建永),91,66,157,0
3651,고영인(高永寅),윤관석(尹官石),108,64,172,1
3652,고영인(高永寅),윤두현(尹斗鉉),50,4,54,1
3653,고영인(高永寅),윤미향(尹美香),80,85,165,1
3654,고영인(高永寅),윤상현(尹相現),30,6,36,1
3655,고영인(高永寅),윤영덕(尹永德),104,124,228,0
3656,고영인(高永寅),윤영석(尹永碩),50,6,56,1
3657,고영인(高永寅),윤영찬(尹永燦),86,93,179,0
3658,고영인(高永寅),윤재갑(尹才鉀),131,118,249,0
3659,고영인(高永寅),윤재옥(尹在玉),49,4,53,1
3660,고영인(高永寅),윤주경(尹柱卿),50,5,55,1
3661,고영인(高永寅),윤준병(尹準炳),123,184,307,0
3662,고영인(高永寅),윤창현(尹暢賢),49,5,54,1
3663,고영인(高永寅),윤한홍(尹漢洪),50,4,54,1
3664,고영인(高永寅),윤호중(尹昊重),79,62,141,0
3665,고영인(高永寅),윤후덕(尹厚德),96,74,170,0
3666,고영인(高永寅),이개호(李介昊),88,73,161,0
3667,고영인(高永寅),이달곤(李達坤),52,6,58,1
3668,고영인(高永寅),이동주(李東洲),117,119,236,0
3669,고영인(高永寅),이만희(李晩熙),49,5,54,1
3670,고영인(高永寅),이명수(李明洙),51,17,68,1
3671,고영인(高永寅),이병훈(李炳勳),125,164,289,0
3672,고영인(高永寅),이상민(李相珉),79,35,114,0
3673,고영인(高永寅),이상헌(李相憲),109,99,208,0
3674,고영인(高永寅),이성만(李成萬),109,102,211,1
3675,고영인(高永寅),이소영(李素永),95,65,160,0
3676,고영인(高永寅),이수진(李壽珍),132,148,280,0
3677,고영인(高永寅),이수진(李秀眞),128,132,260,0
3678,고영인(高永寅),이양수(李亮壽),50,7,57,1
3679,고영인(高永寅),이용(李鏞),49,4,53,1
3680,고영인(高永寅),이용빈(李龍彬),172,218,390,0
3681,고영인(高永寅),이용선(李庸瑄),106,117,223,0
3682,고영인(高永寅),이용우(李龍雨),144,154,298,0
3683,고영인(高永寅),이용호(李容鎬),42,34,76,1
3684,고영인(高永寅),이원욱(李元旭),99,113,212,0
3685,고영인(高永寅),이원택(李源澤),101,81,182,0
3686,고영인(高永寅),이은주(李恩周),31,52,83,1
3687,고영인(高永寅),이인선(李仁善),25,4,29,1
3688,고영인(高永寅),이인영(李仁榮),84,62,146,0
3689,고영인(高永寅),이장섭(李將燮),117,135,252,0
3690,고영인(高永寅),이재명(李在明),40,19,59,0
3691,고영인(高永寅),이재정(李在汀),95,68,163,0
3692,고영인(高永寅),이정문(李楨文),106,107,213,0
3693,고영인(高永寅),이종배(李鍾培),50,5,55,1
3694,고영인(高永寅),이종성(李鍾成),50,7,57,1
3695,고영인(高永寅),이주환(李周桓),49,6,55,1
3696,고영인(高永寅),이채익(李埰益),52,7,59,1
3697,고영인(高永寅),이철규(李喆圭),51,5,56,1
3698,고영인(高永寅),이탄희(李誕熙),125,126,251,0
3699,고영인(高永寅),이태규(李泰珪),32,13,45,1
3700,고영인(高永寅),이학영(李學永),96,105,201,0
3701,고영인(高永寅),이해식(李海植),115,104,219,0
3702,고영인(高永寅),이헌승(李憲昇),50,5,55,1
3703,고영인(高永寅),이형석(李炯錫),120,114,234,0
3704,고영인(高永寅),인재근(印在謹),133,162,295,0
3705,고영인(高永寅),임병헌(林炳憲),25,4,29,1
3706,고영인(高永寅),임오경(林五卿),105,93,198,0
3707,고영인(高永寅),임이자(林利子),49,4,53,1
3708,고영인(高永寅),임종성(林鍾聲),117,98,215,0
3709,고영인(高永寅),임호선(林昊宣),133,206,339,0
3710,고영인(高永寅),장경태(張耿態),115,118,233,0
3711,고영인(高永寅),장동혁(張東赫),25,4,29,1
3712,고영인(高永寅),장제원(張濟元),49,4,53,1
3713,고영인(高永寅),장철민(張喆敏),99,81,180,0
3714,고영인(高永寅),장혜영(張惠英),19,29,48,1
3715,고영인(高永寅),전봉민(田奉珉),35,6,41,1
3716,고영인(高永寅),전용기(田溶冀),119,141,260,0
3717,고영인(高永寅),전재수(田載秀),108,85,193,0
3718,고영인(高永寅),전주혜(全珠惠),51,7,58,1
3719,고영인(高永寅),전해철(全海澈),86,87,173,0
3720,고영인(高永寅),전혜숙(全惠淑),117,141,258,0
3721,고영인(高永寅),정경희(丁慶姬),49,5,54,1
3722,고영인(高永寅),정동만(鄭東萬),49,4,53,1
3723,고영인(高永寅),정성호(鄭成湖),90,66,156,0
3724,고영인(高永寅),정우택(鄭宇澤),25,4,29,1
3725,고영인(高永寅),정운천(鄭雲天),49,6,55,1
3726,고영인(高永寅),정일영(鄭日永),92,79,171,0
3727,고영인(高永寅),정점식(鄭点植),50,4,54,1
3728,고영인(高永寅),정진석(鄭鎭碩),50,7,57,1
3729,고영인(高永寅),정청래(鄭淸來),110,76,186,0
3730,고영인(高永寅),정춘숙(鄭春淑),112,118,230,0
3731,고영인(高永寅),정태호(鄭泰浩),89,99,188,0
3732,고영인(高永寅),정필모(鄭必模),109,114,223,0
3733,고영인(高永寅),정희용(鄭熙溶),50,5,55,1
3734,고영인(高永寅),조경태(趙慶泰),49,4,53,1
3735,고영인(高永寅),조명희(曺明姬),49,7,56,1
3736,고영인(高永寅),조수진(趙修眞),50,6,56,1
3737,고영인(高永寅),조승래(趙承來),114,99,213,0
3738,고영인(高永寅),조오섭(曺五燮),129,156,285,0
3739,고영인(高永寅),조은희(趙恩禧),25,4,29,1
3740,고영인(高永寅),조응천(趙應天),79,40,119,0
3741,고영인(高永寅),조정식(趙正湜),79,41,120,0
3742,고영인(高永寅),조정훈(趙廷訓),9,12,21,1
3743,고영인(高永寅),조해진(曺海珍),51,6,57,1
3744,고영인(高永寅),주철현(朱哲鉉),102,92,194,0
3745,고영인(高永寅),주호영(朱豪英),49,4,53,1
3746,고영인(高永寅),지성호(池成浩),49,5,54,1
3747,고영인(高永寅),진선미(陳善美),98,68,166,0
3748,고영인(高永寅),진성준(陳聲準),125,126,251,0
3749,고영인(高永寅),천준호(千俊鎬),102,77,179,0
3750,고영인(高永寅),최기상(崔基相),83,61,144,0
3751,고영인(高永寅),최승재(崔承宰),49,4,53,1
3752,고영인(高永寅),최연숙(崔姸淑),40,24,64,1
3753,고영인(高永寅),최영희(崔英姬),25,5,30,1
3754,고영인(高永寅),최인호(崔仁昊),105,92,197,0
3755,고영인(高永寅),최재형(崔在亨),25,4,29,1
3756,고영인(高永寅),최종윤(崔鍾允),144,197,341,0
3757,고영인(高永寅),최춘식(崔春植),49,7,56,1
3758,고영인(高永寅),최형두(崔炯斗),51,4,55,1
3759,고영인(高永寅),최혜영(崔惠英),167,192,359,0
3760,고영인(高永寅),추경호(秋慶鎬),50,4,54,1
3761,고영인(高永寅),태영호(太永浩),49,7,56,1
3762,고영인(高永寅),하영제(河榮帝),41,2,43,1
3763,고영인(高永寅),하태경(河泰慶),51,7,58,1
3764,고영인(高永寅),한기호(韓起鎬),50,5,55,1
3765,고영인(高永寅),한무경(韓茂景),51,4,55,1
3766,고영인(高永寅),한병도(韓秉道),118,121,239,0
3767,고영인(高永寅),한정애(韓貞愛),89,69,158,0
3768,고영인(高永寅),한준호(韓俊鎬),102,107,209,0
3769,고영인(高永寅),허숙정(許淑湞),1,1,2,0
3770,고영인(高永寅),허영(許榮),135,142,277,0
3771,고영인(高永寅),허은아(許垠娥),49,5,54,1
3772,고영인(高永寅),허종식(許琮植),136,121,257,0
3773,고영인(高永寅),홍기원(洪起元),108,111,219,0
3774,고영인(高永寅),홍문표(洪文杓),50,6,56,1
3775,고영인(高永寅),홍석준(洪碩晙),52,5,57,1
3776,고영인(高永寅),홍성국(洪性國),131,138,269,0
3777,고영인(高永寅),홍영표(洪永杓),88,69,157,0
3778,고영인(高永寅),홍익표(洪翼杓),94,83,177,0
3779,고영인(高永寅),홍정민(洪貞敏),169,186,355,0
3780,고영인(高永寅),황보승희(皇甫承希),46,3,49,1
3781,고영인(高永寅),황운하(黃雲夏),134,129,263,0
3782,고영인(高永寅),황희(黃熙),82,54,136,0
3783,고용진(高榕禛),구자근(具滋根),51,7,58,1
3784,고용진(高榕禛),권명호(權明浩),51,4,55,1
3785,고용진(高榕禛),권성동(權性東),43,5,48,1
3786,고용진(高榕禛),권영세(權寧世),52,5,57,1
3787,고용진(高榕禛),권은희(權垠希),30,4,34,1
3788,고용진(高榕禛),권인숙(權仁淑),93,72,165,0
3789,고용진(高榕禛),권칠승(權七勝),94,89,183,0
3790,고용진(高榕禛),기동민(奇東旻),117,112,229,0
3791,고용진(高榕禛),김경만(金京萬),113,86,199,0
3792,고용진(高榕禛),김경협(金炅俠),120,79,199,0
3793,고용진(高榕禛),김교흥(金敎興),106,85,191,0
3794,고용진(高榕禛),김기현(金起炫),52,5,57,1
3795,고용진(高榕禛),김남국(金南局),79,59,138,1
3796,고용진(高榕禛),김도읍(金度邑),51,4,55,1
3797,고용진(高榕禛),김두관(金斗官),95,76,171,0
3798,고용진(高榕禛),김미애(金美愛),51,5,56,1
3799,고용진(高榕禛),김민기(金敏基),103,78,181,0
3800,고용진(高榕禛),김민석(金民錫),97,71,168,0
3801,고용진(高榕禛),김민철(金敏徹),125,86,211,0
3802,고용진(高榕禛),김병기(金炳基),97,64,161,0
3803,고용진(高榕禛),김병욱A(金炳旭),112,95,207,0
3804,고용진(高榕禛),김병욱B(金炳旭),44,4,48,1
3805,고용진(高榕禛),김병주(金柄周),88,49,137,0
3806,고용진(高榕禛),김상훈(金相勳),53,6,59,1
3807,고용진(高榕禛),김상희(金相姬),93,65,158,0
3808,고용진(高榕禛),김석기(金碩基),52,5,57,1
3809,고용진(高榕禛),김성원(金成願),52,7,59,1
3810,고용진(高榕禛),김성주(金成柱),105,91,196,0
3811,고용진(高榕禛),김성환(金星煥),96,62,158,0
3812,고용진(高榕禛),김수흥(金洙興),139,128,267,0
3813,고용진(高榕禛),김승남(金承南),89,95,184,0
3814,고용진(高榕禛),김승수(金承洙),52,7,59,1
3815,고용진(高榕禛),김승원(金勝源),110,81,191,0
3816,고용진(高榕禛),김영배(金永培),116,83,199,0
3817,고용진(高榕禛),김영선(金映宣),26,5,31,1
3818,고용진(高榕禛),김영식(金英植),53,6,59,1
3819,고용진(高榕禛),김영주(金榮珠),96,81,177,0
3820,고용진(高榕禛),김영진(金榮鎭),92,69,161,0
3821,고용진(高榕禛),김영호(金映豪),87,58,145,0
3822,고용진(高榕禛),김예지(金睿智),55,8,63,1
3823,고용진(高榕禛),김용민(金容民),93,74,167,0
3824,고용진(高榕禛),김용판(金用判),52,6,58,1
3825,고용진(高榕禛),김웅(金雄),52,4,56,1
3826,고용진(高榕禛),김원이(金元二),100,79,179,0
3827,고용진(高榕禛),김윤덕(金潤德),99,82,181,0
3828,고용진(高榕禛),김의겸(金宜謙),50,40,90,0
3829,고용진(高榕禛),김정재(金汀才),53,5,58,1
3830,고용진(高榕禛),김정호(金禎鎬),121,151,272,0
3831,고용진(高榕禛),김종민(金鐘民),91,70,161,0
3832,고용진(高榕禛),김주영(金周暎),136,134,270,0
3833,고용진(高榕禛),김진표(金振杓),73,67,140,1
3834,고용진(高榕禛),김철민(金哲玟),114,108,222,0
3835,고용진(高榕禛),김태년(金太年),86,79,165,0
3836,고용진(高榕禛),김태호(金台鎬),41,6,47,1
3837,고용진(高榕禛),김학용(金學容),25,7,32,1
3838,고용진(高榕禛),김한규(金翰奎),42,34,76,0
3839,고용진(高榕禛),김한정(金漢正),81,50,131,0
3840,고용진(高榕禛),김형동(金亨東),52,8,60,1
3841,고용진(高榕禛),김홍걸(金弘傑),61,104,165,0
3842,고용진(高榕禛),김회재(金會在),94,62,156,0
3843,고용진(高榕禛),김희곤(金熙坤),50,4,54,1
3844,고용진(高榕禛),김희국(金熙國),49,6,55,1
3845,고용진(高榕禛),남인순(南仁順),104,68,172,0
3846,고용진(高榕禛),노용호(魯容昊),25,4,29,1
3847,고용진(高榕禛),노웅래(盧雄來),103,94,197,0
3848,고용진(高榕禛),도종환(都鍾煥),100,78,178,0
3849,고용진(高榕禛),류성걸(柳性杰),50,6,56,1
3850,고용진(高榕禛),류호정(柳好貞),18,27,45,1
3851,고용진(高榕禛),맹성규(孟聖奎),100,72,172,0
3852,고용진(高榕禛),문정복(文貞福),83,52,135,0
3853,고용진(高榕禛),문진석(文振碩),94,72,166,0
3854,고용진(高榕禛),민병덕(閔炳德),94,101,195,0
3855,고용진(高榕禛),민형배(閔馨培),78,92,170,0
3856,고용진(高榕禛),민홍철(閔洪喆),79,68,147,0
3857,고용진(高榕禛),박광온(朴洸瑥),92,70,162,0
3858,고용진(高榕禛),박대수(朴大壽),50,7,57,1
3859,고용진(高榕禛),박대출(朴大出),50,4,54,1
3860,고용진(高榕禛),박덕흠(朴德欽),36,8,44,1
3861,고용진(高榕禛),박범계(朴範界),85,48,133,0
3862,고용진(高榕禛),박병석(朴炳錫),41,20,61,0
3863,고용진(高榕禛),박상혁(朴商赫),114,136,250,0
3864,고용진(高榕禛),박성민(朴聖敏),49,5,54,1
3865,고용진(高榕禛),박성준(朴省俊),114,109,223,0
3866,고용진(高榕禛),박성중(朴成重),49,4,53,1
3867,고용진(高榕禛),박수영(朴洙瑩),49,4,53,1
3868,고용진(高榕禛),박영순(朴英淳),93,66,159,0
3869,고용진(高榕禛),박완주(朴完柱),60,44,104,1
3870,고용진(高榕禛),박용진(朴用鎭),80,51,131,0
3871,고용진(高榕禛),박재호(朴在昊),98,63,161,0
3872,고용진(高榕禛),박정(朴釘),124,99,223,0
3873,고용진(高榕禛),박정하(朴正河),25,4,29,1
3874,고용진(高榕禛),박주민(朴柱民),80,51,131,0
3875,고용진(高榕禛),박진(朴振),50,4,54,1
3876,고용진(高榕禛),박찬대(朴贊大),93,61,154,0
3877,고용진(高榕禛),박형수(朴亨修),49,5,54,1
3878,고용진(高榕禛),박홍근(朴洪根),118,103,221,0
3879,고용진(高榕禛),배준영(裵俊英),49,5,54,1
3880,고용진(高榕禛),배진교(裵晋敎),14,15,29,1
3881,고용진(高榕禛),배현진(裵賢鎭),49,4,53,1
3882,고용진(高榕禛),백종헌(白宗憲),50,5,55,1
3883,고용진(高榕禛),백혜련(白惠蓮),101,71,172,0
3884,고용진(高榕禛),변재일(卞在一),90,86,176,0
3885,고용진(高榕禛),서동용(徐東榕),95,74,169,0
3886,고용진(高榕禛),서범수(徐範洙),51,6,57,1
3887,고용진(高榕禛),서병수(徐秉洙),50,6,56,1
3888,고용진(高榕禛),서삼석(徐參錫),93,62,155,0
3889,고용진(高榕禛),서영교(徐瑛敎),118,110,228,0
3890,고용진(高榕禛),서영석(徐暎錫),96,88,184,0
3891,고용진(高榕禛),서일준(徐一俊),50,6,56,1
3892,고용진(高榕禛),서정숙(徐正淑),49,6,55,1
3893,고용진(高榕禛),설훈(薛勳),87,60,147,0
3894,고용진(高榕禛),성일종(成一鍾),51,6,57,1
3895,고용진(高榕禛),소병철(蘇秉哲),93,66,159,0
3896,고용진(高榕禛),소병훈(蘇秉勳),90,75,165,0
3897,고용진(高榕禛),송갑석(宋甲錫),100,76,176,0
3898,고용진(高榕禛),송기헌(宋基憲),81,54,135,0
3899,고용진(高榕禛),송석준(宋錫俊),52,5,57,1
3900,고용진(高榕禛),송언석(宋彦錫),45,4,49,1
3901,고용진(高榕禛),송옥주(宋玉珠),97,83,180,0
3902,고용진(高榕禛),송재호(宋在祜),98,67,165,0
3903,고용진(高榕禛),신동근(申東根),107,105,212,0
3904,고용진(高榕禛),신영대(申榮大),93,74,167,0
3905,고용진(高榕禛),신원식(申源湜),50,6,56,1
3906,고용진(高榕禛),신정훈(辛正勳),103,119,222,0
3907,고용진(高榕禛),신현영(申賢榮),88,61,149,0
3908,고용진(高榕禛),심상정(沈相奵),14,26,40,1
3909,고용진(高榕禛),안규백(安圭伯),115,103,218,0
3910,고용진(高榕禛),안민석(安敏錫),91,57,148,0
3911,고용진(高榕禛),안병길(安炳吉),50,5,55,1
3912,고용진(高榕禛),안철수(安哲秀),25,6,31,1
3913,고용진(高榕禛),안호영(安浩永),90,78,168,0
3914,고용진(高榕禛),양경숙(梁敬淑),109,88,197,0
3915,고용진(高榕禛),양금희(梁琴喜),50,6,56,1
3916,고용진(高榕禛),양기대(梁基大),99,84,183,0
3917,고용진(高榕禛),양이원영(梁李媛瑛),88,60,148,0
3918,고용진(高榕禛),양정숙(梁貞淑),58,116,174,1
3919,고용진(高榕禛),양향자(梁香子),70,66,136,1
3920,고용진(高榕禛),어기구(魚基龜),90,68,158,0
3921,고용진(高榕禛),엄태영(嚴泰永),50,5,55,1
3922,고용진(高榕禛),오기형(吳奇炯),76,41,117,0
3923,고용진(高榕禛),오영환(吳永煥),137,144,281,0
3924,고용진(高榕禛),용혜인(龍慧仁),17,22,39,1
3925,고용진(高榕禛),우상호(禹相虎),80,43,123,0
3926,고용진(高榕禛),우원식(禹元植),110,75,185,0
3927,고용진(高榕禛),위성곤(魏聖坤),95,95,190,0
3928,고용진(高榕禛),유경준(兪京濬),49,5,54,1
3929,고용진(高榕禛),유기홍(柳基洪),84,55,139,0
3930,고용진(高榕禛),유동수(柳東秀),99,69,168,0
3931,고용진(高榕禛),유상범(劉相凡),49,4,53,1
3932,고용진(高榕禛),유의동(兪義東),50,4,54,1
3933,고용진(高榕禛),유정주(兪訂炷),122,97,219,0
3934,고용진(高榕禛),윤건영(尹建永),90,59,149,0
3935,고용진(高榕禛),윤관석(尹官石),95,84,179,1
3936,고용진(高榕禛),윤두현(尹斗鉉),49,6,55,1
3937,고용진(高榕禛),윤미향(尹美香),47,50,97,1
3938,고용진(高榕禛),윤상현(尹相現),30,6,36,1
3939,고용진(高榕禛),윤영덕(尹永德),91,73,164,0
3940,고용진(高榕禛),윤영석(尹永碩),51,6,57,1
3941,고용진(高榕禛),윤영찬(尹永燦),89,72,161,0
3942,고용진(高榕禛),윤재갑(尹才鉀),95,82,177,0
3943,고용진(高榕禛),윤재옥(尹在玉),50,4,54,1
3944,고용진(高榕禛),윤주경(尹柱卿),49,9,58,1
3945,고용진(高榕禛),윤준병(尹準炳),108,125,233,0
3946,고용진(高榕禛),윤창현(尹暢賢),49,6,55,1
3947,고용진(高榕禛),윤한홍(尹漢洪),50,5,55,1
3948,고용진(高榕禛),윤호중(尹昊重),83,65,148,0
3949,고용진(高榕禛),윤후덕(尹厚德),127,110,237,0
3950,고용진(高榕禛),이개호(李介昊),90,56,146,0
3951,고용진(高榕禛),이달곤(李達坤),52,7,59,1
3952,고용진(高榕禛),이동주(李東洲),93,110,203,0
3953,고용진(高榕禛),이만희(李晩熙),50,4,54,1
3954,고용진(高榕禛),이명수(李明洙),51,12,63,1
3955,고용진(高榕禛),이병훈(李炳勳),103,95,198,0
3956,고용진(高榕禛),이상민(李相珉),84,44,128,0
3957,고용진(高榕禛),이상헌(李相憲),99,88,187,0
3958,고용진(高榕禛),이성만(李成萬),103,74,177,1
3959,고용진(高榕禛),이소영(李素永),84,46,130,0
3960,고용진(高榕禛),이수진(李壽珍),100,78,178,0
3961,고용진(高榕禛),이수진(李秀眞),113,100,213,0
3962,고용진(高榕禛),이양수(李亮壽),50,4,54,1
3963,고용진(高榕禛),이용(李鏞),49,4,53,1
3964,고용진(高榕禛),이용빈(李龍彬),112,139,251,0
3965,고용진(高榕禛),이용선(李庸瑄),88,84,172,0
3966,고용진(高榕禛),이용우(李龍雨),95,57,152,0
3967,고용진(高榕禛),이용호(李容鎬),37,16,53,1
3968,고용진(高榕禛),이원욱(李元旭),121,130,251,0
3969,고용진(高榕禛),이원택(李源澤),85,48,133,0
3970,고용진(高榕禛),이은주(李恩周),15,18,33,1
3971,고용진(高榕禛),이인선(李仁善),25,5,30,1
3972,고용진(高榕禛),이인영(李仁榮),77,44,121,0
3973,고용진(高榕禛),이장섭(李將燮),101,84,185,0
3974,고용진(高榕禛),이재명(李在明),40,22,62,0
3975,고용진(高榕禛),이재정(李在汀),82,58,140,0
3976,고용진(高榕禛),이정문(李楨文),100,89,189,0
3977,고용진(高榕禛),이종배(李鍾培),50,5,55,1
3978,고용진(高榕禛),이종성(李鍾成),49,5,54,1
3979,고용진(高榕禛),이주환(李周桓),49,4,53,1
3980,고용진(高榕禛),이채익(李埰益),51,7,58,1
3981,고용진(高榕禛),이철규(李喆圭),51,4,55,1
3982,고용진(高榕禛),이탄희(李誕熙),108,82,190,0
3983,고용진(高榕禛),이태규(李泰珪),29,4,33,1
3984,고용진(高榕禛),이학영(李學永),109,112,221,0
3985,고용진(高榕禛),이해식(李海植),102,57,159,0
3986,고용진(高榕禛),이헌승(李憲昇),50,5,55,1
3987,고용진(高榕禛),이형석(李炯錫),107,84,191,0
3988,고용진(高榕禛),인재근(印在謹),90,85,175,0
3989,고용진(高榕禛),임병헌(林炳憲),25,4,29,1
3990,고용진(高榕禛),임오경(林五卿),118,109,227,0
3991,고용진(高榕禛),임이자(林利子),49,5,54,1
3992,고용진(高榕禛),임종성(林鍾聲),109,103,212,0
3993,고용진(高榕禛),임호선(林昊宣),128,178,306,0
3994,고용진(高榕禛),장경태(張耿態),104,86,190,0
3995,고용진(高榕禛),장동혁(張東赫),25,4,29,1
3996,고용진(高榕禛),장제원(張濟元),49,5,54,1
3997,고용진(高榕禛),장철민(張喆敏),117,88,205,0
3998,고용진(高榕禛),장혜영(張惠英),17,11,28,1
3999,고용진(高榕禛),전봉민(田奉珉),35,5,40,1
4000,고용진(高榕禛),전용기(田溶冀),107,105,212,0
4001,고용진(高榕禛),전재수(田載秀),92,77,169,0
4002,고용진(高榕禛),전주혜(全珠惠),51,4,55,1
4003,고용진(高榕禛),전해철(全海澈),78,57,135,0
4004,고용진(高榕禛),전혜숙(全惠淑),104,83,187,0
4005,고용진(高榕禛),정경희(丁慶姬),49,4,53,1
4006,고용진(高榕禛),정동만(鄭東萬),49,5,54,1
4007,고용진(高榕禛),정성호(鄭成湖),99,71,170,0
4008,고용진(高榕禛),정우택(鄭宇澤),26,6,32,1
4009,고용진(高榕禛),정운천(鄭雲天),50,7,57,1
4010,고용진(高榕禛),정일영(鄭日永),125,131,256,0
4011,고용진(高榕禛),정점식(鄭点植),50,4,54,1
4012,고용진(高榕禛),정진석(鄭鎭碩),50,7,57,1
4013,고용진(高榕禛),정청래(鄭淸來),89,62,151,0
4014,고용진(高榕禛),정춘숙(鄭春淑),101,86,187,0
4015,고용진(高榕禛),정태호(鄭泰浩),89,91,180,0
4016,고용진(高榕禛),정필모(鄭必模),92,63,155,0
4017,고용진(高榕禛),정희용(鄭熙溶),51,5,56,1
4018,고용진(高榕禛),조경태(趙慶泰),50,4,54,1
4019,고용진(高榕禛),조명희(曺明姬),50,7,57,1
4020,고용진(高榕禛),조수진(趙修眞),49,5,54,1
4021,고용진(高榕禛),조승래(趙承來),106,73,179,0
4022,고용진(高榕禛),조오섭(曺五燮),90,86,176,0
4023,고용진(高榕禛),조은희(趙恩禧),25,5,30,1
4024,고용진(高榕禛),조응천(趙應天),75,48,123,0
4025,고용진(高榕禛),조정식(趙正湜),87,55,142,0
4026,고용진(高榕禛),조정훈(趙廷訓),4,3,7,1
4027,고용진(高榕禛),조해진(曺海珍),51,7,58,1
4028,고용진(高榕禛),주철현(朱哲鉉),95,57,152,0
4029,고용진(高榕禛),주호영(朱豪英),49,4,53,1
4030,고용진(高榕禛),지성호(池成浩),49,4,53,1
4031,고용진(高榕禛),진선미(陳善美),84,52,136,0
4032,고용진(高榕禛),진성준(陳聲準),99,55,154,0
4033,고용진(高榕禛),천준호(千俊鎬),89,54,143,0
4034,고용진(高榕禛),최기상(崔基相),84,68,152,0
4035,고용진(高榕禛),최승재(崔承宰),49,5,54,1
4036,고용진(高榕禛),최연숙(崔姸淑),32,16,48,1
4037,고용진(高榕禛),최영희(崔英姬),25,7,32,1
4038,고용진(高榕禛),최인호(崔仁昊),95,100,195,0
4039,고용진(高榕禛),최재형(崔在亨),25,6,31,1
4040,고용진(高榕禛),최종윤(崔鍾允),94,80,174,0
4041,고용진(高榕禛),최춘식(崔春植),49,5,54,1
4042,고용진(高榕禛),최형두(崔炯斗),50,6,56,1
4043,고용진(高榕禛),최혜영(崔惠英),112,105,217,0
4044,고용진(高榕禛),추경호(秋慶鎬),49,4,53,1
4045,고용진(高榕禛),태영호(太永浩),49,6,55,1
4046,고용진(高榕禛),하영제(河榮帝),41,3,44,1
4047,고용진(高榕禛),하태경(河泰慶),49,6,55,1
4048,고용진(高榕禛),한기호(韓起鎬),50,6,56,1
4049,고용진(高榕禛),한무경(韓茂景),49,5,54,1
4050,고용진(高榕禛),한병도(韓秉道),109,115,224,0
4051,고용진(高榕禛),한정애(韓貞愛),78,56,134,0
4052,고용진(高榕禛),한준호(韓俊鎬),100,112,212,0
4053,고용진(高榕禛),허숙정(許淑湞),1,1,2,0
4054,고용진(高榕禛),허영(許榮),102,85,187,0
4055,고용진(高榕禛),허은아(許垠娥),49,5,54,1
4056,고용진(高榕禛),허종식(許琮植),96,86,182,0
4057,고용진(高榕禛),홍기원(洪起元),99,80,179,0
4058,고용진(高榕禛),홍문표(洪文杓),50,7,57,1
4059,고용진(高榕禛),홍석준(洪碩晙),50,4,54,1
4060,고용진(高榕禛),홍성국(洪性國),121,139,260,0
4061,고용진(高榕禛),홍영표(洪永杓),92,67,159,0
4062,고용진(高榕禛),홍익표(洪翼杓),101,93,194,0
4063,고용진(高榕禛),홍정민(洪貞敏),104,100,204,0
4064,고용진(高榕禛),황보승희(皇甫承希),47,5,52,1
4065,고용진(高榕禛),황운하(黃雲夏),98,84,182,0
4066,고용진(高榕禛),황희(黃熙),84,54,138,0
4067,구자근(具滋根),권명호(權明浩),198,482,680,0
4068,구자근(具滋根),권성동(權性東),97,136,233,0
4069,구자근(具滋根),권영세(權寧世),76,82,158,0
4070,구자근(具滋根),권은희(權垠希),34,30,64,0
4071,구자근(具滋根),권인숙(權仁淑),51,5,56,1
4072,구자근(具滋根),권칠승(權七勝),52,4,56,1
4073,구자근(具滋根),기동민(奇東旻),51,3,54,1
4074,구자근(具滋根),김경만(金京萬),51,4,55,1
4075,구자근(具滋根),김경협(金炅俠),51,4,55,1
4076,구자근(具滋根),김교흥(金敎興),51,4,55,1
4077,구자근(具滋根),김기현(金起炫),90,94,184,0
4078,구자근(具滋根),김남국(金南局),42,1,43,1
4079,구자근(具滋根),김도읍(金度邑),131,243,374,0
4080,구자근(具滋根),김두관(金斗官),51,6,57,1
4081,구자근(具滋根),김미애(金美愛),79,107,186,0
4082,구자근(具滋根),김민기(金敏基),51,5,56,1
4083,구자근(具滋根),김민석(金民錫),51,11,62,1
4084,구자근(具滋根),김민철(金敏徹),51,6,57,1
4085,구자근(具滋根),김병기(金炳基),52,5,57,1
4086,구자근(具滋根),김병욱A(金炳旭),51,5,56,1
4087,구자근(具滋根),김병욱B(金炳旭),108,198,306,0
4088,구자근(具滋根),김병주(金柄周),52,4,56,1
4089,구자근(具滋根),김상훈(金相勳),118,155,273,0
4090,구자근(具滋根),김상희(金相姬),51,4,55,1
4091,구자근(具滋根),김석기(金碩基),146,314,460,0
4092,구자근(具滋根),김성원(金成願),139,296,435,0
4093,구자근(具滋根),김성주(金成柱),51,4,55,1
4094,구자근(具滋根),김성환(金星煥),51,4,55,1
4095,구자근(具滋根),김수흥(金洙興),52,9,61,1
4096,구자근(具滋根),김승남(金承南),51,5,56,1
4097,구자근(具滋根),김승수(金承洙),107,204,311,0
4098,구자근(具滋根),김승원(金勝源),52,4,56,1
4099,구자근(具滋根),김영배(金永培),51,5,56,1
4100,구자근(具滋根),김영선(金映宣),30,54,84,0
4101,구자근(具滋根),김영식(金英植),139,261,400,0
4102,구자근(具滋根),김영주(金榮珠),51,4,55,1
4103,구자근(具滋根),김영진(金榮鎭),52,3,55,1
4104,구자근(具滋根),김영호(金映豪),51,4,55,1
4105,구자근(具滋根),김예지(金睿智),143,377,520,0
4106,구자근(具滋根),김용민(金容民),51,4,55,1
4107,구자근(具滋根),김용판(金用判),167,402,569,0
4108,구자근(具滋根),김웅(金雄),66,48,114,0
4109,구자근(具滋根),김원이(金元二),51,5,56,1
4110,구자근(具滋根),김윤덕(金潤德),51,5,56,1
4111,구자근(具滋根),김의겸(金宜謙),26,8,34,1
4112,구자근(具滋根),김정재(金汀才),137,207,344,0
4113,구자근(具滋根),김정호(金禎鎬),52,6,58,1
4114,구자근(具滋根),김종민(金鐘民),51,4,55,1
4115,구자근(具滋根),김주영(金周暎),50,5,55,1
4116,구자근(具滋根),김진표(金振杓),25,0,25,1
4117,구자근(具滋根),김철민(金哲玟),50,3,53,1
4118,구자근(具滋根),김태년(金太年),50,4,54,1
4119,구자근(具滋根),김태호(金台鎬),82,115,197,0
4120,구자근(具滋根),김학용(金學容),57,143,200,0
4121,구자근(具滋根),김한규(金翰奎),25,4,29,1
4122,구자근(具滋根),김한정(金漢正),50,4,54,1
4123,구자근(具滋根),김형동(金亨東),112,227,339,0
4124,구자근(具滋根),김홍걸(金弘傑),14,6,20,1
4125,구자근(具滋根),김회재(金會在),51,4,55,1
4126,구자근(具滋根),김희곤(金熙坤),125,318,443,0
4127,구자근(具滋根),김희국(金熙國),102,140,242,0
4128,구자근(具滋根),남인순(南仁順),49,4,53,1
4129,구자근(具滋根),노용호(魯容昊),38,57,95,0
4130,구자근(具滋根),노웅래(盧雄來),49,5,54,1
4131,구자근(具滋根),도종환(都鍾煥),49,5,54,1
4132,구자근(具滋根),류성걸(柳性杰),97,163,260,0
4133,구자근(具滋根),류호정(柳好貞),4,17,21,1
4134,구자근(具滋根),맹성규(孟聖奎),49,5,54,1
4135,구자근(具滋根),문정복(文貞福),49,5,54,1
4136,구자근(具滋根),문진석(文振碩),49,5,54,1
4137,구자근(具滋根),민병덕(閔炳德),49,11,60,1
4138,구자근(具滋根),민형배(閔馨培),33,5,38,1
4139,구자근(具滋根),민홍철(閔洪喆),50,5,55,1
4140,구자근(具滋根),박광온(朴洸瑥),49,4,53,1
4141,구자근(具滋根),박대수(朴大壽),171,455,626,0
4142,구자근(具滋根),박대출(朴大出),73,79,152,0
4143,구자근(具滋根),박덕흠(朴德欽),128,277,405,0
4144,구자근(具滋根),박범계(朴範界),50,4,54,1
4145,구자근(具滋根),박병석(朴炳錫),25,3,28,1
4146,구자근(具滋根),박상혁(朴商赫),49,9,58,1
4147,구자근(具滋根),박성민(朴聖敏),103,292,395,0
4148,구자근(具滋根),박성준(朴省俊),49,5,54,1
4149,구자근(具滋根),박성중(朴成重),85,125,210,0
4150,구자근(具滋根),박수영(朴洙瑩),76,82,158,0
4151,구자근(具滋根),박영순(朴英淳),49,4,53,1
4152,구자근(具滋根),박완주(朴完柱),24,0,24,1
4153,구자근(具滋根),박용진(朴用鎭),49,6,55,1
4154,구자근(具滋根),박재호(朴在昊),50,5,55,1
4155,구자근(具滋根),박정(朴釘),49,6,55,1
4156,구자근(具滋根),박정하(朴正河),37,57,94,0
4157,구자근(具滋根),박주민(朴柱民),49,4,53,1
4158,구자근(具滋根),박진(朴振),71,75,146,0
4159,구자근(具滋根),박찬대(朴贊大),49,4,53,1
4160,구자근(具滋根),박형수(朴亨修),76,90,166,0
4161,구자근(具滋根),박홍근(朴洪根),50,4,54,1
4162,구자근(具滋根),배준영(裵俊英),83,121,204,0
4163,구자근(具滋根),배진교(裵晋敎),5,4,9,1
4164,구자근(具滋根),배현진(裵賢鎭),76,61,137,0
4165,구자근(具滋根),백종헌(白宗憲),118,219,337,0
4166,구자근(具滋根),백혜련(白惠蓮),49,5,54,1
4167,구자근(具滋根),변재일(卞在一),49,4,53,1
4168,구자근(具滋根),서동용(徐東榕),49,4,53,1
4169,구자근(具滋根),서범수(徐範洙),102,164,266,0
4170,구자근(具滋根),서병수(徐秉洙),95,179,274,0
4171,구자근(具滋根),서삼석(徐參錫),49,5,54,1
4172,구자근(具滋根),서영교(徐瑛敎),50,4,54,1
4173,구자근(具滋根),서영석(徐暎錫),49,7,56,1
4174,구자근(具滋根),서일준(徐一俊),119,213,332,0
4175,구자근(具滋根),서정숙(徐正淑),96,139,235,0
4176,구자근(具滋根),설훈(薛勳),50,7,57,1
4177,구자근(具滋根),성일종(成一鍾),124,267,391,0
4178,구자근(具滋根),소병철(蘇秉哲),50,5,55,1
4179,구자근(具滋根),소병훈(蘇秉勳),49,5,54,1
4180,구자근(具滋根),송갑석(宋甲錫),49,4,53,1
4181,구자근(具滋根),송기헌(宋基憲),52,6,58,1
4182,구자근(具滋根),송석준(宋錫俊),79,101,180,0
4183,구자근(具滋根),송언석(宋彦錫),128,198,326,0
4184,구자근(具滋根),송옥주(宋玉珠),49,4,53,1
4185,구자근(具滋根),송재호(宋在祜),50,6,56,1
4186,구자근(具滋根),신동근(申東根),49,3,52,1
4187,구자근(具滋根),신영대(申榮大),49,6,55,1
4188,구자근(具滋根),신원식(申源湜),75,79,154,0
4189,구자근(具滋根),신정훈(辛正勳),50,4,54,1
4190,구자근(具滋根),신현영(申賢榮),49,4,53,1
4191,구자근(具滋根),심상정(沈相奵),5,4,9,1
4192,구자근(具滋根),안규백(安圭伯),52,5,57,1
4193,구자근(具滋根),안민석(安敏錫),49,3,52,1
4194,구자근(具滋根),안병길(安炳吉),121,304,425,0
4195,구자근(具滋根),안철수(安哲秀),28,17,45,0
4196,구자근(具滋根),안호영(安浩永),49,7,56,1
4197,구자근(具滋根),양경숙(梁敬淑),49,4,53,1
4198,구자근(具滋根),양금희(梁琴喜),127,246,373,0
4199,구자근(具滋根),양기대(梁基大),49,4,53,1
4200,구자근(具滋根),양이원영(梁李媛瑛),45,4,49,1
4201,구자근(具滋根),양정숙(梁貞淑),2,8,10,1
4202,구자근(具滋根),양향자(梁香子),22,21,43,1
4203,구자근(具滋根),어기구(魚基龜),49,8,57,1
4204,구자근(具滋根),엄태영(嚴泰永),108,166,274,0
4205,구자근(具滋根),오기형(吳奇炯),49,4,53,1
4206,구자근(具滋根),오영환(吳永煥),49,11,60,1
4207,구자근(具滋根),용혜인(龍慧仁),1,5,6,1
4208,구자근(具滋根),우상호(禹相虎),49,4,53,1
4209,구자근(具滋根),우원식(禹元植),49,4,53,1
4210,구자근(具滋根),위성곤(魏聖坤),50,7,57,1
4211,구자근(具滋根),유경준(兪京濬),92,136,228,0
4212,구자근(具滋根),유기홍(柳基洪),49,4,53,1
4213,구자근(具滋根),유동수(柳東秀),49,5,54,1
4214,구자근(具滋根),유상범(劉相凡),94,135,229,0
4215,구자근(具滋根),유의동(兪義東),87,114,201,0
4216,구자근(具滋根),유정주(兪訂炷),49,4,53,1
4217,구자근(具滋根),윤건영(尹建永),49,4,53,1
4218,구자근(具滋根),윤관석(尹官石),40,0,40,1
4219,구자근(具滋根),윤두현(尹斗鉉),105,178,283,0
4220,구자근(具滋根),윤미향(尹美香),20,0,20,1
4221,구자근(具滋根),윤상현(尹相現),53,81,134,0
4222,구자근(具滋根),윤영덕(尹永德),49,6,55,1
4223,구자근(具滋根),윤영석(尹永碩),120,183,303,0
4224,구자근(具滋根),윤영찬(尹永燦),49,4,53,1
4225,구자근(具滋根),윤재갑(尹才鉀),51,7,58,1
4226,구자근(具滋根),윤재옥(尹在玉),96,83,179,0
4227,구자근(具滋根),윤주경(尹柱卿),90,100,190,0
4228,구자근(具滋根),윤준병(尹準炳),49,4,53,1
4229,구자근(具滋根),윤창현(尹暢賢),116,232,348,0
4230,구자근(具滋根),윤한홍(尹漢洪),74,95,169,0
4231,구자근(具滋根),윤호중(尹昊重),50,4,54,1
4232,구자근(具滋根),윤후덕(尹厚德),50,6,56,1
4233,구자근(具滋根),이개호(李介昊),50,7,57,1
4234,구자근(具滋根),이달곤(李達坤),70,90,160,0
4235,구자근(具滋根),이동주(李東洲),49,4,53,1
4236,구자근(具滋根),이만희(李晩熙),103,94,197,0
4237,구자근(具滋根),이명수(李明洙),129,298,427,0
4238,구자근(具滋根),이병훈(李炳勳),50,5,55,1
4239,구자근(具滋根),이상민(李相珉),49,4,53,1
4240,구자근(具滋根),이상헌(李相憲),49,12,61,1
4241,구자근(具滋根),이성만(李成萬),41,0,41,1
4242,구자근(具滋根),이소영(李素永),50,4,54,1
4243,구자근(具滋根),이수진(李壽珍),49,5,54,1
4244,구자근(具滋根),이수진(李秀眞),49,4,53,1
4245,구자근(具滋根),이양수(李亮壽),98,70,168,0
4246,구자근(具滋根),이용(李鏞),101,204,305,0
4247,구자근(具滋根),이용빈(李龍彬),49,6,55,1
4248,구자근(具滋根),이용선(李庸瑄),49,4,53,1
4249,구자근(具滋根),이용우(李龍雨),49,4,53,1
4250,구자근(具滋根),이용호(李容鎬),34,55,89,0
4251,구자근(具滋根),이원욱(李元旭),49,5,54,1
4252,구자근(具滋根),이원택(李源澤),49,4,53,1
4253,구자근(具滋根),이은주(李恩周),5,3,8,1
4254,구자근(具滋根),이인선(李仁善),43,82,125,0
4255,구자근(具滋根),이인영(李仁榮),49,4,53,1
4256,구자근(具滋根),이장섭(李將燮),49,5,54,1
4257,구자근(具滋根),이재명(李在明),25,4,29,1
4258,구자근(具滋根),이재정(李在汀),49,4,53,1
4259,구자근(具滋根),이정문(李楨文),49,7,56,1
4260,구자근(具滋根),이종배(李鍾培),134,245,379,0
4261,구자근(具滋根),이종성(李鍾成),133,286,419,0
4262,구자근(具滋根),이주환(李周桓),119,294,413,0
4263,구자근(具滋根),이채익(李埰益),98,167,265,0
4264,구자근(具滋根),이철규(李喆圭),124,173,297,0
4265,구자근(具滋根),이탄희(李誕熙),49,4,53,1
4266,구자근(具滋根),이태규(李泰珪),47,65,112,0
4267,구자근(具滋根),이학영(李學永),50,4,54,1
4268,구자근(具滋根),이해식(李海植),49,4,53,1
4269,구자근(具滋根),이헌승(李憲昇),78,220,298,0
4270,구자근(具滋根),이형석(李炯錫),49,5,54,1
4271,구자근(具滋根),인재근(印在謹),49,6,55,1
4272,구자근(具滋根),임병헌(林炳憲),37,85,122,0
4273,구자근(具滋根),임오경(林五卿),49,4,53,1
4274,구자근(具滋根),임이자(林利子),118,215,333,0
4275,구자근(具滋根),임종성(林鍾聲),50,5,55,1
4276,구자근(具滋根),임호선(林昊宣),49,8,57,1
4277,구자근(具滋根),장경태(張耿態),49,5,54,1
4278,구자근(具滋根),장동혁(張東赫),43,108,151,0
4279,구자근(具滋根),장제원(張濟元),78,57,135,0
4280,구자근(具滋根),장철민(張喆敏),49,4,53,1
4281,구자근(具滋根),장혜영(張惠英),6,9,15,1
4282,구자근(具滋根),전봉민(田奉珉),82,227,309,0
4283,구자근(具滋根),전용기(田溶冀),50,5,55,1
4284,구자근(具滋根),전재수(田載秀),49,4,53,1
4285,구자근(具滋根),전주혜(全珠惠),75,103,178,0
4286,구자근(具滋根),전해철(全海澈),50,4,54,1
4287,구자근(具滋根),전혜숙(全惠淑),49,7,56,1
4288,구자근(具滋根),정경희(丁慶姬),82,66,148,0
4289,구자근(具滋根),정동만(鄭東萬),90,182,272,0
4290,구자근(具滋根),정성호(鄭成湖),50,6,56,1
4291,구자근(具滋根),정우택(鄭宇澤),59,110,169,0
4292,구자근(具滋根),정운천(鄭雲天),119,206,325,0
4293,구자근(具滋根),정일영(鄭日永),49,5,54,1
4294,구자근(具滋根),정점식(鄭点植),70,81,151,0
4295,구자근(具滋根),정진석(鄭鎭碩),91,144,235,0
4296,구자근(具滋根),정청래(鄭淸來),51,4,55,1
4297,구자근(具滋根),정춘숙(鄭春淑),49,4,53,1
4298,구자근(具滋根),정태호(鄭泰浩),49,6,55,1
4299,구자근(具滋根),정필모(鄭必模),49,4,53,1
4300,구자근(具滋根),정희용(鄭熙溶),147,286,433,0
4301,구자근(具滋根),조경태(趙慶泰),94,126,220,0
4302,구자근(具滋根),조명희(曺明姬),112,218,330,0
4303,구자근(具滋根),조수진(趙修眞),98,182,280,0
4304,구자근(具滋根),조승래(趙承來),49,6,55,1
4305,구자근(具滋根),조오섭(曺五燮),49,5,54,1
4306,구자근(具滋根),조은희(趙恩禧),39,49,88,0
4307,구자근(具滋根),조응천(趙應天),49,4,53,1
4308,구자근(具滋根),조정식(趙正湜),49,3,52,1
4309,구자근(具滋根),조정훈(趙廷訓),1,14,15,1
4310,구자근(具滋根),조해진(曺海珍),65,53,118,0
4311,구자근(具滋根),주철현(朱哲鉉),50,5,55,1
4312,구자근(具滋根),주호영(朱豪英),76,113,189,0
4313,구자근(具滋根),지성호(池成浩),106,221,327,0
4314,구자근(具滋根),진선미(陳善美),49,4,53,1
4315,구자근(具滋根),진성준(陳聲準),49,4,53,1
4316,구자근(具滋根),천준호(千俊鎬),49,3,52,1
4317,구자근(具滋根),최기상(崔基相),49,4,53,1
4318,구자근(具滋根),최승재(崔承宰),98,138,236,0
4319,구자근(具滋根),최연숙(崔姸淑),38,55,93,0
4320,구자근(具滋根),최영희(崔英姬),46,116,162,0
4321,구자근(具滋根),최인호(崔仁昊),50,5,55,1
4322,구자근(具滋根),최재형(崔在亨),31,27,58,0
4323,구자근(具滋根),최종윤(崔鍾允),49,4,53,1
4324,구자근(具滋根),최춘식(崔春植),137,257,394,0
4325,구자근(具滋根),최형두(崔炯斗),128,199,327,0
4326,구자근(具滋根),최혜영(崔惠英),50,17,67,1
4327,구자근(具滋根),추경호(秋慶鎬),141,261,402,0
4328,구자근(具滋根),태영호(太永浩),127,289,416,0
4329,구자근(具滋根),하영제(河榮帝),92,152,244,1
4330,구자근(具滋根),하태경(河泰慶),68,68,136,0
4331,구자근(具滋根),한기호(韓起鎬),81,85,166,0
4332,구자근(具滋根),한무경(韓茂景),112,178,290,0
4333,구자근(具滋根),한병도(韓秉道),50,7,57,1
4334,구자근(具滋根),한정애(韓貞愛),49,6,55,1
4335,구자근(具滋根),한준호(韓俊鎬),50,4,54,1
4336,구자근(具滋根),허숙정(許淑湞),0,0,0,1
4337,구자근(具滋根),허영(許榮),52,4,56,1
4338,구자근(具滋根),허은아(許垠娥),78,105,183,0
4339,구자근(具滋根),허종식(許琮植),53,13,66,1
4340,구자근(具滋根),홍기원(洪起元),49,4,53,1
4341,구자근(具滋根),홍문표(洪文杓),75,111,186,0
4342,구자근(具滋根),홍석준(洪碩晙),90,105,195,0
4343,구자근(具滋根),홍성국(洪性國),49,5,54,1
4344,구자근(具滋根),홍영표(洪永杓),49,4,53,1
4345,구자근(具滋根),홍익표(洪翼杓),49,4,53,1
4346,구자근(具滋根),홍정민(洪貞敏),49,4,53,1
4347,구자근(具滋根),황보승희(皇甫承希),82,181,263,1
4348,구자근(具滋根),황운하(黃雲夏),49,7,56,1
4349,구자근(具滋根),황희(黃熙),49,5,54,1
4350,권명호(權明浩),권성동(權性東),94,146,240,0
4351,권명호(權明浩),권영세(權寧世),81,89,170,0
4352,권명호(權明浩),권은희(權垠希),42,31,73,0
4353,권명호(權明浩),권인숙(權仁淑),51,4,55,1
4354,권명호(權明浩),권칠승(權七勝),52,6,58,1
4355,권명호(權明浩),기동민(奇東旻),51,3,54,1
4356,권명호(權明浩),김경만(金京萬),52,5,57,1
4357,권명호(權明浩),김경협(金炅俠),51,4,55,1
4358,권명호(權明浩),김교흥(金敎興),51,4,55,1
4359,권명호(權明浩),김기현(金起炫),120,162,282,0
4360,권명호(權明浩),김남국(金南局),43,1,44,1
4361,권명호(權明浩),김도읍(金度邑),123,209,332,0
4362,권명호(權明浩),김두관(金斗官),51,6,57,1
4363,권명호(權明浩),김미애(金美愛),88,125,213,0
4364,권명호(權明浩),김민기(金敏基),52,4,56,1
4365,권명호(權明浩),김민석(金民錫),52,13,65,1
4366,권명호(權明浩),김민철(金敏徹),51,6,57,1
4367,권명호(權明浩),김병기(金炳基),54,5,59,1
4368,권명호(權明浩),김병욱A(金炳旭),51,12,63,1
4369,권명호(權明浩),김병욱B(金炳旭),137,187,324,0
4370,권명호(權明浩),김병주(金柄周),54,3,57,1
4371,권명호(權明浩),김상훈(金相勳),103,142,245,0
4372,권명호(權明浩),김상희(金相姬),52,5,57,1
4373,권명호(權明浩),김석기(金碩基),146,284,430,0
4374,권명호(權明浩),김성원(金成願),183,317,500,0
4375,권명호(權明浩),김성주(金成柱),51,5,56,1
4376,권명호(權明浩),김성환(金星煥),51,4,55,1
4377,권명호(權明浩),김수흥(金洙興),52,4,56,1
4378,권명호(權明浩),김승남(金承南),51,5,56,1
4379,권명호(權明浩),김승수(金承洙),114,186,300,0
4380,권명호(權明浩),김승원(金勝源),51,4,55,1
4381,권명호(權明浩),김영배(金永培),52,5,57,1
4382,권명호(權明浩),김영선(金映宣),28,32,60,0
4383,권명호(權明浩),김영식(金英植),167,300,467,0
4384,권명호(權明浩),김영주(金榮珠),51,4,55,1
4385,권명호(權明浩),김영진(金榮鎭),52,9,61,1
4386,권명호(權明浩),김영호(金映豪),51,4,55,1
4387,권명호(權明浩),김예지(金睿智),116,253,369,0
4388,권명호(權明浩),김용민(金容民),51,4,55,1
4389,권명호(權明浩),김용판(金用判),153,351,504,0
4390,권명호(權明浩),김웅(金雄),80,62,142,0
4391,권명호(權明浩),김원이(金元二),51,4,55,1
4392,권명호(權明浩),김윤덕(金潤德),51,4,55,1
4393,권명호(權明浩),김의겸(金宜謙),26,4,30,1
4394,권명호(權明浩),김정재(金汀才),159,277,436,0
4395,권명호(權明浩),김정호(金禎鎬),52,5,57,1
4396,권명호(權明浩),김종민(金鐘民),51,6,57,1
4397,권명호(權明浩),김주영(金周暎),52,6,58,1
4398,권명호(權明浩),김진표(金振杓),25,2,27,1
4399,권명호(權明浩),김철민(金哲玟),50,3,53,1
4400,권명호(權明浩),김태년(金太年),50,5,55,1
4401,권명호(權明浩),김태호(金台鎬),77,104,181,0
4402,권명호(權明浩),김학용(金學容),43,110,153,0
4403,권명호(權明浩),김한규(金翰奎),25,6,31,1
4404,권명호(權明浩),김한정(金漢正),50,4,54,1
4405,권명호(權明浩),김형동(金亨東),135,194,329,0
4406,권명호(權明浩),김홍걸(金弘傑),14,7,21,1
4407,권명호(權明浩),김회재(金會在),51,4,55,1
4408,권명호(權明浩),김희곤(金熙坤),94,208,302,0
4409,권명호(權明浩),김희국(金熙國),97,116,213,0
4410,권명호(權明浩),남인순(南仁順),49,6,55,1
4411,권명호(權明浩),노용호(魯容昊),40,68,108,0
4412,권명호(權明浩),노웅래(盧雄來),50,4,54,1
4413,권명호(權明浩),도종환(都鍾煥),49,5,54,1
4414,권명호(權明浩),류성걸(柳性杰),82,103,185,0
4415,권명호(權明浩),류호정(柳好貞),4,8,12,1
4416,권명호(權明浩),맹성규(孟聖奎),49,4,53,1
4417,권명호(權明浩),문정복(文貞福),49,5,54,1
4418,권명호(權明浩),문진석(文振碩),49,8,57,1
4419,권명호(權明浩),민병덕(閔炳德),50,8,58,1
4420,권명호(權明浩),민형배(閔馨培),33,5,38,1
4421,권명호(權明浩),민홍철(閔洪喆),49,4,53,1
4422,권명호(權明浩),박광온(朴洸瑥),49,4,53,1
4423,권명호(權明浩),박대수(朴大壽),171,343,514,0
4424,권명호(權明浩),박대출(朴大出),84,125,209,0
4425,권명호(權明浩),박덕흠(朴德欽),105,218,323,0
4426,권명호(權明浩),박범계(朴範界),49,4,53,1
4427,권명호(權明浩),박병석(朴炳錫),25,3,28,1
4428,권명호(權明浩),박상혁(朴商赫),49,6,55,1
4429,권명호(權明浩),박성민(朴聖敏),122,252,374,0
4430,권명호(權明浩),박성준(朴省俊),50,5,55,1
4431,권명호(權明浩),박성중(朴成重),85,118,203,0
4432,권명호(權明浩),박수영(朴洙瑩),77,78,155,0
4433,권명호(權明浩),박영순(朴英淳),49,5,54,1
4434,권명호(權明浩),박완주(朴完柱),24,0,24,1
4435,권명호(權明浩),박용진(朴用鎭),49,6,55,1
4436,권명호(權明浩),박재호(朴在昊),50,5,55,1
4437,권명호(權明浩),박정(朴釘),49,6,55,1
4438,권명호(權明浩),박정하(朴正河),34,41,75,0
4439,권명호(權明浩),박주민(朴柱民),49,4,53,1
4440,권명호(權明浩),박진(朴振),75,103,178,0
4441,권명호(權明浩),박찬대(朴贊大),50,4,54,1
4442,권명호(權明浩),박형수(朴亨修),72,72,144,0
4443,권명호(權明浩),박홍근(朴洪根),51,5,56,1
4444,권명호(權明浩),배준영(裵俊英),92,129,221,0
4445,권명호(權明浩),배진교(裵晋敎),4,8,12,1
4446,권명호(權明浩),배현진(裵賢鎭),87,90,177,0
4447,권명호(權明浩),백종헌(白宗憲),101,246,347,0
4448,권명호(權明浩),백혜련(白惠蓮),49,5,54,1
4449,권명호(權明浩),변재일(卞在一),51,5,56,1
4450,권명호(權明浩),서동용(徐東榕),49,4,53,1
4451,권명호(權明浩),서범수(徐範洙),93,195,288,0
4452,권명호(權明浩),서병수(徐秉洙),91,148,239,0
4453,권명호(權明浩),서삼석(徐參錫),51,6,57,1
4454,권명호(權明浩),서영교(徐瑛敎),51,6,57,1
4455,권명호(權明浩),서영석(徐暎錫),52,7,59,1
4456,권명호(權明浩),서일준(徐一俊),144,226,370,0
4457,권명호(權明浩),서정숙(徐正淑),84,117,201,0
4458,권명호(權明浩),설훈(薛勳),51,7,58,1
4459,권명호(權明浩),성일종(成一鍾),99,176,275,0
4460,권명호(權明浩),소병철(蘇秉哲),50,6,56,1
4461,권명호(權明浩),소병훈(蘇秉勳),49,4,53,1
4462,권명호(權明浩),송갑석(宋甲錫),49,5,54,1
4463,권명호(權明浩),송기헌(宋基憲),49,9,58,1
4464,권명호(權明浩),송석준(宋錫俊),85,111,196,0
4465,권명호(權明浩),송언석(宋彦錫),156,229,385,0
4466,권명호(權明浩),송옥주(宋玉珠),49,4,53,1
4467,권명호(權明浩),송재호(宋在祜),50,4,54,1
4468,권명호(權明浩),신동근(申東根),49,7,56,1
4469,권명호(權明浩),신영대(申榮大),49,4,53,1
4470,권명호(權明浩),신원식(申源湜),92,131,223,0
4471,권명호(權明浩),신정훈(辛正勳),50,5,55,1
4472,권명호(權明浩),신현영(申賢榮),49,4,53,1
4473,권명호(權明浩),심상정(沈相奵),5,3,8,1
4474,권명호(權明浩),안규백(安圭伯),54,12,66,1
4475,권명호(權明浩),안민석(安敏錫),51,4,55,1
4476,권명호(權明浩),안병길(安炳吉),115,261,376,0
4477,권명호(權明浩),안철수(安哲秀),27,24,51,0
4478,권명호(權明浩),안호영(安浩永),49,4,53,1
4479,권명호(權明浩),양경숙(梁敬淑),49,4,53,1
4480,권명호(權明浩),양금희(梁琴喜),143,244,387,0
4481,권명호(權明浩),양기대(梁基大),49,4,53,1
4482,권명호(權明浩),양이원영(梁李媛瑛),45,4,49,1
4483,권명호(權明浩),양정숙(梁貞淑),2,4,6,1
4484,권명호(權明浩),양향자(梁香子),22,10,32,1
4485,권명호(權明浩),어기구(魚基龜),49,4,53,1
4486,권명호(權明浩),엄태영(嚴泰永),133,192,325,0
4487,권명호(權明浩),오기형(吳奇炯),49,4,53,1
4488,권명호(權明浩),오영환(吳永煥),49,7,56,1
4489,권명호(權明浩),용혜인(龍慧仁),2,8,10,1
4490,권명호(權明浩),우상호(禹相虎),49,4,53,1
4491,권명호(權明浩),우원식(禹元植),49,4,53,1
4492,권명호(權明浩),위성곤(魏聖坤),50,8,58,1
4493,권명호(權明浩),유경준(兪京濬),96,127,223,0
4494,권명호(權明浩),유기홍(柳基洪),49,4,53,1
4495,권명호(權明浩),유동수(柳東秀),50,7,57,1
4496,권명호(權明浩),유상범(劉相凡),101,132,233,0
4497,권명호(權明浩),유의동(兪義東),76,83,159,0
4498,권명호(權明浩),유정주(兪訂炷),49,6,55,1
4499,권명호(權明浩),윤건영(尹建永),49,4,53,1
4500,권명호(權明浩),윤관석(尹官石),40,0,40,1
4501,권명호(權明浩),윤두현(尹斗鉉),102,183,285,0
4502,권명호(權明浩),윤미향(尹美香),20,0,20,1
4503,권명호(權明浩),윤상현(尹相現),39,61,100,0
4504,권명호(權明浩),윤영덕(尹永德),49,4,53,1
4505,권명호(權明浩),윤영석(尹永碩),119,151,270,0
4506,권명호(權明浩),윤영찬(尹永燦),49,5,54,1
4507,권명호(權明浩),윤재갑(尹才鉀),51,6,57,1
4508,권명호(權明浩),윤재옥(尹在玉),93,87,180,0
4509,권명호(權明浩),윤주경(尹柱卿),81,101,182,0
4510,권명호(權明浩),윤준병(尹準炳),49,4,53,1
4511,권명호(權明浩),윤창현(尹暢賢),139,195,334,0
4512,권명호(權明浩),윤한홍(尹漢洪),82,131,213,0
4513,권명호(權明浩),윤호중(尹昊重),50,5,55,1
4514,권명호(權明浩),윤후덕(尹厚德),49,4,53,1
4515,권명호(權明浩),이개호(李介昊),49,5,54,1
4516,권명호(權明浩),이달곤(李達坤),68,122,190,0
4517,권명호(權明浩),이동주(李東洲),49,4,53,1
4518,권명호(權明浩),이만희(李晩熙),116,132,248,0
4519,권명호(權明浩),이명수(李明洙),131,178,309,0
4520,권명호(權明浩),이병훈(李炳勳),51,8,59,1
4521,권명호(權明浩),이상민(李相珉),49,4,53,1
4522,권명호(權明浩),이상헌(李相憲),50,14,64,1
4523,권명호(權明浩),이성만(李成萬),40,0,40,1
4524,권명호(權明浩),이소영(李素永),50,4,54,1
4525,권명호(權明浩),이수진(李壽珍),49,4,53,1
4526,권명호(權明浩),이수진(李秀眞),49,5,54,1
4527,권명호(權明浩),이양수(李亮壽),97,131,228,0
4528,권명호(權明浩),이용(李鏞),110,176,286,0
4529,권명호(權明浩),이용빈(李龍彬),49,8,57,1
4530,권명호(權明浩),이용선(李庸瑄),49,5,54,1
4531,권명호(權明浩),이용우(李龍雨),49,6,55,1
4532,권명호(權明浩),이용호(李容鎬),29,38,67,0
4533,권명호(權明浩),이원욱(李元旭),50,5,55,1
4534,권명호(權明浩),이원택(李源澤),49,4,53,1
4535,권명호(權明浩),이은주(李恩周),4,4,8,1
4536,권명호(權明浩),이인선(李仁善),34,59,93,0
4537,권명호(權明浩),이인영(李仁榮),49,4,53,1
4538,권명호(權明浩),이장섭(李將燮),49,5,54,1
4539,권명호(權明浩),이재명(李在明),25,4,29,1
4540,권명호(權明浩),이재정(李在汀),49,4,53,1
4541,권명호(權明浩),이정문(李楨文),49,4,53,1
4542,권명호(權明浩),이종배(李鍾培),113,179,292,0
4543,권명호(權明浩),이종성(李鍾成),180,283,463,0
4544,권명호(權明浩),이주환(李周桓),143,312,455,0
4545,권명호(權明浩),이채익(李埰益),104,183,287,0
4546,권명호(權明浩),이철규(李喆圭),124,171,295,0
4547,권명호(權明浩),이탄희(李誕熙),49,4,53,1
4548,권명호(權明浩),이태규(李泰珪),56,67,123,0
4549,권명호(權明浩),이학영(李學永),49,4,53,1
4550,권명호(權明浩),이해식(李海植),50,4,54,1
4551,권명호(權明浩),이헌승(李憲昇),85,191,276,0
4552,권명호(權明浩),이형석(李炯錫),49,4,53,1
4553,권명호(權明浩),인재근(印在謹),49,5,54,1
4554,권명호(權明浩),임병헌(林炳憲),36,59,95,0
4555,권명호(權明浩),임오경(林五卿),49,4,53,1
4556,권명호(權明浩),임이자(林利子),178,249,427,0
4557,권명호(權明浩),임종성(林鍾聲),50,6,56,1
4558,권명호(權明浩),임호선(林昊宣),49,5,54,1
4559,권명호(權明浩),장경태(張耿態),49,4,53,1
4560,권명호(權明浩),장동혁(張東赫),30,57,87,0
4561,권명호(權明浩),장제원(張濟元),64,49,113,0
4562,권명호(權明浩),장철민(張喆敏),49,4,53,1
4563,권명호(權明浩),장혜영(張惠英),6,7,13,1
4564,권명호(權明浩),전봉민(田奉珉),75,198,273,0
4565,권명호(權明浩),전용기(田溶冀),50,9,59,1
4566,권명호(權明浩),전재수(田載秀),49,4,53,1
4567,권명호(權明浩),전주혜(全珠惠),92,140,232,0
4568,권명호(權明浩),전해철(全海澈),51,4,55,1
4569,권명호(權明浩),전혜숙(全惠淑),49,6,55,1
4570,권명호(權明浩),정경희(丁慶姬),97,112,209,0
4571,권명호(權明浩),정동만(鄭東萬),96,161,257,0
4572,권명호(權明浩),정성호(鄭成湖),53,8,61,1
4573,권명호(權明浩),정우택(鄭宇澤),40,84,124,0
4574,권명호(權明浩),정운천(鄭雲天),143,193,336,0
4575,권명호(權明浩),정일영(鄭日永),50,6,56,1
4576,권명호(權明浩),정점식(鄭点植),87,89,176,0
4577,권명호(權明浩),정진석(鄭鎭碩),115,189,304,0
4578,권명호(權明浩),정청래(鄭淸來),49,4,53,1
4579,권명호(權明浩),정춘숙(鄭春淑),49,6,55,1
4580,권명호(權明浩),정태호(鄭泰浩),49,5,54,1
4581,권명호(權明浩),정필모(鄭必模),49,4,53,1
4582,권명호(權明浩),정희용(鄭熙溶),143,250,393,0
4583,권명호(權明浩),조경태(趙慶泰),83,110,193,0
4584,권명호(權明浩),조명희(曺明姬),98,165,263,0
4585,권명호(權明浩),조수진(趙修眞),100,181,281,0
4586,권명호(權明浩),조승래(趙承來),49,6,55,1
4587,권명호(權明浩),조오섭(曺五燮),49,5,54,1
4588,권명호(權明浩),조은희(趙恩禧),37,42,79,0
4589,권명호(權明浩),조응천(趙應天),50,6,56,1
4590,권명호(權明浩),조정식(趙正湜),49,3,52,1
4591,권명호(權明浩),조정훈(趙廷訓),0,8,8,1
4592,권명호(權明浩),조해진(曺海珍),64,46,110,0
4593,권명호(權明浩),주철현(朱哲鉉),50,7,57,1
4594,권명호(權明浩),주호영(朱豪英),78,59,137,0
4595,권명호(權明浩),지성호(池成浩),111,210,321,0
4596,권명호(權明浩),진선미(陳善美),49,4,53,1
4597,권명호(權明浩),진성준(陳聲準),49,4,53,1
4598,권명호(權明浩),천준호(千俊鎬),49,3,52,1
4599,권명호(權明浩),최기상(崔基相),49,4,53,1
4600,권명호(權明浩),최승재(崔承宰),120,188,308,0
4601,권명호(權明浩),최연숙(崔姸淑),42,51,93,0
4602,권명호(權明浩),최영희(崔英姬),37,88,125,0
4603,권명호(權明浩),최인호(崔仁昊),50,5,55,1
4604,권명호(權明浩),최재형(崔在亨),30,18,48,0
4605,권명호(權明浩),최종윤(崔鍾允),49,4,53,1
4606,권명호(權明浩),최춘식(崔春植),115,197,312,0
4607,권명호(權明浩),최형두(崔炯斗),150,252,402,0
4608,권명호(權明浩),최혜영(崔惠英),50,13,63,1
4609,권명호(權明浩),추경호(秋慶鎬),148,238,386,0
4610,권명호(權明浩),태영호(太永浩),131,266,397,0
4611,권명호(權明浩),하영제(河榮帝),115,179,294,1
4612,권명호(權明浩),하태경(河泰慶),75,64,139,0
4613,권명호(權明浩),한기호(韓起鎬),79,105,184,0
4614,권명호(權明浩),한무경(韓茂景),141,216,357,0
4615,권명호(權明浩),한병도(韓秉道),49,6,55,1
4616,권명호(權明浩),한정애(韓貞愛),49,5,54,1
4617,권명호(權明浩),한준호(韓俊鎬),51,4,55,1
4618,권명호(權明浩),허숙정(許淑湞),0,0,0,1
4619,권명호(權明浩),허영(許榮),51,10,61,1
4620,권명호(權明浩),허은아(許垠娥),96,109,205,0
4621,권명호(權明浩),허종식(許琮植),50,7,57,1
4622,권명호(權明浩),홍기원(洪起元),49,4,53,1
4623,권명호(權明浩),홍문표(洪文杓),86,98,184,0
4624,권명호(權明浩),홍석준(洪碩晙),71,84,155,0
4625,권명호(權明浩),홍성국(洪性國),49,5,54,1
4626,권명호(權明浩),홍영표(洪永杓),49,4,53,1
4627,권명호(權明浩),홍익표(洪翼杓),49,4,53,1
4628,권명호(權明浩),홍정민(洪貞敏),49,5,54,1
4629,권명호(權明浩),황보승희(皇甫承希),87,155,242,1
4630,권명호(權明浩),황운하(黃雲夏),49,7,56,1
4631,권명호(權明浩),황희(黃熙),49,7,56,1
4632,권성동(權性東),권영세(權寧世),64,57,121,0
4633,권성동(權性東),권은희(權垠希),39,28,67,0
4634,권성동(權性東),권인숙(權仁淑),43,4,47,1
4635,권성동(權性東),권칠승(權七勝),44,4,48,1
4636,권성동(權性東),기동민(奇東旻),43,3,46,1
4637,권성동(權性東),김경만(金京萬),46,4,50,1
4638,권성동(權性東),김경협(金炅俠),42,4,46,1
4639,권성동(權性東),김교흥(金敎興),44,3,47,1
4640,권성동(權性東),김기현(金起炫),73,71,144,0
4641,권성동(權性東),김남국(金南局),36,1,37,1
4642,권성동(權性東),김도읍(金度邑),67,68,135,0
4643,권성동(權性東),김두관(金斗官),44,5,49,1
4644,권성동(權性東),김미애(金美愛),63,57,120,0
4645,권성동(權性東),김민기(金敏基),43,4,47,1
4646,권성동(權性東),김민석(金民錫),43,4,47,1
4647,권성동(權性東),김민철(金敏徹),43,5,48,1
4648,권성동(權性東),김병기(金炳基),45,6,51,1
4649,권성동(權性東),김병욱A(金炳旭),43,4,47,1
4650,권성동(權性東),김병욱B(金炳旭),71,105,176,0
4651,권성동(權性東),김병주(金柄周),45,3,48,1
4652,권성동(權性東),김상훈(金相勳),75,70,145,0
4653,권성동(權性東),김상희(金相姬),42,4,46,1
4654,권성동(權性東),김석기(金碩基),87,99,186,0
4655,권성동(權性東),김성원(金成願),80,95,175,0
4656,권성동(權性東),김성주(金成柱),43,4,47,1
4657,권성동(權性東),김성환(金星煥),43,5,48,1
4658,권성동(權性東),김수흥(金洙興),43,4,47,1
4659,권성동(權性東),김승남(金承南),43,4,47,1
4660,권성동(權性東),김승수(金承洙),77,98,175,0
4661,권성동(權性東),김승원(金勝源),43,4,47,1
4662,권성동(權性東),김영배(金永培),44,4,48,1
4663,권성동(權性東),김영선(金映宣),28,37,65,0
4664,권성동(權性東),김영식(金英植),95,130,225,0
4665,권성동(權性東),김영주(金榮珠),44,5,49,1
4666,권성동(權性東),김영진(金榮鎭),44,3,47,1
4667,권성동(權性東),김영호(金映豪),42,4,46,1
4668,권성동(權性東),김예지(金睿智),91,114,205,0
4669,권성동(權性東),김용민(金容民),43,4,47,1
4670,권성동(權性東),김용판(金用判),97,129,226,0
4671,권성동(權性東),김웅(金雄),58,40,98,0
4672,권성동(權性東),김원이(金元二),43,4,47,1
4673,권성동(權性東),김윤덕(金潤德),44,3,47,1
4674,권성동(權性東),김의겸(金宜謙),26,7,33,1
4675,권성동(權性東),김정재(金汀才),81,68,149,0
4676,권성동(權性東),김정호(金禎鎬),43,5,48,1
4677,권성동(權性東),김종민(金鐘民),43,4,47,1
4678,권성동(權性東),김주영(金周暎),44,4,48,1
4679,권성동(權性東),김진표(金振杓),17,2,19,1
4680,권성동(權性東),김철민(金哲玟),43,3,46,1
4681,권성동(權性東),김태년(金太年),41,4,45,1
4682,권성동(權性東),김태호(金台鎬),60,72,132,0
4683,권성동(權性東),김학용(金學容),31,21,52,0
4684,권성동(權性東),김한규(金翰奎),25,6,31,1
4685,권성동(權性東),김한정(金漢正),41,4,45,1
4686,권성동(權性東),김형동(金亨東),68,83,151,0
4687,권성동(權性東),김홍걸(金弘傑),6,4,10,1
4688,권성동(權性東),김회재(金會在),44,4,48,1
4689,권성동(權性東),김희곤(金熙坤),64,102,166,0
4690,권성동(權性東),김희국(金熙國),65,61,126,0
4691,권성동(權性東),남인순(南仁順),41,4,45,1
4692,권성동(權性東),노용호(魯容昊),39,43,82,0
4693,권성동(權性東),노웅래(盧雄來),42,3,45,1
4694,권성동(權性東),도종환(都鍾煥),41,5,46,1
4695,권성동(權性東),류성걸(柳性杰),74,82,156,0
4696,권성동(權性東),류호정(柳好貞),4,5,9,1
4697,권성동(權性東),맹성규(孟聖奎),41,5,46,1
4698,권성동(權性東),문정복(文貞福),40,4,44,1
4699,권성동(權性東),문진석(文振碩),41,5,46,1
4700,권성동(權性東),민병덕(閔炳德),41,5,46,1
4701,권성동(權性東),민형배(閔馨培),25,5,30,1
4702,권성동(權性東),민홍철(閔洪喆),41,4,45,1
4703,권성동(權性東),박광온(朴洸瑥),42,4,46,1
4704,권성동(權性東),박대수(朴大壽),90,160,250,0
4705,권성동(權性東),박대출(朴大出),52,46,98,0
4706,권성동(權性東),박덕흠(朴德欽),75,128,203,0
4707,권성동(權性東),박범계(朴範界),42,4,46,1
4708,권성동(權性東),박병석(朴炳錫),25,3,28,1
4709,권성동(權性東),박상혁(朴商赫),41,4,45,1
4710,권성동(權性東),박성민(朴聖敏),62,85,147,0
4711,권성동(權性東),박성준(朴省俊),42,6,48,1
4712,권성동(權性東),박성중(朴成重),67,85,152,0
4713,권성동(權性東),박수영(朴洙瑩),58,46,104,0
4714,권성동(權性東),박영순(朴英淳),42,3,45,1
4715,권성동(權性東),박완주(朴完柱),16,0,16,1
4716,권성동(權性東),박용진(朴用鎭),40,4,44,1
4717,권성동(權性東),박재호(朴在昊),42,4,46,1
4718,권성동(權性東),박정(朴釘),44,4,48,1
4719,권성동(權性東),박정하(朴正河),42,44,86,0
4720,권성동(權性東),박주민(朴柱民),41,4,45,1
4721,권성동(權性東),박진(朴振),66,58,124,0
4722,권성동(權性東),박찬대(朴贊大),42,4,46,1
4723,권성동(權性東),박형수(朴亨修),54,53,107,0
4724,권성동(權性東),박홍근(朴洪根),42,5,47,1
4725,권성동(權性東),배준영(裵俊英),67,55,122,0
4726,권성동(權性東),배진교(裵晋敎),5,3,8,1
4727,권성동(權性東),배현진(裵賢鎭),68,61,129,0
4728,권성동(權性東),백종헌(白宗憲),63,111,174,0
4729,권성동(權性東),백혜련(白惠蓮),42,4,46,1
4730,권성동(權性東),변재일(卞在一),41,5,46,1
4731,권성동(權性東),서동용(徐東榕),41,4,45,1
4732,권성동(權性東),서범수(徐範洙),66,81,147,0
4733,권성동(權性東),서병수(徐秉洙),73,79,152,0
4734,권성동(權性東),서삼석(徐參錫),46,9,55,1
4735,권성동(權性東),서영교(徐瑛敎),43,5,48,1
4736,권성동(權性東),서영석(徐暎錫),40,4,44,1
4737,권성동(權性東),서일준(徐一俊),107,131,238,0
4738,권성동(權性東),서정숙(徐正淑),76,69,145,0
4739,권성동(權性東),설훈(薛勳),41,5,46,1
4740,권성동(權性東),성일종(成一鍾),94,106,200,0
4741,권성동(權性東),소병철(蘇秉哲),43,4,47,1
4742,권성동(權性東),소병훈(蘇秉勳),43,4,47,1
4743,권성동(權性東),송갑석(宋甲錫),42,5,47,1
4744,권성동(權性東),송기헌(宋基憲),47,12,59,1
4745,권성동(權性東),송석준(宋錫俊),65,73,138,0
4746,권성동(權性東),송언석(宋彦錫),69,72,141,0
4747,권성동(權性東),송옥주(宋玉珠),41,4,45,1
4748,권성동(權性東),송재호(宋在祜),42,4,46,1
4749,권성동(權性東),신동근(申東根),41,3,44,1
4750,권성동(權性東),신영대(申榮大),41,4,45,1
4751,권성동(權性東),신원식(申源湜),61,54,115,0
4752,권성동(權性東),신정훈(辛正勳),44,6,50,1
4753,권성동(權性東),신현영(申賢榮),41,4,45,1
4754,권성동(權性東),심상정(沈相奵),5,2,7,1
4755,권성동(權性東),안규백(安圭伯),44,12,56,1
4756,권성동(權性東),안민석(安敏錫),43,4,47,1
4757,권성동(權性東),안병길(安炳吉),80,106,186,0
4758,권성동(權性東),안철수(安哲秀),29,17,46,0
4759,권성동(權性東),안호영(安浩永),41,4,45,1
4760,권성동(權性東),양경숙(梁敬淑),41,4,45,1
4761,권성동(權性東),양금희(梁琴喜),83,118,201,0
4762,권성동(權性東),양기대(梁基大),41,5,46,1
4763,권성동(權性東),양이원영(梁李媛瑛),36,4,40,1
4764,권성동(權性東),양정숙(梁貞淑),2,2,4,1
4765,권성동(權性東),양향자(梁香子),14,4,18,1
4766,권성동(權性東),어기구(魚基龜),41,8,49,1
4767,권성동(權性東),엄태영(嚴泰永),83,99,182,0
4768,권성동(權性東),오기형(吳奇炯),40,4,44,1
4769,권성동(權性東),오영환(吳永煥),41,6,47,1
4770,권성동(權性東),용혜인(龍慧仁),1,2,3,1
4771,권성동(權性東),우상호(禹相虎),42,4,46,1
4772,권성동(權性東),우원식(禹元植),41,4,45,1
4773,권성동(權性東),위성곤(魏聖坤),43,6,49,1
4774,권성동(權性東),유경준(兪京濬),68,87,155,0
4775,권성동(權性東),유기홍(柳基洪),41,4,45,1
4776,권성동(權性東),유동수(柳東秀),42,5,47,1
4777,권성동(權性東),유상범(劉相凡),67,74,141,0
4778,권성동(權性東),유의동(兪義東),65,66,131,0
4779,권성동(權性東),유정주(兪訂炷),41,4,45,1
4780,권성동(權性東),윤건영(尹建永),40,4,44,1
4781,권성동(權性東),윤관석(尹官石),32,0,32,1
4782,권성동(權性東),윤두현(尹斗鉉),77,105,182,0
4783,권성동(權性東),윤미향(尹美香),11,0,11,1
4784,권성동(權性東),윤상현(尹相現),47,53,100,0
4785,권성동(權性東),윤영덕(尹永德),40,7,47,1
4786,권성동(權性東),윤영석(尹永碩),62,65,127,0
4787,권성동(權性東),윤영찬(尹永燦),41,4,45,1
4788,권성동(權性東),윤재갑(尹才鉀),42,9,51,1
4789,권성동(權性東),윤재옥(尹在玉),59,58,117,0
4790,권성동(權性東),윤주경(尹柱卿),68,64,132,0
4791,권성동(權性東),윤준병(尹準炳),42,5,47,1
4792,권성동(權性東),윤창현(尹暢賢),105,141,246,0
4793,권성동(權性東),윤한홍(尹漢洪),86,110,196,0
4794,권성동(權性東),윤호중(尹昊重),43,4,47,1
4795,권성동(權性東),윤후덕(尹厚德),41,5,46,1
4796,권성동(權性東),이개호(李介昊),46,5,51,1
4797,권성동(權性東),이달곤(李達坤),54,55,109,0
4798,권성동(權性東),이동주(李東洲),40,4,44,1
4799,권성동(權性東),이만희(李晩熙),78,59,137,0
4800,권성동(權性東),이명수(李明洙),75,107,182,0
4801,권성동(權性東),이병훈(李炳勳),45,5,50,1
4802,권성동(權性東),이상민(李相珉),41,6,47,1
4803,권성동(權性東),이상헌(李相憲),42,5,47,1
4804,권성동(權性東),이성만(李成萬),32,0,32,1
4805,권성동(權性東),이소영(李素永),42,5,47,1
4806,권성동(權性東),이수진(李壽珍),41,4,45,1
4807,권성동(權性東),이수진(李秀眞),41,4,45,1
4808,권성동(權性東),이양수(李亮壽),83,80,163,0
4809,권성동(權性東),이용(李鏞),77,99,176,0
4810,권성동(權性東),이용빈(李龍彬),43,4,47,1
4811,권성동(權性東),이용선(李庸瑄),41,4,45,1
4812,권성동(權性東),이용우(李龍雨),40,4,44,1
4813,권성동(權性東),이용호(李容鎬),31,16,47,0
4814,권성동(權性東),이원욱(李元旭),42,4,46,1
4815,권성동(權性東),이원택(李源澤),41,4,45,1
4816,권성동(權性東),이은주(李恩周),5,3,8,1
4817,권성동(權性東),이인선(李仁善),38,51,89,0
4818,권성동(權性東),이인영(李仁榮),41,4,45,1
4819,권성동(權性東),이장섭(李將燮),41,4,45,1
4820,권성동(權性東),이재명(李在明),25,4,29,1
4821,권성동(權性東),이재정(李在汀),41,4,45,1
4822,권성동(權性東),이정문(李楨文),41,8,49,1
4823,권성동(權性東),이종배(李鍾培),84,98,182,0
4824,권성동(權性東),이종성(李鍾成),88,104,192,0
4825,권성동(權性東),이주환(李周桓),66,69,135,0
4826,권성동(權性東),이채익(李埰益),61,63,124,0
4827,권성동(權性東),이철규(李喆圭),102,118,220,0
4828,권성동(權性東),이탄희(李誕熙),41,4,45,1
4829,권성동(權性東),이태규(李泰珪),46,48,94,0
4830,권성동(權性東),이학영(李學永),40,4,44,1
4831,권성동(權性東),이해식(李海植),42,4,46,1
4832,권성동(權性東),이헌승(李憲昇),59,61,120,0
4833,권성동(權性東),이형석(李炯錫),41,4,45,1
4834,권성동(權性東),인재근(印在謹),41,4,45,1
4835,권성동(權性東),임병헌(林炳憲),30,35,65,0
4836,권성동(權性東),임오경(林五卿),41,4,45,1
4837,권성동(權性東),임이자(林利子),81,97,178,0
4838,권성동(權性東),임종성(林鍾聲),43,4,47,1
4839,권성동(權性東),임호선(林昊宣),42,5,47,1
4840,권성동(權性東),장경태(張耿態),41,4,45,1
4841,권성동(權性東),장동혁(張東赫),29,27,56,0
4842,권성동(權性東),장제원(張濟元),55,44,99,0
4843,권성동(權性東),장철민(張喆敏),42,5,47,1
4844,권성동(權性東),장혜영(張惠英),6,2,8,1
4845,권성동(權性東),전봉민(田奉珉),39,54,93,0
4846,권성동(權性東),전용기(田溶冀),41,5,46,1
4847,권성동(權性東),전재수(田載秀),41,4,45,1
4848,권성동(權性東),전주혜(全珠惠),63,47,110,0
4849,권성동(權性東),전해철(全海澈),41,4,45,1
4850,권성동(權性東),전혜숙(全惠淑),41,5,46,1
4851,권성동(權性東),정경희(丁慶姬),58,65,123,0
4852,권성동(權性東),정동만(鄭東萬),57,48,105,0
4853,권성동(權性東),정성호(鄭成湖),45,5,50,1
4854,권성동(權性東),정우택(鄭宇澤),32,42,74,0
4855,권성동(權性東),정운천(鄭雲天),96,109,205,0
4856,권성동(權性東),정일영(鄭日永),40,4,44,1
4857,권성동(權性東),정점식(鄭点植),67,51,118,0
4858,권성동(權性東),정진석(鄭鎭碩),74,76,150,0
4859,권성동(權性東),정청래(鄭淸來),42,4,46,1
4860,권성동(權性東),정춘숙(鄭春淑),41,4,45,1
4861,권성동(權性東),정태호(鄭泰浩),41,4,45,1
4862,권성동(權性東),정필모(鄭必模),41,4,45,1
4863,권성동(權性東),정희용(鄭熙溶),79,111,190,0
4864,권성동(權性東),조경태(趙慶泰),75,75,150,0
4865,권성동(權性東),조명희(曺明姬),70,78,148,0
4866,권성동(權性東),조수진(趙修眞),65,73,138,0
4867,권성동(權性東),조승래(趙承來),41,4,45,1
4868,권성동(權性東),조오섭(曺五燮),42,5,47,1
4869,권성동(權性東),조은희(趙恩禧),41,55,96,0
4870,권성동(權性東),조응천(趙應天),41,3,44,1
4871,권성동(權性東),조정식(趙正湜),40,3,43,1
4872,권성동(權性東),조정훈(趙廷訓),0,3,3,1
4873,권성동(權性東),조해진(曺海珍),55,30,85,0
4874,권성동(權性東),주철현(朱哲鉉),47,6,53,1
4875,권성동(權性東),주호영(朱豪英),62,39,101,0
4876,권성동(權性東),지성호(池成浩),75,121,196,0
4877,권성동(權性東),진선미(陳善美),41,4,45,1
4878,권성동(權性東),진성준(陳聲準),41,5,46,1
4879,권성동(權性東),천준호(千俊鎬),40,3,43,1
4880,권성동(權性東),최기상(崔基相),41,4,45,1
4881,권성동(權性東),최승재(崔承宰),85,70,155,0
4882,권성동(權性東),최연숙(崔姸淑),38,40,78,0
4883,권성동(權性東),최영희(崔英姬),30,30,60,0
4884,권성동(權性東),최인호(崔仁昊),43,5,48,1
4885,권성동(權性東),최재형(崔在亨),27,18,45,0
4886,권성동(權性東),최종윤(崔鍾允),42,4,46,1
4887,권성동(權性東),최춘식(崔春植),76,75,151,0
4888,권성동(權性東),최형두(崔炯斗),75,73,148,0
4889,권성동(權性東),최혜영(崔惠英),41,5,46,1
4890,권성동(權性東),추경호(秋慶鎬),108,104,212,0
4891,권성동(權性東),태영호(太永浩),93,128,221,0
4892,권성동(權性東),하영제(河榮帝),72,68,140,1
4893,권성동(權性東),하태경(河泰慶),53,52,105,0
4894,권성동(權性東),한기호(韓起鎬),72,65,137,0
4895,권성동(權性東),한무경(韓茂景),106,135,241,0
4896,권성동(權性東),한병도(韓秉道),42,4,46,1
4897,권성동(權性東),한정애(韓貞愛),41,4,45,1
4898,권성동(權性東),한준호(韓俊鎬),41,4,45,1
4899,권성동(權性東),허숙정(許淑湞),0,0,0,1
4900,권성동(權性東),허영(許榮),45,12,57,1
4901,권성동(權性東),허은아(許垠娥),71,75,146,0
4902,권성동(權性東),허종식(許琮植),42,4,46,1
4903,권성동(權性東),홍기원(洪起元),42,6,48,1
4904,권성동(權性東),홍문표(洪文杓),82,94,176,0
4905,권성동(權性東),홍석준(洪碩晙),66,72,138,0
4906,권성동(權性東),홍성국(洪性國),41,5,46,1
4907,권성동(權性東),홍영표(洪永杓),41,4,45,1
4908,권성동(權性東),홍익표(洪翼杓),42,4,46,1
4909,권성동(權性東),홍정민(洪貞敏),42,4,46,1
4910,권성동(權性東),황보승희(皇甫承希),60,68,128,1
4911,권성동(權性東),황운하(黃雲夏),41,5,46,1
4912,권성동(權性東),황희(黃熙),40,4,44,1
4913,권영세(權寧世),권은희(權垠希),49,43,92,0
4914,권영세(權寧世),권인숙(權仁淑),51,11,62,1
4915,권영세(權寧世),권칠승(權七勝),52,4,56,1
4916,권영세(權寧世),기동민(奇東旻),52,4,56,1
4917,권영세(權寧世),김경만(金京萬),52,6,58,1
4918,권영세(權寧世),김경협(金炅俠),51,4,55,1
4919,권영세(權寧世),김교흥(金敎興),52,4,56,1
4920,권영세(權寧世),김기현(金起炫),86,80,166,0
4921,권영세(權寧世),김남국(金南局),43,2,45,1
4922,권영세(權寧世),김도읍(金度邑),78,60,138,0
4923,권영세(權寧世),김두관(金斗官),52,6,58,1
4924,권영세(權寧世),김미애(金美愛),66,54,120,0
4925,권영세(權寧世),김민기(金敏基),52,5,57,1
4926,권영세(權寧世),김민석(金民錫),53,14,67,1
4927,권영세(權寧世),김민철(金敏徹),54,7,61,1
4928,권영세(權寧世),김병기(金炳基),52,6,58,1
4929,권영세(權寧世),김병욱A(金炳旭),52,7,59,1
4930,권영세(權寧世),김병욱B(金炳旭),81,95,176,0
4931,권영세(權寧世),김병주(金柄周),52,4,56,1
4932,권영세(權寧世),김상훈(金相勳),71,62,133,0
4933,권영세(權寧世),김상희(金相姬),52,5,57,1
4934,권영세(權寧世),김석기(金碩基),75,83,158,0
4935,권영세(權寧世),김성원(金成願),103,108,211,0
4936,권영세(權寧世),김성주(金成柱),52,7,59,1
4937,권영세(權寧世),김성환(金星煥),52,6,58,1
4938,권영세(權寧世),김수흥(金洙興),53,5,58,1
4939,권영세(權寧世),김승남(金承南),52,4,56,1
4940,권영세(權寧世),김승수(金承洙),77,74,151,0
4941,권영세(權寧世),김승원(金勝源),52,5,57,1
4942,권영세(權寧世),김영배(金永培),52,7,59,1
4943,권영세(權寧世),김영선(金映宣),26,11,37,0
4944,권영세(權寧世),김영식(金英植),83,113,196,0
4945,권영세(權寧世),김영주(金榮珠),52,6,58,1
4946,권영세(權寧世),김영진(金榮鎭),51,4,55,1
4947,권영세(權寧世),김영호(金映豪),51,5,56,1
4948,권영세(權寧世),김예지(金睿智),77,73,150,0
4949,권영세(權寧世),김용민(金容民),52,5,57,1
4950,권영세(權寧世),김용판(金用判),90,120,210,0
4951,권영세(權寧世),김웅(金雄),76,48,124,0
4952,권영세(權寧世),김원이(金元二),52,5,57,1
4953,권영세(權寧世),김윤덕(金潤德),52,4,56,1
4954,권영세(權寧世),김의겸(金宜謙),26,5,31,1
4955,권영세(權寧世),김정재(金汀才),80,95,175,0
4956,권영세(權寧世),김정호(金禎鎬),53,6,59,1
4957,권영세(權寧世),김종민(金鐘民),52,5,57,1
4958,권영세(權寧世),김주영(金周暎),53,6,59,1
4959,권영세(權寧世),김진표(金振杓),27,1,28,1
4960,권영세(權寧世),김철민(金哲玟),52,5,57,1
4961,권영세(權寧世),김태년(金太年),49,4,53,1
4962,권영세(權寧世),김태호(金台鎬),60,63,123,0
4963,권영세(權寧世),김학용(金學容),25,15,40,0
4964,권영세(權寧世),김한규(金翰奎),25,4,29,1
4965,권영세(權寧世),김한정(金漢正),50,5,55,1
4966,권영세(權寧世),김형동(金亨東),87,93,180,0
4967,권영세(權寧世),김홍걸(金弘傑),15,6,21,1
4968,권영세(權寧世),김회재(金會在),50,4,54,1
4969,권영세(權寧世),김희곤(金熙坤),76,65,141,0
4970,권영세(權寧世),김희국(金熙國),66,47,113,0
4971,권영세(權寧世),남인순(南仁順),52,6,58,1
4972,권영세(權寧世),노용호(魯容昊),25,13,38,0
4973,권영세(權寧世),노웅래(盧雄來),51,7,58,1
4974,권영세(權寧世),도종환(都鍾煥),50,6,56,1
4975,권영세(權寧世),류성걸(柳性杰),63,52,115,0
4976,권영세(權寧世),류호정(柳好貞),7,9,16,1
4977,권영세(權寧世),맹성규(孟聖奎),50,6,56,1
4978,권영세(權寧世),문정복(文貞福),49,5,54,1
4979,권영세(權寧世),문진석(文振碩),50,6,56,1
4980,권영세(權寧世),민병덕(閔炳德),50,6,56,1
4981,권영세(權寧世),민형배(閔馨培),35,6,41,1
4982,권영세(權寧世),민홍철(閔洪喆),50,5,55,1
4983,권영세(權寧世),박광온(朴洸瑥),50,4,54,1
4984,권영세(權寧世),박대수(朴大壽),86,108,194,0
4985,권영세(權寧世),박대출(朴大出),69,68,137,0
4986,권영세(權寧世),박덕흠(朴德欽),54,72,126,0
4987,권영세(權寧世),박범계(朴範界),50,4,54,1
4988,권영세(權寧世),박병석(朴炳錫),25,3,28,1
4989,권영세(權寧世),박상혁(朴商赫),51,5,56,1
4990,권영세(權寧世),박성민(朴聖敏),73,68,141,0
4991,권영세(權寧世),박성준(朴省俊),51,6,57,1
4992,권영세(權寧世),박성중(朴成重),71,72,143,0
4993,권영세(權寧世),박수영(朴洙瑩),74,47,121,0
4994,권영세(權寧世),박영순(朴英淳),51,11,62,1
4995,권영세(權寧世),박완주(朴完柱),25,1,26,1
4996,권영세(權寧世),박용진(朴用鎭),49,4,53,1
4997,권영세(權寧世),박재호(朴在昊),50,5,55,1
4998,권영세(權寧世),박정(朴釘),50,6,56,1
4999,권영세(權寧世),박정하(朴正河),25,20,45,0
5000,권영세(權寧世),박주민(朴柱民),50,5,55,1
5001,권영세(權寧世),박진(朴振),72,68,140,0
5002,권영세(權寧世),박찬대(朴贊大),50,5,55,1
5003,권영세(權寧世),박형수(朴亨修),62,42,104,0
5004,권영세(權寧世),박홍근(朴洪根),52,5,57,1
5005,권영세(權寧世),배준영(裵俊英),70,58,128,0
5006,권영세(權寧世),배진교(裵晋敎),6,3,9,1
5007,권영세(權寧世),배현진(裵賢鎭),69,66,135,0
5008,권영세(權寧世),백종헌(白宗憲),74,88,162,0
5009,권영세(權寧世),백혜련(白惠蓮),50,5,55,1
5010,권영세(權寧世),변재일(卞在一),51,7,58,1
5011,권영세(權寧世),서동용(徐東榕),51,5,56,1
5012,권영세(權寧世),서범수(徐範洙),72,76,148,0
5013,권영세(權寧世),서병수(徐秉洙),75,62,137,0
5014,권영세(權寧世),서삼석(徐參錫),53,4,57,1
5015,권영세(權寧世),서영교(徐瑛敎),53,9,62,1
5016,권영세(權寧世),서영석(徐暎錫),49,6,55,1
5017,권영세(權寧世),서일준(徐一俊),77,101,178,0
5018,권영세(權寧世),서정숙(徐正淑),68,66,134,0
5019,권영세(權寧世),설훈(薛勳),51,7,58,1
5020,권영세(權寧世),성일종(成一鍾),94,115,209,0
5021,권영세(權寧世),소병철(蘇秉哲),50,5,55,1
5022,권영세(權寧世),소병훈(蘇秉勳),50,6,56,1
5023,권영세(權寧世),송갑석(宋甲錫),50,5,55,1
5024,권영세(權寧世),송기헌(宋基憲),50,6,56,1
5025,권영세(權寧世),송석준(宋錫俊),70,61,131,0
5026,권영세(權寧世),송언석(宋彦錫),67,64,131,0
5027,권영세(權寧世),송옥주(宋玉珠),51,4,55,1
5028,권영세(權寧世),송재호(宋在祜),51,7,58,1
5029,권영세(權寧世),신동근(申東根),50,3,53,1
5030,권영세(權寧世),신영대(申榮大),50,5,55,1
5031,권영세(權寧世),신원식(申源湜),73,68,141,0
5032,권영세(權寧世),신정훈(辛正勳),50,5,55,1
5033,권영세(權寧世),신현영(申賢榮),49,5,54,1
5034,권영세(權寧世),심상정(沈相奵),6,4,10,1
5035,권영세(權寧世),안규백(安圭伯),51,6,57,1
5036,권영세(權寧世),안민석(安敏錫),50,3,53,1
5037,권영세(權寧世),안병길(安炳吉),67,54,121,0
5038,권영세(權寧世),안철수(安哲秀),25,14,39,0
5039,권영세(權寧世),안호영(安浩永),50,6,56,1
5040,권영세(權寧世),양경숙(梁敬淑),50,6,56,1
5041,권영세(權寧世),양금희(梁琴喜),82,93,175,0
5042,권영세(權寧世),양기대(梁基大),51,4,55,1
5043,권영세(權寧世),양이원영(梁李媛瑛),45,6,51,1
5044,권영세(權寧世),양정숙(梁貞淑),3,8,11,1
5045,권영세(權寧世),양향자(梁香子),22,3,25,1
5046,권영세(權寧世),어기구(魚基龜),50,6,56,1
5047,권영세(權寧世),엄태영(嚴泰永),64,51,115,0
5048,권영세(權寧世),오기형(吳奇炯),49,5,54,1
5049,권영세(權寧世),오영환(吳永煥),52,7,59,1
5050,권영세(權寧世),용혜인(龍慧仁),1,9,10,1
5051,권영세(權寧世),우상호(禹相虎),50,4,54,1
5052,권영세(權寧世),우원식(禹元植),49,4,53,1
5053,권영세(權寧世),위성곤(魏聖坤),50,6,56,1
5054,권영세(權寧世),유경준(兪京濬),74,66,140,0
5055,권영세(權寧世),유기홍(柳基洪),50,4,54,1
5056,권영세(權寧世),유동수(柳東秀),50,6,56,1
5057,권영세(權寧世),유상범(劉相凡),60,46,106,0
5058,권영세(權寧世),유의동(兪義東),69,59,128,0
5059,권영세(權寧世),유정주(兪訂炷),49,6,55,1
5060,권영세(權寧世),윤건영(尹建永),49,4,53,1
5061,권영세(權寧世),윤관석(尹官石),41,1,42,1
5062,권영세(權寧世),윤두현(尹斗鉉),71,80,151,0
5063,권영세(權寧世),윤미향(尹美香),20,3,23,1
5064,권영세(權寧世),윤상현(尹相現),34,21,55,0
5065,권영세(權寧世),윤영덕(尹永德),49,5,54,1
5066,권영세(權寧世),윤영석(尹永碩),65,42,107,0
5067,권영세(權寧世),윤영찬(尹永燦),50,7,57,1
5068,권영세(權寧世),윤재갑(尹才鉀),50,6,56,1
5069,권영세(權寧世),윤재옥(尹在玉),65,52,117,0
5070,권영세(權寧世),윤주경(尹柱卿),67,52,119,0
5071,권영세(權寧世),윤준병(尹準炳),50,5,55,1
5072,권영세(權寧世),윤창현(尹暢賢),81,93,174,0
5073,권영세(權寧世),윤한홍(尹漢洪),78,62,140,0
5074,권영세(權寧世),윤호중(尹昊重),51,5,56,1
5075,권영세(權寧世),윤후덕(尹厚德),50,6,56,1
5076,권영세(權寧世),이개호(李介昊),54,4,58,1
5077,권영세(權寧世),이달곤(李達坤),60,43,103,0
5078,권영세(權寧世),이동주(李東洲),50,6,56,1
5079,권영세(權寧世),이만희(李晩熙),66,54,120,0
5080,권영세(權寧世),이명수(李明洙),98,88,186,0
5081,권영세(權寧世),이병훈(李炳勳),52,7,59,1
5082,권영세(權寧世),이상민(李相珉),50,4,54,1
5083,권영세(權寧世),이상헌(李相憲),51,12,63,1
5084,권영세(權寧世),이성만(李成萬),41,2,43,1
5085,권영세(權寧世),이소영(李素永),50,6,56,1
5086,권영세(權寧世),이수진(李壽珍),51,10,61,1
5087,권영세(權寧世),이수진(李秀眞),50,7,57,1
5088,권영세(權寧世),이양수(李亮壽),78,73,151,0
5089,권영세(權寧世),이용(李鏞),72,57,129,0
5090,권영세(權寧世),이용빈(李龍彬),53,6,59,1
5091,권영세(權寧世),이용선(李庸瑄),50,6,56,1
5092,권영세(權寧世),이용우(李龍雨),49,5,54,1
5093,권영세(權寧世),이용호(李容鎬),33,17,50,0
5094,권영세(權寧世),이원욱(李元旭),50,5,55,1
5095,권영세(權寧世),이원택(李源澤),50,5,55,1
5096,권영세(權寧世),이은주(李恩周),6,5,11,1
5097,권영세(權寧世),이인선(李仁善),25,22,47,0
5098,권영세(權寧世),이인영(李仁榮),50,4,54,1
5099,권영세(權寧世),이장섭(李將燮),50,5,55,1
5100,권영세(權寧世),이재명(李在明),25,4,29,1
5101,권영세(權寧世),이재정(李在汀),50,5,55,1
5102,권영세(權寧世),이정문(李楨文),50,5,55,1
5103,권영세(權寧世),이종배(李鍾培),73,56,129,0
5104,권영세(權寧世),이종성(李鍾成),69,80,149,0
5105,권영세(權寧世),이주환(李周桓),82,80,162,0
5106,권영세(權寧世),이채익(李埰益),65,60,125,0
5107,권영세(權寧世),이철규(李喆圭),64,55,119,0
5108,권영세(權寧世),이탄희(李誕熙),50,6,56,1
5109,권영세(權寧世),이태규(李泰珪),47,54,101,0
5110,권영세(權寧世),이학영(李學永),49,6,55,1
5111,권영세(權寧世),이해식(李海植),52,6,58,1
5112,권영세(權寧世),이헌승(李憲昇),73,47,120,0
5113,권영세(權寧世),이형석(李炯錫),50,5,55,1
5114,권영세(權寧世),인재근(印在謹),52,9,61,1
5115,권영세(權寧世),임병헌(林炳憲),25,12,37,0
5116,권영세(權寧世),임오경(林五卿),51,7,58,1
5117,권영세(權寧世),임이자(林利子),74,60,134,0
5118,권영세(權寧世),임종성(林鍾聲),50,6,56,1
5119,권영세(權寧世),임호선(林昊宣),51,6,57,1
5120,권영세(權寧世),장경태(張耿態),50,11,61,1
5121,권영세(權寧世),장동혁(張東赫),25,15,40,0
5122,권영세(權寧世),장제원(張濟元),59,48,107,0
5123,권영세(權寧世),장철민(張喆敏),50,4,54,1
5124,권영세(權寧世),장혜영(張惠英),7,4,11,1
5125,권영세(權寧世),전봉민(田奉珉),47,32,79,0
5126,권영세(權寧世),전용기(田溶冀),51,6,57,1
5127,권영세(權寧世),전재수(田載秀),50,4,54,1
5128,권영세(權寧世),전주혜(全珠惠),73,71,144,0
5129,권영세(權寧世),전해철(全海澈),51,4,55,1
5130,권영세(權寧世),전혜숙(全惠淑),50,15,65,1
5131,권영세(權寧世),정경희(丁慶姬),66,62,128,0
5132,권영세(權寧世),정동만(鄭東萬),67,57,124,0
5133,권영세(權寧世),정성호(鄭成湖),51,8,59,1
5134,권영세(權寧世),정우택(鄭宇澤),25,13,38,0
5135,권영세(權寧世),정운천(鄭雲天),67,53,120,0
5136,권영세(權寧世),정일영(鄭日永),50,6,56,1
5137,권영세(權寧世),정점식(鄭点植),67,40,107,0
5138,권영세(權寧世),정진석(鄭鎭碩),68,58,126,0
5139,권영세(權寧世),정청래(鄭淸來),49,6,55,1
5140,권영세(權寧世),정춘숙(鄭春淑),50,5,55,1
5141,권영세(權寧世),정태호(鄭泰浩),50,5,55,1
5142,권영세(權寧世),정필모(鄭必模),50,6,56,1
5143,권영세(權寧世),정희용(鄭熙溶),88,83,171,0
5144,권영세(權寧世),조경태(趙慶泰),80,77,157,0
5145,권영세(權寧世),조명희(曺明姬),73,95,168,0
5146,권영세(權寧世),조수진(趙修眞),92,94,186,0
5147,권영세(權寧世),조승래(趙承來),50,5,55,1
5148,권영세(權寧世),조오섭(曺五燮),51,9,60,1
5149,권영세(權寧世),조은희(趙恩禧),25,11,36,0
5150,권영세(權寧世),조응천(趙應天),51,5,56,1
5151,권영세(權寧世),조정식(趙正湜),49,3,52,1
5152,권영세(權寧世),조정훈(趙廷訓),1,10,11,1
5153,권영세(權寧世),조해진(曺海珍),62,43,105,0
5154,권영세(權寧世),주철현(朱哲鉉),55,5,60,1
5155,권영세(權寧世),주호영(朱豪英),61,48,109,0
5156,권영세(權寧世),지성호(池成浩),79,83,162,0
5157,권영세(權寧世),진선미(陳善美),51,6,57,1
5158,권영세(權寧世),진성준(陳聲準),51,5,56,1
5159,권영세(權寧世),천준호(千俊鎬),50,4,54,1
5160,권영세(權寧世),최기상(崔基相),49,5,54,1
5161,권영세(權寧世),최승재(崔承宰),71,57,128,0
5162,권영세(權寧世),최연숙(崔姸淑),44,46,90,0
5163,권영세(權寧世),최영희(崔英姬),25,11,36,0
5164,권영세(權寧世),최인호(崔仁昊),50,4,54,1
5165,권영세(權寧世),최재형(崔在亨),25,11,36,0
5166,권영세(權寧世),최종윤(崔鍾允),50,6,56,1
5167,권영세(權寧世),최춘식(崔春植),79,72,151,0
5168,권영세(權寧世),최형두(崔炯斗),94,74,168,0
5169,권영세(權寧世),최혜영(崔惠英),50,6,56,1
5170,권영세(權寧世),추경호(秋慶鎬),110,107,217,0
5171,권영세(權寧世),태영호(太永浩),91,126,217,0
5172,권영세(權寧世),하영제(河榮帝),66,68,134,1
5173,권영세(權寧世),하태경(河泰慶),62,40,102,0
5174,권영세(權寧世),한기호(韓起鎬),64,49,113,0
5175,권영세(權寧世),한무경(韓茂景),75,88,163,0
5176,권영세(權寧世),한병도(韓秉道),50,5,55,1
5177,권영세(權寧世),한정애(韓貞愛),50,5,55,1
5178,권영세(權寧世),한준호(韓俊鎬),50,5,55,1
5179,권영세(權寧世),허숙정(許淑湞),0,0,0,1
5180,권영세(權寧世),허영(許榮),50,6,56,1
5181,권영세(權寧世),허은아(許垠娥),80,85,165,0
5182,권영세(權寧世),허종식(許琮植),50,4,54,1
5183,권영세(權寧世),홍기원(洪起元),50,6,56,1
5184,권영세(權寧世),홍문표(洪文杓),72,60,132,0
5185,권영세(權寧世),홍석준(洪碩晙),66,49,115,0
5186,권영세(權寧世),홍성국(洪性國),51,6,57,1
5187,권영세(權寧世),홍영표(洪永杓),50,7,57,1
5188,권영세(權寧世),홍익표(洪翼杓),50,6,56,1
5189,권영세(權寧世),홍정민(洪貞敏),50,8,58,1
5190,권영세(權寧世),황보승희(皇甫承希),74,75,149,1
5191,권영세(權寧世),황운하(黃雲夏),50,4,54,1
5192,권영세(權寧世),황희(黃熙),49,5,54,1
5193,권은희(權垠希),권인숙(權仁淑),29,6,35,1
5194,권은희(權垠希),권칠승(權七勝),30,6,36,1
5195,권은희(權垠希),기동민(奇東旻),29,5,34,1
5196,권은희(權垠希),김경만(金京萬),29,7,36,1
5197,권은희(權垠希),김경협(金炅俠),30,4,34,1
5198,권은희(權垠希),김교흥(金敎興),30,5,35,1
5199,권은희(權垠希),김기현(金起炫),48,43,91,0
5200,권은희(權垠希),김남국(金南局),21,3,24,1
5201,권은희(權垠希),김도읍(金度邑),36,22,58,0
5202,권은희(權垠希),김두관(金斗官),29,14,43,1
5203,권은희(權垠希),김미애(金美愛),36,33,69,0
5204,권은희(權垠希),김민기(金敏基),29,4,33,1
5205,권은희(權垠希),김민석(金民錫),29,12,41,1
5206,권은희(權垠希),김민철(金敏徹),29,11,40,1
5207,권은희(權垠希),김병기(金炳基),32,6,38,1
5208,권은희(權垠希),김병욱A(金炳旭),29,7,36,1
5209,권은희(權垠希),김병욱B(金炳旭),60,67,127,0
5210,권은희(權垠希),김병주(金柄周),31,5,36,1
5211,권은희(權垠希),김상훈(金相勳),42,37,79,0
5212,권은희(權垠希),김상희(金相姬),30,6,36,1
5213,권은희(權垠希),김석기(金碩基),43,34,77,0
5214,권은희(權垠希),김성원(金成願),39,32,71,0
5215,권은희(權垠希),김성주(金成柱),30,9,39,1
5216,권은희(權垠希),김성환(金星煥),29,5,34,1
5217,권은희(權垠希),김수흥(金洙興),30,5,35,1
5218,권은희(權垠希),김승남(金承南),29,9,38,1
5219,권은희(權垠希),김승수(金承洙),40,38,78,0
5220,권은희(權垠希),김승원(金勝源),30,6,36,1
5221,권은희(權垠希),김영배(金永培),30,6,36,1
5222,권은희(權垠希),김영선(金映宣),26,18,44,0
5223,권은희(權垠希),김영식(金英植),41,39,80,0
5224,권은희(權垠希),김영주(金榮珠),29,6,35,1
5225,권은희(權垠希),김영진(金榮鎭),30,3,33,1
5226,권은희(權垠希),김영호(金映豪),29,6,35,1
5227,권은희(權垠希),김예지(金睿智),41,58,99,0
5228,권은희(權垠希),김용민(金容民),29,4,33,1
5229,권은희(權垠希),김용판(金用判),35,35,70,0
5230,권은희(權垠希),김웅(金雄),38,31,69,0
5231,권은희(權垠希),김원이(金元二),30,7,37,1
5232,권은희(權垠希),김윤덕(金潤德),29,6,35,1
5233,권은희(權垠希),김의겸(金宜謙),27,4,31,1
5234,권은희(權垠希),김정재(金汀才),43,48,91,0
5235,권은희(權垠希),김정호(金禎鎬),29,11,40,1
5236,권은희(權垠希),김종민(金鐘民),29,7,36,1
5237,권은희(權垠希),김주영(金周暎),29,7,36,1
5238,권은희(權垠希),김진표(金振杓),4,0,4,1
5239,권은희(權垠希),김철민(金哲玟),28,8,36,1
5240,권은희(權垠希),김태년(金太年),29,8,37,1
5241,권은희(權垠希),김태호(金台鎬),39,25,64,0
5242,권은희(權垠希),김학용(金學容),29,15,44,0
5243,권은희(權垠希),김한규(金翰奎),25,6,31,1
5244,권은희(權垠希),김한정(金漢正),28,4,32,1
5245,권은희(權垠希),김형동(金亨東),43,38,81,0
5246,권은희(權垠希),김홍걸(金弘傑),6,13,19,1
5247,권은희(權垠希),김회재(金會在),29,5,34,1
5248,권은희(權垠希),김희곤(金熙坤),36,29,65,0
5249,권은희(權垠希),김희국(金熙國),38,27,65,0
5250,권은희(權垠希),남인순(南仁順),31,11,42,1
5251,권은희(權垠希),노용호(魯容昊),28,11,39,0
5252,권은희(權垠希),노웅래(盧雄來),28,4,32,1
5253,권은희(權垠希),도종환(都鍾煥),29,8,37,1
5254,권은희(權垠希),류성걸(柳性杰),39,32,71,0
5255,권은희(權垠希),류호정(柳好貞),11,8,19,1
5256,권은희(權垠希),맹성규(孟聖奎),28,5,33,1
5257,권은희(權垠希),문정복(文貞福),28,5,33,1
5258,권은희(權垠希),문진석(文振碩),28,8,36,1
5259,권은희(權垠希),민병덕(閔炳德),28,9,37,1
5260,권은희(權垠希),민형배(閔馨培),12,9,21,1
5261,권은희(權垠希),민홍철(閔洪喆),28,6,34,1
5262,권은희(權垠希),박광온(朴洸瑥),28,4,32,1
5263,권은희(權垠希),박대수(朴大壽),35,36,71,0
5264,권은희(權垠希),박대출(朴大出),35,19,54,0
5265,권은희(權垠希),박덕흠(朴德欽),35,26,61,0
5266,권은희(權垠希),박범계(朴範界),28,4,32,1
5267,권은희(權垠希),박병석(朴炳錫),25,3,28,1
5268,권은희(權垠希),박상혁(朴商赫),29,4,33,1
5269,권은희(權垠希),박성민(朴聖敏),39,30,69,0
5270,권은희(權垠希),박성준(朴省俊),30,6,36,1
5271,권은희(權垠希),박성중(朴成重),33,26,59,0
5272,권은희(權垠希),박수영(朴洙瑩),30,32,62,0
5273,권은희(權垠希),박영순(朴英淳),29,9,38,1
5274,권은희(權垠希),박완주(朴完柱),4,2,6,1
5275,권은희(權垠希),박용진(朴用鎭),28,6,34,1
5276,권은희(權垠希),박재호(朴在昊),28,5,33,1
5277,권은희(權垠希),박정(朴釘),29,7,36,1
5278,권은희(權垠希),박정하(朴正河),28,15,43,0
5279,권은희(權垠希),박주민(朴柱民),30,4,34,1
5280,권은희(權垠希),박진(朴振),31,32,63,0
5281,권은희(權垠希),박찬대(朴贊大),28,6,34,1
5282,권은희(權垠希),박형수(朴亨修),33,24,57,0
5283,권은희(權垠希),박홍근(朴洪根),29,4,33,1
5284,권은희(權垠希),배준영(裵俊英),33,27,60,0
5285,권은희(權垠希),배진교(裵晋敎),8,12,20,1
5286,권은희(權垠希),배현진(裵賢鎭),38,28,66,0
5287,권은희(權垠希),백종헌(白宗憲),39,49,88,0
5288,권은희(權垠希),백혜련(白惠蓮),28,5,33,1
5289,권은희(權垠希),변재일(卞在一),29,5,34,1
5290,권은희(權垠希),서동용(徐東榕),29,7,36,1
5291,권은희(權垠希),서범수(徐範洙),31,25,56,0
5292,권은희(權垠希),서병수(徐秉洙),39,36,75,0
5293,권은희(權垠希),서삼석(徐參錫),30,5,35,1
5294,권은희(權垠希),서영교(徐瑛敎),29,9,38,1
5295,권은희(權垠希),서영석(徐暎錫),29,9,38,1
5296,권은희(權垠希),서일준(徐一俊),39,31,70,0
5297,권은희(權垠希),서정숙(徐正淑),42,54,96,0
5298,권은희(權垠希),설훈(薛勳),29,5,34,1
5299,권은희(權垠希),성일종(成一鍾),40,42,82,0
5300,권은희(權垠希),소병철(蘇秉哲),30,7,37,1
5301,권은희(權垠希),소병훈(蘇秉勳),29,10,39,1
5302,권은희(權垠希),송갑석(宋甲錫),28,7,35,1
5303,권은희(權垠希),송기헌(宋基憲),28,5,33,1
5304,권은희(權垠希),송석준(宋錫俊),32,22,54,0
5305,권은희(權垠希),송언석(宋彦錫),39,28,67,0
5306,권은희(權垠希),송옥주(宋玉珠),28,3,31,1
5307,권은희(權垠希),송재호(宋在祜),29,8,37,1
5308,권은희(權垠希),신동근(申東根),28,4,32,1
5309,권은희(權垠希),신영대(申榮大),28,5,33,1
5310,권은희(權垠希),신원식(申源湜),34,33,67,0
5311,권은희(權垠希),신정훈(辛正勳),29,9,38,1
5312,권은희(權垠希),신현영(申賢榮),28,5,33,1
5313,권은희(權垠希),심상정(沈相奵),8,5,13,1
5314,권은희(權垠希),안규백(安圭伯),30,6,36,1
5315,권은희(權垠希),안민석(安敏錫),30,3,33,1
5316,권은희(權垠希),안병길(安炳吉),38,35,73,0
5317,권은희(權垠希),안철수(安哲秀),28,13,41,0
5318,권은희(權垠希),안호영(安浩永),28,9,37,1
5319,권은희(權垠希),양경숙(梁敬淑),28,7,35,1
5320,권은희(權垠希),양금희(梁琴喜),46,36,82,0
5321,권은희(權垠希),양기대(梁基大),29,4,33,1
5322,권은희(權垠希),양이원영(梁李媛瑛),28,6,34,1
5323,권은희(權垠希),양정숙(梁貞淑),6,26,32,1
5324,권은희(權垠希),양향자(梁香子),4,20,24,1
5325,권은희(權垠希),어기구(魚基龜),28,7,35,1
5326,권은희(權垠希),엄태영(嚴泰永),34,22,56,0
5327,권은희(權垠希),오기형(吳奇炯),28,5,33,1
5328,권은희(權垠希),오영환(吳永煥),29,7,36,1
5329,권은희(權垠希),용혜인(龍慧仁),4,18,22,1
5330,권은희(權垠希),우상호(禹相虎),28,4,32,1
5331,권은희(權垠希),우원식(禹元植),28,4,32,1
5332,권은희(權垠希),위성곤(魏聖坤),28,11,39,1
5333,권은희(權垠希),유경준(兪京濬),36,37,73,0
5334,권은희(權垠希),유기홍(柳基洪),30,4,34,1
5335,권은희(權垠希),유동수(柳東秀),30,10,40,1
5336,권은희(權垠希),유상범(劉相凡),35,22,57,0
5337,권은희(權垠希),유의동(兪義東),46,48,94,0
5338,권은희(權垠希),유정주(兪訂炷),29,6,35,1
5339,권은희(權垠希),윤건영(尹建永),29,4,33,1
5340,권은희(權垠希),윤관석(尹官石),19,0,19,1
5341,권은희(權垠希),윤두현(尹斗鉉),48,32,80,0
5342,권은희(權垠希),윤미향(尹美香),3,6,9,1
5343,권은희(權垠希),윤상현(尹相現),29,19,48,0
5344,권은희(權垠希),윤영덕(尹永德),29,6,35,1
5345,권은희(權垠希),윤영석(尹永碩),31,20,51,0
5346,권은희(權垠希),윤영찬(尹永燦),28,4,32,1
5347,권은희(權垠希),윤재갑(尹才鉀),35,15,50,1
5348,권은희(權垠希),윤재옥(尹在玉),35,22,57,0
5349,권은희(權垠希),윤주경(尹柱卿),35,35,70,0
5350,권은희(權垠希),윤준병(尹準炳),29,9,38,1
5351,권은희(權垠希),윤창현(尹暢賢),42,41,83,0
5352,권은희(權垠希),윤한홍(尹漢洪),41,32,73,0
5353,권은희(權垠希),윤호중(尹昊重),28,4,32,1
5354,권은희(權垠希),윤후덕(尹厚德),28,5,33,1
5355,권은희(權垠希),이개호(李介昊),28,8,36,1
5356,권은희(權垠希),이달곤(李達坤),33,19,52,0
5357,권은희(權垠希),이동주(李東洲),28,7,35,1
5358,권은희(權垠希),이만희(李晩熙),32,20,52,0
5359,권은희(權垠希),이명수(李明洙),45,44,89,0
5360,권은희(權垠希),이병훈(李炳勳),30,7,37,1
5361,권은희(權垠希),이상민(李相珉),28,4,32,1
5362,권은희(權垠希),이상헌(李相憲),29,10,39,1
5363,권은희(權垠希),이성만(李成萬),20,2,22,1
5364,권은희(權垠希),이소영(李素永),29,5,34,1
5365,권은희(權垠希),이수진(李壽珍),30,13,43,1
5366,권은희(權垠希),이수진(李秀眞),29,7,36,1
5367,권은희(權垠希),이양수(李亮壽),35,28,63,0
5368,권은희(權垠希),이용(李鏞),38,36,74,0
5369,권은희(權垠希),이용빈(李龍彬),30,12,42,1
5370,권은희(權垠希),이용선(李庸瑄),28,8,36,1
5371,권은희(權垠希),이용우(李龍雨),29,7,36,1
5372,권은희(權垠希),이용호(李容鎬),32,19,51,0
5373,권은희(權垠希),이원욱(李元旭),28,5,33,1
5374,권은희(權垠希),이원택(李源澤),28,5,33,1
5375,권은희(權垠希),이은주(李恩周),7,10,17,1
5376,권은희(權垠希),이인선(李仁善),30,22,52,0
5377,권은희(權垠希),이인영(李仁榮),28,6,34,1
5378,권은희(權垠希),이장섭(李將燮),28,5,33,1
5379,권은희(權垠希),이재명(李在明),25,4,29,1
5380,권은희(權垠希),이재정(李在汀),28,4,32,1
5381,권은희(權垠希),이정문(李楨文),28,4,32,1
5382,권은희(權垠希),이종배(李鍾培),35,35,70,0
5383,권은희(權垠希),이종성(李鍾成),39,29,68,0
5384,권은희(權垠希),이주환(李周桓),39,24,63,0
5385,권은희(權垠希),이채익(李埰益),36,37,73,0
5386,권은희(權垠希),이철규(李喆圭),34,18,52,0
5387,권은희(權垠希),이탄희(李誕熙),28,5,33,1
5388,권은희(權垠希),이태규(李泰珪),65,76,141,0
5389,권은희(權垠希),이학영(李學永),28,7,35,1
5390,권은희(權垠希),이해식(李海植),28,6,34,1
5391,권은희(權垠希),이헌승(李憲昇),32,19,51,0
5392,권은희(權垠希),이형석(李炯錫),29,5,34,1
5393,권은희(權垠希),인재근(印在謹),33,13,46,1
5394,권은희(權垠希),임병헌(林炳憲),29,20,49,0
5395,권은희(權垠希),임오경(林五卿),28,5,33,1
5396,권은희(權垠希),임이자(林利子),35,33,68,0
5397,권은희(權垠希),임종성(林鍾聲),31,8,39,1
5398,권은희(權垠希),임호선(林昊宣),29,11,40,1
5399,권은희(權垠希),장경태(張耿態),29,5,34,1
5400,권은희(權垠希),장동혁(張東赫),27,15,42,0
5401,권은희(權垠希),장제원(張濟元),32,17,49,0
5402,권은희(權垠希),장철민(張喆敏),28,4,32,1
5403,권은희(權垠希),장혜영(張惠英),7,10,17,1
5404,권은희(權垠希),전봉민(田奉珉),31,25,56,0
5405,권은희(權垠希),전용기(田溶冀),28,7,35,1
5406,권은희(權垠希),전재수(田載秀),28,5,33,1
5407,권은희(權垠希),전주혜(全珠惠),40,38,78,0
5408,권은희(權垠希),전해철(全海澈),28,6,34,1
5409,권은희(權垠希),전혜숙(全惠淑),29,5,34,1
5410,권은희(權垠希),정경희(丁慶姬),39,23,62,0
5411,권은희(權垠希),정동만(鄭東萬),40,25,65,0
5412,권은희(權垠希),정성호(鄭成湖),31,7,38,1
5413,권은희(權垠希),정우택(鄭宇澤),27,22,49,0
5414,권은희(權垠希),정운천(鄭雲天),37,25,62,0
5415,권은희(權垠希),정일영(鄭日永),28,6,34,1
5416,권은희(權垠希),정점식(鄭点植),33,20,53,0
5417,권은희(權垠希),정진석(鄭鎭碩),41,31,72,0
5418,권은희(權垠希),정청래(鄭淸來),28,4,32,1
5419,권은희(權垠希),정춘숙(鄭春淑),28,8,36,1
5420,권은희(權垠希),정태호(鄭泰浩),29,9,38,1
5421,권은희(權垠希),정필모(鄭必模),28,5,33,1
5422,권은희(權垠希),정희용(鄭熙溶),44,28,72,0
5423,권은희(權垠希),조경태(趙慶泰),43,33,76,0
5424,권은희(權垠希),조명희(曺明姬),40,38,78,0
5425,권은희(權垠希),조수진(趙修眞),39,34,73,0
5426,권은희(權垠希),조승래(趙承來),28,3,31,1
5427,권은희(權垠希),조오섭(曺五燮),30,13,43,1
5428,권은희(權垠希),조은희(趙恩禧),28,17,45,0
5429,권은희(權垠希),조응천(趙應天),28,5,33,1
5430,권은희(權垠希),조정식(趙正湜),28,3,31,1
5431,권은희(權垠希),조정훈(趙廷訓),4,11,15,1
5432,권은희(權垠希),조해진(曺海珍),32,16,48,0
5433,권은희(權垠希),주철현(朱哲鉉),30,9,39,1
5434,권은희(權垠希),주호영(朱豪英),34,27,61,0
5435,권은희(權垠希),지성호(池成浩),33,30,63,0
5436,권은희(權垠希),진선미(陳善美),28,6,34,1
5437,권은희(權垠希),진성준(陳聲準),29,4,33,1
5438,권은희(權垠希),천준호(千俊鎬),28,3,31,1
5439,권은희(權垠希),최기상(崔基相),28,5,33,1
5440,권은희(權垠希),최승재(崔承宰),32,32,64,0
5441,권은희(權垠希),최연숙(崔姸淑),58,85,143,0
5442,권은희(權垠希),최영희(崔英姬),27,13,40,0
5443,권은희(權垠希),최인호(崔仁昊),28,4,32,1
5444,권은희(權垠希),최재형(崔在亨),26,12,38,0
5445,권은희(權垠希),최종윤(崔鍾允),29,8,37,1
5446,권은희(權垠希),최춘식(崔春植),37,28,65,0
5447,권은희(權垠希),최형두(崔炯斗),43,27,70,0
5448,권은희(權垠希),최혜영(崔惠英),28,10,38,1
5449,권은희(權垠希),추경호(秋慶鎬),44,32,76,0
5450,권은희(權垠希),태영호(太永浩),40,44,84,0
5451,권은희(權垠希),하영제(河榮帝),27,24,51,1
5452,권은희(權垠希),하태경(河泰慶),39,33,72,0
5453,권은희(權垠希),한기호(韓起鎬),34,21,55,0
5454,권은희(權垠希),한무경(韓茂景),44,30,74,0
5455,권은희(權垠希),한병도(韓秉道),28,5,33,1
5456,권은희(權垠希),한정애(韓貞愛),28,6,34,1
5457,권은희(權垠希),한준호(韓俊鎬),30,4,34,1
5458,권은희(權垠希),허숙정(許淑湞),0,0,0,1
5459,권은희(權垠希),허영(許榮),29,5,34,1
5460,권은희(權垠希),허은아(許垠娥),42,42,84,0
5461,권은희(權垠希),허종식(許琮植),29,8,37,1
5462,권은희(權垠希),홍기원(洪起元),30,8,38,1
5463,권은희(權垠希),홍문표(洪文杓),33,19,52,0
5464,권은희(權垠希),홍석준(洪碩晙),38,21,59,0
5465,권은희(權垠希),홍성국(洪性國),28,6,34,1
5466,권은희(權垠希),홍영표(洪永杓),29,6,35,1
5467,권은희(權垠希),홍익표(洪翼杓),29,5,34,1
5468,권은희(權垠希),홍정민(洪貞敏),29,6,35,1
5469,권은희(權垠希),황보승희(皇甫承希),36,43,79,1
5470,권은희(權垠希),황운하(黃雲夏),28,7,35,1
5471,권은희(權垠希),황희(黃熙),28,5,33,1
5472,권인숙(權仁淑),권칠승(權七勝),104,99,203,0
5473,권인숙(權仁淑),기동민(奇東旻),97,107,204,0
5474,권인숙(權仁淑),김경만(金京萬),135,136,271,0
5475,권인숙(權仁淑),김경협(金炅俠),92,61,153,0
5476,권인숙(權仁淑),김교흥(金敎興),89,57,146,0
5477,권인숙(權仁淑),김기현(金起炫),53,6,59,1
5478,권인숙(權仁淑),김남국(金南局),98,94,192,1
5479,권인숙(權仁淑),김도읍(金度邑),51,4,55,1
5480,권인숙(權仁淑),김두관(金斗官),92,85,177,0
5481,권인숙(權仁淑),김미애(金美愛),51,5,56,1
5482,권인숙(權仁淑),김민기(金敏基),92,74,166,0
5483,권인숙(權仁淑),김민석(金民錫),90,94,184,0
5484,권인숙(權仁淑),김민철(金敏徹),101,92,193,0
5485,권인숙(權仁淑),김병기(金炳基),87,57,144,0
5486,권인숙(權仁淑),김병욱A(金炳旭),93,66,159,0
5487,권인숙(權仁淑),김병욱B(金炳旭),44,5,49,1
5488,권인숙(權仁淑),김병주(金柄周),82,39,121,0
5489,권인숙(權仁淑),김상훈(金相勳),52,5,57,1
5490,권인숙(權仁淑),김상희(金相姬),105,116,221,0
5491,권인숙(權仁淑),김석기(金碩基),51,4,55,1
5492,권인숙(權仁淑),김성원(金成願),51,4,55,1
5493,권인숙(權仁淑),김성주(金成柱),91,70,161,0
5494,권인숙(權仁淑),김성환(金星煥),90,57,147,0
5495,권인숙(權仁淑),김수흥(金洙興),92,68,160,0
5496,권인숙(權仁淑),김승남(金承南),109,104,213,0
5497,권인숙(權仁淑),김승수(金承洙),52,8,60,1
5498,권인숙(權仁淑),김승원(金勝源),117,154,271,0
5499,권인숙(權仁淑),김영배(金永培),110,100,210,0
5500,권인숙(權仁淑),김영선(金映宣),26,4,30,1
5501,권인숙(權仁淑),김영식(金英植),51,10,61,1
5502,권인숙(權仁淑),김영주(金榮珠),87,84,171,0
5503,권인숙(權仁淑),김영진(金榮鎭),83,49,132,0
5504,권인숙(權仁淑),김영호(金映豪),98,70,168,0
5505,권인숙(權仁淑),김예지(金睿智),54,12,66,1
5506,권인숙(權仁淑),김용민(金容民),97,97,194,0
5507,권인숙(權仁淑),김용판(金用判),52,4,56,1
5508,권인숙(權仁淑),김웅(金雄),51,5,56,1
5509,권인숙(權仁淑),김원이(金元二),92,97,189,0
5510,권인숙(權仁淑),김윤덕(金潤德),93,66,159,0
5511,권인숙(權仁淑),김의겸(金宜謙),50,82,132,0
5512,권인숙(權仁淑),김정재(金汀才),52,5,57,1
5513,권인숙(權仁淑),김정호(金禎鎬),119,151,270,0
5514,권인숙(權仁淑),김종민(金鐘民),84,68,152,0
5515,권인숙(權仁淑),김주영(金周暎),97,79,176,0
5516,권인숙(權仁淑),김진표(金振杓),47,49,96,1
5517,권인숙(權仁淑),김철민(金哲玟),138,164,302,0
5518,권인숙(權仁淑),김태년(金太年),78,48,126,0
5519,권인숙(權仁淑),김태호(金台鎬),41,4,45,1
5520,권인숙(權仁淑),김학용(金學容),25,4,29,1
5521,권인숙(權仁淑),김한규(金翰奎),44,37,81,0
5522,권인숙(權仁淑),김한정(金漢正),82,52,134,0
5523,권인숙(權仁淑),김형동(金亨東),51,12,63,1
5524,권인숙(權仁淑),김홍걸(金弘傑),51,101,152,0
5525,권인숙(權仁淑),김회재(金會在),98,84,182,0
5526,권인숙(權仁淑),김희곤(金熙坤),49,4,53,1
5527,권인숙(權仁淑),김희국(金熙國),49,4,53,1
5528,권인숙(權仁淑),남인순(南仁順),129,159,288,0
5529,권인숙(權仁淑),노용호(魯容昊),26,4,30,1
5530,권인숙(權仁淑),노웅래(盧雄來),99,92,191,0
5531,권인숙(權仁淑),도종환(都鍾煥),100,122,222,0
5532,권인숙(權仁淑),류성걸(柳性杰),49,5,54,1
5533,권인숙(權仁淑),류호정(柳好貞),29,107,136,1
5534,권인숙(權仁淑),맹성규(孟聖奎),101,68,169,0
5535,권인숙(權仁淑),문정복(文貞福),85,78,163,0
5536,권인숙(權仁淑),문진석(文振碩),102,101,203,0
5537,권인숙(權仁淑),민병덕(閔炳德),94,120,214,0
5538,권인숙(權仁淑),민형배(閔馨培),90,160,250,0
5539,권인숙(權仁淑),민홍철(閔洪喆),84,62,146,0
5540,권인숙(權仁淑),박광온(朴洸瑥),89,66,155,0
5541,권인숙(權仁淑),박대수(朴大壽),51,7,58,1
5542,권인숙(權仁淑),박대출(朴大出),50,4,54,1
5543,권인숙(權仁淑),박덕흠(朴德欽),35,10,45,1
5544,권인숙(權仁淑),박범계(朴範界),75,46,121,0
5545,권인숙(權仁淑),박병석(朴炳錫),40,16,56,0
5546,권인숙(權仁淑),박상혁(朴商赫),94,96,190,0
5547,권인숙(權仁淑),박성민(朴聖敏),49,4,53,1
5548,권인숙(權仁淑),박성준(朴省俊),121,126,247,0
5549,권인숙(權仁淑),박성중(朴成重),49,4,53,1
5550,권인숙(權仁淑),박수영(朴洙瑩),49,5,54,1
5551,권인숙(權仁淑),박영순(朴英淳),104,106,210,0
5552,권인숙(權仁淑),박완주(朴完柱),45,43,88,1
5553,권인숙(權仁淑),박용진(朴用鎭),82,57,139,0
5554,권인숙(權仁淑),박재호(朴在昊),87,57,144,0
5555,권인숙(權仁淑),박정(朴釘),109,128,237,0
5556,권인숙(權仁淑),박정하(朴正河),26,4,30,1
5557,권인숙(權仁淑),박주민(朴柱民),90,101,191,0
5558,권인숙(權仁淑),박진(朴振),49,5,54,1
5559,권인숙(權仁淑),박찬대(朴贊大),108,130,238,0
5560,권인숙(權仁淑),박형수(朴亨修),49,5,54,1
5561,권인숙(權仁淑),박홍근(朴洪根),108,97,205,0
5562,권인숙(權仁淑),배준영(裵俊英),49,4,53,1
5563,권인숙(權仁淑),배진교(裵晋敎),29,77,106,1
5564,권인숙(權仁淑),배현진(裵賢鎭),49,5,54,1
5565,권인숙(權仁淑),백종헌(白宗憲),50,4,54,1
5566,권인숙(權仁淑),백혜련(白惠蓮),95,75,170,0
5567,권인숙(權仁淑),변재일(卞在一),84,47,131,0
5568,권인숙(權仁淑),서동용(徐東榕),138,193,331,0
5569,권인숙(權仁淑),서범수(徐範洙),49,4,53,1
5570,권인숙(權仁淑),서병수(徐秉洙),49,4,53,1
5571,권인숙(權仁淑),서삼석(徐參錫),99,86,185,0
5572,권인숙(權仁淑),서영교(徐瑛敎),92,98,190,0
5573,권인숙(權仁淑),서영석(徐暎錫),91,97,188,0
5574,권인숙(權仁淑),서일준(徐一俊),50,7,57,1
5575,권인숙(權仁淑),서정숙(徐正淑),49,7,56,1
5576,권인숙(權仁淑),설훈(薛勳),81,62,143,0
5577,권인숙(權仁淑),성일종(成一鍾),49,10,59,1
5578,권인숙(權仁淑),소병철(蘇秉哲),95,68,163,0
5579,권인숙(權仁淑),소병훈(蘇秉勳),93,93,186,0
5580,권인숙(權仁淑),송갑석(宋甲錫),98,144,242,0
5581,권인숙(權仁淑),송기헌(宋基憲),83,51,134,0
5582,권인숙(權仁淑),송석준(宋錫俊),49,4,53,1
5583,권인숙(權仁淑),송언석(宋彦錫),45,4,49,1
5584,권인숙(權仁淑),송옥주(宋玉珠),107,130,237,0
5585,권인숙(權仁淑),송재호(宋在祜),96,85,181,0
5586,권인숙(權仁淑),신동근(申東根),94,81,175,0
5587,권인숙(權仁淑),신영대(申榮大),82,61,143,0
5588,권인숙(權仁淑),신원식(申源湜),51,4,55,1
5589,권인숙(權仁淑),신정훈(辛正勳),108,134,242,0
5590,권인숙(權仁淑),신현영(申賢榮),93,67,160,0
5591,권인숙(權仁淑),심상정(沈相奵),28,105,133,1
5592,권인숙(權仁淑),안규백(安圭伯),97,77,174,0
5593,권인숙(權仁淑),안민석(安敏錫),102,111,213,0
5594,권인숙(權仁淑),안병길(安炳吉),49,4,53,1
5595,권인숙(權仁淑),안철수(安哲秀),26,4,30,1
5596,권인숙(權仁淑),안호영(安浩永),93,110,203,0
5597,권인숙(權仁淑),양경숙(梁敬淑),97,104,201,0
5598,권인숙(權仁淑),양금희(梁琴喜),50,7,57,1
5599,권인숙(權仁淑),양기대(梁基大),85,50,135,0
5600,권인숙(權仁淑),양이원영(梁李媛瑛),116,147,263,0
5601,권인숙(權仁淑),양정숙(梁貞淑),64,156,220,1
5602,권인숙(權仁淑),양향자(梁香子),38,49,87,1
5603,권인숙(權仁淑),어기구(魚基龜),81,54,135,0
5604,권인숙(權仁淑),엄태영(嚴泰永),50,4,54,1
5605,권인숙(權仁淑),오기형(吳奇炯),82,47,129,0
5606,권인숙(權仁淑),오영환(吳永煥),137,206,343,0
5607,권인숙(權仁淑),용혜인(龍慧仁),30,98,128,1
5608,권인숙(權仁淑),우상호(禹相虎),80,45,125,0
5609,권인숙(權仁淑),우원식(禹元植),97,73,170,0
5610,권인숙(權仁淑),위성곤(魏聖坤),90,86,176,0
5611,권인숙(權仁淑),유경준(兪京濬),49,4,53,1
5612,권인숙(權仁淑),유기홍(柳基洪),100,86,186,0
5613,권인숙(權仁淑),유동수(柳東秀),101,71,172,0
5614,권인숙(權仁淑),유상범(劉相凡),50,5,55,1
5615,권인숙(權仁淑),유의동(兪義東),49,5,54,1
5616,권인숙(權仁淑),유정주(兪訂炷),126,162,288,0
5617,권인숙(權仁淑),윤건영(尹建永),83,79,162,0
5618,권인숙(權仁淑),윤관석(尹官石),85,69,154,1
5619,권인숙(權仁淑),윤두현(尹斗鉉),50,4,54,1
5620,권인숙(權仁淑),윤미향(尹美香),80,162,242,1
5621,권인숙(權仁淑),윤상현(尹相現),30,4,34,1
5622,권인숙(權仁淑),윤영덕(尹永德),110,156,266,0
5623,권인숙(權仁淑),윤영석(尹永碩),49,6,55,1
5624,권인숙(權仁淑),윤영찬(尹永燦),87,58,145,0
5625,권인숙(權仁淑),윤재갑(尹才鉀),112,95,207,0
5626,권인숙(權仁淑),윤재옥(尹在玉),49,4,53,1
5627,권인숙(權仁淑),윤주경(尹柱卿),49,5,54,1
5628,권인숙(權仁淑),윤준병(尹準炳),98,120,218,0
5629,권인숙(權仁淑),윤창현(尹暢賢),49,5,54,1
5630,권인숙(權仁淑),윤한홍(尹漢洪),49,4,53,1
5631,권인숙(權仁淑),윤호중(尹昊重),84,51,135,0
5632,권인숙(權仁淑),윤후덕(尹厚德),97,74,171,0
5633,권인숙(權仁淑),이개호(李介昊),85,52,137,0
5634,권인숙(權仁淑),이달곤(李達坤),51,5,56,1
5635,권인숙(權仁淑),이동주(李東洲),95,142,237,0
5636,권인숙(權仁淑),이만희(李晩熙),50,4,54,1
5637,권인숙(權仁淑),이명수(李明洙),49,10,59,1
5638,권인숙(權仁淑),이병훈(李炳勳),109,113,222,0
5639,권인숙(權仁淑),이상민(李相珉),75,38,113,0
5640,권인숙(權仁淑),이상헌(李相憲),81,78,159,0
5641,권인숙(權仁淑),이성만(李成萬),90,131,221,1
5642,권인숙(權仁淑),이소영(李素永),87,57,144,0
5643,권인숙(權仁淑),이수진(李壽珍),145,239,384,0
5644,권인숙(權仁淑),이수진(李秀眞),122,147,269,0
5645,권인숙(權仁淑),이양수(李亮壽),51,6,57,1
5646,권인숙(權仁淑),이용(李鏞),50,4,54,1
5647,권인숙(權仁淑),이용빈(李龍彬),112,148,260,0
5648,권인숙(權仁淑),이용선(李庸瑄),92,79,171,0
5649,권인숙(權仁淑),이용우(李龍雨),110,87,197,0
5650,권인숙(權仁淑),이용호(李容鎬),33,20,53,1
5651,권인숙(權仁淑),이원욱(李元旭),94,84,178,0
5652,권인숙(權仁淑),이원택(李源澤),94,94,188,0
5653,권인숙(權仁淑),이은주(李恩周),28,89,117,1
5654,권인숙(權仁淑),이인선(李仁善),25,4,29,1
5655,권인숙(權仁淑),이인영(李仁榮),80,55,135,0
5656,권인숙(權仁淑),이장섭(李將燮),88,72,160,0
5657,권인숙(權仁淑),이재명(李在明),40,20,60,0
5658,권인숙(權仁淑),이재정(李在汀),93,74,167,0
5659,권인숙(權仁淑),이정문(李楨文),90,87,177,0
5660,권인숙(權仁淑),이종배(李鍾培),51,6,57,1
5661,권인숙(權仁淑),이종성(李鍾成),51,8,59,1
5662,권인숙(權仁淑),이주환(李周桓),50,5,55,1
5663,권인숙(權仁淑),이채익(李埰益),51,6,57,1
5664,권인숙(權仁淑),이철규(李喆圭),51,5,56,1
5665,권인숙(權仁淑),이탄희(李誕熙),121,129,250,0
5666,권인숙(權仁淑),이태규(李泰珪),29,10,39,1
5667,권인숙(權仁淑),이학영(李學永),96,78,174,0
5668,권인숙(權仁淑),이해식(李海植),104,76,180,0
5669,권인숙(權仁淑),이헌승(李憲昇),50,4,54,1
5670,권인숙(權仁淑),이형석(李炯錫),99,86,185,0
5671,권인숙(權仁淑),인재근(印在謹),110,157,267,0
5672,권인숙(權仁淑),임병헌(林炳憲),25,4,29,1
5673,권인숙(權仁淑),임오경(林五卿),103,121,224,0
5674,권인숙(權仁淑),임이자(林利子),49,4,53,1
5675,권인숙(權仁淑),임종성(林鍾聲),100,110,210,0
5676,권인숙(權仁淑),임호선(林昊宣),101,124,225,0
5677,권인숙(權仁淑),장경태(張耿態),105,141,246,0
5678,권인숙(權仁淑),장동혁(張東赫),25,4,29,1
5679,권인숙(權仁淑),장제원(張濟元),49,4,53,1
5680,권인숙(權仁淑),장철민(張喆敏),95,94,189,0
5681,권인숙(權仁淑),장혜영(張惠英),38,89,127,1
5682,권인숙(權仁淑),전봉민(田奉珉),35,5,40,1
5683,권인숙(權仁淑),전용기(田溶冀),85,99,184,0
5684,권인숙(權仁淑),전재수(田載秀),85,54,139,0
5685,권인숙(權仁淑),전주혜(全珠惠),51,5,56,1
5686,권인숙(權仁淑),전해철(全海澈),77,51,128,0
5687,권인숙(權仁淑),전혜숙(全惠淑),109,112,221,0
5688,권인숙(權仁淑),정경희(丁慶姬),50,4,54,1
5689,권인숙(權仁淑),정동만(鄭東萬),49,4,53,1
5690,권인숙(權仁淑),정성호(鄭成湖),79,49,128,0
5691,권인숙(權仁淑),정우택(鄭宇澤),26,4,30,1
5692,권인숙(權仁淑),정운천(鄭雲天),50,4,54,1
5693,권인숙(權仁淑),정일영(鄭日永),90,83,173,0
5694,권인숙(權仁淑),정점식(鄭点植),49,4,53,1
5695,권인숙(權仁淑),정진석(鄭鎭碩),49,8,57,1
5696,권인숙(權仁淑),정청래(鄭淸來),104,126,230,0
5697,권인숙(權仁淑),정춘숙(鄭春淑),118,141,259,0
5698,권인숙(權仁淑),정태호(鄭泰浩),85,79,164,0
5699,권인숙(權仁淑),정필모(鄭必模),94,79,173,0
5700,권인숙(權仁淑),정희용(鄭熙溶),50,6,56,1
5701,권인숙(權仁淑),조경태(趙慶泰),50,4,54,1
5702,권인숙(權仁淑),조명희(曺明姬),50,7,57,1
5703,권인숙(權仁淑),조수진(趙修眞),50,4,54,1
5704,권인숙(權仁淑),조승래(趙承來),96,62,158,0
5705,권인숙(權仁淑),조오섭(曺五燮),116,141,257,0
5706,권인숙(權仁淑),조은희(趙恩禧),26,5,31,1
5707,권인숙(權仁淑),조응천(趙應天),75,33,108,0
5708,권인숙(權仁淑),조정식(趙正湜),76,36,112,0
5709,권인숙(權仁淑),조정훈(趙廷訓),7,22,29,1
5710,권인숙(權仁淑),조해진(曺海珍),51,6,57,1
5711,권인숙(權仁淑),주철현(朱哲鉉),103,97,200,0
5712,권인숙(權仁淑),주호영(朱豪英),49,4,53,1
5713,권인숙(權仁淑),지성호(池成浩),51,4,55,1
5714,권인숙(權仁淑),진선미(陳善美),95,85,180,0
5715,권인숙(權仁淑),진성준(陳聲準),102,94,196,0
5716,권인숙(權仁淑),천준호(千俊鎬),90,63,153,0
5717,권인숙(權仁淑),최기상(崔基相),82,61,143,0
5718,권인숙(權仁淑),최승재(崔承宰),50,5,55,1
5719,권인숙(權仁淑),최연숙(崔姸淑),32,18,50,1
5720,권인숙(權仁淑),최영희(崔英姬),25,4,29,1
5721,권인숙(權仁淑),최인호(崔仁昊),82,60,142,0
5722,권인숙(權仁淑),최재형(崔在亨),25,4,29,1
5723,권인숙(權仁淑),최종윤(崔鍾允),104,105,209,0
5724,권인숙(權仁淑),최춘식(崔春植),49,4,53,1
5725,권인숙(權仁淑),최형두(崔炯斗),50,6,56,1
5726,권인숙(權仁淑),최혜영(崔惠英),121,157,278,0
5727,권인숙(權仁淑),추경호(秋慶鎬),49,3,52,1
5728,권인숙(權仁淑),태영호(太永浩),49,11,60,1
5729,권인숙(權仁淑),하영제(河榮帝),41,1,42,1
5730,권인숙(權仁淑),하태경(河泰慶),50,4,54,1
5731,권인숙(權仁淑),한기호(韓起鎬),50,4,54,1
5732,권인숙(權仁淑),한무경(韓茂景),49,5,54,1
5733,권인숙(權仁淑),한병도(韓秉道),99,87,186,0
5734,권인숙(權仁淑),한정애(韓貞愛),84,73,157,0
5735,권인숙(權仁淑),한준호(韓俊鎬),95,89,184,0
5736,권인숙(權仁淑),허숙정(許淑湞),1,1,2,0
5737,권인숙(權仁淑),허영(許榮),105,92,197,0
5738,권인숙(權仁淑),허은아(許垠娥),50,5,55,1
5739,권인숙(權仁淑),허종식(許琮植),98,77,175,0
5740,권인숙(權仁淑),홍기원(洪起元),96,80,176,0
5741,권인숙(權仁淑),홍문표(洪文杓),49,5,54,1
5742,권인숙(權仁淑),홍석준(洪碩晙),49,4,53,1
5743,권인숙(權仁淑),홍성국(洪性國),119,127,246,0
5744,권인숙(權仁淑),홍영표(洪永杓),83,62,145,0
5745,권인숙(權仁淑),홍익표(洪翼杓),82,68,150,0
5746,권인숙(權仁淑),홍정민(洪貞敏),107,93,200,0
5747,권인숙(權仁淑),황보승희(皇甫承希),45,2,47,1
5748,권인숙(權仁淑),황운하(黃雲夏),123,112,235,0
5749,권인숙(權仁淑),황희(黃熙),81,38,119,0
5750,권칠승(權七勝),기동민(奇東旻),95,95,190,0
5751,권칠승(權七勝),김경만(金京萬),118,102,220,0
5752,권칠승(權七勝),김경협(金炅俠),93,61,154,0
5753,권칠승(權七勝),김교흥(金敎興),92,66,158,0
5754,권칠승(權七勝),김기현(金起炫),53,7,60,1
5755,권칠승(權七勝),김남국(金南局),88,64,152,1
5756,권칠승(權七勝),김도읍(金度邑),51,4,55,1
5757,권칠승(權七勝),김두관(金斗官),95,72,167,0
5758,권칠승(權七勝),김미애(金美愛),51,4,55,1
5759,권칠승(權七勝),김민기(金敏基),101,62,163,0
5760,권칠승(權七勝),김민석(金民錫),105,99,204,0
5761,권칠승(權七勝),김민철(金敏徹),99,80,179,0
5762,권칠승(權七勝),김병기(金炳基),89,58,147,0
5763,권칠승(權七勝),김병욱A(金炳旭),106,81,187,0
5764,권칠승(權七勝),김병욱B(金炳旭),45,5,50,1
5765,권칠승(權七勝),김병주(金柄周),86,31,117,0
5766,권칠승(權七勝),김상훈(金相勳),54,6,60,1
5767,권칠승(權七勝),김상희(金相姬),94,102,196,0
5768,권칠승(權七勝),김석기(金碩基),53,4,57,1
5769,권칠승(權七勝),김성원(金成願),53,5,58,1
5770,권칠승(權七勝),김성주(金成柱),102,74,176,0
5771,권칠승(權七勝),김성환(金星煥),89,46,135,0
5772,권칠승(權七勝),김수흥(金洙興),95,64,159,0
5773,권칠승(權七勝),김승남(金承南),96,95,191,0
5774,권칠승(權七勝),김승수(金承洙),54,4,58,1
5775,권칠승(權七勝),김승원(金勝源),119,114,233,0
5776,권칠승(權七勝),김영배(金永培),108,112,220,0
5777,권칠승(權七勝),김영선(金映宣),26,4,30,1
5778,권칠승(權七勝),김영식(金英植),54,4,58,1
5779,권칠승(權七勝),김영주(金榮珠),91,67,158,0
5780,권칠승(權七勝),김영진(金榮鎭),84,51,135,0
5781,권칠승(權七勝),김영호(金映豪),96,58,154,0
5782,권칠승(權七勝),김예지(金睿智),53,6,59,1
5783,권칠승(權七勝),김용민(金容民),90,61,151,0
5784,권칠승(權七勝),김용판(金用判),53,4,57,1
5785,권칠승(權七勝),김웅(金雄),51,4,55,1
5786,권칠승(權七勝),김원이(金元二),96,87,183,0
5787,권칠승(權七勝),김윤덕(金潤德),97,59,156,0
5788,권칠승(權七勝),김의겸(金宜謙),59,61,120,0
5789,권칠승(權七勝),김정재(金汀才),54,5,59,1
5790,권칠승(權七勝),김정호(金禎鎬),118,150,268,0
5791,권칠승(權七勝),김종민(金鐘民),84,86,170,0
5792,권칠승(權七勝),김주영(金周暎),96,76,172,0
5793,권칠승(權七勝),김진표(金振杓),50,30,80,1
5794,권칠승(權七勝),김철민(金哲玟),127,159,286,0
5795,권칠승(權七勝),김태년(金太年),87,68,155,0
5796,권칠승(權七勝),김태호(金台鎬),42,6,48,1
5797,권칠승(權七勝),김학용(金學容),26,4,30,1
5798,권칠승(權七勝),김한규(金翰奎),43,41,84,0
5799,권칠승(權七勝),김한정(金漢正),79,44,123,0
5800,권칠승(權七勝),김형동(金亨東),53,4,57,1
5801,권칠승(權七勝),김홍걸(金弘傑),43,94,137,0
5802,권칠승(權七勝),김회재(金會在),107,71,178,0
5803,권칠승(權七勝),김희곤(金熙坤),51,9,60,1
5804,권칠승(權七勝),김희국(金熙國),50,4,54,1
5805,권칠승(權七勝),남인순(南仁順),103,91,194,0
5806,권칠승(權七勝),노용호(魯容昊),25,4,29,1
5807,권칠승(權七勝),노웅래(盧雄來),88,61,149,0
5808,권칠승(權七勝),도종환(都鍾煥),101,100,201,0
5809,권칠승(權七勝),류성걸(柳性杰),50,4,54,1
5810,권칠승(權七勝),류호정(柳好貞),17,17,34,1
5811,권칠승(權七勝),맹성규(孟聖奎),93,65,158,0
5812,권칠승(權七勝),문정복(文貞福),86,45,131,0
5813,권칠승(權七勝),문진석(文振碩),99,61,160,0
5814,권칠승(權七勝),민병덕(閔炳德),89,103,192,0
5815,권칠승(權七勝),민형배(閔馨培),77,89,166,0
5816,권칠승(權七勝),민홍철(閔洪喆),87,53,140,0
5817,권칠승(權七勝),박광온(朴洸瑥),108,76,184,0
5818,권칠승(權七勝),박대수(朴大壽),50,4,54,1
5819,권칠승(權七勝),박대출(朴大出),50,4,54,1
5820,권칠승(權七勝),박덕흠(朴德欽),37,5,42,1
5821,권칠승(權七勝),박범계(朴範界),77,48,125,0
5822,권칠승(權七勝),박병석(朴炳錫),40,16,56,0
5823,권칠승(權七勝),박상혁(朴商赫),102,91,193,0
5824,권칠승(權七勝),박성민(朴聖敏),50,4,54,1
5825,권칠승(權七勝),박성준(朴省俊),105,120,225,0
5826,권칠승(權七勝),박성중(朴成重),49,4,53,1
5827,권칠승(權七勝),박수영(朴洙瑩),49,4,53,1
5828,권칠승(權七勝),박영순(朴英淳),97,68,165,0
5829,권칠승(權七勝),박완주(朴完柱),45,42,87,1
5830,권칠승(權七勝),박용진(朴用鎭),83,61,144,0
5831,권칠승(權七勝),박재호(朴在昊),98,73,171,0
5832,권칠승(權七勝),박정(朴釘),118,134,252,0
5833,권칠승(權七勝),박정하(朴正河),26,4,30,1
5834,권칠승(權七勝),박주민(朴柱民),84,61,145,0
5835,권칠승(權七勝),박진(朴振),50,3,53,1
5836,권칠승(權七勝),박찬대(朴贊大),85,59,144,0
5837,권칠승(權七勝),박형수(朴亨修),50,5,55,1
5838,권칠승(權七勝),박홍근(朴洪根),112,108,220,0
5839,권칠승(權七勝),배준영(裵俊英),49,4,53,1
5840,권칠승(權七勝),배진교(裵晋敎),13,12,25,1
5841,권칠승(權七勝),배현진(裵賢鎭),50,4,54,1
5842,권칠승(權七勝),백종헌(白宗憲),50,5,55,1
5843,권칠승(權七勝),백혜련(白惠蓮),95,66,161,0
5844,권칠승(權七勝),변재일(卞在一),78,57,135,0
5845,권칠승(權七勝),서동용(徐東榕),104,84,188,0
5846,권칠승(權七勝),서범수(徐範洙),50,6,56,1
5847,권칠승(權七勝),서병수(徐秉洙),50,4,54,1
5848,권칠승(權七勝),서삼석(徐參錫),100,79,179,0
5849,권칠승(權七勝),서영교(徐瑛敎),88,69,157,0
5850,권칠승(權七勝),서영석(徐暎錫),104,97,201,0
5851,권칠승(權七勝),서일준(徐一俊),50,5,55,1
5852,권칠승(權七勝),서정숙(徐正淑),50,4,54,1
5853,권칠승(權七勝),설훈(薛勳),82,44,126,0
5854,권칠승(權七勝),성일종(成一鍾),51,4,55,1
5855,권칠승(權七勝),소병철(蘇秉哲),82,62,144,0
5856,권칠승(權七勝),소병훈(蘇秉勳),91,71,162,0
5857,권칠승(權七勝),송갑석(宋甲錫),94,107,201,0
5858,권칠승(權七勝),송기헌(宋基憲),79,47,126,0
5859,권칠승(權七勝),송석준(宋錫俊),50,7,57,1
5860,권칠승(權七勝),송언석(宋彦錫),46,4,50,1
5861,권칠승(權七勝),송옥주(宋玉珠),110,103,213,0
5862,권칠승(權七勝),송재호(宋在祜),94,63,157,0
5863,권칠승(權七勝),신동근(申東根),95,74,169,0
5864,권칠승(權七勝),신영대(申榮大),86,57,143,0
5865,권칠승(權七勝),신원식(申源湜),50,4,54,1
5866,권칠승(權七勝),신정훈(辛正勳),112,129,241,0
5867,권칠승(權七勝),신현영(申賢榮),78,52,130,0
5868,권칠승(權七勝),심상정(沈相奵),12,13,25,1
5869,권칠승(權七勝),안규백(安圭伯),96,68,164,0
5870,권칠승(權七勝),안민석(安敏錫),95,70,165,0
5871,권칠승(權七勝),안병길(安炳吉),50,4,54,1
5872,권칠승(權七勝),안철수(安哲秀),26,4,30,1
5873,권칠승(權七勝),안호영(安浩永),86,55,141,0
5874,권칠승(權七勝),양경숙(梁敬淑),90,71,161,0
5875,권칠승(權七勝),양금희(梁琴喜),51,5,56,1
5876,권칠승(權七勝),양기대(梁基大),86,55,141,0
5877,권칠승(權七勝),양이원영(梁李媛瑛),86,53,139,0
5878,권칠승(權七勝),양정숙(梁貞淑),40,81,121,1
5879,권칠승(權七勝),양향자(梁香子),38,31,69,1
5880,권칠승(權七勝),어기구(魚基龜),74,40,114,0
5881,권칠승(權七勝),엄태영(嚴泰永),51,4,55,1
5882,권칠승(權七勝),오기형(吳奇炯),75,48,123,0
5883,권칠승(權七勝),오영환(吳永煥),111,158,269,0
5884,권칠승(權七勝),용혜인(龍慧仁),14,27,41,1
5885,권칠승(權七勝),우상호(禹相虎),77,46,123,0
5886,권칠승(權七勝),우원식(禹元植),82,49,131,0
5887,권칠승(權七勝),위성곤(魏聖坤),82,75,157,0
5888,권칠승(權七勝),유경준(兪京濬),50,4,54,1
5889,권칠승(權七勝),유기홍(柳基洪),80,58,138,0
5890,권칠승(權七勝),유동수(柳東秀),92,69,161,0
5891,권칠승(權七勝),유상범(劉相凡),50,4,54,1
5892,권칠승(權七勝),유의동(兪義東),50,4,54,1
5893,권칠승(權七勝),유정주(兪訂炷),92,85,177,0
5894,권칠승(權七勝),윤건영(尹建永),82,51,133,0
5895,권칠승(權七勝),윤관석(尹官石),75,58,133,1
5896,권칠승(權七勝),윤두현(尹斗鉉),50,4,54,1
5897,권칠승(權七勝),윤미향(尹美香),59,71,130,1
5898,권칠승(權七勝),윤상현(尹相現),31,5,36,1
5899,권칠승(權七勝),윤영덕(尹永德),89,69,158,0
5900,권칠승(權七勝),윤영석(尹永碩),50,4,54,1
5901,권칠승(權七勝),윤영찬(尹永燦),91,66,157,0
5902,권칠승(權七勝),윤재갑(尹才鉀),96,85,181,0
5903,권칠승(權七勝),윤재옥(尹在玉),50,4,54,1
5904,권칠승(權七勝),윤주경(尹柱卿),50,4,54,1
5905,권칠승(權七勝),윤준병(尹準炳),83,72,155,0
5906,권칠승(權七勝),윤창현(尹暢賢),50,4,54,1
5907,권칠승(權七勝),윤한홍(尹漢洪),50,4,54,1
5908,권칠승(權七勝),윤호중(尹昊重),78,66,144,0
5909,권칠승(權七勝),윤후덕(尹厚德),96,85,181,0
5910,권칠승(權七勝),이개호(李介昊),82,61,143,0
5911,권칠승(權七勝),이달곤(李達坤),52,5,57,1
5912,권칠승(權七勝),이동주(李東洲),87,97,184,0
5913,권칠승(權七勝),이만희(李晩熙),50,4,54,1
5914,권칠승(權七勝),이명수(李明洙),50,7,57,1
5915,권칠승(權七勝),이병훈(李炳勳),102,97,199,0
5916,권칠승(權七勝),이상민(李相珉),77,33,110,0
5917,권칠승(權七勝),이상헌(李相憲),94,73,167,0
5918,권칠승(權七勝),이성만(李成萬),89,85,174,1
5919,권칠승(權七勝),이소영(李素永),79,40,119,0
5920,권칠승(權七勝),이수진(李壽珍),106,103,209,0
5921,권칠승(權七勝),이수진(李秀眞),106,73,179,0
5922,권칠승(權七勝),이양수(李亮壽),51,4,55,1
5923,권칠승(權七勝),이용(李鏞),50,5,55,1
5924,권칠승(權七勝),이용빈(李龍彬),103,103,206,0
5925,권칠승(權七勝),이용선(李庸瑄),93,71,164,0
5926,권칠승(權七勝),이용우(李龍雨),99,71,170,0
5927,권칠승(權七勝),이용호(李容鎬),31,18,49,1
5928,권칠승(權七勝),이원욱(李元旭),92,88,180,0
5929,권칠승(權七勝),이원택(李源澤),97,73,170,0
5930,권칠승(權七勝),이은주(李恩周),14,15,29,1
5931,권칠승(權七勝),이인선(李仁善),26,4,30,1
5932,권칠승(權七勝),이인영(李仁榮),77,39,116,0
5933,권칠승(權七勝),이장섭(李將燮),102,101,203,0
5934,권칠승(權七勝),이재명(李在明),40,18,58,0
5935,권칠승(權七勝),이재정(李在汀),80,42,122,0
5936,권칠승(權七勝),이정문(李楨文),99,83,182,0
5937,권칠승(權七勝),이종배(李鍾培),50,5,55,1
5938,권칠승(權七勝),이종성(李鍾成),50,5,55,1
5939,권칠승(權七勝),이주환(李周桓),49,4,53,1
5940,권칠승(權七勝),이채익(李埰益),51,5,56,1
5941,권칠승(權七勝),이철규(李喆圭),51,4,55,1
5942,권칠승(權七勝),이탄희(李誕熙),94,75,169,0
5943,권칠승(權七勝),이태규(李泰珪),28,5,33,1
5944,권칠승(權七勝),이학영(李學永),99,100,199,0
5945,권칠승(權七勝),이해식(李海植),93,72,165,0
5946,권칠승(權七勝),이헌승(李憲昇),52,4,56,1
5947,권칠승(權七勝),이형석(李炯錫),98,100,198,0
5948,권칠승(權七勝),인재근(印在謹),106,106,212,0
5949,권칠승(權七勝),임병헌(林炳憲),26,4,30,1
5950,권칠승(權七勝),임오경(林五卿),84,58,142,0
5951,권칠승(權七勝),임이자(林利子),50,4,54,1
5952,권칠승(權七勝),임종성(林鍾聲),101,129,230,0
5953,권칠승(權七勝),임호선(林昊宣),114,173,287,0
5954,권칠승(權七勝),장경태(張耿態),95,77,172,0
5955,권칠승(權七勝),장동혁(張東赫),26,4,30,1
5956,권칠승(權七勝),장제원(張濟元),49,4,53,1
5957,권칠승(權七勝),장철민(張喆敏),86,58,144,0
5958,권칠승(權七勝),장혜영(張惠英),14,11,25,1
5959,권칠승(權七勝),전봉민(田奉珉),35,5,40,1
5960,권칠승(權七勝),전용기(田溶冀),97,108,205,0
5961,권칠승(權七勝),전재수(田載秀),99,66,165,0
5962,권칠승(權七勝),전주혜(全珠惠),52,4,56,1
5963,권칠승(權七勝),전해철(全海澈),78,54,132,0
5964,권칠승(權七勝),전혜숙(全惠淑),100,83,183,0
5965,권칠승(權七勝),정경희(丁慶姬),49,4,53,1
5966,권칠승(權七勝),정동만(鄭東萬),49,4,53,1
5967,권칠승(權七勝),정성호(鄭成湖),78,70,148,0
5968,권칠승(權七勝),정우택(鄭宇澤),25,4,29,1
5969,권칠승(權七勝),정운천(鄭雲天),51,4,55,1
5970,권칠승(權七勝),정일영(鄭日永),88,81,169,0
5971,권칠승(權七勝),정점식(鄭点植),50,4,54,1
5972,권칠승(權七勝),정진석(鄭鎭碩),50,4,54,1
5973,권칠승(權七勝),정청래(鄭淸來),84,65,149,0
5974,권칠승(權七勝),정춘숙(鄭春淑),103,142,245,0
5975,권칠승(權七勝),정태호(鄭泰浩),84,74,158,0
5976,권칠승(權七勝),정필모(鄭必模),84,58,142,0
5977,권칠승(權七勝),정희용(鄭熙溶),52,5,57,1
5978,권칠승(權七勝),조경태(趙慶泰),50,5,55,1
5979,권칠승(權七勝),조명희(曺明姬),50,4,54,1
5980,권칠승(權七勝),조수진(趙修眞),49,4,53,1
5981,권칠승(權七勝),조승래(趙承來),92,58,150,0
5982,권칠승(權七勝),조오섭(曺五燮),98,96,194,0
5983,권칠승(權七勝),조은희(趙恩禧),26,4,30,1
5984,권칠승(權七勝),조응천(趙應天),91,37,128,0
5985,권칠승(權七勝),조정식(趙正湜),80,51,131,0
5986,권칠승(權七勝),조정훈(趙廷訓),5,6,11,1
5987,권칠승(權七勝),조해진(曺海珍),52,6,58,1
5988,권칠승(權七勝),주철현(朱哲鉉),90,53,143,0
5989,권칠승(權七勝),주호영(朱豪英),50,4,54,1
5990,권칠승(權七勝),지성호(池成浩),50,4,54,1
5991,권칠승(權七勝),진선미(陳善美),83,51,134,0
5992,권칠승(權七勝),진성준(陳聲準),88,55,143,0
5993,권칠승(權七勝),천준호(千俊鎬),82,56,138,0
5994,권칠승(權七勝),최기상(崔基相),82,73,155,0
5995,권칠승(權七勝),최승재(崔承宰),50,5,55,1
5996,권칠승(權七勝),최연숙(崔姸淑),33,13,46,1
5997,권칠승(權七勝),최영희(崔英姬),26,6,32,1
5998,권칠승(權七勝),최인호(崔仁昊),91,77,168,0
5999,권칠승(權七勝),최재형(崔在亨),26,4,30,1
6000,권칠승(權七勝),최종윤(崔鍾允),98,73,171,0
6001,권칠승(權七勝),최춘식(崔春植),50,5,55,1
6002,권칠승(權七勝),최형두(崔炯斗),51,4,55,1
6003,권칠승(權七勝),최혜영(崔惠英),113,133,246,0
6004,권칠승(權七勝),추경호(秋慶鎬),49,3,52,1
6005,권칠승(權七勝),태영호(太永浩),50,4,54,1
6006,권칠승(權七勝),하영제(河榮帝),42,1,43,1
6007,권칠승(權七勝),하태경(河泰慶),49,4,53,1
6008,권칠승(權七勝),한기호(韓起鎬),51,4,55,1
6009,권칠승(權七勝),한무경(韓茂景),53,4,57,1
6010,권칠승(權七勝),한병도(韓秉道),104,91,195,0
6011,권칠승(權七勝),한정애(韓貞愛),86,66,152,0
6012,권칠승(權七勝),한준호(韓俊鎬),92,96,188,0
6013,권칠승(權七勝),허숙정(許淑湞),1,3,4,0
6014,권칠승(權七勝),허영(許榮),99,99,198,0
6015,권칠승(權七勝),허은아(許垠娥),50,4,54,1
6016,권칠승(權七勝),허종식(許琮植),91,96,187,0
6017,권칠승(權七勝),홍기원(洪起元),87,68,155,0
6018,권칠승(權七勝),홍문표(洪文杓),50,5,55,1
6019,권칠승(權七勝),홍석준(洪碩晙),51,4,55,1
6020,권칠승(權七勝),홍성국(洪性國),102,98,200,0
6021,권칠승(權七勝),홍영표(洪永杓),81,54,135,0
6022,권칠승(權七勝),홍익표(洪翼杓),87,64,151,0
6023,권칠승(權七勝),홍정민(洪貞敏),93,97,190,0
6024,권칠승(權七勝),황보승희(皇甫承希),45,1,46,1
6025,권칠승(權七勝),황운하(黃雲夏),106,104,210,0
6026,권칠승(權七勝),황희(黃熙),81,38,119,0
6027,기동민(奇東旻),김경만(金京萬),109,87,196,0
6028,기동민(奇東旻),김경협(金炅俠),121,104,225,0
6029,기동민(奇東旻),김교흥(金敎興),96,58,154,0
6030,기동민(奇東旻),김기현(金起炫),52,4,56,1
6031,기동민(奇東旻),김남국(金南局),84,98,182,1
6032,기동민(奇東旻),김도읍(金度邑),51,3,54,1
6033,기동민(奇東旻),김두관(金斗官),107,120,227,0
6034,기동민(奇東旻),김미애(金美愛),51,3,54,1
6035,기동민(奇東旻),김민기(金敏基),110,97,207,0
6036,기동민(奇東旻),김민석(金民錫),109,88,197,0
6037,기동민(奇東旻),김민철(金敏徹),96,102,198,0
6038,기동민(奇東旻),김병기(金炳基),127,132,259,0
6039,기동민(奇東旻),김병욱A(金炳旭),96,87,183,0
6040,기동민(奇東旻),김병욱B(金炳旭),44,3,47,1
6041,기동민(奇東旻),김병주(金柄周),91,57,148,0
6042,기동민(奇東旻),김상훈(金相勳),53,4,57,1
6043,기동민(奇東旻),김상희(金相姬),94,102,196,0
6044,기동민(奇東旻),김석기(金碩基),52,3,55,1
6045,기동민(奇東旻),김성원(金成願),52,3,55,1
6046,기동민(奇東旻),김성주(金成柱),102,81,183,0
6047,기동민(奇東旻),김성환(金星煥),92,98,190,0
6048,기동민(奇東旻),김수흥(金洙興),120,67,187,0
6049,기동민(奇東旻),김승남(金承南),97,96,193,0
6050,기동민(奇東旻),김승수(金承洙),52,5,57,1
6051,기동민(奇東旻),김승원(金勝源),120,135,255,0
6052,기동민(奇東旻),김영배(金永培),120,140,260,0
6053,기동민(奇東旻),김영선(金映宣),26,3,29,1
6054,기동민(奇東旻),김영식(金英植),51,3,54,1
6055,기동민(奇東旻),김영주(金榮珠),94,72,166,0
6056,기동민(奇東旻),김영진(金榮鎭),81,71,152,0
6057,기동민(奇東旻),김영호(金映豪),99,85,184,0
6058,기동민(奇東旻),김예지(金睿智),53,5,58,1
6059,기동민(奇東旻),김용민(金容民),92,128,220,0
6060,기동민(奇東旻),김용판(金用判),52,3,55,1
6061,기동민(奇東旻),김웅(金雄),52,3,55,1
6062,기동민(奇東旻),김원이(金元二),168,262,430,0
6063,기동민(奇東旻),김윤덕(金潤德),98,103,201,0
6064,기동민(奇東旻),김의겸(金宜謙),50,102,152,0
6065,기동민(奇東旻),김정재(金汀才),53,4,57,1
6066,기동민(奇東旻),김정호(金禎鎬),107,173,280,0
6067,기동민(奇東旻),김종민(金鐘民),93,89,182,0
6068,기동민(奇東旻),김주영(金周暎),115,100,215,0
6069,기동민(奇東旻),김진표(金振杓),67,64,131,1
6070,기동민(奇東旻),김철민(金哲玟),131,176,307,0
6071,기동민(奇東旻),김태년(金太年),79,63,142,0
6072,기동민(奇東旻),김태호(金台鎬),42,3,45,1
6073,기동민(奇東旻),김학용(金學容),25,3,28,1
6074,기동민(奇東旻),김한규(金翰奎),41,39,80,0
6075,기동민(奇東旻),김한정(金漢正),79,53,132,0
6076,기동민(奇東旻),김형동(金亨東),51,5,56,1
6077,기동민(奇東旻),김홍걸(金弘傑),55,104,159,0
6078,기동민(奇東旻),김회재(金會在),115,105,220,0
6079,기동민(奇東旻),김희곤(金熙坤),50,3,53,1
6080,기동민(奇東旻),김희국(金熙國),49,3,52,1
6081,기동민(奇東旻),남인순(南仁順),105,105,210,0
6082,기동민(奇東旻),노용호(魯容昊),25,3,28,1
6083,기동민(奇東旻),노웅래(盧雄來),100,93,193,0
6084,기동민(奇東旻),도종환(都鍾煥),125,115,240,0
6085,기동민(奇東旻),류성걸(柳性杰),49,3,52,1
6086,기동민(奇東旻),류호정(柳好貞),20,46,66,1
6087,기동민(奇東旻),맹성규(孟聖奎),108,75,183,0
6088,기동민(奇東旻),문정복(文貞福),93,71,164,0
6089,기동민(奇東旻),문진석(文振碩),106,113,219,0
6090,기동민(奇東旻),민병덕(閔炳德),107,164,271,0
6091,기동민(奇東旻),민형배(閔馨培),88,166,254,0
6092,기동민(奇東旻),민홍철(閔洪喆),92,92,184,0
6093,기동민(奇東旻),박광온(朴洸瑥),85,67,152,0
6094,기동민(奇東旻),박대수(朴大壽),50,7,57,1
6095,기동민(奇東旻),박대출(朴大出),50,3,53,1
6096,기동민(奇東旻),박덕흠(朴德欽),37,4,41,1
6097,기동민(奇東旻),박범계(朴範界),76,58,134,0
6098,기동민(奇東旻),박병석(朴炳錫),40,19,59,0
6099,기동민(奇東旻),박상혁(朴商赫),114,222,336,0
6100,기동민(奇東旻),박성민(朴聖敏),51,4,55,1
6101,기동민(奇東旻),박성준(朴省俊),123,127,250,0
6102,기동민(奇東旻),박성중(朴成重),49,5,54,1
6103,기동민(奇東旻),박수영(朴洙瑩),49,12,61,1
6104,기동민(奇東旻),박영순(朴英淳),101,92,193,0
6105,기동민(奇東旻),박완주(朴完柱),57,49,106,1
6106,기동민(奇東旻),박용진(朴用鎭),118,163,281,0
6107,기동민(奇東旻),박재호(朴在昊),88,80,168,0
6108,기동민(奇東旻),박정(朴釘),115,97,212,0
6109,기동민(奇東旻),박정하(朴正河),25,3,28,1
6110,기동민(奇東旻),박주민(朴柱民),80,85,165,0
6111,기동민(奇東旻),박진(朴振),50,4,54,1
6112,기동민(奇東旻),박찬대(朴贊大),88,86,174,0
6113,기동민(奇東旻),박형수(朴亨修),49,3,52,1
6114,기동민(奇東旻),박홍근(朴洪根),144,171,315,0
6115,기동민(奇東旻),배준영(裵俊英),49,3,52,1
6116,기동민(奇東旻),배진교(裵晋敎),17,42,59,1
6117,기동민(奇東旻),배현진(裵賢鎭),49,3,52,1
6118,기동민(奇東旻),백종헌(白宗憲),50,3,53,1
6119,기동민(奇東旻),백혜련(白惠蓮),93,77,170,0
6120,기동민(奇東旻),변재일(卞在一),96,95,191,0
6121,기동민(奇東旻),서동용(徐東榕),102,93,195,0
6122,기동민(奇東旻),서범수(徐範洙),51,3,54,1
6123,기동민(奇東旻),서병수(徐秉洙),50,3,53,1
6124,기동민(奇東旻),서삼석(徐參錫),95,117,212,0
6125,기동민(奇東旻),서영교(徐瑛敎),109,120,229,0
6126,기동민(奇東旻),서영석(徐暎錫),111,149,260,0
6127,기동민(奇東旻),서일준(徐一俊),50,3,53,1
6128,기동민(奇東旻),서정숙(徐正淑),49,3,52,1
6129,기동민(奇東旻),설훈(薛勳),88,60,148,0
6130,기동민(奇東旻),성일종(成一鍾),51,5,56,1
6131,기동민(奇東旻),소병철(蘇秉哲),92,74,166,0
6132,기동민(奇東旻),소병훈(蘇秉勳),106,99,205,0
6133,기동민(奇東旻),송갑석(宋甲錫),138,160,298,0
6134,기동민(奇東旻),송기헌(宋基憲),81,50,131,0
6135,기동민(奇東旻),송석준(宋錫俊),51,3,54,1
6136,기동민(奇東旻),송언석(宋彦錫),45,3,48,1
6137,기동민(奇東旻),송옥주(宋玉珠),111,153,264,0
6138,기동민(奇東旻),송재호(宋在祜),106,90,196,0
6139,기동민(奇東旻),신동근(申東根),107,103,210,0
6140,기동민(奇東旻),신영대(申榮大),85,67,152,0
6141,기동민(奇東旻),신원식(申源湜),49,3,52,1
6142,기동민(奇東旻),신정훈(辛正勳),125,184,309,0
6143,기동민(奇東旻),신현영(申賢榮),82,68,150,0
6144,기동민(奇東旻),심상정(沈相奵),15,42,57,1
6145,기동민(奇東旻),안규백(安圭伯),122,98,220,0
6146,기동민(奇東旻),안민석(安敏錫),115,137,252,0
6147,기동민(奇東旻),안병길(安炳吉),50,3,53,1
6148,기동민(奇東旻),안철수(安哲秀),25,3,28,1
6149,기동민(奇東旻),안호영(安浩永),89,72,161,0
6150,기동민(奇東旻),양경숙(梁敬淑),101,94,195,0
6151,기동민(奇東旻),양금희(梁琴喜),50,3,53,1
6152,기동민(奇東旻),양기대(梁基大),88,79,167,0
6153,기동민(奇東旻),양이원영(梁李媛瑛),100,116,216,0
6154,기동민(奇東旻),양정숙(梁貞淑),53,162,215,1
6155,기동민(奇東旻),양향자(梁香子),49,40,89,1
6156,기동민(奇東旻),어기구(魚基龜),86,57,143,0
6157,기동민(奇東旻),엄태영(嚴泰永),51,3,54,1
6158,기동민(奇東旻),오기형(吳奇炯),84,55,139,0
6159,기동민(奇東旻),오영환(吳永煥),131,194,325,0
6160,기동민(奇東旻),용혜인(龍慧仁),32,78,110,1
6161,기동민(奇東旻),우상호(禹相虎),81,40,121,0
6162,기동민(奇東旻),우원식(禹元植),113,107,220,0
6163,기동민(奇東旻),위성곤(魏聖坤),103,125,228,0
6164,기동민(奇東旻),유경준(兪京濬),49,4,53,1
6165,기동민(奇東旻),유기홍(柳基洪),82,60,142,0
6166,기동민(奇東旻),유동수(柳東秀),95,103,198,0
6167,기동민(奇東旻),유상범(劉相凡),50,3,53,1
6168,기동민(奇東旻),유의동(兪義東),50,3,53,1
6169,기동민(奇東旻),유정주(兪訂炷),103,117,220,0
6170,기동민(奇東旻),윤건영(尹建永),86,67,153,0
6171,기동민(奇東旻),윤관석(尹官石),77,75,152,1
6172,기동민(奇東旻),윤두현(尹斗鉉),49,3,52,1
6173,기동민(奇東旻),윤미향(尹美香),53,69,122,1
6174,기동민(奇東旻),윤상현(尹相現),30,3,33,1
6175,기동민(奇東旻),윤영덕(尹永德),96,153,249,0
6176,기동민(奇東旻),윤영석(尹永碩),51,4,55,1
6177,기동민(奇東旻),윤영찬(尹永燦),85,60,145,0
6178,기동민(奇東旻),윤재갑(尹才鉀),95,73,168,0
6179,기동민(奇東旻),윤재옥(尹在玉),50,3,53,1
6180,기동민(奇東旻),윤주경(尹柱卿),49,3,52,1
6181,기동민(奇東旻),윤준병(尹準炳),106,143,249,0
6182,기동민(奇東旻),윤창현(尹暢賢),49,3,52,1
6183,기동민(奇東旻),윤한홍(尹漢洪),50,3,53,1
6184,기동민(奇東旻),윤호중(尹昊重),81,61,142,0
6185,기동민(奇東旻),윤후덕(尹厚德),93,88,181,0
6186,기동민(奇東旻),이개호(李介昊),89,73,162,0
6187,기동민(奇東旻),이달곤(李達坤),51,4,55,1
6188,기동민(奇東旻),이동주(李東洲),102,165,267,0
6189,기동민(奇東旻),이만희(李晩熙),50,3,53,1
6190,기동민(奇東旻),이명수(李明洙),63,15,78,1
6191,기동민(奇東旻),이병훈(李炳勳),103,90,193,0
6192,기동민(奇東旻),이상민(李相珉),94,52,146,0
6193,기동민(奇東旻),이상헌(李相憲),96,103,199,0
6194,기동민(奇東旻),이성만(李成萬),100,91,191,1
6195,기동민(奇東旻),이소영(李素永),94,97,191,0
6196,기동민(奇東旻),이수진(李壽珍),114,148,262,0
6197,기동민(奇東旻),이수진(李秀眞),104,111,215,0
6198,기동민(奇東旻),이양수(李亮壽),52,4,56,1
6199,기동민(奇東旻),이용(李鏞),49,3,52,1
6200,기동민(奇東旻),이용빈(李龍彬),122,185,307,0
6201,기동민(奇東旻),이용선(李庸瑄),89,107,196,0
6202,기동민(奇東旻),이용우(李龍雨),87,66,153,0
6203,기동민(奇東旻),이용호(李容鎬),31,11,42,1
6204,기동민(奇東旻),이원욱(李元旭),97,94,191,0
6205,기동민(奇東旻),이원택(李源澤),93,81,174,0
6206,기동민(奇東旻),이은주(李恩周),20,50,70,1
6207,기동민(奇東旻),이인선(李仁善),25,3,28,1
6208,기동민(奇東旻),이인영(李仁榮),79,54,133,0
6209,기동민(奇東旻),이장섭(李將燮),99,87,186,0
6210,기동민(奇東旻),이재명(李在明),39,18,57,0
6211,기동민(奇東旻),이재정(李在汀),96,67,163,0
6212,기동민(奇東旻),이정문(李楨文),132,161,293,0
6213,기동민(奇東旻),이종배(李鍾培),50,4,54,1
6214,기동민(奇東旻),이종성(李鍾成),49,3,52,1
6215,기동민(奇東旻),이주환(李周桓),49,3,52,1
6216,기동민(奇東旻),이채익(李埰益),52,4,56,1
6217,기동민(奇東旻),이철규(李喆圭),52,3,55,1
6218,기동민(奇東旻),이탄희(李誕熙),96,86,182,0
6219,기동민(奇東旻),이태규(李泰珪),28,3,31,1
6220,기동민(奇東旻),이학영(李學永),111,155,266,0
6221,기동민(奇東旻),이해식(李海植),102,93,195,0
6222,기동민(奇東旻),이헌승(李憲昇),50,5,55,1
6223,기동민(奇東旻),이형석(李炯錫),103,108,211,0
6224,기동민(奇東旻),인재근(印在謹),138,173,311,0
6225,기동민(奇東旻),임병헌(林炳憲),25,3,28,1
6226,기동민(奇東旻),임오경(林五卿),95,92,187,0
6227,기동민(奇東旻),임이자(林利子),49,3,52,1
6228,기동민(奇東旻),임종성(林鍾聲),119,182,301,0
6229,기동민(奇東旻),임호선(林昊宣),129,247,376,0
6230,기동민(奇東旻),장경태(張耿態),97,127,224,0
6231,기동민(奇東旻),장동혁(張東赫),25,3,28,1
6232,기동민(奇東旻),장제원(張濟元),49,3,52,1
6233,기동민(奇東旻),장철민(張喆敏),92,78,170,0
6234,기동민(奇東旻),장혜영(張惠英),17,34,51,1
6235,기동민(奇東旻),전봉민(田奉珉),35,5,40,1
6236,기동민(奇東旻),전용기(田溶冀),102,130,232,0
6237,기동민(奇東旻),전재수(田載秀),84,60,144,0
6238,기동민(奇東旻),전주혜(全珠惠),51,3,54,1
6239,기동민(奇東旻),전해철(全海澈),77,64,141,0
6240,기동민(奇東旻),전혜숙(全惠淑),95,104,199,0
6241,기동민(奇東旻),정경희(丁慶姬),49,3,52,1
6242,기동민(奇東旻),정동만(鄭東萬),49,3,52,1
6243,기동민(奇東旻),정성호(鄭成湖),103,135,238,0
6244,기동민(奇東旻),정우택(鄭宇澤),25,3,28,1
6245,기동민(奇東旻),정운천(鄭雲天),49,4,53,1
6246,기동민(奇東旻),정일영(鄭日永),110,103,213,0
6247,기동민(奇東旻),정점식(鄭点植),50,3,53,1
6248,기동민(奇東旻),정진석(鄭鎭碩),50,4,54,1
6249,기동민(奇東旻),정청래(鄭淸來),84,60,144,0
6250,기동민(奇東旻),정춘숙(鄭春淑),133,229,362,0
6251,기동민(奇東旻),정태호(鄭泰浩),88,105,193,0
6252,기동민(奇東旻),정필모(鄭必模),96,87,183,0
6253,기동민(奇東旻),정희용(鄭熙溶),50,4,54,1
6254,기동민(奇東旻),조경태(趙慶泰),49,4,53,1
6255,기동민(奇東旻),조명희(曺明姬),50,5,55,1
6256,기동민(奇東旻),조수진(趙修眞),49,3,52,1
6257,기동민(奇東旻),조승래(趙承來),120,140,260,0
6258,기동민(奇東旻),조오섭(曺五燮),114,173,287,0
6259,기동민(奇東旻),조은희(趙恩禧),25,3,28,1
6260,기동민(奇東旻),조응천(趙應天),85,63,148,0
6261,기동민(奇東旻),조정식(趙正湜),82,35,117,0
6262,기동민(奇東旻),조정훈(趙廷訓),4,10,14,1
6263,기동민(奇東旻),조해진(曺海珍),52,4,56,1
6264,기동민(奇東旻),주철현(朱哲鉉),86,101,187,0
6265,기동민(奇東旻),주호영(朱豪英),50,3,53,1
6266,기동민(奇東旻),지성호(池成浩),49,3,52,1
6267,기동민(奇東旻),진선미(陳善美),91,65,156,0
6268,기동민(奇東旻),진성준(陳聲準),100,119,219,0
6269,기동민(奇東旻),천준호(千俊鎬),100,94,194,0
6270,기동민(奇東旻),최기상(崔基相),86,137,223,0
6271,기동민(奇東旻),최승재(崔承宰),49,4,53,1
6272,기동민(奇東旻),최연숙(崔姸淑),32,10,42,1
6273,기동민(奇東旻),최영희(崔英姬),25,4,29,1
6274,기동민(奇東旻),최인호(崔仁昊),100,92,192,0
6275,기동민(奇東旻),최재형(崔在亨),25,3,28,1
6276,기동민(奇東旻),최종윤(崔鍾允),114,158,272,0
6277,기동민(奇東旻),최춘식(崔春植),49,12,61,1
6278,기동민(奇東旻),최형두(崔炯斗),50,5,55,1
6279,기동민(奇東旻),최혜영(崔惠英),125,183,308,0
6280,기동민(奇東旻),추경호(秋慶鎬),49,4,53,1
6281,기동민(奇東旻),태영호(太永浩),49,3,52,1
6282,기동민(奇東旻),하영제(河榮帝),41,0,41,1
6283,기동민(奇東旻),하태경(河泰慶),49,3,52,1
6284,기동민(奇東旻),한기호(韓起鎬),51,5,56,1
6285,기동민(奇東旻),한무경(韓茂景),49,3,52,1
6286,기동민(奇東旻),한병도(韓秉道),96,95,191,0
6287,기동민(奇東旻),한정애(韓貞愛),83,61,144,0
6288,기동민(奇東旻),한준호(韓俊鎬),115,208,323,0
6289,기동민(奇東旻),허숙정(許淑湞),1,2,3,0
6290,기동민(奇東旻),허영(許榮),110,105,215,0
6291,기동민(奇東旻),허은아(許垠娥),49,3,52,1
6292,기동민(奇東旻),허종식(許琮植),88,104,192,0
6293,기동민(奇東旻),홍기원(洪起元),101,89,190,0
6294,기동민(奇東旻),홍문표(洪文杓),50,5,55,1
6295,기동민(奇東旻),홍석준(洪碩晙),50,3,53,1
6296,기동민(奇東旻),홍성국(洪性國),125,173,298,0
6297,기동민(奇東旻),홍영표(洪永杓),92,74,166,0
6298,기동민(奇東旻),홍익표(洪翼杓),103,113,216,0
6299,기동민(奇東旻),홍정민(洪貞敏),99,119,218,0
6300,기동민(奇東旻),황보승희(皇甫承希),47,0,47,1
6301,기동민(奇東旻),황운하(黃雲夏),122,174,296,0
6302,기동민(奇東旻),황희(黃熙),84,50,134,0
6303,김경만(金京萬),김경협(金炅俠),109,91,200,0
6304,김경만(金京萬),김교흥(金敎興),104,73,177,0
6305,김경만(金京萬),김기현(金起炫),54,6,60,1
6306,김경만(金京萬),김남국(金南局),113,131,244,1
6307,김경만(金京萬),김도읍(金度邑),53,6,59,1
6308,김경만(金京萬),김두관(金斗官),101,128,229,0
6309,김경만(金京萬),김미애(金美愛),53,5,58,1
6310,김경만(金京萬),김민기(金敏基),90,73,163,0
6311,김경만(金京萬),김민석(金民錫),106,113,219,0
6312,김경만(金京萬),김민철(金敏徹),131,157,288,0
6313,김경만(金京萬),김병기(金炳基),90,95,185,0
6314,김경만(金京萬),김병욱A(金炳旭),108,86,194,0
6315,김경만(金京萬),김병욱B(金炳旭),45,6,51,1
6316,김경만(金京萬),김병주(金柄周),92,77,169,0
6317,김경만(金京萬),김상훈(金相勳),53,5,58,1
6318,김경만(金京萬),김상희(金相姬),110,92,202,0
6319,김경만(金京萬),김석기(金碩基),54,4,58,1
6320,김경만(金京萬),김성원(金成願),53,6,59,1
6321,김경만(金京萬),김성주(金成柱),122,115,237,0
6322,김경만(金京萬),김성환(金星煥),105,108,213,0
6323,김경만(金京萬),김수흥(金洙興),141,139,280,0
6324,김경만(金京萬),김승남(金承南),112,142,254,0
6325,김경만(金京萬),김승수(金承洙),53,6,59,1
6326,김경만(金京萬),김승원(金勝源),175,246,421,0
6327,김경만(金京萬),김영배(金永培),126,126,252,0
6328,김경만(金京萬),김영선(金映宣),26,4,30,1
6329,김경만(金京萬),김영식(金英植),54,5,59,1
6330,김경만(金京萬),김영주(金榮珠),114,110,224,0
6331,김경만(金京萬),김영진(金榮鎭),88,59,147,0
6332,김경만(金京萬),김영호(金映豪),120,127,247,0
6333,김경만(金京萬),김예지(金睿智),54,5,59,1
6334,김경만(金京萬),김용민(金容民),119,106,225,0
6335,김경만(金京萬),김용판(金用判),52,5,57,1
6336,김경만(金京萬),김웅(金雄),52,6,58,1
6337,김경만(金京萬),김원이(金元二),120,128,248,0
6338,김경만(金京萬),김윤덕(金潤德),100,85,185,0
6339,김경만(金京萬),김의겸(金宜謙),51,48,99,0
6340,김경만(金京萬),김정재(金汀才),55,6,61,1
6341,김경만(金京萬),김정호(金禎鎬),144,219,363,0
6342,김경만(金京萬),김종민(金鐘民),92,85,177,0
6343,김경만(金京萬),김주영(金周暎),136,142,278,0
6344,김경만(金京萬),김진표(金振杓),66,89,155,1
6345,김경만(金京萬),김철민(金哲玟),119,141,260,0
6346,김경만(金京萬),김태년(金太年),82,62,144,0
6347,김경만(金京萬),김태호(金台鎬),45,7,52,1
6348,김경만(金京萬),김학용(金學容),25,4,29,1
6349,김경만(金京萬),김한규(金翰奎),46,43,89,0
6350,김경만(金京萬),김한정(金漢正),89,69,158,0
6351,김경만(金京萬),김형동(金亨東),52,9,61,1
6352,김경만(金京萬),김홍걸(金弘傑),93,206,299,0
6353,김경만(金京萬),김회재(金會在),127,144,271,0
6354,김경만(金京萬),김희곤(金熙坤),51,5,56,1
6355,김경만(金京萬),김희국(金熙國),49,5,54,1
6356,김경만(金京萬),남인순(南仁順),137,150,287,0
6357,김경만(金京萬),노용호(魯容昊),25,5,30,1
6358,김경만(金京萬),노웅래(盧雄來),109,147,256,0
6359,김경만(金京萬),도종환(都鍾煥),89,78,167,0
6360,김경만(金京萬),류성걸(柳性杰),49,5,54,1
6361,김경만(金京萬),류호정(柳好貞),19,36,55,1
6362,김경만(金京萬),맹성규(孟聖奎),122,115,237,0
6363,김경만(金京萬),문정복(文貞福),93,74,167,0
6364,김경만(金京萬),문진석(文振碩),133,156,289,0
6365,김경만(金京萬),민병덕(閔炳德),104,148,252,0
6366,김경만(金京萬),민형배(閔馨培),136,262,398,0
6367,김경만(金京萬),민홍철(閔洪喆),91,87,178,0
6368,김경만(金京萬),박광온(朴洸瑥),90,74,164,0
6369,김경만(金京萬),박대수(朴大壽),50,4,54,1
6370,김경만(金京萬),박대출(朴大出),50,4,54,1
6371,김경만(金京萬),박덕흠(朴德欽),37,9,46,1
6372,김경만(金京萬),박범계(朴範界),80,51,131,0
6373,김경만(金京萬),박병석(朴炳錫),40,18,58,0
6374,김경만(金京萬),박상혁(朴商赫),109,128,237,0
6375,김경만(金京萬),박성민(朴聖敏),50,4,54,1
6376,김경만(金京萬),박성준(朴省俊),203,258,461,0
6377,김경만(金京萬),박성중(朴成重),49,4,53,1
6378,김경만(金京萬),박수영(朴洙瑩),50,5,55,1
6379,김경만(金京萬),박영순(朴英淳),151,171,322,0
6380,김경만(金京萬),박완주(朴完柱),58,55,113,1
6381,김경만(金京萬),박용진(朴用鎭),91,56,147,0
6382,김경만(金京萬),박재호(朴在昊),104,92,196,0
6383,김경만(金京萬),박정(朴釘),137,172,309,0
6384,김경만(金京萬),박정하(朴正河),27,4,31,1
6385,김경만(金京萬),박주민(朴柱民),95,72,167,0
6386,김경만(金京萬),박진(朴振),51,4,55,1
6387,김경만(金京萬),박찬대(朴贊大),99,75,174,0
6388,김경만(金京萬),박형수(朴亨修),52,5,57,1
6389,김경만(金京萬),박홍근(朴洪根),166,180,346,0
6390,김경만(金京萬),배준영(裵俊英),50,4,54,1
6391,김경만(金京萬),배진교(裵晋敎),19,25,44,1
6392,김경만(金京萬),배현진(裵賢鎭),50,5,55,1
6393,김경만(金京萬),백종헌(白宗憲),51,5,56,1
6394,김경만(金京萬),백혜련(白惠蓮),96,71,167,0
6395,김경만(金京萬),변재일(卞在一),92,55,147,0
6396,김경만(金京萬),서동용(徐東榕),106,119,225,0
6397,김경만(金京萬),서범수(徐範洙),51,4,55,1
6398,김경만(金京萬),서병수(徐秉洙),53,5,58,1
6399,김경만(金京萬),서삼석(徐參錫),120,134,254,0
6400,김경만(金京萬),서영교(徐瑛敎),106,140,246,0
6401,김경만(金京萬),서영석(徐暎錫),141,152,293,0
6402,김경만(金京萬),서일준(徐一俊),51,8,59,1
6403,김경만(金京萬),서정숙(徐正淑),52,6,58,1
6404,김경만(金京萬),설훈(薛勳),93,104,197,0
6405,김경만(金京萬),성일종(成一鍾),53,5,58,1
6406,김경만(金京萬),소병철(蘇秉哲),92,70,162,0
6407,김경만(金京萬),소병훈(蘇秉勳),92,120,212,0
6408,김경만(金京萬),송갑석(宋甲錫),135,185,320,0
6409,김경만(金京萬),송기헌(宋基憲),83,63,146,0
6410,김경만(金京萬),송석준(宋錫俊),53,7,60,1
6411,김경만(金京萬),송언석(宋彦錫),46,7,53,1
6412,김경만(金京萬),송옥주(宋玉珠),118,155,273,0
6413,김경만(金京萬),송재호(宋在祜),110,128,238,0
6414,김경만(金京萬),신동근(申東根),100,79,179,0
6415,김경만(金京萬),신영대(申榮大),96,86,182,0
6416,김경만(金京萬),신원식(申源湜),50,4,54,1
6417,김경만(金京萬),신정훈(辛正勳),184,277,461,0
6418,김경만(金京萬),신현영(申賢榮),93,67,160,0
6419,김경만(金京萬),심상정(沈相奵),17,23,40,1
6420,김경만(金京萬),안규백(安圭伯),129,131,260,0
6421,김경만(金京萬),안민석(安敏錫),98,82,180,0
6422,김경만(金京萬),안병길(安炳吉),51,4,55,1
6423,김경만(金京萬),안철수(安哲秀),26,4,30,1
6424,김경만(金京萬),안호영(安浩永),101,113,214,0
6425,김경만(金京萬),양경숙(梁敬淑),112,131,243,0
6426,김경만(金京萬),양금희(梁琴喜),53,7,60,1
6427,김경만(金京萬),양기대(梁基大),127,160,287,0
6428,김경만(金京萬),양이원영(梁李媛瑛),143,144,287,0
6429,김경만(金京萬),양정숙(梁貞淑),120,287,407,1
6430,김경만(金京萬),양향자(梁香子),65,76,141,1
6431,김경만(金京萬),어기구(魚基龜),90,71,161,0
6432,김경만(金京萬),엄태영(嚴泰永),52,4,56,1
6433,김경만(金京萬),오기형(吳奇炯),84,57,141,0
6434,김경만(金京萬),오영환(吳永煥),172,240,412,0
6435,김경만(金京萬),용혜인(龍慧仁),31,70,101,1
6436,김경만(金京萬),우상호(禹相虎),80,44,124,0
6437,김경만(金京萬),우원식(禹元植),110,122,232,0
6438,김경만(金京萬),위성곤(魏聖坤),117,129,246,0
6439,김경만(金京萬),유경준(兪京濬),49,4,53,1
6440,김경만(金京萬),유기홍(柳基洪),83,59,142,0
6441,김경만(金京萬),유동수(柳東秀),109,101,210,0
6442,김경만(金京萬),유상범(劉相凡),51,4,55,1
6443,김경만(金京萬),유의동(兪義東),50,5,55,1
6444,김경만(金京萬),유정주(兪訂炷),126,142,268,0
6445,김경만(金京萬),윤건영(尹建永),106,101,207,0
6446,김경만(金京萬),윤관석(尹官石),101,82,183,1
6447,김경만(金京萬),윤두현(尹斗鉉),50,4,54,1
6448,김경만(金京萬),윤미향(尹美香),111,178,289,1
6449,김경만(金京萬),윤상현(尹相現),30,4,34,1
6450,김경만(金京萬),윤영덕(尹永德),133,173,306,0
6451,김경만(金京萬),윤영석(尹永碩),50,4,54,1
6452,김경만(金京萬),윤영찬(尹永燦),99,72,171,0
6453,김경만(金京萬),윤재갑(尹才鉀),161,205,366,0
6454,김경만(金京萬),윤재옥(尹在玉),50,4,54,1
6455,김경만(金京萬),윤주경(尹柱卿),51,5,56,1
6456,김경만(金京萬),윤준병(尹準炳),141,216,357,0
6457,김경만(金京萬),윤창현(尹暢賢),50,6,56,1
6458,김경만(金京萬),윤한홍(尹漢洪),50,5,55,1
6459,김경만(金京萬),윤호중(尹昊重),82,60,142,0
6460,김경만(金京萬),윤후덕(尹厚德),120,114,234,0
6461,김경만(金京萬),이개호(李介昊),98,97,195,0
6462,김경만(金京萬),이달곤(李達坤),52,6,58,1
6463,김경만(金京萬),이동주(李東洲),117,171,288,0
6464,김경만(金京萬),이만희(李晩熙),50,4,54,1
6465,김경만(金京萬),이명수(李明洙),54,15,69,1
6466,김경만(金京萬),이병훈(李炳勳),132,214,346,0
6467,김경만(金京萬),이상민(李相珉),83,51,134,0
6468,김경만(金京萬),이상헌(李相憲),109,113,222,0
6469,김경만(金京萬),이성만(李成萬),136,182,318,1
6470,김경만(金京萬),이소영(李素永),94,71,165,0
6471,김경만(金京萬),이수진(李壽珍),170,256,426,0
6472,김경만(金京萬),이수진(李秀眞),160,163,323,0
6473,김경만(金京萬),이양수(李亮壽),52,6,58,1
6474,김경만(金京萬),이용(李鏞),51,5,56,1
6475,김경만(金京萬),이용빈(李龍彬),152,241,393,0
6476,김경만(金京萬),이용선(李庸瑄),122,136,258,0
6477,김경만(金京萬),이용우(李龍雨),152,141,293,0
6478,김경만(金京萬),이용호(李容鎬),42,33,75,1
6479,김경만(金京萬),이원욱(李元旭),105,115,220,0
6480,김경만(金京萬),이원택(李源澤),126,141,267,0
6481,김경만(金京萬),이은주(李恩周),28,27,55,1
6482,김경만(金京萬),이인선(李仁善),27,4,31,1
6483,김경만(金京萬),이인영(李仁榮),92,53,145,0
6484,김경만(金京萬),이장섭(李將燮),120,118,238,0
6485,김경만(金京萬),이재명(李在明),41,20,61,0
6486,김경만(金京萬),이재정(李在汀),85,69,154,0
6487,김경만(金京萬),이정문(李楨文),109,111,220,0
6488,김경만(金京萬),이종배(李鍾培),52,6,58,1
6489,김경만(金京萬),이종성(李鍾成),50,5,55,1
6490,김경만(金京萬),이주환(李周桓),50,5,55,1
6491,김경만(金京萬),이채익(李埰益),52,9,61,1
6492,김경만(金京萬),이철규(李喆圭),52,7,59,1
6493,김경만(金京萬),이탄희(李誕熙),114,94,208,0
6494,김경만(金京萬),이태규(李泰珪),31,6,37,1
6495,김경만(金京萬),이학영(李學永),120,138,258,0
6496,김경만(金京萬),이해식(李海植),125,145,270,0
6497,김경만(金京萬),이헌승(李憲昇),51,5,56,1
6498,김경만(金京萬),이형석(李炯錫),117,137,254,0
6499,김경만(金京萬),인재근(印在謹),128,164,292,0
6500,김경만(金京萬),임병헌(林炳憲),27,4,31,1
6501,김경만(金京萬),임오경(林五卿),115,117,232,0
6502,김경만(金京萬),임이자(林利子),49,4,53,1
6503,김경만(金京萬),임종성(林鍾聲),119,162,281,0
6504,김경만(金京萬),임호선(林昊宣),120,174,294,0
6505,김경만(金京萬),장경태(張耿態),118,142,260,0
6506,김경만(金京萬),장동혁(張東赫),25,4,29,1
6507,김경만(金京萬),장제원(張濟元),50,4,54,1
6508,김경만(金京萬),장철민(張喆敏),114,98,212,0
6509,김경만(金京萬),장혜영(張惠英),24,21,45,1
6510,김경만(金京萬),전봉민(田奉珉),36,5,41,1
6511,김경만(金京萬),전용기(田溶冀),142,152,294,0
6512,김경만(金京萬),전재수(田載秀),97,107,204,0
6513,김경만(金京萬),전주혜(全珠惠),54,6,60,1
6514,김경만(金京萬),전해철(全海澈),81,57,138,0
6515,김경만(金京萬),전혜숙(全惠淑),127,150,277,0
6516,김경만(金京萬),정경희(丁慶姬),50,4,54,1
6517,김경만(金京萬),정동만(鄭東萬),50,4,54,1
6518,김경만(金京萬),정성호(鄭成湖),99,80,179,0
6519,김경만(金京萬),정우택(鄭宇澤),27,4,31,1
6520,김경만(金京萬),정운천(鄭雲天),51,7,58,1
6521,김경만(金京萬),정일영(鄭日永),118,114,232,0
6522,김경만(金京萬),정점식(鄭点植),51,4,55,1
6523,김경만(金京萬),정진석(鄭鎭碩),51,5,56,1
6524,김경만(金京萬),정청래(鄭淸來),110,103,213,0
6525,김경만(金京萬),정춘숙(鄭春淑),115,130,245,0
6526,김경만(金京萬),정태호(鄭泰浩),103,101,204,0
6527,김경만(金京萬),정필모(鄭必模),123,132,255,0
6528,김경만(金京萬),정희용(鄭熙溶),50,6,56,1
6529,김경만(金京萬),조경태(趙慶泰),50,4,54,1
6530,김경만(金京萬),조명희(曺明姬),52,6,58,1
6531,김경만(金京萬),조수진(趙修眞),49,5,54,1
6532,김경만(金京萬),조승래(趙承來),102,94,196,0
6533,김경만(金京萬),조오섭(曺五燮),132,193,325,0
6534,김경만(金京萬),조은희(趙恩禧),29,6,35,1
6535,김경만(金京萬),조응천(趙應天),77,36,113,0
6536,김경만(金京萬),조정식(趙正湜),85,53,138,0
6537,김경만(金京萬),조정훈(趙廷訓),6,8,14,1
6538,김경만(金京萬),조해진(曺海珍),51,6,57,1
6539,김경만(金京萬),주철현(朱哲鉉),122,142,264,0
6540,김경만(金京萬),주호영(朱豪英),52,4,56,1
6541,김경만(金京萬),지성호(池成浩),49,4,53,1
6542,김경만(金京萬),진선미(陳善美),97,73,170,0
6543,김경만(金京萬),진성준(陳聲準),130,131,261,0
6544,김경만(金京萬),천준호(千俊鎬),113,77,190,0
6545,김경만(金京萬),최기상(崔基相),90,87,177,0
6546,김경만(金京萬),최승재(崔承宰),52,5,57,1
6547,김경만(金京萬),최연숙(崔姸淑),32,20,52,1
6548,김경만(金京萬),최영희(崔英姬),25,5,30,1
6549,김경만(金京萬),최인호(崔仁昊),92,78,170,0
6550,김경만(金京萬),최재형(崔在亨),25,4,29,1
6551,김경만(金京萬),최종윤(崔鍾允),119,125,244,0
6552,김경만(金京萬),최춘식(崔春植),50,4,54,1
6553,김경만(金京萬),최형두(崔炯斗),53,8,61,1
6554,김경만(金京萬),최혜영(崔惠英),131,122,253,0
6555,김경만(金京萬),추경호(秋慶鎬),49,4,53,1
6556,김경만(金京萬),태영호(太永浩),49,5,54,1
6557,김경만(金京萬),하영제(河榮帝),43,5,48,1
6558,김경만(金京萬),하태경(河泰慶),51,5,56,1
6559,김경만(金京萬),한기호(韓起鎬),51,7,58,1
6560,김경만(金京萬),한무경(韓茂景),53,8,61,1
6561,김경만(金京萬),한병도(韓秉道),130,133,263,0
6562,김경만(金京萬),한정애(韓貞愛),88,61,149,0
6563,김경만(金京萬),한준호(韓俊鎬),107,121,228,0
6564,김경만(金京萬),허숙정(許淑湞),1,3,4,0
6565,김경만(金京萬),허영(許榮),139,149,288,0
6566,김경만(金京萬),허은아(許垠娥),50,5,55,1
6567,김경만(金京萬),허종식(許琮植),121,107,228,0
6568,김경만(金京萬),홍기원(洪起元),116,105,221,0
6569,김경만(金京萬),홍문표(洪文杓),51,9,60,1
6570,김경만(金京萬),홍석준(洪碩晙),50,4,54,1
6571,김경만(金京萬),홍성국(洪性國),168,236,404,0
6572,김경만(金京萬),홍영표(洪永杓),87,59,146,0
6573,김경만(金京萬),홍익표(洪翼杓),105,88,193,0
6574,김경만(金京萬),홍정민(洪貞敏),132,151,283,0
6575,김경만(金京萬),황보승희(皇甫承希),46,2,48,1
6576,김경만(金京萬),황운하(黃雲夏),199,270,469,0
6577,김경만(金京萬),황희(黃熙),86,53,139,0
6578,김경협(金炅俠),김교흥(金敎興),99,66,165,0
6579,김경협(金炅俠),김기현(金起炫),51,5,56,1
6580,김경협(金炅俠),김남국(金南局),83,72,155,1
6581,김경협(金炅俠),김도읍(金度邑),51,4,55,1
6582,김경협(金炅俠),김두관(金斗官),104,75,179,0
6583,김경협(金炅俠),김미애(金美愛),51,4,55,1
6584,김경협(金炅俠),김민기(金敏基),95,60,155,0
6585,김경협(金炅俠),김민석(金民錫),98,70,168,0
6586,김경협(金炅俠),김민철(金敏徹),112,80,192,0
6587,김경협(金炅俠),김병기(金炳基),102,64,166,0
6588,김경협(金炅俠),김병욱A(金炳旭),112,77,189,0
6589,김경협(金炅俠),김병욱B(金炳旭),44,4,48,1
6590,김경협(金炅俠),김병주(金柄周),98,53,151,0
6591,김경협(金炅俠),김상훈(金相勳),52,4,56,1
6592,김경협(金炅俠),김상희(金相姬),91,87,178,0
6593,김경협(金炅俠),김석기(金碩基),51,4,55,1
6594,김경협(金炅俠),김성원(金成願),51,6,57,1
6595,김경협(金炅俠),김성주(金成柱),109,64,173,0
6596,김경협(金炅俠),김성환(金星煥),87,53,140,0
6597,김경협(金炅俠),김수흥(金洙興),128,84,212,0
6598,김경협(金炅俠),김승남(金承南),95,63,158,0
6599,김경협(金炅俠),김승수(金承洙),52,6,58,1
6600,김경협(金炅俠),김승원(金勝源),110,90,200,0
6601,김경협(金炅俠),김영배(金永培),115,81,196,0
6602,김경협(金炅俠),김영선(金映宣),26,4,30,1
6603,김경협(金炅俠),김영식(金英植),51,4,55,1
6604,김경협(金炅俠),김영주(金榮珠),97,90,187,0
6605,김경협(金炅俠),김영진(金榮鎭),92,77,169,0
6606,김경협(金炅俠),김영호(金映豪),94,54,148,0
6607,김경협(金炅俠),김예지(金睿智),52,4,56,1
6608,김경협(金炅俠),김용민(金容民),92,63,155,0
6609,김경협(金炅俠),김용판(金用判),51,4,55,1
6610,김경협(金炅俠),김웅(金雄),51,4,55,1
6611,김경협(金炅俠),김원이(金元二),106,77,183,0
6612,김경협(金炅俠),김윤덕(金潤德),100,66,166,0
6613,김경협(金炅俠),김의겸(金宜謙),48,46,94,0
6614,김경협(金炅俠),김정재(金汀才),52,4,56,1
6615,김경협(金炅俠),김정호(金禎鎬),149,154,303,0
6616,김경협(金炅俠),김종민(金鐘民),92,68,160,0
6617,김경협(金炅俠),김주영(金周暎),120,110,230,0
6618,김경협(金炅俠),김진표(金振杓),63,53,116,1
6619,김경협(金炅俠),김철민(金哲玟),109,100,209,0
6620,김경협(金炅俠),김태년(金太年),80,54,134,0
6621,김경협(金炅俠),김태호(金台鎬),41,5,46,1
6622,김경협(金炅俠),김학용(金學容),25,4,29,1
6623,김경협(金炅俠),김한규(金翰奎),42,28,70,0
6624,김경협(金炅俠),김한정(金漢正),82,50,132,0
6625,김경협(金炅俠),김형동(金亨東),51,4,55,1
6626,김경협(金炅俠),김홍걸(金弘傑),49,114,163,0
6627,김경협(金炅俠),김회재(金會在),89,57,146,0
6628,김경협(金炅俠),김희곤(金熙坤),49,4,53,1
6629,김경협(金炅俠),김희국(金熙國),49,4,53,1
6630,김경협(金炅俠),남인순(南仁順),95,66,161,0
6631,김경협(金炅俠),노용호(魯容昊),25,4,29,1
6632,김경협(金炅俠),노웅래(盧雄來),96,80,176,0
6633,김경협(金炅俠),도종환(都鍾煥),96,63,159,0
6634,김경협(金炅俠),류성걸(柳性杰),50,4,54,1
6635,김경협(金炅俠),류호정(柳好貞),19,23,42,1
6636,김경협(金炅俠),맹성규(孟聖奎),84,61,145,0
6637,김경협(金炅俠),문정복(文貞福),87,48,135,0
6638,김경협(金炅俠),문진석(文振碩),101,83,184,0
6639,김경협(金炅俠),민병덕(閔炳德),100,85,185,0
6640,김경협(金炅俠),민형배(閔馨培),78,100,178,0
6641,김경협(金炅俠),민홍철(閔洪喆),93,50,143,0
6642,김경협(金炅俠),박광온(朴洸瑥),81,57,138,0
6643,김경협(金炅俠),박대수(朴大壽),50,8,58,1
6644,김경협(金炅俠),박대출(朴大出),49,4,53,1
6645,김경협(金炅俠),박덕흠(朴德欽),35,7,42,1
6646,김경협(金炅俠),박범계(朴範界),78,40,118,0
6647,김경협(金炅俠),박병석(朴炳錫),41,23,64,0
6648,김경협(金炅俠),박상혁(朴商赫),95,103,198,0
6649,김경협(金炅俠),박성민(朴聖敏),49,5,54,1
6650,김경협(金炅俠),박성준(朴省俊),105,74,179,0
6651,김경협(金炅俠),박성중(朴成重),49,4,53,1
6652,김경협(金炅俠),박수영(朴洙瑩),49,4,53,1
6653,김경협(金炅俠),박영순(朴英淳),105,74,179,0
6654,김경협(金炅俠),박완주(朴完柱),54,34,88,1
6655,김경협(金炅俠),박용진(朴用鎭),91,81,172,0
6656,김경협(金炅俠),박재호(朴在昊),122,72,194,0
6657,김경협(金炅俠),박정(朴釘),101,99,200,0
6658,김경협(金炅俠),박정하(朴正河),25,4,29,1
6659,김경협(金炅俠),박주민(朴柱民),79,51,130,0
6660,김경협(金炅俠),박진(朴振),49,3,52,1
6661,김경협(金炅俠),박찬대(朴贊大),84,61,145,0
6662,김경협(金炅俠),박형수(朴亨修),49,4,53,1
6663,김경협(金炅俠),박홍근(朴洪根),113,106,219,0
6664,김경협(金炅俠),배준영(裵俊英),49,4,53,1
6665,김경협(金炅俠),배진교(裵晋敎),16,17,33,1
6666,김경협(金炅俠),배현진(裵賢鎭),49,4,53,1
6667,김경협(金炅俠),백종헌(白宗憲),49,5,54,1
6668,김경협(金炅俠),백혜련(白惠蓮),97,74,171,0
6669,김경협(金炅俠),변재일(卞在一),85,42,127,0
6670,김경협(金炅俠),서동용(徐東榕),97,72,169,0
6671,김경협(金炅俠),서범수(徐範洙),49,5,54,1
6672,김경협(金炅俠),서병수(徐秉洙),49,4,53,1
6673,김경협(金炅俠),서삼석(徐參錫),108,75,183,0
6674,김경협(金炅俠),서영교(徐瑛敎),105,84,189,0
6675,김경협(金炅俠),서영석(徐暎錫),108,93,201,0
6676,김경협(金炅俠),서일준(徐一俊),49,5,54,1
6677,김경협(金炅俠),서정숙(徐正淑),49,4,53,1
6678,김경협(金炅俠),설훈(薛勳),87,70,157,0
6679,김경협(金炅俠),성일종(成一鍾),49,4,53,1
6680,김경협(金炅俠),소병철(蘇秉哲),92,63,155,0
6681,김경협(金炅俠),소병훈(蘇秉勳),90,67,157,0
6682,김경협(金炅俠),송갑석(宋甲錫),98,113,211,0
6683,김경협(金炅俠),송기헌(宋基憲),85,46,131,0
6684,김경협(金炅俠),송석준(宋錫俊),51,11,62,1
6685,김경협(金炅俠),송언석(宋彦錫),47,5,52,1
6686,김경협(金炅俠),송옥주(宋玉珠),99,97,196,0
6687,김경협(金炅俠),송재호(宋在祜),109,72,181,0
6688,김경협(金炅俠),신동근(申東根),88,74,162,0
6689,김경협(金炅俠),신영대(申榮大),82,49,131,0
6690,김경협(金炅俠),신원식(申源湜),49,5,54,1
6691,김경협(金炅俠),신정훈(辛正勳),103,106,209,0
6692,김경협(金炅俠),신현영(申賢榮),95,49,144,0
6693,김경협(金炅俠),심상정(沈相奵),24,27,51,1
6694,김경협(金炅俠),안규백(安圭伯),95,73,168,0
6695,김경협(金炅俠),안민석(安敏錫),89,74,163,0
6696,김경협(金炅俠),안병길(安炳吉),49,4,53,1
6697,김경협(金炅俠),안철수(安哲秀),25,4,29,1
6698,김경협(金炅俠),안호영(安浩永),87,58,145,0
6699,김경협(金炅俠),양경숙(梁敬淑),99,75,174,0
6700,김경협(金炅俠),양금희(梁琴喜),49,5,54,1
6701,김경협(金炅俠),양기대(梁基大),104,63,167,0
6702,김경협(金炅俠),양이원영(梁李媛瑛),89,66,155,0
6703,김경협(金炅俠),양정숙(梁貞淑),37,100,137,1
6704,김경협(金炅俠),양향자(梁香子),55,38,93,1
6705,김경협(金炅俠),어기구(魚基龜),92,46,138,0
6706,김경협(金炅俠),엄태영(嚴泰永),50,5,55,1
6707,김경협(金炅俠),오기형(吳奇炯),86,50,136,0
6708,김경협(金炅俠),오영환(吳永煥),124,128,252,0
6709,김경협(金炅俠),용혜인(龍慧仁),18,26,44,1
6710,김경협(金炅俠),우상호(禹相虎),78,46,124,0
6711,김경협(金炅俠),우원식(禹元植),115,75,190,0
6712,김경협(金炅俠),위성곤(魏聖坤),102,73,175,0
6713,김경협(金炅俠),유경준(兪京濬),49,4,53,1
6714,김경협(金炅俠),유기홍(柳基洪),78,46,124,0
6715,김경협(金炅俠),유동수(柳東秀),96,92,188,0
6716,김경협(金炅俠),유상범(劉相凡),49,4,53,1
6717,김경협(金炅俠),유의동(兪義東),49,4,53,1
6718,김경협(金炅俠),유정주(兪訂炷),101,89,190,0
6719,김경협(金炅俠),윤건영(尹建永),87,55,142,0
6720,김경협(金炅俠),윤관석(尹官石),95,82,177,1
6721,김경협(金炅俠),윤두현(尹斗鉉),49,4,53,1
6722,김경협(金炅俠),윤미향(尹美香),59,56,115,1
6723,김경협(金炅俠),윤상현(尹相現),29,4,33,1
6724,김경협(金炅俠),윤영덕(尹永德),100,85,185,0
6725,김경협(金炅俠),윤영석(尹永碩),50,4,54,1
6726,김경협(金炅俠),윤영찬(尹永燦),82,50,132,0
6727,김경협(金炅俠),윤재갑(尹才鉀),110,90,200,0
6728,김경협(金炅俠),윤재옥(尹在玉),49,4,53,1
6729,김경협(金炅俠),윤주경(尹柱卿),49,4,53,1
6730,김경협(金炅俠),윤준병(尹準炳),99,90,189,0
6731,김경협(金炅俠),윤창현(尹暢賢),49,5,54,1
6732,김경협(金炅俠),윤한홍(尹漢洪),49,4,53,1
6733,김경협(金炅俠),윤호중(尹昊重),80,62,142,0
6734,김경협(金炅俠),윤후덕(尹厚德),119,157,276,0
6735,김경협(金炅俠),이개호(李介昊),96,78,174,0
6736,김경협(金炅俠),이달곤(李達坤),51,4,55,1
6737,김경협(金炅俠),이동주(李東洲),95,105,200,0
6738,김경협(金炅俠),이만희(李晩熙),49,4,53,1
6739,김경협(金炅俠),이명수(李明洙),49,7,56,1
6740,김경협(金炅俠),이병훈(李炳勳),93,83,176,0
6741,김경협(金炅俠),이상민(李相珉),86,49,135,0
6742,김경협(金炅俠),이상헌(李相憲),92,74,166,0
6743,김경협(金炅俠),이성만(李成萬),87,66,153,1
6744,김경협(金炅俠),이소영(李素永),86,57,143,0
6745,김경협(金炅俠),이수진(李壽珍),112,96,208,0
6746,김경협(金炅俠),이수진(李秀眞),98,69,167,0
6747,김경협(金炅俠),이양수(李亮壽),49,4,53,1
6748,김경협(金炅俠),이용(李鏞),49,4,53,1
6749,김경협(金炅俠),이용빈(李龍彬),104,100,204,0
6750,김경협(金炅俠),이용선(李庸瑄),91,85,176,0
6751,김경협(金炅俠),이용우(李龍雨),100,67,167,0
6752,김경협(金炅俠),이용호(李容鎬),42,15,57,1
6753,김경협(金炅俠),이원욱(李元旭),106,105,211,0
6754,김경협(金炅俠),이원택(李源澤),87,56,143,0
6755,김경협(金炅俠),이은주(李恩周),16,25,41,1
6756,김경협(金炅俠),이인선(李仁善),25,4,29,1
6757,김경협(金炅俠),이인영(李仁榮),81,47,128,0
6758,김경협(金炅俠),이장섭(李將燮),87,61,148,0
6759,김경협(金炅俠),이재명(李在明),40,21,61,0
6760,김경협(金炅俠),이재정(李在汀),84,52,136,0
6761,김경협(金炅俠),이정문(李楨文),90,84,174,0
6762,김경협(金炅俠),이종배(李鍾培),50,5,55,1
6763,김경협(金炅俠),이종성(李鍾成),49,6,55,1
6764,김경협(金炅俠),이주환(李周桓),49,4,53,1
6765,김경협(金炅俠),이채익(李埰益),50,5,55,1
6766,김경협(金炅俠),이철규(李喆圭),50,4,54,1
6767,김경협(金炅俠),이탄희(李誕熙),91,56,147,0
6768,김경협(金炅俠),이태규(李泰珪),28,5,33,1
6769,김경협(金炅俠),이학영(李學永),97,87,184,0
6770,김경협(金炅俠),이해식(李海植),107,69,176,0
6771,김경협(金炅俠),이헌승(李憲昇),49,4,53,1
6772,김경협(金炅俠),이형석(李炯錫),112,81,193,0
6773,김경협(金炅俠),인재근(印在謹),101,69,170,0
6774,김경협(金炅俠),임병헌(林炳憲),25,4,29,1
6775,김경협(金炅俠),임오경(林五卿),100,66,166,0
6776,김경협(金炅俠),임이자(林利子),49,4,53,1
6777,김경협(金炅俠),임종성(林鍾聲),131,110,241,0
6778,김경협(金炅俠),임호선(林昊宣),113,114,227,0
6779,김경협(金炅俠),장경태(張耿態),94,84,178,0
6780,김경협(金炅俠),장동혁(張東赫),25,4,29,1
6781,김경협(金炅俠),장제원(張濟元),49,4,53,1
6782,김경협(金炅俠),장철민(張喆敏),95,66,161,0
6783,김경협(金炅俠),장혜영(張惠英),11,13,24,1
6784,김경협(金炅俠),전봉민(田奉珉),35,4,39,1
6785,김경협(金炅俠),전용기(田溶冀),97,79,176,0
6786,김경협(金炅俠),전재수(田載秀),96,62,158,0
6787,김경협(金炅俠),전주혜(全珠惠),50,4,54,1
6788,김경협(金炅俠),전해철(全海澈),78,52,130,0
6789,김경협(金炅俠),전혜숙(全惠淑),98,66,164,0
6790,김경협(金炅俠),정경희(丁慶姬),49,4,53,1
6791,김경협(金炅俠),정동만(鄭東萬),49,4,53,1
6792,김경협(金炅俠),정성호(鄭成湖),107,85,192,0
6793,김경협(金炅俠),정우택(鄭宇澤),25,4,29,1
6794,김경협(金炅俠),정운천(鄭雲天),49,6,55,1
6795,김경협(金炅俠),정일영(鄭日永),103,100,203,0
6796,김경협(金炅俠),정점식(鄭点植),49,4,53,1
6797,김경협(金炅俠),정진석(鄭鎭碩),49,4,53,1
6798,김경협(金炅俠),정청래(鄭淸來),82,43,125,0
6799,김경협(金炅俠),정춘숙(鄭春淑),113,110,223,0
6800,김경협(金炅俠),정태호(鄭泰浩),90,73,163,0
6801,김경협(金炅俠),정필모(鄭必模),88,64,152,0
6802,김경협(金炅俠),정희용(鄭熙溶),50,4,54,1
6803,김경협(金炅俠),조경태(趙慶泰),49,5,54,1
6804,김경협(金炅俠),조명희(曺明姬),50,5,55,1
6805,김경협(金炅俠),조수진(趙修眞),49,4,53,1
6806,김경협(金炅俠),조승래(趙承來),100,82,182,0
6807,김경협(金炅俠),조오섭(曺五燮),98,87,185,0
6808,김경협(金炅俠),조은희(趙恩禧),25,4,29,1
6809,김경협(金炅俠),조응천(趙應天),74,36,110,0
6810,김경협(金炅俠),조정식(趙正湜),78,44,122,0
6811,김경협(金炅俠),조정훈(趙廷訓),5,6,11,1
6812,김경협(金炅俠),조해진(曺海珍),50,4,54,1
6813,김경협(金炅俠),주철현(朱哲鉉),86,70,156,0
6814,김경협(金炅俠),주호영(朱豪英),49,5,54,1
6815,김경협(金炅俠),지성호(池成浩),49,4,53,1
6816,김경협(金炅俠),진선미(陳善美),81,65,146,0
6817,김경협(金炅俠),진성준(陳聲準),101,81,182,0
6818,김경협(金炅俠),천준호(千俊鎬),89,51,140,0
6819,김경협(金炅俠),최기상(崔基相),81,57,138,0
6820,김경협(金炅俠),최승재(崔承宰),50,7,57,1
6821,김경협(金炅俠),최연숙(崔姸淑),33,8,41,1
6822,김경협(金炅俠),최영희(崔英姬),25,6,31,1
6823,김경협(金炅俠),최인호(崔仁昊),94,90,184,0
6824,김경협(金炅俠),최재형(崔在亨),25,4,29,1
6825,김경협(金炅俠),최종윤(崔鍾允),90,86,176,0
6826,김경협(金炅俠),최춘식(崔春植),49,6,55,1
6827,김경협(金炅俠),최형두(崔炯斗),49,9,58,1
6828,김경협(金炅俠),최혜영(崔惠英),96,78,174,0
6829,김경협(金炅俠),추경호(秋慶鎬),49,3,52,1
6830,김경협(金炅俠),태영호(太永浩),49,4,53,1
6831,김경협(金炅俠),하영제(河榮帝),40,2,42,1
6832,김경협(金炅俠),하태경(河泰慶),50,5,55,1
6833,김경협(金炅俠),한기호(韓起鎬),50,4,54,1
6834,김경협(金炅俠),한무경(韓茂景),49,4,53,1
6835,김경협(金炅俠),한병도(韓秉道),114,78,192,0
6836,김경협(金炅俠),한정애(韓貞愛),81,50,131,0
6837,김경협(金炅俠),한준호(韓俊鎬),107,104,211,0
6838,김경협(金炅俠),허숙정(許淑湞),1,1,2,0
6839,김경협(金炅俠),허영(許榮),122,94,216,0
6840,김경협(金炅俠),허은아(許垠娥),49,4,53,1
6841,김경협(金炅俠),허종식(許琮植),93,83,176,0
6842,김경협(金炅俠),홍기원(洪起元),98,92,190,0
6843,김경협(金炅俠),홍문표(洪文杓),49,8,57,1
6844,김경협(金炅俠),홍석준(洪碩晙),49,4,53,1
6845,김경협(金炅俠),홍성국(洪性國),105,100,205,0
6846,김경협(金炅俠),홍영표(洪永杓),91,59,150,0
6847,김경협(金炅俠),홍익표(洪翼杓),97,65,162,0
6848,김경협(金炅俠),홍정민(洪貞敏),96,102,198,0
6849,김경협(金炅俠),황보승희(皇甫承希),44,1,45,1
6850,김경협(金炅俠),황운하(黃雲夏),104,88,192,0
6851,김경협(金炅俠),황희(黃熙),84,51,135,0
6852,김교흥(金敎興),김기현(金起炫),53,4,57,1
6853,김교흥(金敎興),김남국(金南局),75,52,127,1
6854,김교흥(金敎興),김도읍(金度邑),51,3,54,1
6855,김교흥(金敎興),김두관(金斗官),87,57,144,0
6856,김교흥(金敎興),김미애(金美愛),51,3,54,1
6857,김교흥(金敎興),김민기(金敏基),98,58,156,0
6858,김교흥(金敎興),김민석(金民錫),102,53,155,0
6859,김교흥(金敎興),김민철(金敏徹),93,91,184,0
6860,김교흥(金敎興),김병기(金炳基),93,88,181,0
6861,김교흥(金敎興),김병욱A(金炳旭),111,90,201,0
6862,김교흥(金敎興),김병욱B(金炳旭),44,7,51,1
6863,김교흥(金敎興),김병주(金柄周),82,38,120,0
6864,김교흥(金敎興),김상훈(金相勳),53,4,57,1
6865,김교흥(金敎興),김상희(金相姬),80,54,134,0
6866,김교흥(金敎興),김석기(金碩基),52,3,55,1
6867,김교흥(金敎興),김성원(金成願),52,4,56,1
6868,김교흥(金敎興),김성주(金成柱),95,82,177,0
6869,김교흥(金敎興),김성환(金星煥),88,52,140,0
6870,김교흥(金敎興),김수흥(金洙興),128,94,222,0
6871,김교흥(金敎興),김승남(金承南),82,76,158,0
6872,김교흥(金敎興),김승수(金承洙),52,4,56,1
6873,김교흥(金敎興),김승원(金勝源),98,56,154,0
6874,김교흥(金敎興),김영배(金永培),97,60,157,0
6875,김교흥(金敎興),김영선(金映宣),26,3,29,1
6876,김교흥(金敎興),김영식(金英植),51,3,54,1
6877,김교흥(金敎興),김영주(金榮珠),90,78,168,0
6878,김교흥(金敎興),김영진(金榮鎭),82,59,141,0
6879,김교흥(金敎興),김영호(金映豪),91,47,138,0
6880,김교흥(金敎興),김예지(金睿智),51,3,54,1
6881,김교흥(金敎興),김용민(金容民),83,56,139,0
6882,김교흥(金敎興),김용판(金用判),53,3,56,1
6883,김교흥(金敎興),김웅(金雄),51,3,54,1
6884,김교흥(金敎興),김원이(金元二),86,50,136,0
6885,김교흥(金敎興),김윤덕(金潤德),112,95,207,0
6886,김교흥(金敎興),김의겸(金宜謙),47,35,82,0
6887,김교흥(金敎興),김정재(金汀才),53,4,57,1
6888,김교흥(金敎興),김정호(金禎鎬),128,119,247,0
6889,김교흥(金敎興),김종민(金鐘民),86,60,146,0
6890,김교흥(金敎興),김주영(金周暎),99,92,191,0
6891,김교흥(金敎興),김진표(金振杓),49,38,87,1
6892,김교흥(金敎興),김철민(金哲玟),90,73,163,0
6893,김교흥(金敎興),김태년(金太年),79,44,123,0
6894,김교흥(金敎興),김태호(金台鎬),41,5,46,1
6895,김교흥(金敎興),김학용(金學容),26,6,32,1
6896,김교흥(金敎興),김한규(金翰奎),43,27,70,0
6897,김교흥(金敎興),김한정(金漢正),78,41,119,0
6898,김교흥(金敎興),김형동(金亨東),51,4,55,1
6899,김교흥(金敎興),김홍걸(金弘傑),52,96,148,0
6900,김교흥(金敎興),김회재(金會在),101,56,157,0
6901,김교흥(金敎興),김희곤(金熙坤),50,4,54,1
6902,김교흥(金敎興),김희국(金熙國),49,3,52,1
6903,김교흥(金敎興),남인순(南仁順),87,64,151,0
6904,김교흥(金敎興),노용호(魯容昊),26,3,29,1
6905,김교흥(金敎興),노웅래(盧雄來),90,58,148,0
6906,김교흥(金敎興),도종환(都鍾煥),83,50,133,0
6907,김교흥(金敎興),류성걸(柳性杰),49,3,52,1
6908,김교흥(金敎興),류호정(柳好貞),16,19,35,1
6909,김교흥(金敎興),맹성규(孟聖奎),110,76,186,0
6910,김교흥(金敎興),문정복(文貞福),99,65,164,0
6911,김교흥(金敎興),문진석(文振碩),118,127,245,0
6912,김교흥(金敎興),민병덕(閔炳德),82,94,176,0
6913,김교흥(金敎興),민형배(閔馨培),67,58,125,0
6914,김교흥(金敎興),민홍철(閔洪喆),82,42,124,0
6915,김교흥(金敎興),박광온(朴洸瑥),82,37,119,0
6916,김교흥(金敎興),박대수(朴大壽),51,9,60,1
6917,김교흥(金敎興),박대출(朴大出),51,3,54,1
6918,김교흥(金敎興),박덕흠(朴德欽),39,7,46,1
6919,김교흥(金敎興),박범계(朴範界),76,30,106,0
6920,김교흥(金敎興),박병석(朴炳錫),40,15,55,0
6921,김교흥(金敎興),박상혁(朴商赫),112,97,209,0
6922,김교흥(金敎興),박성민(朴聖敏),50,3,53,1
6923,김교흥(金敎興),박성준(朴省俊),102,96,198,0
6924,김교흥(金敎興),박성중(朴成重),49,3,52,1
6925,김교흥(金敎興),박수영(朴洙瑩),49,3,52,1
6926,김교흥(金敎興),박영순(朴英淳),100,95,195,0
6927,김교흥(金敎興),박완주(朴完柱),44,32,76,1
6928,김교흥(金敎興),박용진(朴用鎭),80,51,131,0
6929,김교흥(金敎興),박재호(朴在昊),80,47,127,0
6930,김교흥(金敎興),박정(朴釘),96,103,199,0
6931,김교흥(金敎興),박정하(朴正河),26,3,29,1
6932,김교흥(金敎興),박주민(朴柱民),78,45,123,0
6933,김교흥(金敎興),박진(朴振),50,3,53,1
6934,김교흥(金敎興),박찬대(朴贊大),132,124,256,0
6935,김교흥(金敎興),박형수(朴亨修),49,3,52,1
6936,김교흥(金敎興),박홍근(朴洪根),89,79,168,0
6937,김교흥(金敎興),배준영(裵俊英),53,15,68,1
6938,김교흥(金敎興),배진교(裵晋敎),25,40,65,1
6939,김교흥(金敎興),배현진(裵賢鎭),49,3,52,1
6940,김교흥(金敎興),백종헌(白宗憲),51,3,54,1
6941,김교흥(金敎興),백혜련(白惠蓮),85,49,134,0
6942,김교흥(金敎興),변재일(卞在一),81,43,124,0
6943,김교흥(金敎興),서동용(徐東榕),85,56,141,0
6944,김교흥(金敎興),서범수(徐範洙),50,4,54,1
6945,김교흥(金敎興),서병수(徐秉洙),50,4,54,1
6946,김교흥(金敎興),서삼석(徐參錫),87,55,142,0
6947,김교흥(金敎興),서영교(徐瑛敎),93,76,169,0
6948,김교흥(金敎興),서영석(徐暎錫),91,82,173,0
6949,김교흥(金敎興),서일준(徐一俊),51,4,55,1
6950,김교흥(金敎興),서정숙(徐正淑),49,3,52,1
6951,김교흥(金敎興),설훈(薛勳),82,43,125,0
6952,김교흥(金敎興),성일종(成一鍾),50,5,55,1
6953,김교흥(金敎興),소병철(蘇秉哲),83,44,127,0
6954,김교흥(金敎興),소병훈(蘇秉勳),93,82,175,0
6955,김교흥(金敎興),송갑석(宋甲錫),87,65,152,0
6956,김교흥(金敎興),송기헌(宋基憲),82,42,124,0
6957,김교흥(金敎興),송석준(宋錫俊),51,5,56,1
6958,김교흥(金敎興),송언석(宋彦錫),45,3,48,1
6959,김교흥(金敎興),송옥주(宋玉珠),91,81,172,0
6960,김교흥(金敎興),송재호(宋在祜),89,109,198,0
6961,김교흥(金敎興),신동근(申東根),120,111,231,0
6962,김교흥(金敎興),신영대(申榮大),91,71,162,0
6963,김교흥(金敎興),신원식(申源湜),50,4,54,1
6964,김교흥(金敎興),신정훈(辛正勳),101,94,195,0
6965,김교흥(金敎興),신현영(申賢榮),87,45,132,0
6966,김교흥(金敎興),심상정(沈相奵),12,12,24,1
6967,김교흥(金敎興),안규백(安圭伯),113,88,201,0
6968,김교흥(金敎興),안민석(安敏錫),86,67,153,0
6969,김교흥(金敎興),안병길(安炳吉),50,4,54,1
6970,김교흥(金敎興),안철수(安哲秀),26,3,29,1
6971,김교흥(金敎興),안호영(安浩永),82,73,155,0
6972,김교흥(金敎興),양경숙(梁敬淑),91,80,171,0
6973,김교흥(金敎興),양금희(梁琴喜),51,4,55,1
6974,김교흥(金敎興),양기대(梁基大),90,56,146,0
6975,김교흥(金敎興),양이원영(梁李媛瑛),79,49,128,0
6976,김교흥(金敎興),양정숙(梁貞淑),37,76,113,1
6977,김교흥(金敎興),양향자(梁香子),41,21,62,1
6978,김교흥(金敎興),어기구(魚基龜),89,67,156,0
6979,김교흥(金敎興),엄태영(嚴泰永),51,4,55,1
6980,김교흥(金敎興),오기형(吳奇炯),76,38,114,0
6981,김교흥(金敎興),오영환(吳永煥),104,127,231,0
6982,김교흥(金敎興),용혜인(龍慧仁),11,17,28,1
6983,김교흥(金敎興),우상호(禹相虎),77,33,110,0
6984,김교흥(金敎興),우원식(禹元植),88,80,168,0
6985,김교흥(金敎興),위성곤(魏聖坤),83,71,154,0
6986,김교흥(金敎興),유경준(兪京濬),49,4,53,1
6987,김교흥(金敎興),유기홍(柳基洪),77,58,135,0
6988,김교흥(金敎興),유동수(柳東秀),128,130,258,0
6989,김교흥(金敎興),유상범(劉相凡),50,3,53,1
6990,김교흥(金敎興),유의동(兪義東),49,3,52,1
6991,김교흥(金敎興),유정주(兪訂炷),96,74,170,0
6992,김교흥(金敎興),윤건영(尹建永),81,47,128,0
6993,김교흥(金敎興),윤관석(尹官石),106,98,204,1
6994,김교흥(金敎興),윤두현(尹斗鉉),50,3,53,1
6995,김교흥(金敎興),윤미향(尹美香),41,50,91,1
6996,김교흥(金敎興),윤상현(尹相現),36,12,48,1
6997,김교흥(金敎興),윤영덕(尹永德),84,77,161,0
6998,김교흥(金敎興),윤영석(尹永碩),50,5,55,1
6999,김교흥(金敎興),윤영찬(尹永燦),80,41,121,0
7000,김교흥(金敎興),윤재갑(尹才鉀),89,58,147,0
7001,김교흥(金敎興),윤재옥(尹在玉),49,3,52,1
7002,김교흥(金敎興),윤주경(尹柱卿),49,3,52,1
7003,김교흥(金敎興),윤준병(尹準炳),102,126,228,0
7004,김교흥(金敎興),윤창현(尹暢賢),49,3,52,1
7005,김교흥(金敎興),윤한홍(尹漢洪),50,3,53,1
7006,김교흥(金敎興),윤호중(尹昊重),83,49,132,0
7007,김교흥(金敎興),윤후덕(尹厚德),101,60,161,0
7008,김교흥(金敎興),이개호(李介昊),84,47,131,0
7009,김교흥(金敎興),이달곤(李達坤),52,5,57,1
7010,김교흥(金敎興),이동주(李東洲),107,125,232,0
7011,김교흥(金敎興),이만희(李晩熙),50,3,53,1
7012,김교흥(金敎興),이명수(李明洙),64,17,81,1
7013,김교흥(金敎興),이병훈(李炳勳),90,74,164,0
7014,김교흥(金敎興),이상민(李相珉),78,38,116,0
7015,김교흥(金敎興),이상헌(李相憲),99,84,183,0
7016,김교흥(金敎興),이성만(李成萬),137,198,335,1
7017,김교흥(金敎興),이소영(李素永),80,51,131,0
7018,김교흥(金敎興),이수진(李壽珍),90,69,159,0
7019,김교흥(金敎興),이수진(李秀眞),90,69,159,0
7020,김교흥(金敎興),이양수(李亮壽),51,3,54,1
7021,김교흥(金敎興),이용(李鏞),50,3,53,1
7022,김교흥(金敎興),이용빈(李龍彬),95,111,206,0
7023,김교흥(金敎興),이용선(李庸瑄),94,66,160,0
7024,김교흥(金敎興),이용우(李龍雨),82,49,131,0
7025,김교흥(金敎興),이용호(李容鎬),29,14,43,1
7026,김교흥(金敎興),이원욱(李元旭),85,68,153,0
7027,김교흥(金敎興),이원택(李源澤),78,39,117,0
7028,김교흥(金敎興),이은주(李恩周),14,10,24,1
7029,김교흥(金敎興),이인선(李仁善),25,3,28,1
7030,김교흥(金敎興),이인영(李仁榮),75,32,107,0
7031,김교흥(金敎興),이장섭(李將燮),85,60,145,0
7032,김교흥(金敎興),이재명(李在明),40,18,58,0
7033,김교흥(金敎興),이재정(李在汀),79,48,127,0
7034,김교흥(金敎興),이정문(李楨文),83,60,143,0
7035,김교흥(金敎興),이종배(李鍾培),51,5,56,1
7036,김교흥(金敎興),이종성(李鍾成),50,3,53,1
7037,김교흥(金敎興),이주환(李周桓),50,5,55,1
7038,김교흥(金敎興),이채익(李埰益),51,6,57,1
7039,김교흥(金敎興),이철규(李喆圭),52,3,55,1
7040,김교흥(金敎興),이탄희(李誕熙),88,54,142,0
7041,김교흥(金敎興),이태규(李泰珪),28,3,31,1
7042,김교흥(金敎興),이학영(李學永),102,116,218,0
7043,김교흥(金敎興),이해식(李海植),93,79,172,0
7044,김교흥(金敎興),이헌승(李憲昇),50,5,55,1
7045,김교흥(金敎興),이형석(李炯錫),99,81,180,0
7046,김교흥(金敎興),인재근(印在謹),85,63,148,0
7047,김교흥(金敎興),임병헌(林炳憲),25,3,28,1
7048,김교흥(金敎興),임오경(林五卿),88,51,139,0
7049,김교흥(金敎興),임이자(林利子),49,3,52,1
7050,김교흥(金敎興),임종성(林鍾聲),101,70,171,0
7051,김교흥(金敎興),임호선(林昊宣),102,133,235,0
7052,김교흥(金敎興),장경태(張耿態),97,78,175,0
7053,김교흥(金敎興),장동혁(張東赫),25,3,28,1
7054,김교흥(金敎興),장제원(張濟元),49,3,52,1
7055,김교흥(金敎興),장철민(張喆敏),92,78,170,0
7056,김교흥(金敎興),장혜영(張惠英),12,9,21,1
7057,김교흥(金敎興),전봉민(田奉珉),35,5,40,1
7058,김교흥(金敎興),전용기(田溶冀),87,74,161,0
7059,김교흥(金敎興),전재수(田載秀),87,49,136,0
7060,김교흥(金敎興),전주혜(全珠惠),52,4,56,1
7061,김교흥(金敎興),전해철(全海澈),77,37,114,0
7062,김교흥(金敎興),전혜숙(全惠淑),79,52,131,0
7063,김교흥(金敎興),정경희(丁慶姬),50,3,53,1
7064,김교흥(金敎興),정동만(鄭東萬),49,3,52,1
7065,김교흥(金敎興),정성호(鄭成湖),92,72,164,0
7066,김교흥(金敎興),정우택(鄭宇澤),26,4,30,1
7067,김교흥(金敎興),정운천(鄭雲天),51,4,55,1
7068,김교흥(金敎興),정일영(鄭日永),152,182,334,0
7069,김교흥(金敎興),정점식(鄭点植),50,3,53,1
7070,김교흥(金敎興),정진석(鄭鎭碩),50,4,54,1
7071,김교흥(金敎興),정청래(鄭淸來),82,35,117,0
7072,김교흥(金敎興),정춘숙(鄭春淑),89,56,145,0
7073,김교흥(金敎興),정태호(鄭泰浩),89,68,157,0
7074,김교흥(金敎興),정필모(鄭必模),84,47,131,0
7075,김교흥(金敎興),정희용(鄭熙溶),50,4,54,1
7076,김교흥(金敎興),조경태(趙慶泰),50,5,55,1
7077,김교흥(金敎興),조명희(曺明姬),51,6,57,1
7078,김교흥(金敎興),조수진(趙修眞),51,3,54,1
7079,김교흥(金敎興),조승래(趙承來),88,62,150,0
7080,김교흥(金敎興),조오섭(曺五燮),99,100,199,0
7081,김교흥(金敎興),조은희(趙恩禧),26,3,29,1
7082,김교흥(金敎興),조응천(趙應天),100,59,159,0
7083,김교흥(金敎興),조정식(趙正湜),85,69,154,0
7084,김교흥(金敎興),조정훈(趙廷訓),1,8,9,1
7085,김교흥(金敎興),조해진(曺海珍),51,5,56,1
7086,김교흥(金敎興),주철현(朱哲鉉),86,56,142,0
7087,김교흥(金敎興),주호영(朱豪英),49,3,52,1
7088,김교흥(金敎興),지성호(池成浩),50,3,53,1
7089,김교흥(金敎興),진선미(陳善美),88,48,136,0
7090,김교흥(金敎興),진성준(陳聲準),104,70,174,0
7091,김교흥(金敎興),천준호(千俊鎬),93,67,160,0
7092,김교흥(金敎興),최기상(崔基相),86,68,154,0
7093,김교흥(金敎興),최승재(崔承宰),50,5,55,1
7094,김교흥(金敎興),최연숙(崔姸淑),30,5,35,1
7095,김교흥(金敎興),최영희(崔英姬),25,3,28,1
7096,김교흥(金敎興),최인호(崔仁昊),95,100,195,0
7097,김교흥(金敎興),최재형(崔在亨),25,3,28,1
7098,김교흥(金敎興),최종윤(崔鍾允),91,72,163,0
7099,김교흥(金敎興),최춘식(崔春植),49,3,52,1
7100,김교흥(金敎興),최형두(崔炯斗),50,3,53,1
7101,김교흥(金敎興),최혜영(崔惠英),83,55,138,0
7102,김교흥(金敎興),추경호(秋慶鎬),49,3,52,1
7103,김교흥(金敎興),태영호(太永浩),49,4,53,1
7104,김교흥(金敎興),하영제(河榮帝),43,1,44,1
7105,김교흥(金敎興),하태경(河泰慶),49,3,52,1
7106,김교흥(金敎興),한기호(韓起鎬),51,5,56,1
7107,김교흥(金敎興),한무경(韓茂景),51,4,55,1
7108,김교흥(金敎興),한병도(韓秉道),107,82,189,0
7109,김교흥(金敎興),한정애(韓貞愛),80,64,144,0
7110,김교흥(金敎興),한준호(韓俊鎬),90,92,182,0
7111,김교흥(金敎興),허숙정(許淑湞),1,1,2,0
7112,김교흥(金敎興),허영(許榮),117,99,216,0
7113,김교흥(金敎興),허은아(許垠娥),49,3,52,1
7114,김교흥(金敎興),허종식(許琮植),154,187,341,0
7115,김교흥(金敎興),홍기원(洪起元),98,60,158,0
7116,김교흥(金敎興),홍문표(洪文杓),50,4,54,1
7117,김교흥(金敎興),홍석준(洪碩晙),50,3,53,1
7118,김교흥(金敎興),홍성국(洪性國),105,66,171,0
7119,김교흥(金敎興),홍영표(洪永杓),93,87,180,0
7120,김교흥(金敎興),홍익표(洪翼杓),90,51,141,0
7121,김교흥(金敎興),홍정민(洪貞敏),91,64,155,0
7122,김교흥(金敎興),황보승희(皇甫承希),46,0,46,1
7123,김교흥(金敎興),황운하(黃雲夏),92,73,165,0
7124,김교흥(金敎興),황희(黃熙),74,33,107,0
7125,김기현(金起炫),김남국(金南局),44,4,48,1
7126,김기현(金起炫),김도읍(金度邑),73,75,148,0
7127,김기현(金起炫),김두관(金斗官),53,9,62,1
7128,김기현(金起炫),김미애(金美愛),75,80,155,0
7129,김기현(金起炫),김민기(金敏基),52,4,56,1
7130,김기현(金起炫),김민석(金民錫),57,16,73,1
7131,김기현(金起炫),김민철(金敏徹),53,5,58,1
7132,김기현(金起炫),김병기(金炳基),54,5,59,1
7133,김기현(金起炫),김병욱A(金炳旭),57,14,71,1
7134,김기현(金起炫),김병욱B(金炳旭),95,86,181,0
7135,김기현(金起炫),김병주(金柄周),55,3,58,1
7136,김기현(金起炫),김상훈(金相勳),84,78,162,0
7137,김기현(金起炫),김상희(金相姬),51,6,57,1
7138,김기현(金起炫),김석기(金碩基),90,116,206,0
7139,김기현(金起炫),김성원(金成願),100,100,200,0
7140,김기현(金起炫),김성주(金成柱),55,6,61,1
7141,김기현(金起炫),김성환(金星煥),53,4,57,1
7142,김기현(金起炫),김수흥(金洙興),53,6,59,1
7143,김기현(金起炫),김승남(金承南),53,7,60,1
7144,김기현(金起炫),김승수(金承洙),90,105,195,0
7145,김기현(金起炫),김승원(金勝源),53,5,58,1
7146,김기현(金起炫),김영배(金永培),52,5,57,1
7147,김기현(金起炫),김영선(金映宣),26,13,39,0
7148,김기현(金起炫),김영식(金英植),116,116,232,0
7149,김기현(金起炫),김영주(金榮珠),54,4,58,1
7150,김기현(金起炫),김영진(金榮鎭),53,3,56,1
7151,김기현(金起炫),김영호(金映豪),52,5,57,1
7152,김기현(金起炫),김예지(金睿智),112,121,233,0
7153,김기현(金起炫),김용민(金容民),52,4,56,1
7154,김기현(金起炫),김용판(金用判),112,115,227,0
7155,김기현(金起炫),김웅(金雄),75,55,130,0
7156,김기현(金起炫),김원이(金元二),53,7,60,1
7157,김기현(金起炫),김윤덕(金潤德),53,4,57,1
7158,김기현(金起炫),김의겸(金宜謙),26,6,32,1
7159,김기현(金起炫),김정재(金汀才),108,118,226,0
7160,김기현(金起炫),김정호(金禎鎬),53,5,58,1
7161,김기현(金起炫),김종민(金鐘民),52,5,57,1
7162,김기현(金起炫),김주영(金周暎),54,6,60,1
7163,김기현(金起炫),김진표(金振杓),29,2,31,1
7164,김기현(金起炫),김철민(金哲玟),51,4,55,1
7165,김기현(金起炫),김태년(金太年),50,4,54,1
7166,김기현(金起炫),김태호(金台鎬),70,57,127,0
7167,김기현(金起炫),김학용(金學容),31,16,47,0
7168,김기현(金起炫),김한규(金翰奎),25,4,29,1
7169,김기현(金起炫),김한정(金漢正),51,4,55,1
7170,김기현(金起炫),김형동(金亨東),99,108,207,0
7171,김기현(金起炫),김홍걸(金弘傑),20,9,29,1
7172,김기현(金起炫),김회재(金會在),52,6,58,1
7173,김기현(金起炫),김희곤(金熙坤),79,75,154,0
7174,김기현(金起炫),김희국(金熙國),74,60,134,0
7175,김기현(金起炫),남인순(南仁順),51,9,60,1
7176,김기현(金起炫),노용호(魯容昊),28,14,42,0
7177,김기현(金起炫),노웅래(盧雄來),53,5,58,1
7178,김기현(金起炫),도종환(都鍾煥),51,5,56,1
7179,김기현(金起炫),류성걸(柳性杰),71,58,129,0
7180,김기현(金起炫),류호정(柳好貞),5,8,13,1
7181,김기현(金起炫),맹성규(孟聖奎),50,5,55,1
7182,김기현(金起炫),문정복(文貞福),50,5,55,1
7183,김기현(金起炫),문진석(文振碩),55,13,68,1
7184,김기현(金起炫),민병덕(閔炳德),51,6,57,1
7185,김기현(金起炫),민형배(閔馨培),34,6,40,1
7186,김기현(金起炫),민홍철(閔洪喆),52,5,57,1
7187,김기현(金起炫),박광온(朴洸瑥),51,5,56,1
7188,김기현(金起炫),박대수(朴大壽),99,100,199,0
7189,김기현(金起炫),박대출(朴大出),80,72,152,0
7190,김기현(金起炫),박덕흠(朴德欽),65,75,140,0
7191,김기현(金起炫),박범계(朴範界),50,4,54,1
7192,김기현(金起炫),박병석(朴炳錫),25,3,28,1
7193,김기현(金起炫),박상혁(朴商赫),51,5,56,1
7194,김기현(金起炫),박성민(朴聖敏),82,93,175,0
7195,김기현(金起炫),박성준(朴省俊),50,7,57,1
7196,김기현(金起炫),박성중(朴成重),76,69,145,0
7197,김기현(金起炫),박수영(朴洙瑩),75,72,147,0
7198,김기현(金起炫),박영순(朴英淳),52,6,58,1
7199,김기현(金起炫),박완주(朴完柱),25,0,25,1
7200,김기현(金起炫),박용진(朴用鎭),49,6,55,1
7201,김기현(金起炫),박재호(朴在昊),55,6,61,1
7202,김기현(金起炫),박정(朴釘),52,7,59,1
7203,김기현(金起炫),박정하(朴正河),31,13,44,0
7204,김기현(金起炫),박주민(朴柱民),50,5,55,1
7205,김기현(金起炫),박진(朴振),77,79,156,0
7206,김기현(金起炫),박찬대(朴贊大),51,5,56,1
7207,김기현(金起炫),박형수(朴亨修),73,51,124,0
7208,김기현(金起炫),박홍근(朴洪根),53,4,57,1
7209,김기현(金起炫),배준영(裵俊英),78,68,146,0
7210,김기현(金起炫),배진교(裵晋敎),7,9,16,1
7211,김기현(金起炫),배현진(裵賢鎭),81,74,155,0
7212,김기현(金起炫),백종헌(白宗憲),90,96,186,0
7213,김기현(金起炫),백혜련(白惠蓮),51,5,56,1
7214,김기현(金起炫),변재일(卞在一),52,6,58,1
7215,김기현(金起炫),서동용(徐東榕),50,6,56,1
7216,김기현(金起炫),서범수(徐範洙),83,81,164,0
7217,김기현(金起炫),서병수(徐秉洙),96,82,178,0
7218,김기현(金起炫),서삼석(徐參錫),49,5,54,1
7219,김기현(金起炫),서영교(徐瑛敎),52,6,58,1
7220,김기현(金起炫),서영석(徐暎錫),50,7,57,1
7221,김기현(金起炫),서일준(徐一俊),103,120,223,0
7222,김기현(金起炫),서정숙(徐正淑),78,74,152,0
7223,김기현(金起炫),설훈(薛勳),52,6,58,1
7224,김기현(金起炫),성일종(成一鍾),97,104,201,0
7225,김기현(金起炫),소병철(蘇秉哲),52,4,56,1
7226,김기현(金起炫),소병훈(蘇秉勳),51,6,57,1
7227,김기현(金起炫),송갑석(宋甲錫),52,7,59,1
7228,김기현(金起炫),송기헌(宋基憲),51,5,56,1
7229,김기현(金起炫),송석준(宋錫俊),72,56,128,0
7230,김기현(金起炫),송언석(宋彦錫),99,111,210,0
7231,김기현(金起炫),송옥주(宋玉珠),51,5,56,1
7232,김기현(金起炫),송재호(宋在祜),52,5,57,1
7233,김기현(金起炫),신동근(申東根),52,11,63,1
7234,김기현(金起炫),신영대(申榮大),50,5,55,1
7235,김기현(金起炫),신원식(申源湜),86,81,167,0
7236,김기현(金起炫),신정훈(辛正勳),53,8,61,1
7237,김기현(金起炫),신현영(申賢榮),50,5,55,1
7238,김기현(金起炫),심상정(沈相奵),7,4,11,1
7239,김기현(金起炫),안규백(安圭伯),54,7,61,1
7240,김기현(金起炫),안민석(安敏錫),53,7,60,1
7241,김기현(金起炫),안병길(安炳吉),70,81,151,0
7242,김기현(金起炫),안철수(安哲秀),29,11,40,0
7243,김기현(金起炫),안호영(安浩永),50,5,55,1
7244,김기현(金起炫),양경숙(梁敬淑),50,5,55,1
7245,김기현(金起炫),양금희(梁琴喜),118,142,260,0
7246,김기현(金起炫),양기대(梁基大),50,5,55,1
7247,김기현(金起炫),양이원영(梁李媛瑛),45,6,51,1
7248,김기현(金起炫),양정숙(梁貞淑),4,3,7,1
7249,김기현(金起炫),양향자(梁香子),24,2,26,1
7250,김기현(金起炫),어기구(魚基龜),50,5,55,1
7251,김기현(金起炫),엄태영(嚴泰永),72,60,132,0
7252,김기현(金起炫),오기형(吳奇炯),49,4,53,1
7253,김기현(金起炫),오영환(吳永煥),51,8,59,1
7254,김기현(金起炫),용혜인(龍慧仁),1,10,11,1
7255,김기현(金起炫),우상호(禹相虎),52,5,57,1
7256,김기현(金起炫),우원식(禹元植),51,5,56,1
7257,김기현(金起炫),위성곤(魏聖坤),51,4,55,1
7258,김기현(金起炫),유경준(兪京濬),80,75,155,0
7259,김기현(金起炫),유기홍(柳基洪),50,4,54,1
7260,김기현(金起炫),유동수(柳東秀),52,12,64,1
7261,김기현(金起炫),유상범(劉相凡),70,61,131,0
7262,김기현(金起炫),유의동(兪義東),81,71,152,0
7263,김기현(金起炫),유정주(兪訂炷),50,7,57,1
7264,김기현(金起炫),윤건영(尹建永),49,4,53,1
7265,김기현(金起炫),윤관석(尹官石),42,1,43,1
7266,김기현(金起炫),윤두현(尹斗鉉),96,106,202,0
7267,김기현(金起炫),윤미향(尹美香),20,1,21,1
7268,김기현(金起炫),윤상현(尹相現),40,29,69,0
7269,김기현(金起炫),윤영덕(尹永德),50,5,55,1
7270,김기현(金起炫),윤영석(尹永碩),72,45,117,0
7271,김기현(金起炫),윤영찬(尹永燦),50,4,54,1
7272,김기현(金起炫),윤재갑(尹才鉀),53,10,63,1
7273,김기현(金起炫),윤재옥(尹在玉),73,62,135,0
7274,김기현(金起炫),윤주경(尹柱卿),77,94,171,0
7275,김기현(金起炫),윤준병(尹準炳),51,6,57,1
7276,김기현(金起炫),윤창현(尹暢賢),102,114,216,0
7277,김기현(金起炫),윤한홍(尹漢洪),83,93,176,0
7278,김기현(金起炫),윤호중(尹昊重),52,5,57,1
7279,김기현(金起炫),윤후덕(尹厚德),51,5,56,1
7280,김기현(金起炫),이개호(李介昊),52,4,56,1
7281,김기현(金起炫),이달곤(李達坤),64,57,121,0
7282,김기현(金起炫),이동주(李東洲),50,4,54,1
7283,김기현(金起炫),이만희(李晩熙),83,66,149,0
7284,김기현(金起炫),이명수(李明洙),100,84,184,0
7285,김기현(金起炫),이병훈(李炳勳),53,8,61,1
7286,김기현(金起炫),이상민(李相珉),50,4,54,1
7287,김기현(金起炫),이상헌(李相憲),56,18,74,1
7288,김기현(金起炫),이성만(李成萬),41,2,43,1
7289,김기현(金起炫),이소영(李素永),52,4,56,1
7290,김기현(金起炫),이수진(李壽珍),51,5,56,1
7291,김기현(金起炫),이수진(李秀眞),50,4,54,1
7292,김기현(金起炫),이양수(李亮壽),74,71,145,0
7293,김기현(金起炫),이용(李鏞),81,87,168,0
7294,김기현(金起炫),이용빈(李龍彬),52,10,62,1
7295,김기현(金起炫),이용선(李庸瑄),50,4,54,1
7296,김기현(金起炫),이용우(李龍雨),51,10,61,1
7297,김기현(金起炫),이용호(李容鎬),35,26,61,0
7298,김기현(金起炫),이원욱(李元旭),52,4,56,1
7299,김기현(金起炫),이원택(李源澤),50,5,55,1
7300,김기현(金起炫),이은주(李恩周),7,4,11,1
7301,김기현(金起炫),이인선(李仁善),29,13,42,0
7302,김기현(金起炫),이인영(李仁榮),50,4,54,1
7303,김기현(金起炫),이장섭(李將燮),50,5,55,1
7304,김기현(金起炫),이재명(李在明),25,4,29,1
7305,김기현(金起炫),이재정(李在汀),50,4,54,1
7306,김기현(金起炫),이정문(李楨文),50,4,54,1
7307,김기현(金起炫),이종배(李鍾培),88,94,182,0
7308,김기현(金起炫),이종성(李鍾成),89,106,195,0
7309,김기현(金起炫),이주환(李周桓),123,111,234,0
7310,김기현(金起炫),이채익(李埰益),86,98,184,0
7311,김기현(金起炫),이철규(李喆圭),81,74,155,0
7312,김기현(金起炫),이탄희(李誕熙),50,5,55,1
7313,김기현(金起炫),이태규(李泰珪),48,45,93,0
7314,김기현(金起炫),이학영(李學永),49,4,53,1
7315,김기현(金起炫),이해식(李海植),52,5,57,1
7316,김기현(金起炫),이헌승(李憲昇),72,62,134,0
7317,김기현(金起炫),이형석(李炯錫),51,4,55,1
7318,김기현(金起炫),인재근(印在謹),50,5,55,1
7319,김기현(金起炫),임병헌(林炳憲),32,16,48,0
7320,김기현(金起炫),임오경(林五卿),50,5,55,1
7321,김기현(金起炫),임이자(林利子),100,89,189,0
7322,김기현(金起炫),임종성(林鍾聲),52,5,57,1
7323,김기현(金起炫),임호선(林昊宣),51,6,57,1
7324,김기현(金起炫),장경태(張耿態),50,5,55,1
7325,김기현(金起炫),장동혁(張東赫),27,13,40,0
7326,김기현(金起炫),장제원(張濟元),68,56,124,0
7327,김기현(金起炫),장철민(張喆敏),51,5,56,1
7328,김기현(金起炫),장혜영(張惠英),8,8,16,1
7329,김기현(金起炫),전봉민(田奉珉),71,66,137,0
7330,김기현(金起炫),전용기(田溶冀),52,10,62,1
7331,김기현(金起炫),전재수(田載秀),50,5,55,1
7332,김기현(金起炫),전주혜(全珠惠),89,99,188,0
7333,김기현(金起炫),전해철(全海澈),52,4,56,1
7334,김기현(金起炫),전혜숙(全惠淑),50,8,58,1
7335,김기현(金起炫),정경희(丁慶姬),75,77,152,0
7336,김기현(金起炫),정동만(鄭東萬),80,67,147,0
7337,김기현(金起炫),정성호(鄭成湖),56,6,62,1
7338,김기현(金起炫),정우택(鄭宇澤),33,19,52,0
7339,김기현(金起炫),정운천(鄭雲天),82,68,150,0
7340,김기현(金起炫),정일영(鄭日永),50,8,58,1
7341,김기현(金起炫),정점식(鄭点植),71,48,119,0
7342,김기현(金起炫),정진석(鄭鎭碩),95,110,205,0
7343,김기현(金起炫),정청래(鄭淸來),49,5,54,1
7344,김기현(金起炫),정춘숙(鄭春淑),50,5,55,1
7345,김기현(金起炫),정태호(鄭泰浩),50,4,54,1
7346,김기현(金起炫),정필모(鄭必模),51,4,55,1
7347,김기현(金起炫),정희용(鄭熙溶),105,97,202,0
7348,김기현(金起炫),조경태(趙慶泰),77,68,145,0
7349,김기현(金起炫),조명희(曺明姬),91,106,197,0
7350,김기현(金起炫),조수진(趙修眞),86,92,178,0
7351,김기현(金起炫),조승래(趙承來),52,4,56,1
7352,김기현(金起炫),조오섭(曺五燮),51,4,55,1
7353,김기현(金起炫),조은희(趙恩禧),34,18,52,0
7354,김기현(金起炫),조응천(趙應天),51,5,56,1
7355,김기현(金起炫),조정식(趙正湜),49,3,52,1
7356,김기현(金起炫),조정훈(趙廷訓),1,5,6,1
7357,김기현(金起炫),조해진(曺海珍),64,41,105,0
7358,김기현(金起炫),주철현(朱哲鉉),52,5,57,1
7359,김기현(金起炫),주호영(朱豪英),68,45,113,0
7360,김기현(金起炫),지성호(池成浩),106,125,231,0
7361,김기현(金起炫),진선미(陳善美),50,4,54,1
7362,김기현(金起炫),진성준(陳聲準),50,4,54,1
7363,김기현(金起炫),천준호(千俊鎬),50,3,53,1
7364,김기현(金起炫),최기상(崔基相),50,4,54,1
7365,김기현(金起炫),최승재(崔承宰),96,88,184,0
7366,김기현(金起炫),최연숙(崔姸淑),43,37,80,0
7367,김기현(金起炫),최영희(崔英姬),31,15,46,0
7368,김기현(金起炫),최인호(崔仁昊),52,4,56,1
7369,김기현(金起炫),최재형(崔在亨),27,12,39,0
7370,김기현(金起炫),최종윤(崔鍾允),51,4,55,1
7371,김기현(金起炫),최춘식(崔春植),74,71,145,0
7372,김기현(金起炫),최형두(崔炯斗),90,77,167,0
7373,김기현(金起炫),최혜영(崔惠英),50,5,55,1
7374,김기현(金起炫),추경호(秋慶鎬),107,141,248,0
7375,김기현(金起炫),태영호(太永浩),114,135,249,0
7376,김기현(金起炫),하영제(河榮帝),70,75,145,1
7377,김기현(金起炫),하태경(河泰慶),69,57,126,0
7378,김기현(金起炫),한기호(韓起鎬),67,73,140,0
7379,김기현(金起炫),한무경(韓茂景),100,108,208,0
7380,김기현(金起炫),한병도(韓秉道),52,7,59,1
7381,김기현(金起炫),한정애(韓貞愛),51,4,55,1
7382,김기현(金起炫),한준호(韓俊鎬),53,4,57,1
7383,김기현(金起炫),허숙정(許淑湞),0,0,0,1
7384,김기현(金起炫),허영(許榮),53,4,57,1
7385,김기현(金起炫),허은아(許垠娥),91,82,173,0
7386,김기현(金起炫),허종식(許琮植),52,8,60,1
7387,김기현(金起炫),홍기원(洪起元),52,6,58,1
7388,김기현(金起炫),홍문표(洪文杓),73,62,135,0
7389,김기현(金起炫),홍석준(洪碩晙),70,60,130,0
7390,김기현(金起炫),홍성국(洪性國),50,5,55,1
7391,김기현(金起炫),홍영표(洪永杓),50,6,56,1
7392,김기현(金起炫),홍익표(洪翼杓),51,5,56,1
7393,김기현(金起炫),홍정민(洪貞敏),55,10,65,1
7394,김기현(金起炫),황보승희(皇甫承希),90,94,184,1
7395,김기현(金起炫),황운하(黃雲夏),52,7,59,1
7396,김기현(金起炫),황희(黃熙),49,5,54,1
7397,김남국(金南局),김도읍(金度邑),43,0,43,1
7398,김남국(金南局),김두관(金斗官),91,104,195,1
7399,김남국(金南局),김미애(金美愛),43,0,43,1
7400,김남국(金南局),김민기(金敏基),82,66,148,1
7401,김남국(金南局),김민석(金民錫),98,76,174,1
7402,김남국(金南局),김민철(金敏徹),144,169,313,1
7403,김남국(金南局),김병기(金炳基),78,57,135,1
7404,김남국(金南局),김병욱A(金炳旭),87,102,189,1
7405,김남국(金南局),김병욱B(金炳旭),35,1,36,1
7406,김남국(金南局),김병주(金柄周),118,114,232,1
7407,김남국(金南局),김상훈(金相勳),44,2,46,1
7408,김남국(金南局),김상희(金相姬),85,85,170,1
7409,김남국(金南局),김석기(金碩基),44,3,47,1
7410,김남국(金南局),김성원(金成願),44,7,51,1
7411,김남국(金南局),김성주(金成柱),82,72,154,1
7412,김남국(金南局),김성환(金星煥),85,74,159,1
7413,김남국(金南局),김수흥(金洙興),91,83,174,1
7414,김남국(金南局),김승남(金承南),95,106,201,1
7415,김남국(金南局),김승수(金承洙),44,7,51,1
7416,김남국(金南局),김승원(金勝源),127,230,357,1
7417,김남국(金南局),김영배(金永培),104,118,222,1
7418,김남국(金南局),김영선(金映宣),17,0,17,1
7419,김남국(金南局),김영식(金英植),43,1,44,1
7420,김남국(金南局),김영주(金榮珠),78,59,137,1
7421,김남국(金南局),김영진(金榮鎭),71,55,126,1
7422,김남국(金南局),김영호(金映豪),89,82,171,1
7423,김남국(金南局),김예지(金睿智),45,5,50,1
7424,김남국(金南局),김용민(金容民),125,177,302,1
7425,김남국(金南局),김용판(金用判),46,0,46,1
7426,김남국(金南局),김웅(金雄),42,2,44,1
7427,김남국(金南局),김원이(金元二),95,111,206,1
7428,김남국(金南局),김윤덕(金潤德),83,89,172,1
7429,김남국(金南局),김의겸(金宜謙),38,85,123,1
7430,김남국(金南局),김정재(金汀才),46,2,48,1
7431,김남국(金南局),김정호(金禎鎬),93,148,241,1
7432,김남국(金南局),김종민(金鐘民),97,91,188,1
7433,김남국(金南局),김주영(金周暎),87,90,177,1
7434,김남국(金南局),김진표(金振杓),49,50,99,0
7435,김남국(金南局),김철민(金哲玟),97,119,216,1
7436,김남국(金南局),김태년(金太年),65,36,101,1
7437,김남국(金南局),김태호(金台鎬),34,1,35,1
7438,김남국(金南局),김학용(金學容),16,0,16,1
7439,김남국(金南局),김한규(金翰奎),32,32,64,1
7440,김남국(金南局),김한정(金漢正),71,58,129,1
7441,김남국(金南局),김형동(金亨東),44,6,50,1
7442,김남국(金南局),김홍걸(金弘傑),57,119,176,1
7443,김남국(金南局),김회재(金會在),100,78,178,1
7444,김남국(金南局),김희곤(金熙坤),42,3,45,1
7445,김남국(金南局),김희국(金熙國),40,1,41,1
7446,김남국(金南局),남인순(南仁順),104,107,211,1
7447,김남국(金南局),노용호(魯容昊),17,0,17,1
7448,김남국(金南局),노웅래(盧雄來),91,76,167,1
7449,김남국(金南局),도종환(都鍾煥),88,76,164,1
7450,김남국(金南局),류성걸(柳性杰),40,0,40,1
7451,김남국(金南局),류호정(柳好貞),24,48,72,1
7452,김남국(金南局),맹성규(孟聖奎),87,68,155,1
7453,김남국(金南局),문정복(文貞福),99,100,199,1
7454,김남국(金南局),문진석(文振碩),101,114,215,1
7455,김남국(金南局),민병덕(閔炳德),93,148,241,1
7456,김남국(金南局),민형배(閔馨培),100,262,362,1
7457,김남국(金南局),민홍철(閔洪喆),73,59,132,1
7458,김남국(金南局),박광온(朴洸瑥),79,78,157,1
7459,김남국(金南局),박대수(朴大壽),41,4,45,1
7460,김남국(金南局),박대출(朴大出),42,1,43,1
7461,김남국(金南局),박덕흠(朴德欽),27,5,32,1
7462,김남국(金南局),박범계(朴範界),92,40,132,1
7463,김남국(金南局),박병석(朴炳錫),30,10,40,1
7464,김남국(金南局),박상혁(朴商赫),80,161,241,1
7465,김남국(金南局),박성민(朴聖敏),41,1,42,1
7466,김남국(金南局),박성준(朴省俊),123,132,255,1
7467,김남국(金南局),박성중(朴成重),40,1,41,1
7468,김남국(金南局),박수영(朴洙瑩),41,1,42,1
7469,김남국(金南局),박영순(朴英淳),98,114,212,1
7470,김남국(金南局),박완주(朴完柱),54,38,92,0
7471,김남국(金南局),박용진(朴用鎭),71,44,115,1
7472,김남국(金南局),박재호(朴在昊),76,51,127,1
7473,김남국(金南局),박정(朴釘),103,101,204,1
7474,김남국(金南局),박정하(朴正河),17,0,17,1
7475,김남국(金南局),박주민(朴柱民),107,110,217,1
7476,김남국(金南局),박진(朴振),42,1,43,1
7477,김남국(金南局),박찬대(朴贊大),78,66,144,1
7478,김남국(金南局),박형수(朴亨修),41,1,42,1
7479,김남국(金南局),박홍근(朴洪根),98,105,203,1
7480,김남국(金南局),배준영(裵俊英),41,1,42,1
7481,김남국(金南局),배진교(裵晋敎),18,34,52,1
7482,김남국(金南局),배현진(裵賢鎭),41,0,41,1
7483,김남국(金南局),백종헌(白宗憲),43,0,43,1
7484,김남국(金南局),백혜련(白惠蓮),112,75,187,1
7485,김남국(金南局),변재일(卞在一),66,41,107,1
7486,김남국(金南局),서동용(徐東榕),87,121,208,1
7487,김남국(金南局),서범수(徐範洙),45,2,47,1
7488,김남국(金南局),서병수(徐秉洙),42,1,43,1
7489,김남국(金南局),서삼석(徐參錫),88,90,178,1
7490,김남국(金南局),서영교(徐瑛敎),91,125,216,1
7491,김남국(金南局),서영석(徐暎錫),99,115,214,1
7492,김남국(金南局),서일준(徐一俊),43,2,45,1
7493,김남국(金南局),서정숙(徐正淑),41,2,43,1
7494,김남국(金南局),설훈(薛勳),74,60,134,1
7495,김남국(金南局),성일종(成一鍾),42,3,45,1
7496,김남국(金南局),소병철(蘇秉哲),112,89,201,1
7497,김남국(金南局),소병훈(蘇秉勳),86,78,164,1
7498,김남국(金南局),송갑석(宋甲錫),92,122,214,1
7499,김남국(金南局),송기헌(宋基憲),98,48,146,1
7500,김남국(金南局),송석준(宋錫俊),42,1,43,1
7501,김남국(金南局),송언석(宋彦錫),36,1,37,1
7502,김남국(金南局),송옥주(宋玉珠),78,65,143,1
7503,김남국(金南局),송재호(宋在祜),88,107,195,1
7504,김남국(金南局),신동근(申東根),99,69,168,1
7505,김남국(金南局),신영대(申榮大),72,54,126,1
7506,김남국(金南局),신원식(申源湜),43,1,44,1
7507,김남국(金南局),신정훈(辛正勳),118,159,277,1
7508,김남국(金南局),신현영(申賢榮),104,84,188,1
7509,김남국(金南局),심상정(沈相奵),17,35,52,1
7510,김남국(金南局),안규백(安圭伯),89,94,183,1
7511,김남국(金南局),안민석(安敏錫),86,90,176,1
7512,김남국(金南局),안병길(安炳吉),45,1,46,1
7513,김남국(金南局),안철수(安哲秀),17,1,18,1
7514,김남국(金南局),안호영(安浩永),80,69,149,1
7515,김남국(金南局),양경숙(梁敬淑),95,114,209,1
7516,김남국(金南局),양금희(梁琴喜),42,3,45,1
7517,김남국(金南局),양기대(梁基大),88,76,164,1
7518,김남국(金南局),양이원영(梁李媛瑛),102,118,220,1
7519,김남국(金南局),양정숙(梁貞淑),65,207,272,0
7520,김남국(金南局),양향자(梁香子),55,57,112,1
7521,김남국(金南局),어기구(魚基龜),74,78,152,1
7522,김남국(金南局),엄태영(嚴泰永),43,1,44,1
7523,김남국(金南局),오기형(吳奇炯),86,48,134,1
7524,김남국(金南局),오영환(吳永煥),235,325,560,1
7525,김남국(金南局),용혜인(龍慧仁),20,64,84,1
7526,김남국(金南局),우상호(禹相虎),69,33,102,1
7527,김남국(金南局),우원식(禹元植),81,68,149,1
7528,김남국(金南局),위성곤(魏聖坤),79,148,227,1
7529,김남국(金南局),유경준(兪京濬),40,3,43,1
7530,김남국(金南局),유기홍(柳基洪),71,49,120,1
7531,김남국(金南局),유동수(柳東秀),78,53,131,1
7532,김남국(金南局),유상범(劉相凡),43,1,44,1
7533,김남국(金南局),유의동(兪義東),43,1,44,1
7534,김남국(金南局),유정주(兪訂炷),108,165,273,1
7535,김남국(金南局),윤건영(尹建永),81,82,163,1
7536,김남국(金南局),윤관석(尹官石),80,56,136,0
7537,김남국(金南局),윤두현(尹斗鉉),42,1,43,1
7538,김남국(金南局),윤미향(尹美香),71,122,193,0
7539,김남국(金南局),윤상현(尹相現),22,2,24,1
7540,김남국(金南局),윤영덕(尹永德),100,157,257,1
7541,김남국(金南局),윤영석(尹永碩),41,3,44,1
7542,김남국(金南局),윤영찬(尹永燦),73,51,124,1
7543,김남국(金南局),윤재갑(尹才鉀),99,112,211,1
7544,김남국(金南局),윤재옥(尹在玉),44,1,45,1
7545,김남국(金南局),윤주경(尹柱卿),40,1,41,1
7546,김남국(金南局),윤준병(尹準炳),100,180,280,1
7547,김남국(金南局),윤창현(尹暢賢),40,1,41,1
7548,김남국(金南局),윤한홍(尹漢洪),41,1,42,1
7549,김남국(金南局),윤호중(尹昊重),71,56,127,1
7550,김남국(金南局),윤후덕(尹厚德),82,81,163,1
7551,김남국(金南局),이개호(李介昊),77,91,168,1
7552,김남국(金南局),이달곤(李達坤),44,2,46,1
7553,김남국(金南局),이동주(李東洲),85,131,216,1
7554,김남국(金南局),이만희(李晩熙),42,0,42,1
7555,김남국(金南局),이명수(李明洙),43,7,50,1
7556,김남국(金南局),이병훈(李炳勳),103,154,257,1
7557,김남국(金南局),이상민(李相珉),72,44,116,1
7558,김남국(金南局),이상헌(李相憲),82,91,173,1
7559,김남국(金南局),이성만(李成萬),103,127,230,0
7560,김남국(金南局),이소영(李素永),87,67,154,1
7561,김남국(金南局),이수진(李壽珍),114,157,271,1
7562,김남국(金南局),이수진(李秀眞),149,174,323,1
7563,김남국(金南局),이양수(李亮壽),44,4,48,1
7564,김남국(金南局),이용(李鏞),42,1,43,1
7565,김남국(金南局),이용빈(李龍彬),126,175,301,1
7566,김남국(金南局),이용선(李庸瑄),88,92,180,1
7567,김남국(金南局),이용우(李龍雨),126,132,258,1
7568,김남국(金南局),이용호(李容鎬),23,8,31,1
7569,김남국(金南局),이원욱(李元旭),88,89,177,1
7570,김남국(金南局),이원택(李源澤),129,120,249,1
7571,김남국(金南局),이은주(李恩周),26,35,61,1
7572,김남국(金南局),이인선(李仁善),16,0,16,1
7573,김남국(金南局),이인영(李仁榮),66,40,106,1
7574,김남국(金南局),이장섭(李將燮),77,67,144,1
7575,김남국(金南局),이재명(李在明),29,17,46,1
7576,김남국(金南局),이재정(李在汀),91,66,157,1
7577,김남국(金南局),이정문(李楨文),89,108,197,1
7578,김남국(金南局),이종배(李鍾培),42,3,45,1
7579,김남국(金南局),이종성(李鍾成),42,3,45,1
7580,김남국(金南局),이주환(李周桓),42,2,44,1
7581,김남국(金南局),이채익(李埰益),43,1,44,1
7582,김남국(金南局),이철규(李喆圭),44,0,44,1
7583,김남국(金南局),이탄희(李誕熙),90,83,173,1
7584,김남국(金南局),이태규(李泰珪),19,1,20,1
7585,김남국(金南局),이학영(李學永),86,77,163,1
7586,김남국(金南局),이해식(李海植),104,88,192,1
7587,김남국(金南局),이헌승(李憲昇),42,0,42,1
7588,김남국(金南局),이형석(李炯錫),107,117,224,1
7589,김남국(金南局),인재근(印在謹),84,86,170,1
7590,김남국(金南局),임병헌(林炳憲),16,0,16,1
7591,김남국(金南局),임오경(林五卿),139,169,308,1
7592,김남국(金南局),임이자(林利子),40,0,40,1
7593,김남국(金南局),임종성(林鍾聲),93,109,202,1
7594,김남국(金南局),임호선(林昊宣),152,204,356,1
7595,김남국(金南局),장경태(張耿態),172,255,427,1
7596,김남국(金南局),장동혁(張東赫),16,0,16,1
7597,김남국(金南局),장제원(張濟元),41,0,41,1
7598,김남국(金南局),장철민(張喆敏),136,155,291,1
7599,김남국(金南局),장혜영(張惠英),15,24,39,1
7600,김남국(金南局),전봉민(田奉珉),27,1,28,1
7601,김남국(金南局),전용기(田溶冀),121,130,251,1
7602,김남국(金南局),전재수(田載秀),76,48,124,1
7603,김남국(金南局),전주혜(全珠惠),44,1,45,1
7604,김남국(金南局),전해철(全海澈),74,54,128,1
7605,김남국(金南局),전혜숙(全惠淑),101,88,189,1
7606,김남국(金南局),정경희(丁慶姬),42,1,43,1
7607,김남국(金南局),정동만(鄭東萬),41,0,41,1
7608,김남국(金南局),정성호(鄭成湖),83,78,161,1
7609,김남국(金南局),정우택(鄭宇澤),17,1,18,1
7610,김남국(金南局),정운천(鄭雲天),41,1,42,1
7611,김남국(金南局),정일영(鄭日永),74,72,146,1
7612,김남국(金南局),정점식(鄭点植),42,0,42,1
7613,김남국(金南局),정진석(鄭鎭碩),44,5,49,1
7614,김남국(金南局),정청래(鄭淸來),145,157,302,1
7615,김남국(金南局),정춘숙(鄭春淑),85,82,167,1
7616,김남국(金南局),정태호(鄭泰浩),78,76,154,1
7617,김남국(金南局),정필모(鄭必模),81,72,153,1
7618,김남국(金南局),정희용(鄭熙溶),41,2,43,1
7619,김남국(金南局),조경태(趙慶泰),42,1,43,1
7620,김남국(金南局),조명희(曺明姬),42,3,45,1
7621,김남국(金南局),조수진(趙修眞),43,2,45,1
7622,김남국(金南局),조승래(趙承來),81,65,146,1
7623,김남국(金南局),조오섭(曺五燮),91,152,243,1
7624,김남국(金南局),조은희(趙恩禧),17,0,17,1
7625,김남국(金南局),조응천(趙應天),66,29,95,1
7626,김남국(金南局),조정식(趙正湜),65,35,100,1
7627,김남국(金南局),조정훈(趙廷訓),5,19,24,1
7628,김남국(金南局),조해진(曺海珍),42,2,44,1
7629,김남국(金南局),주철현(朱哲鉉),125,149,274,1
7630,김남국(金南局),주호영(朱豪英),41,0,41,1
7631,김남국(金南局),지성호(池成浩),41,2,43,1
7632,김남국(金南局),진선미(陳善美),71,59,130,1
7633,김남국(金南局),진성준(陳聲準),96,120,216,1
7634,김남국(金南局),천준호(千俊鎬),90,72,162,1
7635,김남국(金南局),최기상(崔基相),101,94,195,1
7636,김남국(金南局),최승재(崔承宰),44,1,45,1
7637,김남국(金南局),최연숙(崔姸淑),24,8,32,1
7638,김남국(金南局),최영희(崔英姬),16,1,17,1
7639,김남국(金南局),최인호(崔仁昊),72,67,139,1
7640,김남국(金南局),최재형(崔在亨),16,1,17,1
7641,김남국(金南局),최종윤(崔鍾允),99,120,219,1
7642,김남국(金南局),최춘식(崔春植),41,1,42,1
7643,김남국(金南局),최형두(崔炯斗),42,5,47,1
7644,김남국(金南局),최혜영(崔惠英),173,214,387,1
7645,김남국(金南局),추경호(秋慶鎬),40,2,42,1
7646,김남국(金南局),태영호(太永浩),40,2,42,1
7647,김남국(金南局),하영제(河榮帝),43,1,44,0
7648,김남국(金南局),하태경(河泰慶),41,1,42,1
7649,김남국(金南局),한기호(韓起鎬),43,1,44,1
7650,김남국(金南局),한무경(韓茂景),41,0,41,1
7651,김남국(金南局),한병도(韓秉道),94,91,185,1
7652,김남국(金南局),한정애(韓貞愛),71,47,118,1
7653,김남국(金南局),한준호(韓俊鎬),129,164,293,1
7654,김남국(金南局),허숙정(許淑湞),1,1,2,1
7655,김남국(金南局),허영(許榮),104,136,240,1
7656,김남국(金南局),허은아(許垠娥),41,1,42,1
7657,김남국(金南局),허종식(許琮植),85,86,171,1
7658,김남국(金南局),홍기원(洪起元),88,88,176,1
7659,김남국(金南局),홍문표(洪文杓),41,7,48,1
7660,김남국(金南局),홍석준(洪碩晙),41,0,41,1
7661,김남국(金南局),홍성국(洪性國),150,177,327,1
7662,김남국(金南局),홍영표(洪永杓),74,53,127,1
7663,김남국(金南局),홍익표(洪翼杓),79,68,147,1
7664,김남국(金南局),홍정민(洪貞敏),119,156,275,1
7665,김남국(金南局),황보승희(皇甫承希),46,2,48,0
7666,김남국(金南局),황운하(黃雲夏),125,189,314,1
7667,김남국(金南局),황희(黃熙),69,42,111,1
7668,김도읍(金度邑),김두관(金斗官),51,4,55,1
7669,김도읍(金度邑),김미애(金美愛),82,100,182,0
7670,김도읍(金度邑),김민기(金敏基),51,4,55,1
7671,김도읍(金度邑),김민석(金民錫),51,4,55,1
7672,김도읍(金度邑),김민철(金敏徹),51,4,55,1
7673,김도읍(金度邑),김병기(金炳基),51,4,55,1
7674,김도읍(金度邑),김병욱A(金炳旭),51,4,55,1
7675,김도읍(金度邑),김병욱B(金炳旭),92,100,192,0
7676,김도읍(金度邑),김병주(金柄周),52,3,55,1
7677,김도읍(金度邑),김상훈(金相勳),80,108,188,0
7678,김도읍(金度邑),김상희(金相姬),51,4,55,1
7679,김도읍(金度邑),김석기(金碩基),87,121,208,0
7680,김도읍(金度邑),김성원(金成願),103,132,235,0
7681,김도읍(金度邑),김성주(金成柱),51,5,56,1
7682,김도읍(金度邑),김성환(金星煥),51,4,55,1
7683,김도읍(金度邑),김수흥(金洙興),51,5,56,1
7684,김도읍(金度邑),김승남(金承南),51,4,55,1
7685,김도읍(金度邑),김승수(金承洙),78,96,174,0
7686,김도읍(金度邑),김승원(金勝源),51,4,55,1
7687,김도읍(金度邑),김영배(金永培),52,4,56,1
7688,김도읍(金度邑),김영선(金映宣),27,16,43,0
7689,김도읍(金度邑),김영식(金英植),71,93,164,0
7690,김도읍(金度邑),김영주(金榮珠),51,4,55,1
7691,김도읍(金度邑),김영진(金榮鎭),53,3,56,1
7692,김도읍(金度邑),김영호(金映豪),51,4,55,1
7693,김도읍(金度邑),김예지(金睿智),88,91,179,0
7694,김도읍(金度邑),김용민(金容民),51,4,55,1
7695,김도읍(金度邑),김용판(金用判),99,148,247,0
7696,김도읍(金度邑),김웅(金雄),68,45,113,0
7697,김도읍(金度邑),김원이(金元二),51,4,55,1
7698,김도읍(金度邑),김윤덕(金潤德),51,3,54,1
7699,김도읍(金度邑),김의겸(金宜謙),26,4,30,1
7700,김도읍(金度邑),김정재(金汀才),102,126,228,0
7701,김도읍(金度邑),김정호(金禎鎬),53,5,58,1
7702,김도읍(金度邑),김종민(金鐘民),51,5,56,1
7703,김도읍(金度邑),김주영(金周暎),50,4,54,1
7704,김도읍(金度邑),김진표(金振杓),25,1,26,1
7705,김도읍(金度邑),김철민(金哲玟),49,3,52,1
7706,김도읍(金度邑),김태년(金太年),49,4,53,1
7707,김도읍(金度邑),김태호(金台鎬),58,61,119,0
7708,김도읍(金度邑),김학용(金學容),34,26,60,0
7709,김도읍(金度邑),김한규(金翰奎),25,5,30,1
7710,김도읍(金度邑),김한정(金漢正),49,4,53,1
7711,김도읍(金度邑),김형동(金亨東),72,78,150,0
7712,김도읍(金度邑),김홍걸(金弘傑),14,5,19,1
7713,김도읍(金度邑),김회재(金會在),50,3,53,1
7714,김도읍(金度邑),김희곤(金熙坤),88,143,231,0
7715,김도읍(金度邑),김희국(金熙國),75,50,125,0
7716,김도읍(金度邑),남인순(南仁順),49,4,53,1
7717,김도읍(金度邑),노용호(魯容昊),36,52,88,0
7718,김도읍(金度邑),노웅래(盧雄來),49,3,52,1
7719,김도읍(金度邑),도종환(都鍾煥),49,4,53,1
7720,김도읍(金度邑),류성걸(柳性杰),68,55,123,0
7721,김도읍(金度邑),류호정(柳好貞),5,3,8,1
7722,김도읍(金度邑),맹성규(孟聖奎),49,5,54,1
7723,김도읍(金度邑),문정복(文貞福),51,4,55,1
7724,김도읍(金度邑),문진석(文振碩),49,4,53,1
7725,김도읍(金度邑),민병덕(閔炳德),49,4,53,1
7726,김도읍(金度邑),민형배(閔馨培),33,4,37,1
7727,김도읍(金度邑),민홍철(閔洪喆),49,4,53,1
7728,김도읍(金度邑),박광온(朴洸瑥),49,4,53,1
7729,김도읍(金度邑),박대수(朴大壽),70,114,184,0
7730,김도읍(金度邑),박대출(朴大出),62,60,122,0
7731,김도읍(金度邑),박덕흠(朴德欽),77,78,155,0
7732,김도읍(金度邑),박범계(朴範界),49,4,53,1
7733,김도읍(金度邑),박병석(朴炳錫),25,3,28,1
7734,김도읍(金度邑),박상혁(朴商赫),50,5,55,1
7735,김도읍(金度邑),박성민(朴聖敏),77,148,225,0
7736,김도읍(金度邑),박성준(朴省俊),49,4,53,1
7737,김도읍(金度邑),박성중(朴成重),73,46,119,0
7738,김도읍(金度邑),박수영(朴洙瑩),79,76,155,0
7739,김도읍(金度邑),박영순(朴英淳),50,3,53,1
7740,김도읍(金度邑),박완주(朴完柱),24,0,24,1
7741,김도읍(金度邑),박용진(朴用鎭),49,5,54,1
7742,김도읍(金度邑),박재호(朴在昊),51,8,59,1
7743,김도읍(金度邑),박정(朴釘),49,4,53,1
7744,김도읍(金度邑),박정하(朴正河),27,16,43,0
7745,김도읍(金度邑),박주민(朴柱民),49,4,53,1
7746,김도읍(金度邑),박진(朴振),70,70,140,0
7747,김도읍(金度邑),박찬대(朴贊大),49,4,53,1
7748,김도읍(金度邑),박형수(朴亨修),65,67,132,0
7749,김도읍(金度邑),박홍근(朴洪根),50,4,54,1
7750,김도읍(金度邑),배준영(裵俊英),71,62,133,0
7751,김도읍(金度邑),배진교(裵晋敎),4,2,6,1
7752,김도읍(金度邑),배현진(裵賢鎭),68,51,119,0
7753,김도읍(金度邑),백종헌(白宗憲),87,132,219,0
7754,김도읍(金度邑),백혜련(白惠蓮),51,5,56,1
7755,김도읍(金度邑),변재일(卞在一),49,4,53,1
7756,김도읍(金度邑),서동용(徐東榕),49,4,53,1
7757,김도읍(金度邑),서범수(徐範洙),76,83,159,0
7758,김도읍(金度邑),서병수(徐秉洙),94,145,239,0
7759,김도읍(金度邑),서삼석(徐參錫),49,5,54,1
7760,김도읍(金度邑),서영교(徐瑛敎),49,4,53,1
7761,김도읍(金度邑),서영석(徐暎錫),49,4,53,1
7762,김도읍(金度邑),서일준(徐一俊),82,118,200,0
7763,김도읍(金度邑),서정숙(徐正淑),69,54,123,0
7764,김도읍(金度邑),설훈(薛勳),50,4,54,1
7765,김도읍(金度邑),성일종(成一鍾),81,118,199,0
7766,김도읍(金度邑),소병철(蘇秉哲),49,4,53,1
7767,김도읍(金度邑),소병훈(蘇秉勳),49,4,53,1
7768,김도읍(金度邑),송갑석(宋甲錫),49,4,53,1
7769,김도읍(金度邑),송기헌(宋基憲),49,9,58,1
7770,김도읍(金度邑),송석준(宋錫俊),71,54,125,0
7771,김도읍(金度邑),송언석(宋彦錫),84,87,171,0
7772,김도읍(金度邑),송옥주(宋玉珠),49,3,52,1
7773,김도읍(金度邑),송재호(宋在祜),49,4,53,1
7774,김도읍(金度邑),신동근(申東根),49,3,52,1
7775,김도읍(金度邑),신영대(申榮大),49,4,53,1
7776,김도읍(金度邑),신원식(申源湜),72,81,153,0
7777,김도읍(金度邑),신정훈(辛正勳),50,4,54,1
7778,김도읍(金度邑),신현영(申賢榮),49,4,53,1
7779,김도읍(金度邑),심상정(沈相奵),4,2,6,1
7780,김도읍(金度邑),안규백(安圭伯),51,12,63,1
7781,김도읍(金度邑),안민석(安敏錫),50,3,53,1
7782,김도읍(金度邑),안병길(安炳吉),91,162,253,0
7783,김도읍(金度邑),안철수(安哲秀),26,16,42,0
7784,김도읍(金度邑),안호영(安浩永),49,4,53,1
7785,김도읍(金度邑),양경숙(梁敬淑),49,4,53,1
7786,김도읍(金度邑),양금희(梁琴喜),95,147,242,0
7787,김도읍(金度邑),양기대(梁基大),49,4,53,1
7788,김도읍(金度邑),양이원영(梁李媛瑛),45,4,49,1
7789,김도읍(金度邑),양정숙(梁貞淑),1,0,1,1
7790,김도읍(金度邑),양향자(梁香子),21,8,29,1
7791,김도읍(金度邑),어기구(魚基龜),49,4,53,1
7792,김도읍(金度邑),엄태영(嚴泰永),86,103,189,0
7793,김도읍(金度邑),오기형(吳奇炯),49,4,53,1
7794,김도읍(金度邑),오영환(吳永煥),49,4,53,1
7795,김도읍(金度邑),용혜인(龍慧仁),1,1,2,1
7796,김도읍(金度邑),우상호(禹相虎),49,4,53,1
7797,김도읍(金度邑),우원식(禹元植),49,4,53,1
7798,김도읍(金度邑),위성곤(魏聖坤),49,5,54,1
7799,김도읍(金度邑),유경준(兪京濬),77,93,170,0
7800,김도읍(金度邑),유기홍(柳基洪),49,4,53,1
7801,김도읍(金度邑),유동수(柳東秀),50,4,54,1
7802,김도읍(金度邑),유상범(劉相凡),87,164,251,0
7803,김도읍(金度邑),유의동(兪義東),71,99,170,0
7804,김도읍(金度邑),유정주(兪訂炷),49,4,53,1
7805,김도읍(金度邑),윤건영(尹建永),49,3,52,1
7806,김도읍(金度邑),윤관석(尹官石),40,0,40,1
7807,김도읍(金度邑),윤두현(尹斗鉉),75,84,159,0
7808,김도읍(金度邑),윤미향(尹美香),20,0,20,1
7809,김도읍(金度邑),윤상현(尹相現),41,34,75,0
7810,김도읍(金度邑),윤영덕(尹永德),49,4,53,1
7811,김도읍(金度邑),윤영석(尹永碩),75,53,128,0
7812,김도읍(金度邑),윤영찬(尹永燦),49,4,53,1
7813,김도읍(金度邑),윤재갑(尹才鉀),49,4,53,1
7814,김도읍(金度邑),윤재옥(尹在玉),64,57,121,0
7815,김도읍(金度邑),윤주경(尹柱卿),67,67,134,0
7816,김도읍(金度邑),윤준병(尹準炳),49,4,53,1
7817,김도읍(金度邑),윤창현(尹暢賢),81,121,202,0
7818,김도읍(金度邑),윤한홍(尹漢洪),78,75,153,0
7819,김도읍(金度邑),윤호중(尹昊重),50,4,54,1
7820,김도읍(金度邑),윤후덕(尹厚德),49,4,53,1
7821,김도읍(金度邑),이개호(李介昊),49,4,53,1
7822,김도읍(金度邑),이달곤(李達坤),63,58,121,0
7823,김도읍(金度邑),이동주(李東洲),49,4,53,1
7824,김도읍(金度邑),이만희(李晩熙),81,76,157,0
7825,김도읍(金度邑),이명수(李明洙),82,97,179,0
7826,김도읍(金度邑),이병훈(李炳勳),51,5,56,1
7827,김도읍(金度邑),이상민(李相珉),49,4,53,1
7828,김도읍(金度邑),이상헌(李相憲),50,5,55,1
7829,김도읍(金度邑),이성만(李成萬),40,0,40,1
7830,김도읍(金度邑),이소영(李素永),49,4,53,1
7831,김도읍(金度邑),이수진(李壽珍),49,4,53,1
7832,김도읍(金度邑),이수진(李秀眞),49,4,53,1
7833,김도읍(金度邑),이양수(李亮壽),79,86,165,0
7834,김도읍(金度邑),이용(李鏞),84,111,195,0
7835,김도읍(金度邑),이용빈(李龍彬),50,4,54,1
7836,김도읍(金度邑),이용선(李庸瑄),49,4,53,1
7837,김도읍(金度邑),이용우(李龍雨),49,5,54,1
7838,김도읍(金度邑),이용호(李容鎬),31,25,56,0
7839,김도읍(金度邑),이원욱(李元旭),50,4,54,1
7840,김도읍(金度邑),이원택(李源澤),49,4,53,1
7841,김도읍(金度邑),이은주(李恩周),5,2,7,1
7842,김도읍(金度邑),이인선(李仁善),28,27,55,0
7843,김도읍(金度邑),이인영(李仁榮),49,4,53,1
7844,김도읍(金度邑),이장섭(李將燮),49,4,53,1
7845,김도읍(金度邑),이재명(李在明),25,4,29,1
7846,김도읍(金度邑),이재정(李在汀),49,4,53,1
7847,김도읍(金度邑),이정문(李楨文),49,4,53,1
7848,김도읍(金度邑),이종배(李鍾培),89,89,178,0
7849,김도읍(金度邑),이종성(李鍾成),92,124,216,0
7850,김도읍(金度邑),이주환(李周桓),106,168,274,0
7851,김도읍(金度邑),이채익(李埰益),70,86,156,0
7852,김도읍(金度邑),이철규(李喆圭),83,84,167,0
7853,김도읍(金度邑),이탄희(李誕熙),49,4,53,1
7854,김도읍(金度邑),이태규(李泰珪),33,29,62,0
7855,김도읍(金度邑),이학영(李學永),49,4,53,1
7856,김도읍(金度邑),이해식(李海植),49,4,53,1
7857,김도읍(金度邑),이헌승(李憲昇),104,153,257,0
7858,김도읍(金度邑),이형석(李炯錫),49,4,53,1
7859,김도읍(金度邑),인재근(印在謹),49,4,53,1
7860,김도읍(金度邑),임병헌(林炳憲),28,27,55,0
7861,김도읍(金度邑),임오경(林五卿),49,4,53,1
7862,김도읍(金度邑),임이자(林利子),83,103,186,0
7863,김도읍(金度邑),임종성(林鍾聲),50,4,54,1
7864,김도읍(金度邑),임호선(林昊宣),49,5,54,1
7865,김도읍(金度邑),장경태(張耿態),49,4,53,1
7866,김도읍(金度邑),장동혁(張東赫),35,79,114,0
7867,김도읍(金度邑),장제원(張濟元),68,64,132,0
7868,김도읍(金度邑),장철민(張喆敏),49,4,53,1
7869,김도읍(金度邑),장혜영(張惠英),5,2,7,1
7870,김도읍(金度邑),전봉민(田奉珉),82,160,242,0
7871,김도읍(金度邑),전용기(田溶冀),49,4,53,1
7872,김도읍(金度邑),전재수(田載秀),50,7,57,1
7873,김도읍(金度邑),전주혜(全珠惠),73,111,184,0
7874,김도읍(金度邑),전해철(全海澈),50,4,54,1
7875,김도읍(金度邑),전혜숙(全惠淑),49,4,53,1
7876,김도읍(金度邑),정경희(丁慶姬),64,59,123,0
7877,김도읍(金度邑),정동만(鄭東萬),97,141,238,0
7878,김도읍(金度邑),정성호(鄭成湖),50,4,54,1
7879,김도읍(金度邑),정우택(鄭宇澤),27,34,61,0
7880,김도읍(金度邑),정운천(鄭雲天),78,112,190,0
7881,김도읍(金度邑),정일영(鄭日永),49,5,54,1
7882,김도읍(金度邑),정점식(鄭点植),75,78,153,0
7883,김도읍(金度邑),정진석(鄭鎭碩),72,78,150,0
7884,김도읍(金度邑),정청래(鄭淸來),49,4,53,1
7885,김도읍(金度邑),정춘숙(鄭春淑),49,4,53,1
7886,김도읍(金度邑),정태호(鄭泰浩),49,4,53,1
7887,김도읍(金度邑),정필모(鄭必模),49,4,53,1
7888,김도읍(金度邑),정희용(鄭熙溶),79,107,186,0
7889,김도읍(金度邑),조경태(趙慶泰),83,99,182,0
7890,김도읍(金度邑),조명희(曺明姬),74,108,182,0
7891,김도읍(金度邑),조수진(趙修眞),97,176,273,0
7892,김도읍(金度邑),조승래(趙承來),49,3,52,1
7893,김도읍(金度邑),조오섭(曺五燮),49,4,53,1
7894,김도읍(金度邑),조은희(趙恩禧),28,17,45,0
7895,김도읍(金度邑),조응천(趙應天),49,4,53,1
7896,김도읍(金度邑),조정식(趙正湜),49,3,52,1
7897,김도읍(金度邑),조정훈(趙廷訓),0,4,4,1
7898,김도읍(金度邑),조해진(曺海珍),62,46,108,0
7899,김도읍(金度邑),주철현(朱哲鉉),50,4,54,1
7900,김도읍(金度邑),주호영(朱豪英),73,76,149,0
7901,김도읍(金度邑),지성호(池成浩),66,85,151,0
7902,김도읍(金度邑),진선미(陳善美),49,4,53,1
7903,김도읍(金度邑),진성준(陳聲準),51,4,55,1
7904,김도읍(金度邑),천준호(千俊鎬),49,3,52,1
7905,김도읍(金度邑),최기상(崔基相),49,4,53,1
7906,김도읍(金度邑),최승재(崔承宰),82,94,176,0
7907,김도읍(金度邑),최연숙(崔姸淑),31,24,55,0
7908,김도읍(金度邑),최영희(崔英姬),30,39,69,0
7909,김도읍(金度邑),최인호(崔仁昊),51,7,58,1
7910,김도읍(金度邑),최재형(崔在亨),25,14,39,0
7911,김도읍(金度邑),최종윤(崔鍾允),49,4,53,1
7912,김도읍(金度邑),최춘식(崔春植),96,114,210,0
7913,김도읍(金度邑),최형두(崔炯斗),103,91,194,0
7914,김도읍(金度邑),최혜영(崔惠英),50,4,54,1
7915,김도읍(金度邑),추경호(秋慶鎬),101,153,254,0
7916,김도읍(金度邑),태영호(太永浩),91,130,221,0
7917,김도읍(金度邑),하영제(河榮帝),71,82,153,1
7918,김도읍(金度邑),하태경(河泰慶),69,63,132,0
7919,김도읍(金度邑),한기호(韓起鎬),65,76,141,0
7920,김도읍(金度邑),한무경(韓茂景),80,139,219,0
7921,김도읍(金度邑),한병도(韓秉道),49,4,53,1
7922,김도읍(金度邑),한정애(韓貞愛),49,4,53,1
7923,김도읍(金度邑),한준호(韓俊鎬),49,4,53,1
7924,김도읍(金度邑),허숙정(許淑湞),0,0,0,1
7925,김도읍(金度邑),허영(許榮),49,9,58,1
7926,김도읍(金度邑),허은아(許垠娥),70,48,118,0
7927,김도읍(金度邑),허종식(許琮植),49,4,53,1
7928,김도읍(金度邑),홍기원(洪起元),49,4,53,1
7929,김도읍(金度邑),홍문표(洪文杓),70,74,144,0
7930,김도읍(金度邑),홍석준(洪碩晙),68,44,112,0
7931,김도읍(金度邑),홍성국(洪性國),49,4,53,1
7932,김도읍(金度邑),홍영표(洪永杓),49,4,53,1
7933,김도읍(金度邑),홍익표(洪翼杓),49,4,53,1
7934,김도읍(金度邑),홍정민(洪貞敏),49,4,53,1
7935,김도읍(金度邑),황보승희(皇甫承希),86,134,220,1
7936,김도읍(金度邑),황운하(黃雲夏),49,4,53,1
7937,김도읍(金度邑),황희(黃熙),49,5,54,1
7938,김두관(金斗官),김미애(金美愛),51,5,56,1
7939,김두관(金斗官),김민기(金敏基),91,69,160,0
7940,김두관(金斗官),김민석(金民錫),89,113,202,0
7941,김두관(金斗官),김민철(金敏徹),96,97,193,0
7942,김두관(金斗官),김병기(金炳基),96,133,229,0
7943,김두관(金斗官),김병욱A(金炳旭),100,142,242,0
7944,김두관(金斗官),김병욱B(金炳旭),44,10,54,1
7945,김두관(金斗官),김병주(金柄周),90,56,146,0
7946,김두관(金斗官),김상훈(金相勳),53,7,60,1
7947,김두관(金斗官),김상희(金相姬),94,85,179,0
7948,김두관(金斗官),김석기(金碩基),52,6,58,1
7949,김두관(金斗官),김성원(金成願),52,6,58,1
7950,김두관(金斗官),김성주(金成柱),88,79,167,0
7951,김두관(金斗官),김성환(金星煥),91,78,169,0
7952,김두관(金斗官),김수흥(金洙興),105,79,184,0
7953,김두관(金斗官),김승남(金承南),103,158,261,0
7954,김두관(金斗官),김승수(金承洙),52,7,59,1
7955,김두관(金斗官),김승원(金勝源),103,130,233,0
7956,김두관(金斗官),김영배(金永培),98,97,195,0
7957,김두관(金斗官),김영선(金映宣),26,6,32,1
7958,김두관(金斗官),김영식(金英植),51,5,56,1
7959,김두관(金斗官),김영주(金榮珠),85,79,164,0
7960,김두관(金斗官),김영진(金榮鎭),84,55,139,0
7961,김두관(金斗官),김영호(金映豪),91,91,182,0
7962,김두관(金斗官),김예지(金睿智),51,8,59,1
7963,김두관(金斗官),김용민(金容民),93,121,214,0
7964,김두관(金斗官),김용판(金用判),53,4,57,1
7965,김두관(金斗官),김웅(金雄),51,4,55,1
7966,김두관(金斗官),김원이(金元二),99,102,201,0
7967,김두관(金斗官),김윤덕(金潤德),99,83,182,0
7968,김두관(金斗官),김의겸(金宜謙),50,93,143,0
7969,김두관(金斗官),김정재(金汀才),53,9,62,1
7970,김두관(金斗官),김정호(金禎鎬),116,227,343,0
7971,김두관(金斗官),김종민(金鐘民),86,97,183,0
7972,김두관(金斗官),김주영(金周暎),105,125,230,0
7973,김두관(金斗官),김진표(金振杓),49,49,98,1
7974,김두관(金斗官),김철민(金哲玟),96,71,167,0
7975,김두관(金斗官),김태년(金太年),79,60,139,0
7976,김두관(金斗官),김태호(金台鎬),41,5,46,1
7977,김두관(金斗官),김학용(金學容),25,8,33,1
7978,김두관(金斗官),김한규(金翰奎),44,50,94,0
7979,김두관(金斗官),김한정(金漢正),80,53,133,0
7980,김두관(金斗官),김형동(金亨東),52,6,58,1
7981,김두관(金斗官),김홍걸(金弘傑),44,111,155,0
7982,김두관(金斗官),김회재(金會在),92,92,184,0
7983,김두관(金斗官),김희곤(金熙坤),50,7,57,1
7984,김두관(金斗官),김희국(金熙國),49,5,54,1
7985,김두관(金斗官),남인순(南仁順),100,95,195,0
7986,김두관(金斗官),노용호(魯容昊),26,4,30,1
7987,김두관(金斗官),노웅래(盧雄來),96,94,190,0
7988,김두관(金斗官),도종환(都鍾煥),90,83,173,0
7989,김두관(金斗官),류성걸(柳性杰),49,4,53,1
7990,김두관(金斗官),류호정(柳好貞),19,69,88,1
7991,김두관(金斗官),맹성규(孟聖奎),93,65,158,0
7992,김두관(金斗官),문정복(文貞福),94,81,175,0
7993,김두관(金斗官),문진석(文振碩),97,112,209,0
7994,김두관(金斗官),민병덕(閔炳德),88,123,211,0
7995,김두관(金斗官),민형배(閔馨培),82,144,226,0
7996,김두관(金斗官),민홍철(閔洪喆),88,145,233,0
7997,김두관(金斗官),박광온(朴洸瑥),88,75,163,0
7998,김두관(金斗官),박대수(朴大壽),50,9,59,1
7999,김두관(金斗官),박대출(朴大出),51,5,56,1
8000,김두관(金斗官),박덕흠(朴德欽),37,9,46,1
8001,김두관(金斗官),박범계(朴範界),79,37,116,0
8002,김두관(金斗官),박병석(朴炳錫),41,16,57,0
8003,김두관(金斗官),박상혁(朴商赫),91,173,264,0
8004,김두관(金斗官),박성민(朴聖敏),50,7,57,1
8005,김두관(金斗官),박성준(朴省俊),97,123,220,0
8006,김두관(金斗官),박성중(朴成重),49,4,53,1
8007,김두관(金斗官),박수영(朴洙瑩),50,4,54,1
8008,김두관(金斗官),박영순(朴英淳),89,73,162,0
8009,김두관(金斗官),박완주(朴完柱),49,54,103,1
8010,김두관(金斗官),박용진(朴用鎭),82,59,141,0
8011,김두관(金斗官),박재호(朴在昊),90,105,195,0
8012,김두관(金斗官),박정(朴釘),98,88,186,0
8013,김두관(金斗官),박정하(朴正河),26,4,30,1
8014,김두관(金斗官),박주민(朴柱民),81,78,159,0
8015,김두관(金斗官),박진(朴振),50,3,53,1
8016,김두관(金斗官),박찬대(朴贊大),87,73,160,0
8017,김두관(金斗官),박형수(朴亨修),49,4,53,1
8018,김두관(金斗官),박홍근(朴洪根),94,91,185,0
8019,김두관(金斗官),배준영(裵俊英),49,6,55,1
8020,김두관(金斗官),배진교(裵晋敎),16,48,64,1
8021,김두관(金斗官),배현진(裵賢鎭),49,4,53,1
8022,김두관(金斗官),백종헌(白宗憲),51,10,61,1
8023,김두관(金斗官),백혜련(白惠蓮),86,77,163,0
8024,김두관(金斗官),변재일(卞在一),80,57,137,0
8025,김두관(金斗官),서동용(徐東榕),92,115,207,0
8026,김두관(金斗官),서범수(徐範洙),50,7,57,1
8027,김두관(金斗官),서병수(徐秉洙),50,6,56,1
8028,김두관(金斗官),서삼석(徐參錫),95,77,172,0
8029,김두관(金斗官),서영교(徐瑛敎),95,127,222,0
8030,김두관(金斗官),서영석(徐暎錫),95,112,207,0
8031,김두관(金斗官),서일준(徐一俊),51,7,58,1
8032,김두관(金斗官),서정숙(徐正淑),49,5,54,1
8033,김두관(金斗官),설훈(薛勳),77,62,139,0
8034,김두관(金斗官),성일종(成一鍾),50,9,59,1
8035,김두관(金斗官),소병철(蘇秉哲),84,62,146,0
8036,김두관(金斗官),소병훈(蘇秉勳),92,100,192,0
8037,김두관(金斗官),송갑석(宋甲錫),95,99,194,0
8038,김두관(金斗官),송기헌(宋基憲),85,62,147,0
8039,김두관(金斗官),송석준(宋錫俊),49,5,54,1
8040,김두관(金斗官),송언석(宋彦錫),45,5,50,1
8041,김두관(金斗官),송옥주(宋玉珠),93,80,173,0
8042,김두관(金斗官),송재호(宋在祜),95,124,219,0
8043,김두관(金斗官),신동근(申東根),88,73,161,0
8044,김두관(金斗官),신영대(申榮大),89,57,146,0
8045,김두관(金斗官),신원식(申源湜),50,13,63,1
8046,김두관(金斗官),신정훈(辛正勳),109,189,298,0
8047,김두관(金斗官),신현영(申賢榮),77,57,134,0
8048,김두관(金斗官),심상정(沈相奵),17,67,84,1
8049,김두관(金斗官),안규백(安圭伯),102,89,191,0
8050,김두관(金斗官),안민석(安敏錫),94,86,180,0
8051,김두관(金斗官),안병길(安炳吉),50,5,55,1
8052,김두관(金斗官),안철수(安哲秀),26,4,30,1
8053,김두관(金斗官),안호영(安浩永),83,68,151,0
8054,김두관(金斗官),양경숙(梁敬淑),110,109,219,0
8055,김두관(金斗官),양금희(梁琴喜),51,6,57,1
8056,김두관(金斗官),양기대(梁基大),86,67,153,0
8057,김두관(金斗官),양이원영(梁李媛瑛),85,82,167,0
8058,김두관(金斗官),양정숙(梁貞淑),42,179,221,1
8059,김두관(金斗官),양향자(梁香子),49,62,111,1
8060,김두관(金斗官),어기구(魚基龜),81,58,139,0
8061,김두관(金斗官),엄태영(嚴泰永),51,5,56,1
8062,김두관(金斗官),오기형(吳奇炯),79,43,122,0
8063,김두관(金斗官),오영환(吳永煥),111,158,269,0
8064,김두관(金斗官),용혜인(龍慧仁),15,97,112,1
8065,김두관(金斗官),우상호(禹相虎),80,45,125,0
8066,김두관(金斗官),우원식(禹元植),92,81,173,0
8067,김두관(金斗官),위성곤(魏聖坤),97,117,214,0
8068,김두관(金斗官),유경준(兪京濬),49,7,56,1
8069,김두관(金斗官),유기홍(柳基洪),85,61,146,0
8070,김두관(金斗官),유동수(柳東秀),87,61,148,0
8071,김두관(金斗官),유상범(劉相凡),50,4,54,1
8072,김두관(金斗官),유의동(兪義東),49,5,54,1
8073,김두관(金斗官),유정주(兪訂炷),90,145,235,0
8074,김두관(金斗官),윤건영(尹建永),84,92,176,0
8075,김두관(金斗官),윤관석(尹官石),78,59,137,1
8076,김두관(金斗官),윤두현(尹斗鉉),50,6,56,1
8077,김두관(金斗官),윤미향(尹美香),46,107,153,1
8078,김두관(金斗官),윤상현(尹相現),32,4,36,1
8079,김두관(金斗官),윤영덕(尹永德),98,124,222,0
8080,김두관(金斗官),윤영석(尹永碩),50,6,56,1
8081,김두관(金斗官),윤영찬(尹永燦),83,58,141,0
8082,김두관(金斗官),윤재갑(尹才鉀),108,112,220,0
8083,김두관(金斗官),윤재옥(尹在玉),49,4,53,1
8084,김두관(金斗官),윤주경(尹柱卿),49,5,54,1
8085,김두관(金斗官),윤준병(尹準炳),92,146,238,0
8086,김두관(金斗官),윤창현(尹暢賢),49,5,54,1
8087,김두관(金斗官),윤한홍(尹漢洪),50,5,55,1
8088,김두관(金斗官),윤호중(尹昊重),79,58,137,0
8089,김두관(金斗官),윤후덕(尹厚德),88,73,161,0
8090,김두관(金斗官),이개호(李介昊),94,112,206,0
8091,김두관(金斗官),이달곤(李達坤),52,7,59,1
8092,김두관(金斗官),이동주(李東洲),91,129,220,0
8093,김두관(金斗官),이만희(李晩熙),51,4,55,1
8094,김두관(金斗官),이명수(李明洙),50,20,70,1
8095,김두관(金斗官),이병훈(李炳勳),105,120,225,0
8096,김두관(金斗官),이상민(李相珉),77,37,114,0
8097,김두관(金斗官),이상헌(李相憲),91,170,261,0
8098,김두관(金斗官),이성만(李成萬),90,114,204,1
8099,김두관(金斗官),이소영(李素永),81,49,130,0
8100,김두관(金斗官),이수진(李壽珍),101,131,232,0
8101,김두관(金斗官),이수진(李秀眞),101,113,214,0
8102,김두관(金斗官),이양수(李亮壽),51,7,58,1
8103,김두관(金斗官),이용(李鏞),50,6,56,1
8104,김두관(金斗官),이용빈(李龍彬),98,129,227,0
8105,김두관(金斗官),이용선(李庸瑄),88,92,180,0
8106,김두관(金斗官),이용우(李龍雨),88,79,167,0
8107,김두관(金斗官),이용호(李容鎬),29,16,45,1
8108,김두관(金斗官),이원욱(李元旭),85,80,165,0
8109,김두관(金斗官),이원택(李源澤),90,82,172,0
8110,김두관(金斗官),이은주(李恩周),19,50,69,1
8111,김두관(金斗官),이인선(李仁善),25,5,30,1
8112,김두관(金斗官),이인영(李仁榮),79,72,151,0
8113,김두관(金斗官),이장섭(李將燮),83,72,155,0
8114,김두관(金斗官),이재명(李在明),41,21,62,0
8115,김두관(金斗官),이재정(李在汀),82,46,128,0
8116,김두관(金斗官),이정문(李楨文),98,85,183,0
8117,김두관(金斗官),이종배(李鍾培),51,7,58,1
8118,김두관(金斗官),이종성(李鍾成),50,7,57,1
8119,김두관(金斗官),이주환(李周桓),50,4,54,1
8120,김두관(金斗官),이채익(李埰益),52,6,58,1
8121,김두관(金斗官),이철규(李喆圭),51,4,55,1
8122,김두관(金斗官),이탄희(李誕熙),84,103,187,0
8123,김두관(金斗官),이태규(李泰珪),29,7,36,1
8124,김두관(金斗官),이학영(李學永),99,127,226,0
8125,김두관(金斗官),이해식(李海植),90,81,171,0
8126,김두관(金斗官),이헌승(李憲昇),50,4,54,1
8127,김두관(金斗官),이형석(李炯錫),100,95,195,0
8128,김두관(金斗官),인재근(印在謹),89,92,181,0
8129,김두관(金斗官),임병헌(林炳憲),26,8,34,1
8130,김두관(金斗官),임오경(林五卿),92,72,164,0
8131,김두관(金斗官),임이자(林利子),49,4,53,1
8132,김두관(金斗官),임종성(林鍾聲),96,119,215,0
8133,김두관(金斗官),임호선(林昊宣),104,155,259,0
8134,김두관(金斗官),장경태(張耿態),96,121,217,0
8135,김두관(金斗官),장동혁(張東赫),25,5,30,1
8136,김두관(金斗官),장제원(張濟元),49,5,54,1
8137,김두관(金斗官),장철민(張喆敏),93,105,198,0
8138,김두관(金斗官),장혜영(張惠英),13,49,62,1
8139,김두관(金斗官),전봉민(田奉珉),35,5,40,1
8140,김두관(金斗官),전용기(田溶冀),95,116,211,0
8141,김두관(金斗官),전재수(田載秀),96,146,242,0
8142,김두관(金斗官),전주혜(全珠惠),52,6,58,1
8143,김두관(金斗官),전해철(全海澈),77,67,144,0
8144,김두관(金斗官),전혜숙(全惠淑),96,117,213,0
8145,김두관(金斗官),정경희(丁慶姬),50,6,56,1
8146,김두관(金斗官),정동만(鄭東萬),49,4,53,1
8147,김두관(金斗官),정성호(鄭成湖),100,131,231,0
8148,김두관(金斗官),정우택(鄭宇澤),26,6,32,1
8149,김두관(金斗官),정운천(鄭雲天),50,5,55,1
8150,김두관(金斗官),정일영(鄭日永),93,112,205,0
8151,김두관(金斗官),정점식(鄭点植),50,7,57,1
8152,김두관(金斗官),정진석(鄭鎭碩),50,8,58,1
8153,김두관(金斗官),정청래(鄭淸來),83,55,138,0
8154,김두관(金斗官),정춘숙(鄭春淑),85,77,162,0
8155,김두관(金斗官),정태호(鄭泰浩),89,137,226,0
8156,김두관(金斗官),정필모(鄭必模),94,79,173,0
8157,김두관(金斗官),정희용(鄭熙溶),50,5,55,1
8158,김두관(金斗官),조경태(趙慶泰),50,6,56,1
8159,김두관(金斗官),조명희(曺明姬),50,6,56,1
8160,김두관(金斗官),조수진(趙修眞),50,6,56,1
8161,김두관(金斗官),조승래(趙承來),89,78,167,0
8162,김두관(金斗官),조오섭(曺五燮),97,149,246,0
8163,김두관(金斗官),조은희(趙恩禧),26,7,33,1
8164,김두관(金斗官),조응천(趙應天),78,42,120,0
8165,김두관(金斗官),조정식(趙正湜),78,58,136,0
8166,김두관(金斗官),조정훈(趙廷訓),5,20,25,1
8167,김두관(金斗官),조해진(曺海珍),51,7,58,1
8168,김두관(金斗官),주철현(朱哲鉉),96,111,207,0
8169,김두관(金斗官),주호영(朱豪英),49,4,53,1
8170,김두관(金斗官),지성호(池成浩),50,5,55,1
8171,김두관(金斗官),진선미(陳善美),78,54,132,0
8172,김두관(金斗官),진성준(陳聲準),90,94,184,0
8173,김두관(金斗官),천준호(千俊鎬),91,72,163,0
8174,김두관(金斗官),최기상(崔基相),88,81,169,0
8175,김두관(金斗官),최승재(崔承宰),50,6,56,1
8176,김두관(金斗官),최연숙(崔姸淑),31,25,56,1
8177,김두관(金斗官),최영희(崔英姬),25,4,29,1
8178,김두관(金斗官),최인호(崔仁昊),94,120,214,0
8179,김두관(金斗官),최재형(崔在亨),25,4,29,1
8180,김두관(金斗官),최종윤(崔鍾允),92,145,237,0
8181,김두관(金斗官),최춘식(崔春植),49,4,53,1
8182,김두관(金斗官),최형두(崔炯斗),50,8,58,1
8183,김두관(金斗官),최혜영(崔惠英),90,109,199,0
8184,김두관(金斗官),추경호(秋慶鎬),49,4,53,1
8185,김두관(金斗官),태영호(太永浩),49,8,57,1
8186,김두관(金斗官),하영제(河榮帝),43,4,47,1
8187,김두관(金斗官),하태경(河泰慶),51,5,56,1
8188,김두관(金斗官),한기호(韓起鎬),51,4,55,1
8189,김두관(金斗官),한무경(韓茂景),49,6,55,1
8190,김두관(金斗官),한병도(韓秉道),88,95,183,0
8191,김두관(金斗官),한정애(韓貞愛),81,86,167,0
8192,김두관(金斗官),한준호(韓俊鎬),98,170,268,0
8193,김두관(金斗官),허숙정(許淑湞),1,1,2,0
8194,김두관(金斗官),허영(許榮),102,114,216,0
8195,김두관(金斗官),허은아(許垠娥),49,4,53,1
8196,김두관(金斗官),허종식(許琮植),91,88,179,0
8197,김두관(金斗官),홍기원(洪起元),86,85,171,0
8198,김두관(金斗官),홍문표(洪文杓),50,7,57,1
8199,김두관(金斗官),홍석준(洪碩晙),50,4,54,1
8200,김두관(金斗官),홍성국(洪性國),102,120,222,0
8201,김두관(金斗官),홍영표(洪永杓),86,62,148,0
8202,김두관(金斗官),홍익표(洪翼杓),85,63,148,0
8203,김두관(金斗官),홍정민(洪貞敏),91,102,193,0
8204,김두관(金斗官),황보승희(皇甫承希),47,3,50,1
8205,김두관(金斗官),황운하(黃雲夏),95,161,256,0
8206,김두관(金斗官),황희(黃熙),80,47,127,0
8207,김미애(金美愛),김민기(金敏基),51,4,55,1
8208,김미애(金美愛),김민석(金民錫),51,10,61,1
8209,김미애(金美愛),김민철(金敏徹),51,7,58,1
8210,김미애(金美愛),김병기(金炳基),52,6,58,1
8211,김미애(金美愛),김병욱A(金炳旭),51,6,57,1
8212,김미애(金美愛),김병욱B(金炳旭),82,111,193,0
8213,김미애(金美愛),김병주(金柄周),51,4,55,1
8214,김미애(金美愛),김상훈(金相勳),83,88,171,0
8215,김미애(金美愛),김상희(金相姬),51,5,56,1
8216,김미애(金美愛),김석기(金碩基),89,97,186,0
8217,김미애(金美愛),김성원(金成願),80,76,156,0
8218,김미애(金美愛),김성주(金成柱),51,11,62,1
8219,김미애(金美愛),김성환(金星煥),51,5,56,1
8220,김미애(金美愛),김수흥(金洙興),53,4,57,1
8221,김미애(金美愛),김승남(金承南),51,4,55,1
8222,김미애(金美愛),김승수(金承洙),84,106,190,0
8223,김미애(金美愛),김승원(金勝源),51,4,55,1
8224,김미애(金美愛),김영배(金永培),52,6,58,1
8225,김미애(金美愛),김영선(金映宣),29,22,51,0
8226,김미애(金美愛),김영식(金英植),90,116,206,0
8227,김미애(金美愛),김영주(金榮珠),52,5,57,1
8228,김미애(金美愛),김영진(金榮鎭),51,4,55,1
8229,김미애(金美愛),김영호(金映豪),51,5,56,1
8230,김미애(金美愛),김예지(金睿智),86,109,195,0
8231,김미애(金美愛),김용민(金容民),51,4,55,1
8232,김미애(金美愛),김용판(金用判),88,118,206,0
8233,김미애(金美愛),김웅(金雄),68,65,133,0
8234,김미애(金美愛),김원이(金元二),51,5,56,1
8235,김미애(金美愛),김윤덕(金潤德),51,3,54,1
8236,김미애(金美愛),김의겸(金宜謙),26,4,30,1
8237,김미애(金美愛),김정재(金汀才),91,90,181,0
8238,김미애(金美愛),김정호(金禎鎬),52,6,58,1
8239,김미애(金美愛),김종민(金鐘民),51,11,62,1
8240,김미애(金美愛),김주영(金周暎),52,5,57,1
8241,김미애(金美愛),김진표(金振杓),25,1,26,1
8242,김미애(金美愛),김철민(金哲玟),49,3,52,1
8243,김미애(金美愛),김태년(金太年),49,5,54,1
8244,김미애(金美愛),김태호(金台鎬),56,41,97,0
8245,김미애(金美愛),김학용(金學容),36,40,76,0
8246,김미애(金美愛),김한규(金翰奎),25,6,31,1
8247,김미애(金美愛),김한정(金漢正),50,4,54,1
8248,김미애(金美愛),김형동(金亨東),74,82,156,0
8249,김미애(金美愛),김홍걸(金弘傑),15,7,22,1
8250,김미애(金美愛),김회재(金會在),50,4,54,1
8251,김미애(金美愛),김희곤(金熙坤),73,103,176,0
8252,김미애(金美愛),김희국(金熙國),61,54,115,0
8253,김미애(金美愛),남인순(南仁順),49,6,55,1
8254,김미애(金美愛),노용호(魯容昊),31,40,71,0
8255,김미애(金美愛),노웅래(盧雄來),49,5,54,1
8256,김미애(金美愛),도종환(都鍾煥),49,6,55,1
8257,김미애(金美愛),류성걸(柳性杰),71,51,122,0
8258,김미애(金美愛),류호정(柳好貞),6,4,10,1
8259,김미애(金美愛),맹성규(孟聖奎),49,5,54,1
8260,김미애(金美愛),문정복(文貞福),49,4,53,1
8261,김미애(金美愛),문진석(文振碩),49,5,54,1
8262,김미애(金美愛),민병덕(閔炳德),50,7,57,1
8263,김미애(金美愛),민형배(閔馨培),33,5,38,1
8264,김미애(金美愛),민홍철(閔洪喆),49,5,54,1
8265,김미애(金美愛),박광온(朴洸瑥),49,4,53,1
8266,김미애(金美愛),박대수(朴大壽),76,138,214,0
8267,김미애(金美愛),박대출(朴大出),68,71,139,0
8268,김미애(金美愛),박덕흠(朴德欽),54,83,137,0
8269,김미애(金美愛),박범계(朴範界),49,4,53,1
8270,김미애(金美愛),박병석(朴炳錫),25,3,28,1
8271,김미애(金美愛),박상혁(朴商赫),49,4,53,1
8272,김미애(金美愛),박성민(朴聖敏),81,119,200,0
8273,김미애(金美愛),박성준(朴省俊),49,4,53,1
8274,김미애(金美愛),박성중(朴成重),67,57,124,0
8275,김미애(金美愛),박수영(朴洙瑩),80,93,173,0
8276,김미애(金美愛),박영순(朴英淳),50,4,54,1
8277,김미애(金美愛),박완주(朴完柱),24,0,24,1
8278,김미애(金美愛),박용진(朴用鎭),49,10,59,1
8279,김미애(金美愛),박재호(朴在昊),52,8,60,1
8280,김미애(金美愛),박정(朴釘),50,5,55,1
8281,김미애(金美愛),박정하(朴正河),30,30,60,0
8282,김미애(金美愛),박주민(朴柱民),49,4,53,1
8283,김미애(金美愛),박진(朴振),74,61,135,0
8284,김미애(金美愛),박찬대(朴贊大),49,5,54,1
8285,김미애(金美愛),박형수(朴亨修),70,57,127,0
8286,김미애(金美愛),박홍근(朴洪根),51,6,57,1
8287,김미애(金美愛),배준영(裵俊英),72,70,142,0
8288,김미애(金美愛),배진교(裵晋敎),6,3,9,1
8289,김미애(金美愛),배현진(裵賢鎭),72,60,132,0
8290,김미애(金美愛),백종헌(白宗憲),92,177,269,0
8291,김미애(金美愛),백혜련(白惠蓮),49,5,54,1
8292,김미애(金美愛),변재일(卞在一),49,4,53,1
8293,김미애(金美愛),서동용(徐東榕),50,4,54,1
8294,김미애(金美愛),서범수(徐範洙),75,99,174,0
8295,김미애(金美愛),서병수(徐秉洙),94,126,220,0
8296,김미애(金美愛),서삼석(徐參錫),49,4,53,1
8297,김미애(金美愛),서영교(徐瑛敎),51,5,56,1
8298,김미애(金美愛),서영석(徐暎錫),49,6,55,1
8299,김미애(金美愛),서일준(徐一俊),87,112,199,0
8300,김미애(金美愛),서정숙(徐正淑),83,108,191,0
8301,김미애(金美愛),설훈(薛勳),50,5,55,1
8302,김미애(金美愛),성일종(成一鍾),76,92,168,0
8303,김미애(金美愛),소병철(蘇秉哲),49,5,54,1
8304,김미애(金美愛),소병훈(蘇秉勳),49,5,54,1
8305,김미애(金美愛),송갑석(宋甲錫),50,4,54,1
8306,김미애(金美愛),송기헌(宋基憲),49,5,54,1
8307,김미애(金美愛),송석준(宋錫俊),71,66,137,0
8308,김미애(金美愛),송언석(宋彦錫),67,76,143,0
8309,김미애(金美愛),송옥주(宋玉珠),49,3,52,1
8310,김미애(金美愛),송재호(宋在祜),49,5,54,1
8311,김미애(金美愛),신동근(申東根),49,3,52,1
8312,김미애(金美愛),신영대(申榮大),49,4,53,1
8313,김미애(金美愛),신원식(申源湜),76,110,186,0
8314,김미애(金美愛),신정훈(辛正勳),50,5,55,1
8315,김미애(金美愛),신현영(申賢榮),49,4,53,1
8316,김미애(金美愛),심상정(沈相奵),6,3,9,1
8317,김미애(金美愛),안규백(安圭伯),49,8,57,1
8318,김미애(金美愛),안민석(安敏錫),50,5,55,1
8319,김미애(金美愛),안병길(安炳吉),82,111,193,0
8320,김미애(金美愛),안철수(安哲秀),26,24,50,0
8321,김미애(金美愛),안호영(安浩永),49,5,54,1
8322,김미애(金美愛),양경숙(梁敬淑),49,5,54,1
8323,김미애(金美愛),양금희(梁琴喜),91,131,222,0
8324,김미애(金美愛),양기대(梁基大),49,4,53,1
8325,김미애(金美愛),양이원영(梁李媛瑛),45,6,51,1
8326,김미애(金美愛),양정숙(梁貞淑),3,1,4,1
8327,김미애(金美愛),양향자(梁香子),22,5,27,1
8328,김미애(金美愛),어기구(魚基龜),49,5,54,1
8329,김미애(金美愛),엄태영(嚴泰永),72,66,138,0
8330,김미애(金美愛),오기형(吳奇炯),49,10,59,1
8331,김미애(金美愛),오영환(吳永煥),49,9,58,1
8332,김미애(金美愛),용혜인(龍慧仁),3,5,8,1
8333,김미애(金美愛),우상호(禹相虎),49,4,53,1
8334,김미애(金美愛),우원식(禹元植),49,4,53,1
8335,김미애(金美愛),위성곤(魏聖坤),49,5,54,1
8336,김미애(金美愛),유경준(兪京濬),78,89,167,0
8337,김미애(金美愛),유기홍(柳基洪),49,4,53,1
8338,김미애(金美愛),유동수(柳東秀),49,4,53,1
8339,김미애(金美愛),유상범(劉相凡),68,81,149,0
8340,김미애(金美愛),유의동(兪義東),65,71,136,0
8341,김미애(金美愛),유정주(兪訂炷),49,5,54,1
8342,김미애(金美愛),윤건영(尹建永),49,4,53,1
8343,김미애(金美愛),윤관석(尹官石),40,0,40,1
8344,김미애(金美愛),윤두현(尹斗鉉),81,110,191,0
8345,김미애(金美愛),윤미향(尹美香),20,1,21,1
8346,김미애(金美愛),윤상현(尹相現),41,43,84,0
8347,김미애(金美愛),윤영덕(尹永德),49,4,53,1
8348,김미애(金美愛),윤영석(尹永碩),64,44,108,0
8349,김미애(金美愛),윤영찬(尹永燦),49,4,53,1
8350,김미애(金美愛),윤재갑(尹才鉀),50,5,55,1
8351,김미애(金美愛),윤재옥(尹在玉),64,54,118,0
8352,김미애(金美愛),윤주경(尹柱卿),76,87,163,0
8353,김미애(金美愛),윤준병(尹準炳),49,4,53,1
8354,김미애(金美愛),윤창현(尹暢賢),81,92,173,0
8355,김미애(金美愛),윤한홍(尹漢洪),66,67,133,0
8356,김미애(金美愛),윤호중(尹昊重),50,4,54,1
8357,김미애(金美愛),윤후덕(尹厚德),49,4,53,1
8358,김미애(金美愛),이개호(李介昊),49,4,53,1
8359,김미애(金美愛),이달곤(李達坤),65,64,129,0
8360,김미애(金美愛),이동주(李東洲),49,5,54,1
8361,김미애(金美愛),이만희(李晩熙),76,74,150,0
8362,김미애(金美愛),이명수(李明洙),80,78,158,0
8363,김미애(金美愛),이병훈(李炳勳),52,6,58,1
8364,김미애(金美愛),이상민(李相珉),49,4,53,1
8365,김미애(金美愛),이상헌(李相憲),49,6,55,1
8366,김미애(金美愛),이성만(李成萬),40,1,41,1
8367,김미애(金美愛),이소영(李素永),49,5,54,1
8368,김미애(金美愛),이수진(李壽珍),50,6,56,1
8369,김미애(金美愛),이수진(李秀眞),50,6,56,1
8370,김미애(金美愛),이양수(李亮壽),73,79,152,0
8371,김미애(金美愛),이용(李鏞),76,97,173,0
8372,김미애(金美愛),이용빈(李龍彬),49,5,54,1
8373,김미애(金美愛),이용선(李庸瑄),49,6,55,1
8374,김미애(金美愛),이용우(李龍雨),49,10,59,1
8375,김미애(金美愛),이용호(李容鎬),29,17,46,0
8376,김미애(金美愛),이원욱(李元旭),49,4,53,1
8377,김미애(金美愛),이원택(李源澤),49,4,53,1
8378,김미애(金美愛),이은주(李恩周),6,3,9,1
8379,김미애(金美愛),이인선(李仁善),30,32,62,0
8380,김미애(金美愛),이인영(李仁榮),49,4,53,1
8381,김미애(金美愛),이장섭(李將燮),49,4,53,1
8382,김미애(金美愛),이재명(李在明),25,4,29,1
8383,김미애(金美愛),이재정(李在汀),49,4,53,1
8384,김미애(金美愛),이정문(李楨文),49,4,53,1
8385,김미애(金美愛),이종배(李鍾培),76,74,150,0
8386,김미애(金美愛),이종성(李鍾成),95,161,256,0
8387,김미애(金美愛),이주환(李周桓),84,101,185,0
8388,김미애(金美愛),이채익(李埰益),78,83,161,0
8389,김미애(金美愛),이철규(李喆圭),69,74,143,0
8390,김미애(金美愛),이탄희(李誕熙),49,5,54,1
8391,김미애(金美愛),이태규(李泰珪),42,52,94,0
8392,김미애(金美愛),이학영(李學永),49,5,54,1
8393,김미애(金美愛),이해식(李海植),49,5,54,1
8394,김미애(金美愛),이헌승(李憲昇),84,121,205,0
8395,김미애(金美愛),이형석(李炯錫),49,4,53,1
8396,김미애(金美愛),인재근(印在謹),50,6,56,1
8397,김미애(金美愛),임병헌(林炳憲),32,35,67,0
8398,김미애(金美愛),임오경(林五卿),49,5,54,1
8399,김미애(金美愛),임이자(林利子),80,81,161,0
8400,김미애(金美愛),임종성(林鍾聲),50,6,56,1
8401,김미애(金美愛),임호선(林昊宣),50,5,55,1
8402,김미애(金美愛),장경태(張耿態),49,5,54,1
8403,김미애(金美愛),장동혁(張東赫),31,44,75,0
8404,김미애(金美愛),장제원(張濟元),66,49,115,0
8405,김미애(金美愛),장철민(張喆敏),50,4,54,1
8406,김미애(金美愛),장혜영(張惠英),6,7,13,1
8407,김미애(金美愛),전봉민(田奉珉),70,131,201,0
8408,김미애(金美愛),전용기(田溶冀),50,5,55,1
8409,김미애(金美愛),전재수(田載秀),50,6,56,1
8410,김미애(金美愛),전주혜(全珠惠),94,130,224,0
8411,김미애(金美愛),전해철(全海澈),50,4,54,1
8412,김미애(金美愛),전혜숙(全惠淑),49,6,55,1
8413,김미애(金美愛),정경희(丁慶姬),83,93,176,0
8414,김미애(金美愛),정동만(鄭東萬),79,85,164,0
8415,김미애(金美愛),정성호(鄭成湖),50,5,55,1
8416,김미애(金美愛),정우택(鄭宇澤),33,39,72,0
8417,김미애(金美愛),정운천(鄭雲天),76,71,147,0
8418,김미애(金美愛),정일영(鄭日永),49,5,54,1
8419,김미애(金美愛),정점식(鄭点植),67,54,121,0
8420,김미애(金美愛),정진석(鄭鎭碩),70,65,135,0
8421,김미애(金美愛),정청래(鄭淸來),50,4,54,1
8422,김미애(金美愛),정춘숙(鄭春淑),49,5,54,1
8423,김미애(金美愛),정태호(鄭泰浩),49,5,54,1
8424,김미애(金美愛),정필모(鄭必模),49,5,54,1
8425,김미애(金美愛),정희용(鄭熙溶),80,82,162,0
8426,김미애(金美愛),조경태(趙慶泰),78,92,170,0
8427,김미애(金美愛),조명희(曺明姬),88,131,219,0
8428,김미애(金美愛),조수진(趙修眞),72,94,166,0
8429,김미애(金美愛),조승래(趙承來),49,4,53,1
8430,김미애(金美愛),조오섭(曺五燮),55,7,62,1
8431,김미애(金美愛),조은희(趙恩禧),41,43,84,0
8432,김미애(金美愛),조응천(趙應天),49,4,53,1
8433,김미애(金美愛),조정식(趙正湜),49,4,53,1
8434,김미애(金美愛),조정훈(趙廷訓),2,16,18,1
8435,김미애(金美愛),조해진(曺海珍),64,40,104,0
8436,김미애(金美愛),주철현(朱哲鉉),49,4,53,1
8437,김미애(金美愛),주호영(朱豪英),60,41,101,0
8438,김미애(金美愛),지성호(池成浩),77,86,163,0
8439,김미애(金美愛),진선미(陳善美),49,5,54,1
8440,김미애(金美愛),진성준(陳聲準),49,4,53,1
8441,김미애(金美愛),천준호(千俊鎬),49,3,52,1
8442,김미애(金美愛),최기상(崔基相),49,5,54,1
8443,김미애(金美愛),최승재(崔承宰),76,93,169,0
8444,김미애(金美愛),최연숙(崔姸淑),42,52,94,0
8445,김미애(金美愛),최영희(崔英姬),33,52,85,0
8446,김미애(金美愛),최인호(崔仁昊),51,6,57,1
8447,김미애(金美愛),최재형(崔在亨),28,26,54,0
8448,김미애(金美愛),최종윤(崔鍾允),49,4,53,1
8449,김미애(金美愛),최춘식(崔春植),71,90,161,0
8450,김미애(金美愛),최형두(崔炯斗),80,61,141,0
8451,김미애(金美愛),최혜영(崔惠英),51,6,57,1
8452,김미애(金美愛),추경호(秋慶鎬),77,84,161,0
8453,김미애(金美愛),태영호(太永浩),80,101,181,0
8454,김미애(金美愛),하영제(河榮帝),77,94,171,1
8455,김미애(金美愛),하태경(河泰慶),72,57,129,0
8456,김미애(金美愛),한기호(韓起鎬),63,51,114,0
8457,김미애(金美愛),한무경(韓茂景),80,114,194,0
8458,김미애(金美愛),한병도(韓秉道),49,4,53,1
8459,김미애(金美愛),한정애(韓貞愛),49,5,54,1
8460,김미애(金美愛),한준호(韓俊鎬),50,4,54,1
8461,김미애(金美愛),허숙정(許淑湞),0,0,0,1
8462,김미애(金美愛),허영(許榮),49,5,54,1
8463,김미애(金美愛),허은아(許垠娥),72,82,154,0
8464,김미애(金美愛),허종식(許琮植),49,6,55,1
8465,김미애(金美愛),홍기원(洪起元),49,5,54,1
8466,김미애(金美愛),홍문표(洪文杓),62,54,116,0
8467,김미애(金美愛),홍석준(洪碩晙),72,73,145,0
8468,김미애(金美愛),홍성국(洪性國),49,5,54,1
8469,김미애(金美愛),홍영표(洪永杓),49,5,54,1
8470,김미애(金美愛),홍익표(洪翼杓),49,5,54,1
8471,김미애(金美愛),홍정민(洪貞敏),50,5,55,1
8472,김미애(金美愛),황보승희(皇甫承希),93,146,239,1
8473,김미애(金美愛),황운하(黃雲夏),51,5,56,1
8474,김미애(金美愛),황희(黃熙),49,11,60,1
8475,김민기(金敏基),김민석(金民錫),94,52,146,0
8476,김민기(金敏基),김민철(金敏徹),92,74,166,0
8477,김민기(金敏基),김병기(金炳基),106,80,186,0
8478,김민기(金敏基),김병욱A(金炳旭),112,110,222,0
8479,김민기(金敏基),김병욱B(金炳旭),44,5,49,1
8480,김민기(金敏基),김병주(金柄周),96,65,161,0
8481,김민기(金敏基),김상훈(金相勳),54,5,59,1
8482,김민기(金敏基),김상희(金相姬),94,70,164,0
8483,김민기(金敏基),김석기(金碩基),52,5,57,1
8484,김민기(金敏基),김성원(金成願),52,4,56,1
8485,김민기(金敏基),김성주(金成柱),100,88,188,0
8486,김민기(金敏基),김성환(金星煥),91,55,146,0
8487,김민기(金敏基),김수흥(金洙興),95,82,177,0
8488,김민기(金敏基),김승남(金承南),91,85,176,0
8489,김민기(金敏基),김승수(金承洙),52,5,57,1
8490,김민기(金敏基),김승원(金勝源),100,73,173,0
8491,김민기(金敏基),김영배(金永培),90,65,155,0
8492,김민기(金敏基),김영선(金映宣),26,4,30,1
8493,김민기(金敏基),김영식(金英植),51,4,55,1
8494,김민기(金敏基),김영주(金榮珠),92,59,151,0
8495,김민기(金敏基),김영진(金榮鎭),85,71,156,0
8496,김민기(金敏基),김영호(金映豪),97,81,178,0
8497,김민기(金敏基),김예지(金睿智),51,5,56,1
8498,김민기(金敏基),김용민(金容民),89,52,141,0
8499,김민기(金敏基),김용판(金用判),52,4,56,1
8500,김민기(金敏基),김웅(金雄),51,4,55,1
8501,김민기(金敏基),김원이(金元二),99,87,186,0
8502,김민기(金敏基),김윤덕(金潤德),95,84,179,0
8503,김민기(金敏基),김의겸(金宜謙),46,32,78,0
8504,김민기(金敏基),김정재(金汀才),53,5,58,1
8505,김민기(金敏基),김정호(金禎鎬),118,143,261,0
8506,김민기(金敏基),김종민(金鐘民),88,56,144,0
8507,김민기(金敏基),김주영(金周暎),95,63,158,0
8508,김민기(金敏基),김진표(金振杓),63,49,112,1
8509,김민기(金敏基),김철민(金哲玟),101,86,187,0
8510,김민기(金敏基),김태년(金太年),79,44,123,0
8511,김민기(金敏基),김태호(金台鎬),41,5,46,1
8512,김민기(金敏基),김학용(金學容),25,4,29,1
8513,김민기(金敏基),김한규(金翰奎),43,23,66,0
8514,김민기(金敏基),김한정(金漢正),78,52,130,0
8515,김민기(金敏基),김형동(金亨東),51,5,56,1
8516,김민기(金敏基),김홍걸(金弘傑),53,72,125,0
8517,김민기(金敏基),김회재(金會在),101,60,161,0
8518,김민기(金敏基),김희곤(金熙坤),50,4,54,1
8519,김민기(金敏基),김희국(金熙國),50,4,54,1
8520,김민기(金敏基),남인순(南仁順),90,83,173,0
8521,김민기(金敏基),노용호(魯容昊),25,4,29,1
8522,김민기(金敏基),노웅래(盧雄來),97,60,157,0
8523,김민기(金敏基),도종환(都鍾煥),103,74,177,0
8524,김민기(金敏基),류성걸(柳性杰),49,4,53,1
8525,김민기(金敏基),류호정(柳好貞),17,19,36,1
8526,김민기(金敏基),맹성규(孟聖奎),84,76,160,0
8527,김민기(金敏基),문정복(文貞福),85,39,124,0
8528,김민기(金敏基),문진석(文振碩),106,88,194,0
8529,김민기(金敏基),민병덕(閔炳德),96,101,197,0
8530,김민기(金敏基),민형배(閔馨培),73,98,171,0
8531,김민기(金敏基),민홍철(閔洪喆),85,100,185,0
8532,김민기(金敏基),박광온(朴洸瑥),87,55,142,0
8533,김민기(金敏基),박대수(朴大壽),50,5,55,1
8534,김민기(金敏基),박대출(朴大出),50,4,54,1
8535,김민기(金敏基),박덕흠(朴德欽),36,6,42,1
8536,김민기(金敏基),박범계(朴範界),78,36,114,0
8537,김민기(金敏基),박병석(朴炳錫),40,16,56,0
8538,김민기(金敏基),박상혁(朴商赫),97,145,242,0
8539,김민기(金敏基),박성민(朴聖敏),52,6,58,1
8540,김민기(金敏基),박성준(朴省俊),108,130,238,0
8541,김민기(金敏基),박성중(朴成重),49,4,53,1
8542,김민기(金敏基),박수영(朴洙瑩),50,4,54,1
8543,김민기(金敏基),박영순(朴英淳),94,60,154,0
8544,김민기(金敏基),박완주(朴完柱),52,42,94,1
8545,김민기(金敏基),박용진(朴用鎭),76,40,116,0
8546,김민기(金敏基),박재호(朴在昊),79,60,139,0
8547,김민기(金敏基),박정(朴釘),115,85,200,0
8548,김민기(金敏基),박정하(朴正河),25,4,29,1
8549,김민기(金敏基),박주민(朴柱民),82,53,135,0
8550,김민기(金敏基),박진(朴振),50,4,54,1
8551,김민기(金敏基),박찬대(朴贊大),86,64,150,0
8552,김민기(金敏基),박형수(朴亨修),49,4,53,1
8553,김민기(金敏基),박홍근(朴洪根),105,89,194,0
8554,김민기(金敏基),배준영(裵俊英),49,5,54,1
8555,김민기(金敏基),배진교(裵晋敎),18,16,34,1
8556,김민기(金敏基),배현진(裵賢鎭),49,4,53,1
8557,김민기(金敏基),백종헌(白宗憲),50,4,54,1
8558,김민기(金敏基),백혜련(白惠蓮),102,78,180,0
8559,김민기(金敏基),변재일(卞在一),92,54,146,0
8560,김민기(金敏基),서동용(徐東榕),95,89,184,0
8561,김민기(金敏基),서범수(徐範洙),50,4,54,1
8562,김민기(金敏基),서병수(徐秉洙),51,4,55,1
8563,김민기(金敏基),서삼석(徐參錫),85,56,141,0
8564,김민기(金敏基),서영교(徐瑛敎),101,80,181,0
8565,김민기(金敏基),서영석(徐暎錫),95,89,184,0
8566,김민기(金敏基),서일준(徐一俊),50,4,54,1
8567,김민기(金敏基),서정숙(徐正淑),49,4,53,1
8568,김민기(金敏基),설훈(薛勳),91,64,155,0
8569,김민기(金敏基),성일종(成一鍾),50,5,55,1
8570,김민기(金敏基),소병철(蘇秉哲),87,58,145,0
8571,김민기(金敏基),소병훈(蘇秉勳),87,78,165,0
8572,김민기(金敏基),송갑석(宋甲錫),94,77,171,0
8573,김민기(金敏基),송기헌(宋基憲),96,68,164,0
8574,김민기(金敏基),송석준(宋錫俊),50,5,55,1
8575,김민기(金敏基),송언석(宋彦錫),45,4,49,1
8576,김민기(金敏基),송옥주(宋玉珠),89,83,172,0
8577,김민기(金敏基),송재호(宋在祜),88,98,186,0
8578,김민기(金敏基),신동근(申東根),91,62,153,0
8579,김민기(金敏基),신영대(申榮大),84,65,149,0
8580,김민기(金敏基),신원식(申源湜),50,4,54,1
8581,김민기(金敏基),신정훈(辛正勳),93,98,191,0
8582,김민기(金敏基),신현영(申賢榮),85,52,137,0
8583,김민기(金敏基),심상정(沈相奵),14,14,28,1
8584,김민기(金敏基),안규백(安圭伯),108,79,187,0
8585,김민기(金敏基),안민석(安敏錫),104,73,177,0
8586,김민기(金敏基),안병길(安炳吉),50,4,54,1
8587,김민기(金敏基),안철수(安哲秀),25,4,29,1
8588,김민기(金敏基),안호영(安浩永),86,49,135,0
8589,김민기(金敏基),양경숙(梁敬淑),91,67,158,0
8590,김민기(金敏基),양금희(梁琴喜),50,4,54,1
8591,김민기(金敏基),양기대(梁基大),82,51,133,0
8592,김민기(金敏基),양이원영(梁李媛瑛),88,58,146,0
8593,김민기(金敏基),양정숙(梁貞淑),40,85,125,1
8594,김민기(金敏基),양향자(梁香子),39,21,60,1
8595,김민기(金敏基),어기구(魚基龜),85,66,151,0
8596,김민기(金敏基),엄태영(嚴泰永),50,4,54,1
8597,김민기(金敏基),오기형(吳奇炯),75,37,112,0
8598,김민기(金敏基),오영환(吳永煥),94,120,214,0
8599,김민기(金敏基),용혜인(龍慧仁),15,22,37,1
8600,김민기(金敏基),우상호(禹相虎),78,39,117,0
8601,김민기(金敏基),우원식(禹元植),86,53,139,0
8602,김민기(金敏基),위성곤(魏聖坤),91,67,158,0
8603,김민기(金敏基),유경준(兪京濬),49,4,53,1
8604,김민기(金敏基),유기홍(柳基洪),78,53,131,0
8605,김민기(金敏基),유동수(柳東秀),95,58,153,0
8606,김민기(金敏基),유상범(劉相凡),49,4,53,1
8607,김민기(金敏基),유의동(兪義東),50,4,54,1
8608,김민기(金敏基),유정주(兪訂炷),94,76,170,0
8609,김민기(金敏基),윤건영(尹建永),88,60,148,0
8610,김민기(金敏基),윤관석(尹官石),72,54,126,1
8611,김민기(金敏基),윤두현(尹斗鉉),49,4,53,1
8612,김민기(金敏基),윤미향(尹美香),44,37,81,1
8613,김민기(金敏基),윤상현(尹相現),30,4,34,1
8614,김민기(金敏基),윤영덕(尹永德),87,66,153,0
8615,김민기(金敏基),윤영석(尹永碩),50,5,55,1
8616,김민기(金敏基),윤영찬(尹永燦),86,73,159,0
8617,김민기(金敏基),윤재갑(尹才鉀),96,92,188,0
8618,김민기(金敏基),윤재옥(尹在玉),49,4,53,1
8619,김민기(金敏基),윤주경(尹柱卿),50,5,55,1
8620,김민기(金敏基),윤준병(尹準炳),91,75,166,0
8621,김민기(金敏基),윤창현(尹暢賢),50,4,54,1
8622,김민기(金敏基),윤한홍(尹漢洪),50,4,54,1
8623,김민기(金敏基),윤호중(尹昊重),82,63,145,0
8624,김민기(金敏基),윤후덕(尹厚德),95,81,176,0
8625,김민기(金敏基),이개호(李介昊),88,53,141,0
8626,김민기(金敏基),이달곤(李達坤),52,7,59,1
8627,김민기(金敏基),이동주(李東洲),89,90,179,0
8628,김민기(金敏基),이만희(李晩熙),49,5,54,1
8629,김민기(金敏基),이명수(李明洙),50,9,59,1
8630,김민기(金敏基),이병훈(李炳勳),92,82,174,0
8631,김민기(金敏基),이상민(李相珉),79,40,119,0
8632,김민기(金敏基),이상헌(李相憲),97,82,179,0
8633,김민기(金敏基),이성만(李成萬),87,89,176,1
8634,김민기(金敏基),이소영(李素永),86,49,135,0
8635,김민기(金敏基),이수진(李壽珍),90,74,164,0
8636,김민기(金敏基),이수진(李秀眞),91,66,157,0
8637,김민기(金敏基),이양수(李亮壽),51,4,55,1
8638,김민기(金敏基),이용(李鏞),49,4,53,1
8639,김민기(金敏基),이용빈(李龍彬),103,132,235,0
8640,김민기(金敏基),이용선(李庸瑄),89,60,149,0
8641,김민기(金敏基),이용우(李龍雨),87,53,140,0
8642,김민기(金敏基),이용호(李容鎬),30,17,47,1
8643,김민기(金敏基),이원욱(李元旭),105,78,183,0
8644,김민기(金敏基),이원택(李源澤),85,57,142,0
8645,김민기(金敏基),이은주(李恩周),17,15,32,1
8646,김민기(金敏基),이인선(李仁善),25,4,29,1
8647,김민기(金敏基),이인영(李仁榮),79,50,129,0
8648,김민기(金敏基),이장섭(李將燮),86,72,158,0
8649,김민기(金敏基),이재명(李在明),39,19,58,0
8650,김민기(金敏基),이재정(李在汀),95,73,168,0
8651,김민기(金敏基),이정문(李楨文),116,127,243,0
8652,김민기(金敏基),이종배(李鍾培),50,6,56,1
8653,김민기(金敏基),이종성(李鍾成),49,4,53,1
8654,김민기(金敏基),이주환(李周桓),49,5,54,1
8655,김민기(金敏基),이채익(李埰益),52,6,58,1
8656,김민기(金敏基),이철규(李喆圭),50,7,57,1
8657,김민기(金敏基),이탄희(李誕熙),102,68,170,0
8658,김민기(金敏基),이태규(李泰珪),28,4,32,1
8659,김민기(金敏基),이학영(李學永),89,91,180,0
8660,김민기(金敏基),이해식(李海植),87,60,147,0
8661,김민기(金敏基),이헌승(李憲昇),50,4,54,1
8662,김민기(金敏基),이형석(李炯錫),106,106,212,0
8663,김민기(金敏基),인재근(印在謹),94,105,199,0
8664,김민기(金敏基),임병헌(林炳憲),26,4,30,1
8665,김민기(金敏基),임오경(林五卿),83,70,153,0
8666,김민기(金敏基),임이자(林利子),49,4,53,1
8667,김민기(金敏基),임종성(林鍾聲),99,118,217,0
8668,김민기(金敏基),임호선(林昊宣),100,133,233,0
8669,김민기(金敏基),장경태(張耿態),88,75,163,0
8670,김민기(金敏基),장동혁(張東赫),25,4,29,1
8671,김민기(金敏基),장제원(張濟元),49,4,53,1
8672,김민기(金敏基),장철민(張喆敏),92,103,195,0
8673,김민기(金敏基),장혜영(張惠英),12,8,20,1
8674,김민기(金敏基),전봉민(田奉珉),35,5,40,1
8675,김민기(金敏基),전용기(田溶冀),88,88,176,0
8676,김민기(金敏基),전재수(田載秀),83,64,147,0
8677,김민기(金敏基),전주혜(全珠惠),52,4,56,1
8678,김민기(金敏基),전해철(全海澈),80,52,132,0
8679,김민기(金敏基),전혜숙(全惠淑),99,67,166,0
8680,김민기(金敏基),정경희(丁慶姬),49,4,53,1
8681,김민기(金敏基),정동만(鄭東萬),49,4,53,1
8682,김민기(金敏基),정성호(鄭成湖),80,65,145,0
8683,김민기(金敏基),정우택(鄭宇澤),25,4,29,1
8684,김민기(金敏基),정운천(鄭雲天),49,5,54,1
8685,김민기(金敏基),정일영(鄭日永),83,83,166,0
8686,김민기(金敏基),정점식(鄭点植),50,4,54,1
8687,김민기(金敏基),정진석(鄭鎭碩),50,6,56,1
8688,김민기(金敏基),정청래(鄭淸來),85,51,136,0
8689,김민기(金敏基),정춘숙(鄭春淑),114,95,209,0
8690,김민기(金敏基),정태호(鄭泰浩),83,62,145,0
8691,김민기(金敏基),정필모(鄭必模),92,89,181,0
8692,김민기(金敏基),정희용(鄭熙溶),50,5,55,1
8693,김민기(金敏基),조경태(趙慶泰),49,4,53,1
8694,김민기(金敏基),조명희(曺明姬),50,5,55,1
8695,김민기(金敏基),조수진(趙修眞),49,4,53,1
8696,김민기(金敏基),조승래(趙承來),127,105,232,0
8697,김민기(金敏基),조오섭(曺五燮),97,125,222,0
8698,김민기(金敏基),조은희(趙恩禧),25,4,29,1
8699,김민기(金敏基),조응천(趙應天),82,44,126,0
8700,김민기(金敏基),조정식(趙正湜),80,44,124,0
8701,김민기(金敏基),조정훈(趙廷訓),1,4,5,1
8702,김민기(金敏基),조해진(曺海珍),52,5,57,1
8703,김민기(金敏基),주철현(朱哲鉉),90,60,150,0
8704,김민기(金敏基),주호영(朱豪英),49,4,53,1
8705,김민기(金敏基),지성호(池成浩),49,4,53,1
8706,김민기(金敏基),진선미(陳善美),80,48,128,0
8707,김민기(金敏基),진성준(陳聲準),85,75,160,0
8708,김민기(金敏基),천준호(千俊鎬),83,51,134,0
8709,김민기(金敏基),최기상(崔基相),82,61,143,0
8710,김민기(金敏基),최승재(崔承宰),49,4,53,1
8711,김민기(金敏基),최연숙(崔姸淑),32,13,45,1
8712,김민기(金敏基),최영희(崔英姬),25,4,29,1
8713,김민기(金敏基),최인호(崔仁昊),84,99,183,0
8714,김민기(金敏基),최재형(崔在亨),25,4,29,1
8715,김민기(金敏基),최종윤(崔鍾允),110,149,259,0
8716,김민기(金敏基),최춘식(崔春植),49,5,54,1
8717,김민기(金敏基),최형두(崔炯斗),50,5,55,1
8718,김민기(金敏基),최혜영(崔惠英),93,94,187,0
8719,김민기(金敏基),추경호(秋慶鎬),49,4,53,1
8720,김민기(金敏基),태영호(太永浩),49,5,54,1
8721,김민기(金敏基),하영제(河榮帝),41,2,43,1
8722,김민기(金敏基),하태경(河泰慶),50,4,54,1
8723,김민기(金敏基),한기호(韓起鎬),52,6,58,1
8724,김민기(金敏基),한무경(韓茂景),49,4,53,1
8725,김민기(金敏基),한병도(韓秉道),91,84,175,0
8726,김민기(金敏基),한정애(韓貞愛),74,62,136,0
8727,김민기(金敏基),한준호(韓俊鎬),97,119,216,0
8728,김민기(金敏基),허숙정(許淑湞),1,1,2,0
8729,김민기(金敏基),허영(許榮),100,124,224,0
8730,김민기(金敏基),허은아(許垠娥),49,4,53,1
8731,김민기(金敏基),허종식(許琮植),92,122,214,0
8732,김민기(金敏基),홍기원(洪起元),97,83,180,0
8733,김민기(金敏基),홍문표(洪文杓),50,6,56,1
8734,김민기(金敏基),홍석준(洪碩晙),50,4,54,1
8735,김민기(金敏基),홍성국(洪性國),113,129,242,0
8736,김민기(金敏基),홍영표(洪永杓),90,54,144,0
8737,김민기(金敏基),홍익표(洪翼杓),91,75,166,0
8738,김민기(金敏基),홍정민(洪貞敏),91,73,164,0
8739,김민기(金敏基),황보승희(皇甫承希),46,1,47,1
8740,김민기(金敏基),황운하(黃雲夏),90,77,167,0
8741,김민기(金敏基),황희(黃熙),84,64,148,0
8742,김민석(金民錫),김민철(金敏徹),123,115,238,0
8743,김민석(金民錫),김병기(金炳基),89,51,140,0
8744,김민석(金民錫),김병욱A(金炳旭),102,118,220,0
8745,김민석(金民錫),김병욱B(金炳旭),44,4,48,1
8746,김민석(金民錫),김병주(金柄周),95,48,143,0
8747,김민석(金民錫),김상훈(金相勳),53,7,60,1
8748,김민석(金民錫),김상희(金相姬),92,81,173,0
8749,김민석(金民錫),김석기(金碩基),52,4,56,1
8750,김민석(金民錫),김성원(金成願),52,8,60,1
8751,김민석(金民錫),김성주(金成柱),123,114,237,0
8752,김민석(金民錫),김성환(金星煥),94,65,159,0
8753,김민석(金民錫),김수흥(金洙興),116,74,190,0
8754,김민석(金民錫),김승남(金承南),95,108,203,0
8755,김민석(金民錫),김승수(金承洙),54,11,65,1
8756,김민석(金民錫),김승원(金勝源),126,107,233,0
8757,김민석(金民錫),김영배(金永培),125,79,204,0
8758,김민석(金民錫),김영선(金映宣),26,4,30,1
8759,김민석(金民錫),김영식(金英植),53,16,69,1
8760,김민석(金民錫),김영주(金榮珠),91,68,159,0
8761,김민석(金民錫),김영진(金榮鎭),83,44,127,0
8762,김민석(金民錫),김영호(金映豪),91,78,169,0
8763,김민석(金民錫),김예지(金睿智),55,13,68,1
8764,김민석(金民錫),김용민(金容民),93,78,171,0
8765,김민석(金民錫),김용판(金用判),52,6,58,1
8766,김민석(金民錫),김웅(金雄),51,5,56,1
8767,김민석(金民錫),김원이(金元二),102,113,215,0
8768,김민석(金民錫),김윤덕(金潤德),92,71,163,0
8769,김민석(金民錫),김의겸(金宜謙),47,59,106,0
8770,김민석(金民錫),김정재(金汀才),53,5,58,1
8771,김민석(金民錫),김정호(金禎鎬),106,135,241,0
8772,김민석(金民錫),김종민(金鐘民),86,60,146,0
8773,김민석(金民錫),김주영(金周暎),101,77,178,0
8774,김민석(金民錫),김진표(金振杓),56,48,104,1
8775,김민석(金民錫),김철민(金哲玟),100,82,182,0
8776,김민석(金民錫),김태년(金太年),79,54,133,0
8777,김민석(金民錫),김태호(金台鎬),42,6,48,1
8778,김민석(金民錫),김학용(金學容),25,4,29,1
8779,김민석(金民錫),김한규(金翰奎),45,46,91,0
8780,김민석(金民錫),김한정(金漢正),78,41,119,0
8781,김민석(金民錫),김형동(金亨東),52,8,60,1
8782,김민석(金民錫),김홍걸(金弘傑),49,118,167,0
8783,김민석(金民錫),김회재(金會在),97,66,163,0
8784,김민석(金民錫),김희곤(金熙坤),52,17,69,1
8785,김민석(金民錫),김희국(金熙國),49,4,53,1
8786,김민석(金民錫),남인순(南仁順),106,101,207,0
8787,김민석(金民錫),노용호(魯容昊),25,4,29,1
8788,김민석(金民錫),노웅래(盧雄來),87,55,142,0
8789,김민석(金民錫),도종환(都鍾煥),86,54,140,0
8790,김민석(金民錫),류성걸(柳性杰),49,4,53,1
8791,김민석(金民錫),류호정(柳好貞),23,66,89,1
8792,김민석(金民錫),맹성규(孟聖奎),105,76,181,0
8793,김민석(金民錫),문정복(文貞福),90,63,153,0
8794,김민석(金民錫),문진석(文振碩),101,83,184,0
8795,김민석(金民錫),민병덕(閔炳德),102,135,237,0
8796,김민석(金民錫),민형배(閔馨培),84,108,192,0
8797,김민석(金民錫),민홍철(閔洪喆),80,57,137,0
8798,김민석(金民錫),박광온(朴洸瑥),83,48,131,0
8799,김민석(金民錫),박대수(朴大壽),50,11,61,1
8800,김민석(金民錫),박대출(朴大出),50,6,56,1
8801,김민석(金民錫),박덕흠(朴德欽),37,8,45,1
8802,김민석(金民錫),박범계(朴範界),78,36,114,0
8803,김민석(金民錫),박병석(朴炳錫),40,18,58,0
8804,김민석(金民錫),박상혁(朴商赫),109,81,190,0
8805,김민석(金民錫),박성민(朴聖敏),49,9,58,1
8806,김민석(金民錫),박성준(朴省俊),114,126,240,0
8807,김민석(金民錫),박성중(朴成重),49,4,53,1
8808,김민석(金民錫),박수영(朴洙瑩),50,17,67,1
8809,김민석(金民錫),박영순(朴英淳),96,82,178,0
8810,김민석(金民錫),박완주(朴完柱),58,37,95,1
8811,김민석(金民錫),박용진(朴用鎭),84,64,148,0
8812,김민석(金民錫),박재호(朴在昊),106,75,181,0
8813,김민석(金民錫),박정(朴釘),101,83,184,0
8814,김민석(金民錫),박정하(朴正河),25,4,29,1
8815,김민석(金民錫),박주민(朴柱民),83,66,149,0
8816,김민석(金民錫),박진(朴振),50,4,54,1
8817,김민석(金民錫),박찬대(朴贊大),84,54,138,0
8818,김민석(金民錫),박형수(朴亨修),49,4,53,1
8819,김민석(金民錫),박홍근(朴洪根),110,147,257,0
8820,김민석(金民錫),배준영(裵俊英),51,5,56,1
8821,김민석(金民錫),배진교(裵晋敎),22,43,65,1
8822,김민석(金民錫),배현진(裵賢鎭),49,5,54,1
8823,김민석(金民錫),백종헌(白宗憲),50,9,59,1
8824,김민석(金民錫),백혜련(白惠蓮),86,67,153,0
8825,김민석(金民錫),변재일(卞在一),81,44,125,0
8826,김민석(金民錫),서동용(徐東榕),93,70,163,0
8827,김민석(金民錫),서범수(徐範洙),50,7,57,1
8828,김민석(金民錫),서병수(徐秉洙),50,7,57,1
8829,김민석(金民錫),서삼석(徐參錫),86,56,142,0
8830,김민석(金民錫),서영교(徐瑛敎),110,102,212,0
8831,김민석(金民錫),서영석(徐暎錫),110,123,233,0
8832,김민석(金民錫),서일준(徐一俊),50,10,60,1
8833,김민석(金民錫),서정숙(徐正淑),49,10,59,1
8834,김민석(金民錫),설훈(薛勳),83,47,130,0
8835,김민석(金民錫),성일종(成一鍾),51,11,62,1
8836,김민석(金民錫),소병철(蘇秉哲),93,45,138,0
8837,김민석(金民錫),소병훈(蘇秉勳),90,77,167,0
8838,김민석(金民錫),송갑석(宋甲錫),89,89,178,0
8839,김민석(金民錫),송기헌(宋基憲),83,46,129,0
8840,김민석(金民錫),송석준(宋錫俊),51,6,57,1
8841,김민석(金民錫),송언석(宋彦錫),45,4,49,1
8842,김민석(金民錫),송옥주(宋玉珠),87,84,171,0
8843,김민석(金民錫),송재호(宋在祜),97,88,185,0
8844,김민석(金民錫),신동근(申東根),90,93,183,0
8845,김민석(金民錫),신영대(申榮大),92,49,141,0
8846,김민석(金民錫),신원식(申源湜),49,7,56,1
8847,김민석(金民錫),신정훈(辛正勳),126,161,287,0
8848,김민석(金民錫),신현영(申賢榮),83,55,138,0
8849,김민석(金民錫),심상정(沈相奵),20,48,68,1
8850,김민석(金民錫),안규백(安圭伯),107,70,177,0
8851,김민석(金民錫),안민석(安敏錫),90,63,153,0
8852,김민석(金民錫),안병길(安炳吉),50,5,55,1
8853,김민석(金民錫),안철수(安哲秀),25,5,30,1
8854,김민석(金民錫),안호영(安浩永),82,62,144,0
8855,김민석(金民錫),양경숙(梁敬淑),99,90,189,0
8856,김민석(金民錫),양금희(梁琴喜),50,9,59,1
8857,김민석(金民錫),양기대(梁基大),101,60,161,0
8858,김민석(金民錫),양이원영(梁李媛瑛),89,95,184,0
8859,김민석(金民錫),양정숙(梁貞淑),62,148,210,1
8860,김민석(金民錫),양향자(梁香子),40,51,91,1
8861,김민석(金民錫),어기구(魚基龜),81,60,141,0
8862,김민석(金民錫),엄태영(嚴泰永),51,6,57,1
8863,김민석(金民錫),오기형(吳奇炯),89,44,133,0
8864,김민석(金民錫),오영환(吳永煥),129,162,291,0
8865,김민석(金民錫),용혜인(龍慧仁),19,53,72,1
8866,김민석(金民錫),우상호(禹相虎),80,42,122,0
8867,김민석(金民錫),우원식(禹元植),101,66,167,0
8868,김민석(金民錫),위성곤(魏聖坤),91,81,172,0
8869,김민석(金民錫),유경준(兪京濬),49,4,53,1
8870,김민석(金民錫),유기홍(柳基洪),82,53,135,0
8871,김민석(金民錫),유동수(柳東秀),90,56,146,0
8872,김민석(金民錫),유상범(劉相凡),51,5,56,1
8873,김민석(金民錫),유의동(兪義東),49,9,58,1
8874,김민석(金民錫),유정주(兪訂炷),99,119,218,0
8875,김민석(金民錫),윤건영(尹建永),85,71,156,0
8876,김민석(金民錫),윤관석(尹官石),79,60,139,1
8877,김민석(金民錫),윤두현(尹斗鉉),49,9,58,1
8878,김민석(金民錫),윤미향(尹美香),58,93,151,1
8879,김민석(金民錫),윤상현(尹相現),30,6,36,1
8880,김민석(金民錫),윤영덕(尹永德),91,96,187,0
8881,김민석(金民錫),윤영석(尹永碩),50,5,55,1
8882,김민석(金民錫),윤영찬(尹永燦),88,58,146,0
8883,김민석(金民錫),윤재갑(尹才鉀),104,75,179,0
8884,김민석(金民錫),윤재옥(尹在玉),49,4,53,1
8885,김민석(金民錫),윤주경(尹柱卿),49,8,57,1
8886,김민석(金民錫),윤준병(尹準炳),112,119,231,0
8887,김민석(金民錫),윤창현(尹暢賢),49,8,57,1
8888,김민석(金民錫),윤한홍(尹漢洪),50,7,57,1
8889,김민석(金民錫),윤호중(尹昊重),80,59,139,0
8890,김민석(金民錫),윤후덕(尹厚德),89,56,145,0
8891,김민석(金民錫),이개호(李介昊),83,53,136,0
8892,김민석(金民錫),이달곤(李達坤),52,5,57,1
8893,김민석(金民錫),이동주(李東洲),93,98,191,0
8894,김민석(金民錫),이만희(李晩熙),49,4,53,1
8895,김민석(金民錫),이명수(李明洙),65,26,91,1
8896,김민석(金民錫),이병훈(李炳勳),89,98,187,0
8897,김민석(金民錫),이상민(李相珉),81,38,119,0
8898,김민석(金民錫),이상헌(李相憲),116,121,237,0
8899,김민석(金民錫),이성만(李成萬),94,106,200,1
8900,김민석(金民錫),이소영(李素永),93,50,143,0
8901,김민석(金民錫),이수진(李壽珍),104,160,264,0
8902,김민석(金民錫),이수진(李秀眞),105,89,194,0
8903,김민석(金民錫),이양수(李亮壽),51,7,58,1
8904,김민석(金民錫),이용(李鏞),49,4,53,1
8905,김민석(金民錫),이용빈(李龍彬),137,194,331,0
8906,김민석(金民錫),이용선(李庸瑄),90,107,197,0
8907,김민석(金民錫),이용우(李龍雨),98,77,175,0
8908,김민석(金民錫),이용호(李容鎬),45,37,82,1
8909,김민석(金民錫),이원욱(李元旭),91,94,185,0
8910,김민석(金民錫),이원택(李源澤),95,76,171,0
8911,김민석(金民錫),이은주(李恩周),32,59,91,1
8912,김민석(金民錫),이인선(李仁善),25,7,32,1
8913,김민석(金民錫),이인영(李仁榮),80,48,128,0
8914,김민석(金民錫),이장섭(李將燮),95,75,170,0
8915,김민석(金民錫),이재명(李在明),40,19,59,0
8916,김민석(金民錫),이재정(李在汀),83,54,137,0
8917,김민석(金民錫),이정문(李楨文),91,74,165,0
8918,김민석(金民錫),이종배(李鍾培),50,5,55,1
8919,김민석(金民錫),이종성(李鍾成),49,11,60,1
8920,김민석(金民錫),이주환(李周桓),49,7,56,1
8921,김민석(金民錫),이채익(李埰益),51,6,57,1
8922,김민석(金民錫),이철규(李喆圭),53,11,64,1
8923,김민석(金民錫),이탄희(李誕熙),91,73,164,0
8924,김민석(金民錫),이태규(李泰珪),28,13,41,1
8925,김민석(金民錫),이학영(李學永),99,93,192,0
8926,김민석(金民錫),이해식(李海植),103,71,174,0
8927,김민석(金民錫),이헌승(李憲昇),50,4,54,1
8928,김민석(金民錫),이형석(李炯錫),117,89,206,0
8929,김민석(金民錫),인재근(印在謹),102,99,201,0
8930,김민석(金民錫),임병헌(林炳憲),25,6,31,1
8931,김민석(金民錫),임오경(林五卿),88,72,160,0
8932,김민석(金民錫),임이자(林利子),49,5,54,1
8933,김민석(金民錫),임종성(林鍾聲),93,83,176,0
8934,김민석(金民錫),임호선(林昊宣),124,146,270,0
8935,김민석(金民錫),장경태(張耿態),99,104,203,0
8936,김민석(金民錫),장동혁(張東赫),25,4,29,1
8937,김민석(金民錫),장제원(張濟元),49,4,53,1
8938,김민석(金民錫),장철민(張喆敏),95,74,169,0
8939,김민석(金民錫),장혜영(張惠英),19,38,57,1
8940,김민석(金民錫),전봉민(田奉珉),35,5,40,1
8941,김민석(金民錫),전용기(田溶冀),103,90,193,0
8942,김민석(金民錫),전재수(田載秀),82,58,140,0
8943,김민석(金民錫),전주혜(全珠惠),51,9,60,1
8944,김민석(金民錫),전해철(全海澈),81,49,130,0
8945,김민석(金民錫),전혜숙(全惠淑),100,96,196,0
8946,김민석(金民錫),정경희(丁慶姬),49,4,53,1
8947,김민석(金民錫),정동만(鄭東萬),49,5,54,1
8948,김민석(金民錫),정성호(鄭成湖),86,63,149,0
8949,김민석(金民錫),정우택(鄭宇澤),26,6,32,1
8950,김민석(金民錫),정운천(鄭雲天),50,4,54,1
8951,김민석(金民錫),정일영(鄭日永),105,76,181,0
8952,김민석(金民錫),정점식(鄭点植),50,4,54,1
8953,김민석(金民錫),정진석(鄭鎭碩),50,5,55,1
8954,김민석(金民錫),정청래(鄭淸來),95,56,151,0
8955,김민석(金民錫),정춘숙(鄭春淑),102,118,220,0
8956,김민석(金民錫),정태호(鄭泰浩),91,114,205,0
8957,김민석(金民錫),정필모(鄭必模),85,65,150,0
8958,김민석(金民錫),정희용(鄭熙溶),52,9,61,1
8959,김민석(金民錫),조경태(趙慶泰),50,5,55,1
8960,김민석(金民錫),조명희(曺明姬),49,10,59,1
8961,김민석(金民錫),조수진(趙修眞),49,6,55,1
8962,김민석(金民錫),조승래(趙承來),98,69,167,0
8963,김민석(金民錫),조오섭(曺五燮),102,140,242,0
8964,김민석(金民錫),조은희(趙恩禧),25,6,31,1
8965,김민석(金民錫),조응천(趙應天),76,41,117,0
8966,김민석(金民錫),조정식(趙正湜),80,38,118,0
8967,김민석(金民錫),조정훈(趙廷訓),8,39,47,1
8968,김민석(金民錫),조해진(曺海珍),51,6,57,1
8969,김민석(金民錫),주철현(朱哲鉉),84,53,137,0
8970,김민석(金民錫),주호영(朱豪英),50,5,55,1
8971,김민석(金民錫),지성호(池成浩),49,5,54,1
8972,김민석(金民錫),진선미(陳善美),83,48,131,0
8973,김민석(金民錫),진성준(陳聲準),94,89,183,0
8974,김민석(金民錫),천준호(千俊鎬),86,60,146,0
8975,김민석(金民錫),최기상(崔基相),88,56,144,0
8976,김민석(金民錫),최승재(崔承宰),50,15,65,1
8977,김민석(金民錫),최연숙(崔姸淑),37,20,57,1
8978,김민석(金民錫),최영희(崔英姬),25,4,29,1
8979,김민석(金民錫),최인호(崔仁昊),89,63,152,0
8980,김민석(金民錫),최재형(崔在亨),25,5,30,1
8981,김민석(金民錫),최종윤(崔鍾允),110,110,220,0
8982,김민석(金民錫),최춘식(崔春植),49,17,66,1
8983,김민석(金民錫),최형두(崔炯斗),51,7,58,1
8984,김민석(金民錫),최혜영(崔惠英),134,189,323,0
8985,김민석(金民錫),추경호(秋慶鎬),49,4,53,1
8986,김민석(金民錫),태영호(太永浩),50,15,65,1
8987,김민석(金民錫),하영제(河榮帝),41,1,42,1
8988,김민석(金民錫),하태경(河泰慶),49,4,53,1
8989,김민석(金民錫),한기호(韓起鎬),50,7,57,1
8990,김민석(金民錫),한무경(韓茂景),50,6,56,1
8991,김민석(金民錫),한병도(韓秉道),139,113,252,0
8992,김민석(金民錫),한정애(韓貞愛),78,66,144,0
8993,김민석(金民錫),한준호(韓俊鎬),86,94,180,0
8994,김민석(金民錫),허숙정(許淑湞),1,1,2,0
8995,김민석(金民錫),허영(許榮),107,95,202,0
8996,김민석(金民錫),허은아(許垠娥),49,5,54,1
8997,김민석(金民錫),허종식(許琮植),107,108,215,0
8998,김민석(金民錫),홍기원(洪起元),91,75,166,0
8999,김민석(金民錫),홍문표(洪文杓),51,4,55,1
9000,김민석(金民錫),홍석준(洪碩晙),50,5,55,1
9001,김민석(金民錫),홍성국(洪性國),112,124,236,0
9002,김민석(金民錫),홍영표(洪永杓),84,54,138,0
9003,김민석(金民錫),홍익표(洪翼杓),85,64,149,0
9004,김민석(金民錫),홍정민(洪貞敏),115,128,243,0
9005,김민석(金民錫),황보승희(皇甫承希),46,6,52,1
9006,김민석(金民錫),황운하(黃雲夏),106,98,204,0
9007,김민석(金民錫),황희(黃熙),81,47,128,0
9008,김민철(金敏徹),김병기(金炳基),102,107,209,0
9009,김민철(金敏徹),김병욱A(金炳旭),101,144,245,0
9010,김민철(金敏徹),김병욱B(金炳旭),46,9,55,1
9011,김민철(金敏徹),김병주(金柄周),142,144,286,0
9012,김민철(金敏徹),김상훈(金相勳),53,8,61,1
9013,김민철(金敏徹),김상희(金相姬),92,81,173,0
9014,김민철(金敏徹),김석기(金碩基),52,8,60,1
9015,김민철(金敏徹),김성원(金成願),53,12,65,1
9016,김민철(金敏徹),김성주(金成柱),108,106,214,0
9017,김민철(金敏徹),김성환(金星煥),97,99,196,0
9018,김민철(金敏徹),김수흥(金洙興),120,138,258,0
9019,김민철(金敏徹),김승남(金承南),105,149,254,0
9020,김민철(金敏徹),김승수(金承洙),53,9,62,1
9021,김민철(金敏徹),김승원(金勝源),175,216,391,0
9022,김민철(金敏徹),김영배(金永培),165,197,362,0
9023,김민철(金敏徹),김영선(金映宣),26,4,30,1
9024,김민철(金敏徹),김영식(金英植),52,7,59,1
9025,김민철(金敏徹),김영주(金榮珠),102,83,185,0
9026,김민철(金敏徹),김영진(金榮鎭),93,76,169,0
9027,김민철(金敏徹),김영호(金映豪),109,97,206,0
9028,김민철(金敏徹),김예지(金睿智),54,9,63,1
9029,김민철(金敏徹),김용민(金容民),95,98,193,0
9030,김민철(金敏徹),김용판(金用判),54,7,61,1
9031,김민철(金敏徹),김웅(金雄),51,5,56,1
9032,김민철(金敏徹),김원이(金元二),112,134,246,0
9033,김민철(金敏徹),김윤덕(金潤德),107,120,227,0
9034,김민철(金敏徹),김의겸(金宜謙),53,64,117,0
9035,김민철(金敏徹),김정재(金汀才),53,6,59,1
9036,김민철(金敏徹),김정호(金禎鎬),115,191,306,0
9037,김민철(金敏徹),김종민(金鐘民),99,98,197,0
9038,김민철(金敏徹),김주영(金周暎),119,138,257,0
9039,김민철(金敏徹),김진표(金振杓),69,59,128,1
9040,김민철(金敏徹),김철민(金哲玟),155,191,346,0
9041,김민철(金敏徹),김태년(金太年),79,56,135,0
9042,김민철(金敏徹),김태호(金台鎬),42,6,48,1
9043,김민철(金敏徹),김학용(金學容),26,6,32,1
9044,김민철(金敏徹),김한규(金翰奎),43,45,88,0
9045,김민철(金敏徹),김한정(金漢正),88,62,150,0
9046,김민철(金敏徹),김형동(金亨東),54,10,64,1
9047,김민철(金敏徹),김홍걸(金弘傑),85,174,259,0
9048,김민철(金敏徹),김회재(金會在),111,111,222,0
9049,김민철(金敏徹),김희곤(金熙坤),50,5,55,1
9050,김민철(金敏徹),김희국(金熙國),50,4,54,1
9051,김민철(金敏徹),남인순(南仁順),115,125,240,0
9052,김민철(金敏徹),노용호(魯容昊),25,4,29,1
9053,김민철(金敏徹),노웅래(盧雄來),104,115,219,0
9054,김민철(金敏徹),도종환(都鍾煥),115,99,214,0
9055,김민철(金敏徹),류성걸(柳性杰),49,5,54,1
9056,김민철(金敏徹),류호정(柳好貞),27,37,64,1
9057,김민철(金敏徹),맹성규(孟聖奎),99,112,211,0
9058,김민철(金敏徹),문정복(文貞福),101,92,193,0
9059,김민철(金敏徹),문진석(文振碩),115,137,252,0
9060,김민철(金敏徹),민병덕(閔炳德),107,191,298,0
9061,김민철(金敏徹),민형배(閔馨培),144,250,394,0
9062,김민철(金敏徹),민홍철(閔洪喆),105,122,227,0
9063,김민철(金敏徹),박광온(朴洸瑥),88,71,159,0
9064,김민철(金敏徹),박대수(朴大壽),50,8,58,1
9065,김민철(金敏徹),박대출(朴大出),50,4,54,1
9066,김민철(金敏徹),박덕흠(朴德欽),38,11,49,1
9067,김민철(金敏徹),박범계(朴範界),79,44,123,0
9068,김민철(金敏徹),박병석(朴炳錫),41,15,56,0
9069,김민철(金敏徹),박상혁(朴商赫),122,139,261,0
9070,김민철(金敏徹),박성민(朴聖敏),51,8,59,1
9071,김민철(金敏徹),박성준(朴省俊),147,160,307,0
9072,김민철(金敏徹),박성중(朴成重),50,4,54,1
9073,김민철(金敏徹),박수영(朴洙瑩),50,6,56,1
9074,김민철(金敏徹),박영순(朴英淳),126,118,244,0
9075,김민철(金敏徹),박완주(朴完柱),67,73,140,1
9076,김민철(金敏徹),박용진(朴用鎭),84,62,146,0
9077,김민철(金敏徹),박재호(朴在昊),110,91,201,0
9078,김민철(金敏徹),박정(朴釘),128,147,275,0
9079,김민철(金敏徹),박정하(朴正河),25,5,30,1
9080,김민철(金敏徹),박주민(朴柱民),86,65,151,0
9081,김민철(金敏徹),박진(朴振),50,6,56,1
9082,김민철(金敏徹),박찬대(朴贊大),91,79,170,0
9083,김민철(金敏徹),박형수(朴亨修),49,4,53,1
9084,김민철(金敏徹),박홍근(朴洪根),103,122,225,0
9085,김민철(金敏徹),배준영(裵俊英),49,10,59,1
9086,김민철(金敏徹),배진교(裵晋敎),26,30,56,1
9087,김민철(金敏徹),배현진(裵賢鎭),50,6,56,1
9088,김민철(金敏徹),백종헌(白宗憲),51,5,56,1
9089,김민철(金敏徹),백혜련(白惠蓮),100,75,175,0
9090,김민철(金敏徹),변재일(卞在一),87,66,153,0
9091,김민철(金敏徹),서동용(徐東榕),106,126,232,0
9092,김민철(金敏徹),서범수(徐範洙),52,10,62,1
9093,김민철(金敏徹),서병수(徐秉洙),50,6,56,1
9094,김민철(金敏徹),서삼석(徐參錫),123,100,223,0
9095,김민철(金敏徹),서영교(徐瑛敎),190,224,414,0
9096,김민철(金敏徹),서영석(徐暎錫),113,160,273,0
9097,김민철(金敏徹),서일준(徐一俊),50,6,56,1
9098,김민철(金敏徹),서정숙(徐正淑),49,7,56,1
9099,김민철(金敏徹),설훈(薛勳),88,65,153,0
9100,김민철(金敏徹),성일종(成一鍾),51,11,62,1
9101,김민철(金敏徹),소병철(蘇秉哲),89,87,176,0
9102,김민철(金敏徹),소병훈(蘇秉勳),94,106,200,0
9103,김민철(金敏徹),송갑석(宋甲錫),111,177,288,0
9104,김민철(金敏徹),송기헌(宋基憲),92,56,148,0
9105,김민철(金敏徹),송석준(宋錫俊),51,6,57,1
9106,김민철(金敏徹),송언석(宋彦錫),45,6,51,1
9107,김민철(金敏徹),송옥주(宋玉珠),119,118,237,0
9108,김민철(金敏徹),송재호(宋在祜),121,175,296,0
9109,김민철(金敏徹),신동근(申東根),93,98,191,0
9110,김민철(金敏徹),신영대(申榮大),86,72,158,0
9111,김민철(金敏徹),신원식(申源湜),50,6,56,1
9112,김민철(金敏徹),신정훈(辛正勳),141,222,363,0
9113,김민철(金敏徹),신현영(申賢榮),121,108,229,0
9114,김민철(金敏徹),심상정(沈相奵),21,27,48,1
9115,김민철(金敏徹),안규백(安圭伯),100,108,208,0
9116,김민철(金敏徹),안민석(安敏錫),100,75,175,0
9117,김민철(金敏徹),안병길(安炳吉),50,4,54,1
9118,김민철(金敏徹),안철수(安哲秀),25,5,30,1
9119,김민철(金敏徹),안호영(安浩永),116,120,236,0
9120,김민철(金敏徹),양경숙(梁敬淑),99,116,215,0
9121,김민철(金敏徹),양금희(梁琴喜),50,7,57,1
9122,김민철(金敏徹),양기대(梁基大),131,126,257,0
9123,김민철(金敏徹),양이원영(梁李媛瑛),97,78,175,0
9124,김민철(金敏徹),양정숙(梁貞淑),104,264,368,1
9125,김민철(金敏徹),양향자(梁香子),54,59,113,1
9126,김민철(金敏徹),어기구(魚基龜),96,75,171,0
9127,김민철(金敏徹),엄태영(嚴泰永),52,8,60,1
9128,김민철(金敏徹),오기형(吳奇炯),100,82,182,0
9129,김민철(金敏徹),오영환(吳永煥),279,395,674,0
9130,김민철(金敏徹),용혜인(龍慧仁),21,40,61,1
9131,김민철(金敏徹),우상호(禹相虎),81,41,122,0
9132,김민철(金敏徹),우원식(禹元植),101,82,183,0
9133,김민철(金敏徹),위성곤(魏聖坤),110,115,225,0
9134,김민철(金敏徹),유경준(兪京濬),49,5,54,1
9135,김민철(金敏徹),유기홍(柳基洪),80,65,145,0
9136,김민철(金敏徹),유동수(柳東秀),96,63,159,0
9137,김민철(金敏徹),유상범(劉相凡),49,5,54,1
9138,김민철(金敏徹),유의동(兪義東),49,5,54,1
9139,김민철(金敏徹),유정주(兪訂炷),133,167,300,0
9140,김민철(金敏徹),윤건영(尹建永),89,86,175,0
9141,김민철(金敏徹),윤관석(尹官石),87,61,148,1
9142,김민철(金敏徹),윤두현(尹斗鉉),49,7,56,1
9143,김민철(金敏徹),윤미향(尹美香),72,103,175,1
9144,김민철(金敏徹),윤상현(尹相現),33,6,39,1
9145,김민철(金敏徹),윤영덕(尹永德),107,134,241,0
9146,김민철(金敏徹),윤영석(尹永碩),50,6,56,1
9147,김민철(金敏徹),윤영찬(尹永燦),86,67,153,0
9148,김민철(金敏徹),윤재갑(尹才鉀),136,153,289,0
9149,김민철(金敏徹),윤재옥(尹在玉),49,6,55,1
9150,김민철(金敏徹),윤주경(尹柱卿),49,7,56,1
9151,김민철(金敏徹),윤준병(尹準炳),137,222,359,0
9152,김민철(金敏徹),윤창현(尹暢賢),49,8,57,1
9153,김민철(金敏徹),윤한홍(尹漢洪),51,5,56,1
9154,김민철(金敏徹),윤호중(尹昊重),85,74,159,0
9155,김민철(金敏徹),윤후덕(尹厚德),103,103,206,0
9156,김민철(金敏徹),이개호(李介昊),102,97,199,0
9157,김민철(金敏徹),이달곤(李達坤),52,6,58,1
9158,김민철(金敏徹),이동주(李東洲),90,117,207,0
9159,김민철(金敏徹),이만희(李晩熙),50,6,56,1
9160,김민철(金敏徹),이명수(李明洙),52,21,73,1
9161,김민철(金敏徹),이병훈(李炳勳),137,186,323,0
9162,김민철(金敏徹),이상민(李相珉),80,48,128,0
9163,김민철(金敏徹),이상헌(李相憲),114,131,245,0
9164,김민철(金敏徹),이성만(李成萬),135,154,289,1
9165,김민철(金敏徹),이소영(李素永),107,79,186,0
9166,김민철(金敏徹),이수진(李壽珍),134,179,313,0
9167,김민철(金敏徹),이수진(李秀眞),185,184,369,0
9168,김민철(金敏徹),이양수(李亮壽),52,6,58,1
9169,김민철(金敏徹),이용(李鏞),49,5,54,1
9170,김민철(金敏徹),이용빈(李龍彬),141,264,405,0
9171,김민철(金敏徹),이용선(李庸瑄),109,108,217,0
9172,김민철(金敏徹),이용우(李龍雨),144,156,300,0
9173,김민철(金敏徹),이용호(李容鎬),51,51,102,1
9174,김민철(金敏徹),이원욱(李元旭),101,108,209,0
9175,김민철(金敏徹),이원택(李源澤),148,158,306,0
9176,김민철(金敏徹),이은주(李恩周),35,34,69,1
9177,김민철(金敏徹),이인선(李仁善),25,5,30,1
9178,김민철(金敏徹),이인영(李仁榮),80,60,140,0
9179,김민철(金敏徹),이장섭(李將燮),90,97,187,0
9180,김민철(金敏徹),이재명(李在明),39,20,59,0
9181,김민철(金敏徹),이재정(李在汀),92,69,161,0
9182,김민철(金敏徹),이정문(李楨文),126,148,274,0
9183,김민철(金敏徹),이종배(李鍾培),51,7,58,1
9184,김민철(金敏徹),이종성(李鍾成),49,8,57,1
9185,김민철(金敏徹),이주환(李周桓),49,7,56,1
9186,김민철(金敏徹),이채익(李埰益),52,9,61,1
9187,김민철(金敏徹),이철규(李喆圭),52,8,60,1
9188,김민철(金敏徹),이탄희(李誕熙),94,67,161,0
9189,김민철(金敏徹),이태규(李泰珪),30,6,36,1
9190,김민철(金敏徹),이학영(李學永),103,130,233,0
9191,김민철(金敏徹),이해식(李海植),144,146,290,0
9192,김민철(金敏徹),이헌승(李憲昇),51,5,56,1
9193,김민철(金敏徹),이형석(李炯錫),144,151,295,0
9194,김민철(金敏徹),인재근(印在謹),101,133,234,0
9195,김민철(金敏徹),임병헌(林炳憲),26,5,31,1
9196,김민철(金敏徹),임오경(林五卿),211,208,419,0
9197,김민철(金敏徹),임이자(林利子),50,6,56,1
9198,김민철(金敏徹),임종성(林鍾聲),113,153,266,0
9199,김민철(金敏徹),임호선(林昊宣),217,304,521,0
9200,김민철(金敏徹),장경태(張耿態),164,205,369,0
9201,김민철(金敏徹),장동혁(張東赫),25,4,29,1
9202,김민철(金敏徹),장제원(張濟元),49,4,53,1
9203,김민철(金敏徹),장철민(張喆敏),185,206,391,0
9204,김민철(金敏徹),장혜영(張惠英),21,20,41,1
9205,김민철(金敏徹),전봉민(田奉珉),35,6,41,1
9206,김민철(金敏徹),전용기(田溶冀),123,118,241,0
9207,김민철(金敏徹),전재수(田載秀),85,63,148,0
9208,김민철(金敏徹),전주혜(全珠惠),51,7,58,1
9209,김민철(金敏徹),전해철(全海澈),80,74,154,0
9210,김민철(金敏徹),전혜숙(全惠淑),117,123,240,0
9211,김민철(金敏徹),정경희(丁慶姬),49,6,55,1
9212,김민철(金敏徹),정동만(鄭東萬),49,6,55,1
9213,김민철(金敏徹),정성호(鄭成湖),82,104,186,0
9214,김민철(金敏徹),정우택(鄭宇澤),25,6,31,1
9215,김민철(金敏徹),정운천(鄭雲天),52,6,58,1
9216,김민철(金敏徹),정일영(鄭日永),105,117,222,0
9217,김민철(金敏徹),정점식(鄭点植),52,4,56,1
9218,김민철(金敏徹),정진석(鄭鎭碩),50,6,56,1
9219,김민철(金敏徹),정청래(鄭淸來),146,125,271,0
9220,김민철(金敏徹),정춘숙(鄭春淑),91,90,181,0
9221,김민철(金敏徹),정태호(鄭泰浩),87,93,180,0
9222,김민철(金敏徹),정필모(鄭必模),98,100,198,0
9223,김민철(金敏徹),정희용(鄭熙溶),51,8,59,1
9224,김민철(金敏徹),조경태(趙慶泰),53,7,60,1
9225,김민철(金敏徹),조명희(曺明姬),50,8,58,1
9226,김민철(金敏徹),조수진(趙修眞),49,5,54,1
9227,김민철(金敏徹),조승래(趙承來),100,86,186,0
9228,김민철(金敏徹),조오섭(曺五燮),133,188,321,0
9229,김민철(金敏徹),조은희(趙恩禧),25,4,29,1
9230,김민철(金敏徹),조응천(趙應天),72,45,117,0
9231,김민철(金敏徹),조정식(趙正湜),75,52,127,0
9232,김민철(金敏徹),조정훈(趙廷訓),7,12,19,1
9233,김민철(金敏徹),조해진(曺海珍),53,7,60,1
9234,김민철(金敏徹),주철현(朱哲鉉),160,183,343,0
9235,김민철(金敏徹),주호영(朱豪英),50,4,54,1
9236,김민철(金敏徹),지성호(池成浩),50,4,54,1
9237,김민철(金敏徹),진선미(陳善美),89,87,176,0
9238,김민철(金敏徹),진성준(陳聲準),101,102,203,0
9239,김민철(金敏徹),천준호(千俊鎬),91,70,161,0
9240,김민철(金敏徹),최기상(崔基相),97,82,179,0
9241,김민철(金敏徹),최승재(崔承宰),53,8,61,1
9242,김민철(金敏徹),최연숙(崔姸淑),34,11,45,1
9243,김민철(金敏徹),최영희(崔英姬),25,7,32,1
9244,김민철(金敏徹),최인호(崔仁昊),89,104,193,0
9245,김민철(金敏徹),최재형(崔在亨),26,6,32,1
9246,김민철(金敏徹),최종윤(崔鍾允),129,191,320,0
9247,김민철(金敏徹),최춘식(崔春植),54,12,66,1
9248,김민철(金敏徹),최형두(崔炯斗),52,12,64,1
9249,김민철(金敏徹),최혜영(崔惠英),170,206,376,0
9250,김민철(金敏徹),추경호(秋慶鎬),49,5,54,1
9251,김민철(金敏徹),태영호(太永浩),50,6,56,1
9252,김민철(金敏徹),하영제(河榮帝),42,4,46,1
9253,김민철(金敏徹),하태경(河泰慶),51,4,55,1
9254,김민철(金敏徹),한기호(韓起鎬),51,9,60,1
9255,김민철(金敏徹),한무경(韓茂景),49,6,55,1
9256,김민철(金敏徹),한병도(韓秉道),182,166,348,0
9257,김민철(金敏徹),한정애(韓貞愛),81,76,157,0
9258,김민철(金敏徹),한준호(韓俊鎬),144,215,359,0
9259,김민철(金敏徹),허숙정(許淑湞),1,1,2,0
9260,김민철(金敏徹),허영(許榮),121,163,284,0
9261,김민철(金敏徹),허은아(許垠娥),49,5,54,1
9262,김민철(金敏徹),허종식(許琮植),108,139,247,0
9263,김민철(金敏徹),홍기원(洪起元),103,132,235,0
9264,김민철(金敏徹),홍문표(洪文杓),54,13,67,1
9265,김민철(金敏徹),홍석준(洪碩晙),50,5,55,1
9266,김민철(金敏徹),홍성국(洪性國),183,243,426,0
9267,김민철(金敏徹),홍영표(洪永杓),93,79,172,0
9268,김민철(金敏徹),홍익표(洪翼杓),92,95,187,0
9269,김민철(金敏徹),홍정민(洪貞敏),116,135,251,0
9270,김민철(金敏徹),황보승희(皇甫承希),46,3,49,1
9271,김민철(金敏徹),황운하(黃雲夏),130,192,322,0
9272,김민철(金敏徹),황희(黃熙),78,55,133,0
9273,김병기(金炳基),김병욱A(金炳旭),106,114,220,0
9274,김병기(金炳基),김병욱B(金炳旭),46,5,51,1
9275,김병기(金炳基),김병주(金柄周),107,68,175,0
9276,김병기(金炳基),김상훈(金相勳),55,5,60,1
9277,김병기(金炳基),김상희(金相姬),84,64,148,0
9278,김병기(金炳基),김석기(金碩基),53,4,57,1
9279,김병기(金炳基),김성원(金成願),54,7,61,1
9280,김병기(金炳基),김성주(金成柱),89,56,145,0
9281,김병기(金炳基),김성환(金星煥),88,51,139,0
9282,김병기(金炳基),김수흥(金洙興),104,87,191,0
9283,김병기(金炳基),김승남(金承南),97,99,196,0
9284,김병기(金炳基),김승수(金承洙),54,9,63,1
9285,김병기(金炳基),김승원(金勝源),104,85,189,0
9286,김병기(金炳基),김영배(金永培),104,94,198,0
9287,김병기(金炳基),김영선(金映宣),26,4,30,1
9288,김병기(金炳基),김영식(金英植),52,6,58,1
9289,김병기(金炳基),김영주(金榮珠),95,68,163,0
9290,김병기(金炳基),김영진(金榮鎭),81,70,151,0
9291,김병기(金炳基),김영호(金映豪),90,57,147,0
9292,김병기(金炳基),김예지(金睿智),52,4,56,1
9293,김병기(金炳基),김용민(金容民),92,85,177,0
9294,김병기(金炳基),김용판(金用判),53,5,58,1
9295,김병기(金炳基),김웅(金雄),51,5,56,1
9296,김병기(金炳基),김원이(金元二),101,75,176,0
9297,김병기(金炳基),김윤덕(金潤德),98,78,176,0
9298,김병기(金炳基),김의겸(金宜謙),46,44,90,0
9299,김병기(金炳基),김정재(金汀才),54,5,59,1
9300,김병기(金炳基),김정호(金禎鎬),107,147,254,0
9301,김병기(金炳基),김종민(金鐘民),84,71,155,0
9302,김병기(金炳基),김주영(金周暎),111,134,245,0
9303,김병기(金炳基),김진표(金振杓),77,71,148,1
9304,김병기(金炳基),김철민(金哲玟),108,70,178,0
9305,김병기(金炳基),김태년(金太年),80,44,124,0
9306,김병기(金炳基),김태호(金台鎬),42,5,47,1
9307,김병기(金炳基),김학용(金學容),26,4,30,1
9308,김병기(金炳基),김한규(金翰奎),42,42,84,0
9309,김병기(金炳基),김한정(金漢正),78,46,124,0
9310,김병기(金炳基),김형동(金亨東),52,6,58,1
9311,김병기(金炳基),김홍걸(金弘傑),46,117,163,0
9312,김병기(金炳基),김회재(金會在),91,60,151,0
9313,김병기(金炳基),김희곤(金熙坤),50,5,55,1
9314,김병기(金炳基),김희국(金熙國),51,4,55,1
9315,김병기(金炳基),남인순(南仁順),87,53,140,0
9316,김병기(金炳基),노용호(魯容昊),25,4,29,1
9317,김병기(金炳基),노웅래(盧雄來),101,82,183,0
9318,김병기(金炳基),도종환(都鍾煥),113,61,174,0
9319,김병기(金炳基),류성걸(柳性杰),51,4,55,1
9320,김병기(金炳基),류호정(柳好貞),14,15,29,1
9321,김병기(金炳基),맹성규(孟聖奎),87,70,157,0
9322,김병기(金炳基),문정복(文貞福),89,54,143,0
9323,김병기(金炳基),문진석(文振碩),103,144,247,0
9324,김병기(金炳基),민병덕(閔炳德),96,93,189,0
9325,김병기(金炳基),민형배(閔馨培),79,91,170,0
9326,김병기(金炳基),민홍철(閔洪喆),93,86,179,0
9327,김병기(金炳基),박광온(朴洸瑥),85,77,162,0
9328,김병기(金炳基),박대수(朴大壽),50,7,57,1
9329,김병기(金炳基),박대출(朴大出),50,4,54,1
9330,김병기(金炳基),박덕흠(朴德欽),37,7,44,1
9331,김병기(金炳基),박범계(朴範界),81,43,124,0
9332,김병기(金炳基),박병석(朴炳錫),40,15,55,0
9333,김병기(金炳基),박상혁(朴商赫),96,112,208,0
9334,김병기(金炳基),박성민(朴聖敏),53,10,63,1
9335,김병기(金炳基),박성준(朴省俊),103,115,218,0
9336,김병기(金炳基),박성중(朴成重),49,4,53,1
9337,김병기(金炳基),박수영(朴洙瑩),50,5,55,1
9338,김병기(金炳基),박영순(朴英淳),88,58,146,0
9339,김병기(金炳基),박완주(朴完柱),50,40,90,1
9340,김병기(金炳基),박용진(朴用鎭),79,53,132,0
9341,김병기(金炳基),박재호(朴在昊),90,82,172,0
9342,김병기(金炳基),박정(朴釘),97,69,166,0
9343,김병기(金炳基),박정하(朴正河),26,4,30,1
9344,김병기(金炳基),박주민(朴柱民),80,44,124,0
9345,김병기(金炳基),박진(朴振),50,4,54,1
9346,김병기(金炳基),박찬대(朴贊大),89,68,157,0
9347,김병기(金炳基),박형수(朴亨修),50,5,55,1
9348,김병기(金炳基),박홍근(朴洪根),99,97,196,0
9349,김병기(金炳基),배준영(裵俊英),50,4,54,1
9350,김병기(金炳基),배진교(裵晋敎),14,10,24,1
9351,김병기(金炳基),배현진(裵賢鎭),50,5,55,1
9352,김병기(金炳基),백종헌(白宗憲),51,6,57,1
9353,김병기(金炳基),백혜련(白惠蓮),87,59,146,0
9354,김병기(金炳基),변재일(卞在一),89,54,143,0
9355,김병기(金炳基),서동용(徐東榕),97,67,164,0
9356,김병기(金炳基),서범수(徐範洙),51,5,56,1
9357,김병기(金炳基),서병수(徐秉洙),52,5,57,1
9358,김병기(金炳基),서삼석(徐參錫),107,85,192,0
9359,김병기(金炳基),서영교(徐瑛敎),118,102,220,0
9360,김병기(金炳基),서영석(徐暎錫),99,93,192,0
9361,김병기(金炳基),서일준(徐一俊),52,6,58,1
9362,김병기(金炳基),서정숙(徐正淑),50,9,59,1
9363,김병기(金炳基),설훈(薛勳),92,78,170,0
9364,김병기(金炳基),성일종(成一鍾),51,6,57,1
9365,김병기(金炳基),소병철(蘇秉哲),96,94,190,0
9366,김병기(金炳基),소병훈(蘇秉勳),86,73,159,0
9367,김병기(金炳基),송갑석(宋甲錫),109,118,227,0
9368,김병기(金炳基),송기헌(宋基憲),87,64,151,0
9369,김병기(金炳基),송석준(宋錫俊),51,7,58,1
9370,김병기(金炳基),송언석(宋彦錫),48,7,55,1
9371,김병기(金炳基),송옥주(宋玉珠),90,61,151,0
9372,김병기(金炳基),송재호(宋在祜),100,99,199,0
9373,김병기(金炳基),신동근(申東根),104,92,196,0
9374,김병기(金炳基),신영대(申榮大),88,57,145,0
9375,김병기(金炳基),신원식(申源湜),53,9,62,1
9376,김병기(金炳基),신정훈(辛正勳),107,131,238,0
9377,김병기(金炳基),신현영(申賢榮),89,68,157,0
9378,김병기(金炳基),심상정(沈相奵),14,13,27,1
9379,김병기(金炳基),안규백(安圭伯),103,101,204,0
9380,김병기(金炳基),안민석(安敏錫),106,95,201,0
9381,김병기(金炳基),안병길(安炳吉),50,6,56,1
9382,김병기(金炳基),안철수(安哲秀),26,4,30,1
9383,김병기(金炳基),안호영(安浩永),79,70,149,0
9384,김병기(金炳基),양경숙(梁敬淑),84,74,158,0
9385,김병기(金炳基),양금희(梁琴喜),51,6,57,1
9386,김병기(金炳基),양기대(梁基大),83,50,133,0
9387,김병기(金炳基),양이원영(梁李媛瑛),84,47,131,0
9388,김병기(金炳基),양정숙(梁貞淑),39,97,136,1
9389,김병기(金炳基),양향자(梁香子),44,23,67,1
9390,김병기(金炳基),어기구(魚基龜),81,57,138,0
9391,김병기(金炳基),엄태영(嚴泰永),51,6,57,1
9392,김병기(金炳基),오기형(吳奇炯),75,45,120,0
9393,김병기(金炳基),오영환(吳永煥),128,206,334,0
9394,김병기(金炳基),용혜인(龍慧仁),12,19,31,1
9395,김병기(金炳基),우상호(禹相虎),82,36,118,0
9396,김병기(金炳基),우원식(禹元植),87,65,152,0
9397,김병기(金炳基),위성곤(魏聖坤),115,111,226,0
9398,김병기(金炳基),유경준(兪京濬),50,4,54,1
9399,김병기(金炳基),유기홍(柳基洪),85,44,129,0
9400,김병기(金炳基),유동수(柳東秀),95,67,162,0
9401,김병기(金炳基),유상범(劉相凡),50,5,55,1
9402,김병기(金炳基),유의동(兪義東),51,5,56,1
9403,김병기(金炳基),유정주(兪訂炷),105,108,213,0
9404,김병기(金炳基),윤건영(尹建永),81,69,150,0
9405,김병기(金炳基),윤관석(尹官石),77,55,132,1
9406,김병기(金炳基),윤두현(尹斗鉉),50,5,55,1
9407,김병기(金炳基),윤미향(尹美香),35,46,81,1
9408,김병기(金炳基),윤상현(尹相現),31,4,35,1
9409,김병기(金炳基),윤영덕(尹永德),92,87,179,0
9410,김병기(金炳基),윤영석(尹永碩),51,5,56,1
9411,김병기(金炳基),윤영찬(尹永燦),78,53,131,0
9412,김병기(金炳基),윤재갑(尹才鉀),112,108,220,0
9413,김병기(金炳基),윤재옥(尹在玉),50,5,55,1
9414,김병기(金炳基),윤주경(尹柱卿),51,6,57,1
9415,김병기(金炳基),윤준병(尹準炳),105,128,233,0
9416,김병기(金炳基),윤창현(尹暢賢),51,7,58,1
9417,김병기(金炳基),윤한홍(尹漢洪),51,4,55,1
9418,김병기(金炳基),윤호중(尹昊重),81,78,159,0
9419,김병기(金炳基),윤후덕(尹厚德),81,47,128,0
9420,김병기(金炳基),이개호(李介昊),109,121,230,0
9421,김병기(金炳基),이달곤(李達坤),51,5,56,1
9422,김병기(金炳基),이동주(李東洲),94,87,181,0
9423,김병기(金炳基),이만희(李晩熙),51,5,56,1
9424,김병기(金炳基),이명수(李明洙),50,7,57,1
9425,김병기(金炳基),이병훈(李炳勳),109,128,237,0
9426,김병기(金炳基),이상민(李相珉),77,36,113,0
9427,김병기(金炳基),이상헌(李相憲),103,140,243,0
9428,김병기(金炳基),이성만(李成萬),85,88,173,1
9429,김병기(金炳基),이소영(李素永),80,47,127,0
9430,김병기(金炳基),이수진(李壽珍),94,101,195,0
9431,김병기(金炳基),이수진(李秀眞),93,93,186,0
9432,김병기(金炳基),이양수(李亮壽),52,5,57,1
9433,김병기(金炳基),이용(李鏞),50,5,55,1
9434,김병기(金炳基),이용빈(李龍彬),120,158,278,0
9435,김병기(金炳基),이용선(李庸瑄),90,75,165,0
9436,김병기(金炳基),이용우(李龍雨),91,76,167,0
9437,김병기(金炳基),이용호(李容鎬),28,8,36,1
9438,김병기(金炳基),이원욱(李元旭),88,66,154,0
9439,김병기(金炳基),이원택(李源澤),94,75,169,0
9440,김병기(金炳基),이은주(李恩周),15,15,30,1
9441,김병기(金炳基),이인선(李仁善),26,4,30,1
9442,김병기(金炳基),이인영(李仁榮),74,47,121,0
9443,김병기(金炳基),이장섭(李將燮),86,56,142,0
9444,김병기(金炳基),이재명(李在明),40,20,60,0
9445,김병기(金炳基),이재정(李在汀),79,41,120,0
9446,김병기(金炳基),이정문(李楨文),121,105,226,0
9447,김병기(金炳基),이종배(李鍾培),50,6,56,1
9448,김병기(金炳基),이종성(李鍾成),51,5,56,1
9449,김병기(金炳基),이주환(李周桓),49,5,54,1
9450,김병기(金炳基),이채익(李埰益),52,6,58,1
9451,김병기(金炳基),이철규(李喆圭),52,5,57,1
9452,김병기(金炳基),이탄희(李誕熙),89,51,140,0
9453,김병기(金炳基),이태규(李泰珪),28,5,33,1
9454,김병기(金炳基),이학영(李學永),86,72,158,0
9455,김병기(金炳基),이해식(李海植),87,63,150,0
9456,김병기(金炳基),이헌승(李憲昇),51,5,56,1
9457,김병기(金炳基),이형석(李炯錫),94,70,164,0
9458,김병기(金炳基),인재근(印在謹),88,70,158,0
9459,김병기(金炳基),임병헌(林炳憲),27,4,31,1
9460,김병기(金炳基),임오경(林五卿),91,95,186,0
9461,김병기(金炳基),임이자(林利子),51,4,55,1
9462,김병기(金炳基),임종성(林鍾聲),93,100,193,0
9463,김병기(金炳基),임호선(林昊宣),111,129,240,0
9464,김병기(金炳基),장경태(張耿態),97,161,258,0
9465,김병기(金炳基),장동혁(張東赫),26,5,31,1
9466,김병기(金炳基),장제원(張濟元),49,4,53,1
9467,김병기(金炳基),장철민(張喆敏),94,115,209,0
9468,김병기(金炳基),장혜영(張惠英),11,9,20,1
9469,김병기(金炳基),전봉민(田奉珉),35,5,40,1
9470,김병기(金炳基),전용기(田溶冀),95,108,203,0
9471,김병기(金炳基),전재수(田載秀),90,64,154,0
9472,김병기(金炳基),전주혜(全珠惠),53,7,60,1
9473,김병기(金炳基),전해철(全海澈),78,40,118,0
9474,김병기(金炳基),전혜숙(全惠淑),90,71,161,0
9475,김병기(金炳基),정경희(丁慶姬),50,5,55,1
9476,김병기(金炳基),정동만(鄭東萬),49,4,53,1
9477,김병기(金炳基),정성호(鄭成湖),84,103,187,0
9478,김병기(金炳基),정우택(鄭宇澤),25,4,29,1
9479,김병기(金炳基),정운천(鄭雲天),51,4,55,1
9480,김병기(金炳基),정일영(鄭日永),105,210,315,0
9481,김병기(金炳基),정점식(鄭点植),50,4,54,1
9482,김병기(金炳基),정진석(鄭鎭碩),50,6,56,1
9483,김병기(金炳基),정청래(鄭淸來),87,46,133,0
9484,김병기(金炳基),정춘숙(鄭春淑),88,58,146,0
9485,김병기(金炳基),정태호(鄭泰浩),83,84,167,0
9486,김병기(金炳基),정필모(鄭必模),94,76,170,0
9487,김병기(金炳基),정희용(鄭熙溶),52,8,60,1
9488,김병기(金炳基),조경태(趙慶泰),50,4,54,1
9489,김병기(金炳基),조명희(曺明姬),51,8,59,1
9490,김병기(金炳基),조수진(趙修眞),50,5,55,1
9491,김병기(金炳基),조승래(趙承來),115,100,215,0
9492,김병기(金炳基),조오섭(曺五燮),88,109,197,0
9493,김병기(金炳基),조은희(趙恩禧),26,4,30,1
9494,김병기(金炳基),조응천(趙應天),75,39,114,0
9495,김병기(金炳基),조정식(趙正湜),80,59,139,0
9496,김병기(金炳基),조정훈(趙廷訓),3,13,16,1
9497,김병기(金炳基),조해진(曺海珍),52,6,58,1
9498,김병기(金炳基),주철현(朱哲鉉),104,71,175,0
9499,김병기(金炳基),주호영(朱豪英),50,6,56,1
9500,김병기(金炳基),지성호(池成浩),50,4,54,1
9501,김병기(金炳基),진선미(陳善美),80,40,120,0
9502,김병기(金炳基),진성준(陳聲準),91,75,166,0
9503,김병기(金炳基),천준호(千俊鎬),91,62,153,0
9504,김병기(金炳基),최기상(崔基相),89,70,159,0
9505,김병기(金炳基),최승재(崔承宰),50,5,55,1
9506,김병기(金炳基),최연숙(崔姸淑),33,12,45,1
9507,김병기(金炳基),최영희(崔英姬),26,6,32,1
9508,김병기(金炳基),최인호(崔仁昊),89,94,183,0
9509,김병기(金炳基),최재형(崔在亨),26,4,30,1
9510,김병기(金炳基),최종윤(崔鍾允),97,156,253,0
9511,김병기(金炳基),최춘식(崔春植),50,5,55,1
9512,김병기(金炳基),최형두(崔炯斗),55,11,66,1
9513,김병기(金炳基),최혜영(崔惠英),83,70,153,0
9514,김병기(金炳基),추경호(秋慶鎬),50,5,55,1
9515,김병기(金炳基),태영호(太永浩),50,7,57,1
9516,김병기(金炳基),하영제(河榮帝),42,2,44,1
9517,김병기(金炳基),하태경(河泰慶),52,7,59,1
9518,김병기(金炳基),한기호(韓起鎬),53,5,58,1
9519,김병기(金炳基),한무경(韓茂景),50,5,55,1
9520,김병기(金炳基),한병도(韓秉道),92,73,165,0
9521,김병기(金炳基),한정애(韓貞愛),84,59,143,0
9522,김병기(金炳基),한준호(韓俊鎬),116,173,289,0
9523,김병기(金炳基),허숙정(許淑湞),1,1,2,0
9524,김병기(金炳基),허영(許榮),96,90,186,0
9525,김병기(金炳基),허은아(許垠娥),50,5,55,1
9526,김병기(金炳基),허종식(許琮植),93,79,172,0
9527,김병기(金炳基),홍기원(洪起元),101,107,208,0
9528,김병기(金炳基),홍문표(洪文杓),51,7,58,1
9529,김병기(金炳基),홍석준(洪碩晙),51,5,56,1
9530,김병기(金炳基),홍성국(洪性國),106,117,223,0
9531,김병기(金炳基),홍영표(洪永杓),99,79,178,0
9532,김병기(金炳基),홍익표(洪翼杓),85,59,144,0
9533,김병기(金炳基),홍정민(洪貞敏),93,94,187,0
9534,김병기(金炳基),황보승희(皇甫承希),47,3,50,1
9535,김병기(金炳基),황운하(黃雲夏),100,164,264,0
9536,김병기(金炳基),황희(黃熙),86,41,127,0
9537,김병욱A(金炳旭),김병욱B(金炳旭),44,7,51,1
9538,김병욱A(金炳旭),김병주(金柄周),93,66,159,0
9539,김병욱A(金炳旭),김상훈(金相勳),53,5,58,1
9540,김병욱A(金炳旭),김상희(金相姬),90,81,171,0
9541,김병욱A(金炳旭),김석기(金碩基),52,7,59,1
9542,김병욱A(金炳旭),김성원(金成願),53,10,63,1
9543,김병욱A(金炳旭),김성주(金成柱),112,95,207,0
9544,김병욱A(金炳旭),김성환(金星煥),99,114,213,0
9545,김병욱A(金炳旭),김수흥(金洙興),108,105,213,0
9546,김병욱A(金炳旭),김승남(金承南),94,128,222,0
9547,김병욱A(金炳旭),김승수(金承洙),53,8,61,1
9548,김병욱A(金炳旭),김승원(金勝源),116,126,242,0
9549,김병욱A(金炳旭),김영배(金永培),96,95,191,0
9550,김병욱A(金炳旭),김영선(金映宣),26,4,30,1
9551,김병욱A(金炳旭),김영식(金英植),52,5,57,1
9552,김병욱A(金炳旭),김영주(金榮珠),93,58,151,0
9553,김병욱A(金炳旭),김영진(金榮鎭),95,99,194,0
9554,김병욱A(金炳旭),김영호(金映豪),93,73,166,0
9555,김병욱A(金炳旭),김예지(金睿智),55,4,59,1
9556,김병욱A(金炳旭),김용민(金容民),88,87,175,0
9557,김병욱A(金炳旭),김용판(金用判),52,4,56,1
9558,김병욱A(金炳旭),김웅(金雄),51,5,56,1
9559,김병욱A(金炳旭),김원이(金元二),91,62,153,0
9560,김병욱A(金炳旭),김윤덕(金潤德),118,158,276,0
9561,김병욱A(金炳旭),김의겸(金宜謙),50,64,114,0
9562,김병욱A(金炳旭),김정재(金汀才),53,6,59,1
9563,김병욱A(金炳旭),김정호(金禎鎬),154,269,423,0
9564,김병욱A(金炳旭),김종민(金鐘民),92,92,184,0
9565,김병욱A(金炳旭),김주영(金周暎),109,116,225,0
9566,김병욱A(金炳旭),김진표(金振杓),58,31,89,1
9567,김병욱A(金炳旭),김철민(金哲玟),116,127,243,0
9568,김병욱A(金炳旭),김태년(金太年),80,92,172,0
9569,김병욱A(金炳旭),김태호(金台鎬),43,14,57,1
9570,김병욱A(金炳旭),김학용(金學容),26,5,31,1
9571,김병욱A(金炳旭),김한규(金翰奎),43,94,137,0
9572,김병욱A(金炳旭),김한정(金漢正),85,53,138,0
9573,김병욱A(金炳旭),김형동(金亨東),52,9,61,1
9574,김병욱A(金炳旭),김홍걸(金弘傑),55,126,181,0
9575,김병욱A(金炳旭),김회재(金會在),98,83,181,0
9576,김병욱A(金炳旭),김희곤(金熙坤),51,6,57,1
9577,김병욱A(金炳旭),김희국(金熙國),49,5,54,1
9578,김병욱A(金炳旭),남인순(南仁順),86,64,150,0
9579,김병욱A(金炳旭),노용호(魯容昊),25,4,29,1
9580,김병욱A(金炳旭),노웅래(盧雄來),104,67,171,0
9581,김병욱A(金炳旭),도종환(都鍾煥),99,76,175,0
9582,김병욱A(金炳旭),류성걸(柳性杰),50,4,54,1
9583,김병욱A(金炳旭),류호정(柳好貞),17,26,43,1
9584,김병욱A(金炳旭),맹성규(孟聖奎),84,79,163,0
9585,김병욱A(金炳旭),문정복(文貞福),86,82,168,0
9586,김병욱A(金炳旭),문진석(文振碩),108,180,288,0
9587,김병욱A(金炳旭),민병덕(閔炳德),111,211,322,0
9588,김병욱A(金炳旭),민형배(閔馨培),98,208,306,0
9589,김병욱A(金炳旭),민홍철(閔洪喆),95,108,203,0
9590,김병욱A(金炳旭),박광온(朴洸瑥),101,54,155,0
9591,김병욱A(金炳旭),박대수(朴大壽),50,9,59,1
9592,김병욱A(金炳旭),박대출(朴大出),50,6,56,1
9593,김병욱A(金炳旭),박덕흠(朴德欽),36,9,45,1
9594,김병욱A(金炳旭),박범계(朴範界),78,36,114,0
9595,김병욱A(金炳旭),박병석(朴炳錫),41,17,58,0
9596,김병욱A(金炳旭),박상혁(朴商赫),137,237,374,0
9597,김병욱A(金炳旭),박성민(朴聖敏),49,4,53,1
9598,김병욱A(金炳旭),박성준(朴省俊),112,132,244,0
9599,김병욱A(金炳旭),박성중(朴成重),49,4,53,1
9600,김병욱A(金炳旭),박수영(朴洙瑩),49,5,54,1
9601,김병욱A(金炳旭),박영순(朴英淳),90,78,168,0
9602,김병욱A(金炳旭),박완주(朴完柱),54,37,91,1
9603,김병욱A(金炳旭),박용진(朴用鎭),82,60,142,0
9604,김병욱A(金炳旭),박재호(朴在昊),132,92,224,0
9605,김병욱A(金炳旭),박정(朴釘),117,100,217,0
9606,김병욱A(金炳旭),박정하(朴正河),25,8,33,1
9607,김병욱A(金炳旭),박주민(朴柱民),76,56,132,0
9608,김병욱A(金炳旭),박진(朴振),50,6,56,1
9609,김병욱A(金炳旭),박찬대(朴贊大),92,79,171,0
9610,김병욱A(金炳旭),박형수(朴亨修),49,4,53,1
9611,김병욱A(金炳旭),박홍근(朴洪根),104,108,212,0
9612,김병욱A(金炳旭),배준영(裵俊英),50,5,55,1
9613,김병욱A(金炳旭),배진교(裵晋敎),13,26,39,1
9614,김병욱A(金炳旭),배현진(裵賢鎭),49,5,54,1
9615,김병욱A(金炳旭),백종헌(白宗憲),50,5,55,1
9616,김병욱A(金炳旭),백혜련(白惠蓮),102,82,184,0
9617,김병욱A(金炳旭),변재일(卞在一),86,71,157,0
9618,김병욱A(金炳旭),서동용(徐東榕),128,146,274,0
9619,김병욱A(金炳旭),서범수(徐範洙),50,9,59,1
9620,김병욱A(金炳旭),서병수(徐秉洙),50,5,55,1
9621,김병욱A(金炳旭),서삼석(徐參錫),92,63,155,0
9622,김병욱A(金炳旭),서영교(徐瑛敎),94,98,192,0
9623,김병욱A(金炳旭),서영석(徐暎錫),110,181,291,0
9624,김병욱A(金炳旭),서일준(徐一俊),50,6,56,1
9625,김병욱A(金炳旭),서정숙(徐正淑),49,6,55,1
9626,김병욱A(金炳旭),설훈(薛勳),83,48,131,0
9627,김병욱A(金炳旭),성일종(成一鍾),51,6,57,1
9628,김병욱A(金炳旭),소병철(蘇秉哲),86,71,157,0
9629,김병욱A(金炳旭),소병훈(蘇秉勳),92,96,188,0
9630,김병욱A(金炳旭),송갑석(宋甲錫),102,100,202,0
9631,김병욱A(金炳旭),송기헌(宋基憲),87,55,142,0
9632,김병욱A(金炳旭),송석준(宋錫俊),52,6,58,1
9633,김병욱A(金炳旭),송언석(宋彦錫),45,6,51,1
9634,김병욱A(金炳旭),송옥주(宋玉珠),125,93,218,0
9635,김병욱A(金炳旭),송재호(宋在祜),104,153,257,0
9636,김병욱A(金炳旭),신동근(申東根),100,100,200,0
9637,김병욱A(金炳旭),신영대(申榮大),91,62,153,0
9638,김병욱A(金炳旭),신원식(申源湜),49,4,53,1
9639,김병욱A(金炳旭),신정훈(辛正勳),118,178,296,0
9640,김병욱A(金炳旭),신현영(申賢榮),107,89,196,0
9641,김병욱A(金炳旭),심상정(沈相奵),17,30,47,1
9642,김병욱A(金炳旭),안규백(安圭伯),102,123,225,0
9643,김병욱A(金炳旭),안민석(安敏錫),104,96,200,0
9644,김병욱A(金炳旭),안병길(安炳吉),50,7,57,1
9645,김병욱A(金炳旭),안철수(安哲秀),25,6,31,1
9646,김병욱A(金炳旭),안호영(安浩永),91,68,159,0
9647,김병욱A(金炳旭),양경숙(梁敬淑),98,118,216,0
9648,김병욱A(金炳旭),양금희(梁琴喜),50,6,56,1
9649,김병욱A(金炳旭),양기대(梁基大),102,71,173,0
9650,김병욱A(金炳旭),양이원영(梁李媛瑛),87,71,158,0
9651,김병욱A(金炳旭),양정숙(梁貞淑),36,125,161,1
9652,김병욱A(金炳旭),양향자(梁香子),58,36,94,1
9653,김병욱A(金炳旭),어기구(魚基龜),94,109,203,0
9654,김병욱A(金炳旭),엄태영(嚴泰永),50,10,60,1
9655,김병욱A(金炳旭),오기형(吳奇炯),80,46,126,0
9656,김병욱A(金炳旭),오영환(吳永煥),119,122,241,0
9657,김병욱A(金炳旭),용혜인(龍慧仁),17,28,45,1
9658,김병욱A(金炳旭),우상호(禹相虎),79,34,113,0
9659,김병욱A(金炳旭),우원식(禹元植),85,100,185,0
9660,김병욱A(金炳旭),위성곤(魏聖坤),105,114,219,0
9661,김병욱A(金炳旭),유경준(兪京濬),49,5,54,1
9662,김병욱A(金炳旭),유기홍(柳基洪),79,53,132,0
9663,김병욱A(金炳旭),유동수(柳東秀),107,79,186,0
9664,김병욱A(金炳旭),유상범(劉相凡),50,4,54,1
9665,김병욱A(金炳旭),유의동(兪義東),49,4,53,1
9666,김병욱A(金炳旭),유정주(兪訂炷),118,135,253,0
9667,김병욱A(金炳旭),윤건영(尹建永),80,70,150,0
9668,김병욱A(金炳旭),윤관석(尹官石),95,59,154,1
9669,김병욱A(金炳旭),윤두현(尹斗鉉),49,5,54,1
9670,김병욱A(金炳旭),윤미향(尹美香),37,43,80,1
9671,김병욱A(金炳旭),윤상현(尹相現),30,6,36,1
9672,김병욱A(金炳旭),윤영덕(尹永德),88,104,192,0
9673,김병욱A(金炳旭),윤영석(尹永碩),50,9,59,1
9674,김병욱A(金炳旭),윤영찬(尹永燦),87,64,151,0
9675,김병욱A(金炳旭),윤재갑(尹才鉀),95,75,170,0
9676,김병욱A(金炳旭),윤재옥(尹在玉),49,5,54,1
9677,김병욱A(金炳旭),윤주경(尹柱卿),49,5,54,1
9678,김병욱A(金炳旭),윤준병(尹準炳),106,139,245,0
9679,김병욱A(金炳旭),윤창현(尹暢賢),49,5,54,1
9680,김병욱A(金炳旭),윤한홍(尹漢洪),50,4,54,1
9681,김병욱A(金炳旭),윤호중(尹昊重),82,68,150,0
9682,김병욱A(金炳旭),윤후덕(尹厚德),128,164,292,0
9683,김병욱A(金炳旭),이개호(李介昊),92,57,149,0
9684,김병욱A(金炳旭),이달곤(李達坤),51,7,58,1
9685,김병욱A(金炳旭),이동주(李東洲),88,154,242,0
9686,김병욱A(金炳旭),이만희(李晩熙),49,4,53,1
9687,김병욱A(金炳旭),이명수(李明洙),51,15,66,1
9688,김병욱A(金炳旭),이병훈(李炳勳),103,118,221,0
9689,김병욱A(金炳旭),이상민(李相珉),87,43,130,0
9690,김병욱A(金炳旭),이상헌(李相憲),115,128,243,0
9691,김병욱A(金炳旭),이성만(李成萬),95,129,224,1
9692,김병욱A(金炳旭),이소영(李素永),85,78,163,0
9693,김병욱A(金炳旭),이수진(李壽珍),100,132,232,0
9694,김병욱A(金炳旭),이수진(李秀眞),95,53,148,0
9695,김병욱A(金炳旭),이양수(李亮壽),51,5,56,1
9696,김병욱A(金炳旭),이용(李鏞),49,8,57,1
9697,김병욱A(金炳旭),이용빈(李龍彬),126,237,363,0
9698,김병욱A(金炳旭),이용선(李庸瑄),99,121,220,0
9699,김병욱A(金炳旭),이용우(李龍雨),103,91,194,0
9700,김병욱A(金炳旭),이용호(李容鎬),35,30,65,1
9701,김병욱A(金炳旭),이원욱(李元旭),113,109,222,0
9702,김병욱A(金炳旭),이원택(李源澤),95,73,168,0
9703,김병욱A(金炳旭),이은주(李恩周),16,27,43,1
9704,김병욱A(金炳旭),이인선(李仁善),25,4,29,1
9705,김병욱A(金炳旭),이인영(李仁榮),78,47,125,0
9706,김병욱A(金炳旭),이장섭(李將燮),90,58,148,0
9707,김병욱A(金炳旭),이재명(李在明),39,18,57,0
9708,김병욱A(金炳旭),이재정(李在汀),91,61,152,0
9709,김병욱A(金炳旭),이정문(李楨文),102,172,274,0
9710,김병욱A(金炳旭),이종배(李鍾培),50,6,56,1
9711,김병욱A(金炳旭),이종성(李鍾成),49,9,58,1
9712,김병욱A(金炳旭),이주환(李周桓),49,6,55,1
9713,김병욱A(金炳旭),이채익(李埰益),52,9,61,1
9714,김병욱A(金炳旭),이철규(李喆圭),50,5,55,1
9715,김병욱A(金炳旭),이탄희(李誕熙),102,65,167,0
9716,김병욱A(金炳旭),이태규(李泰珪),28,6,34,1
9717,김병욱A(金炳旭),이학영(李學永),121,97,218,0
9718,김병욱A(金炳旭),이해식(李海植),91,73,164,0
9719,김병욱A(金炳旭),이헌승(李憲昇),50,4,54,1
9720,김병욱A(金炳旭),이형석(李炯錫),97,102,199,0
9721,김병욱A(金炳旭),인재근(印在謹),96,102,198,0
9722,김병욱A(金炳旭),임병헌(林炳憲),26,4,30,1
9723,김병욱A(金炳旭),임오경(林五卿),94,89,183,0
9724,김병욱A(金炳旭),임이자(林利子),49,5,54,1
9725,김병욱A(金炳旭),임종성(林鍾聲),132,193,325,0
9726,김병욱A(金炳旭),임호선(林昊宣),103,102,205,0
9727,김병욱A(金炳旭),장경태(張耿態),100,130,230,0
9728,김병욱A(金炳旭),장동혁(張東赫),25,5,30,1
9729,김병욱A(金炳旭),장제원(張濟元),49,5,54,1
9730,김병욱A(金炳旭),장철민(張喆敏),89,132,221,0
9731,김병욱A(金炳旭),장혜영(張惠英),11,14,25,1
9732,김병욱A(金炳旭),전봉민(田奉珉),35,7,42,1
9733,김병욱A(金炳旭),전용기(田溶冀),108,129,237,0
9734,김병욱A(金炳旭),전재수(田載秀),125,105,230,0
9735,김병욱A(金炳旭),전주혜(全珠惠),51,5,56,1
9736,김병욱A(金炳旭),전해철(全海澈),78,52,130,0
9737,김병욱A(金炳旭),전혜숙(全惠淑),98,102,200,0
9738,김병욱A(金炳旭),정경희(丁慶姬),49,5,54,1
9739,김병욱A(金炳旭),정동만(鄭東萬),49,5,54,1
9740,김병욱A(金炳旭),정성호(鄭成湖),120,185,305,0
9741,김병욱A(金炳旭),정우택(鄭宇澤),25,5,30,1
9742,김병욱A(金炳旭),정운천(鄭雲天),49,6,55,1
9743,김병욱A(金炳旭),정일영(鄭日永),110,138,248,0
9744,김병욱A(金炳旭),정점식(鄭点植),50,5,55,1
9745,김병욱A(金炳旭),정진석(鄭鎭碩),50,7,57,1
9746,김병욱A(金炳旭),정청래(鄭淸來),84,49,133,0
9747,김병욱A(金炳旭),정춘숙(鄭春淑),106,120,226,0
9748,김병욱A(金炳旭),정태호(鄭泰浩),83,80,163,0
9749,김병욱A(金炳旭),정필모(鄭必模),89,80,169,0
9750,김병욱A(金炳旭),정희용(鄭熙溶),50,7,57,1
9751,김병욱A(金炳旭),조경태(趙慶泰),49,5,54,1
9752,김병욱A(金炳旭),조명희(曺明姬),49,7,56,1
9753,김병욱A(金炳旭),조수진(趙修眞),49,5,54,1
9754,김병욱A(金炳旭),조승래(趙承來),107,118,225,0
9755,김병욱A(金炳旭),조오섭(曺五燮),102,196,298,0
9756,김병욱A(金炳旭),조은희(趙恩禧),25,8,33,1
9757,김병욱A(金炳旭),조응천(趙應天),95,45,140,0
9758,김병욱A(金炳旭),조정식(趙正湜),75,61,136,0
9759,김병욱A(金炳旭),조정훈(趙廷訓),4,5,9,1
9760,김병욱A(金炳旭),조해진(曺海珍),52,6,58,1
9761,김병욱A(金炳旭),주철현(朱哲鉉),92,99,191,0
9762,김병욱A(金炳旭),주호영(朱豪英),49,5,54,1
9763,김병욱A(金炳旭),지성호(池成浩),49,7,56,1
9764,김병욱A(金炳旭),진선미(陳善美),82,45,127,0
9765,김병욱A(金炳旭),진성준(陳聲準),96,121,217,0
9766,김병욱A(金炳旭),천준호(千俊鎬),90,66,156,0
9767,김병욱A(金炳旭),최기상(崔基相),90,80,170,0
9768,김병욱A(金炳旭),최승재(崔承宰),49,6,55,1
9769,김병욱A(金炳旭),최연숙(崔姸淑),29,7,36,1
9770,김병욱A(金炳旭),최영희(崔英姬),25,6,31,1
9771,김병욱A(金炳旭),최인호(崔仁昊),128,135,263,0
9772,김병욱A(金炳旭),최재형(崔在亨),25,5,30,1
9773,김병욱A(金炳旭),최종윤(崔鍾允),95,133,228,0
9774,김병욱A(金炳旭),최춘식(崔春植),49,5,54,1
9775,김병욱A(金炳旭),최형두(崔炯斗),50,5,55,1
9776,김병욱A(金炳旭),최혜영(崔惠英),91,110,201,0
9777,김병욱A(金炳旭),추경호(秋慶鎬),49,4,53,1
9778,김병욱A(金炳旭),태영호(太永浩),49,7,56,1
9779,김병욱A(金炳旭),하영제(河榮帝),41,2,43,1
9780,김병욱A(金炳旭),하태경(河泰慶),49,6,55,1
9781,김병욱A(金炳旭),한기호(韓起鎬),52,5,57,1
9782,김병욱A(金炳旭),한무경(韓茂景),52,8,60,1
9783,김병욱A(金炳旭),한병도(韓秉道),107,112,219,0
9784,김병욱A(金炳旭),한정애(韓貞愛),77,97,174,0
9785,김병욱A(金炳旭),한준호(韓俊鎬),109,176,285,0
9786,김병욱A(金炳旭),허숙정(許淑湞),1,2,3,0
9787,김병욱A(金炳旭),허영(許榮),100,154,254,0
9788,김병욱A(金炳旭),허은아(許垠娥),49,5,54,1
9789,김병욱A(金炳旭),허종식(許琮植),111,186,297,0
9790,김병욱A(金炳旭),홍기원(洪起元),98,105,203,0
9791,김병욱A(金炳旭),홍문표(洪文杓),51,6,57,1
9792,김병욱A(金炳旭),홍석준(洪碩晙),50,6,56,1
9793,김병욱A(金炳旭),홍성국(洪性國),125,162,287,0
9794,김병욱A(金炳旭),홍영표(洪永杓),80,56,136,0
9795,김병욱A(金炳旭),홍익표(洪翼杓),98,68,166,0
9796,김병욱A(金炳旭),홍정민(洪貞敏),118,167,285,0
9797,김병욱A(金炳旭),황보승희(皇甫承希),46,3,49,1
9798,김병욱A(金炳旭),황운하(黃雲夏),96,138,234,0
9799,김병욱A(金炳旭),황희(黃熙),78,53,131,0
9800,김병욱B(金炳旭),김병주(金柄周),46,4,50,1
9801,김병욱B(金炳旭),김상훈(金相勳),96,152,248,0
9802,김병욱B(金炳旭),김상희(金相姬),44,5,49,1
9803,김병욱B(金炳旭),김석기(金碩基),134,202,336,0
9804,김병욱B(金炳旭),김성원(金成願),121,211,332,0
9805,김병욱B(金炳旭),김성주(金成柱),44,6,50,1
9806,김병욱B(金炳旭),김성환(金星煥),44,4,48,1
9807,김병욱B(金炳旭),김수흥(金洙興),45,6,51,1
9808,김병욱B(金炳旭),김승남(金承南),44,7,51,1
9809,김병욱B(金炳旭),김승수(金承洙),107,193,300,0
9810,김병욱B(金炳旭),김승원(金勝源),44,5,49,1
9811,김병욱B(金炳旭),김영배(金永培),46,6,52,1
9812,김병욱B(金炳旭),김영선(金映宣),28,44,72,0
9813,김병욱B(金炳旭),김영식(金英植),142,230,372,0
9814,김병욱B(金炳旭),김영주(金榮珠),45,6,51,1
9815,김병욱B(金炳旭),김영진(金榮鎭),48,3,51,1
9816,김병욱B(金炳旭),김영호(金映豪),44,5,49,1
9817,김병욱B(金炳旭),김예지(金睿智),113,192,305,0
9818,김병욱B(金炳旭),김용민(金容民),44,4,48,1
9819,김병욱B(金炳旭),김용판(金用判),143,297,440,0
9820,김병욱B(金炳旭),김웅(金雄),74,76,150,0
9821,김병욱B(金炳旭),김원이(金元二),44,7,51,1
9822,김병욱B(金炳旭),김윤덕(金潤德),44,5,49,1
9823,김병욱B(金炳旭),김의겸(金宜謙),26,4,30,1
9824,김병욱B(金炳旭),김정재(金汀才),165,197,362,0
9825,김병욱B(金炳旭),김정호(金禎鎬),46,14,60,1
9826,김병욱B(金炳旭),김종민(金鐘民),44,10,54,1
9827,김병욱B(金炳旭),김주영(金周暎),44,7,51,1
9828,김병욱B(金炳旭),김진표(金振杓),19,2,21,1
9829,김병욱B(金炳旭),김철민(金哲玟),43,11,54,1
9830,김병욱B(金炳旭),김태년(金太年),43,4,47,1
9831,김병욱B(金炳旭),김태호(金台鎬),55,75,130,0
9832,김병욱B(金炳旭),김학용(金學容),55,72,127,0
9833,김병욱B(金炳旭),김한규(金翰奎),25,8,33,1
9834,김병욱B(金炳旭),김한정(金漢正),42,4,46,1
9835,김병욱B(金炳旭),김형동(金亨東),111,192,303,0
9836,김병욱B(金炳旭),김홍걸(金弘傑),14,6,20,1
9837,김병욱B(金炳旭),김회재(金會在),43,6,49,1
9838,김병욱B(金炳旭),김희곤(金熙坤),75,162,237,0
9839,김병욱B(金炳旭),김희국(金熙國),86,90,176,0
9840,김병욱B(金炳旭),남인순(南仁順),44,6,50,1
9841,김병욱B(金炳旭),노용호(魯容昊),36,66,102,0
9842,김병욱B(金炳旭),노웅래(盧雄來),43,4,47,1
9843,김병욱B(金炳旭),도종환(都鍾煥),43,6,49,1
9844,김병욱B(金炳旭),류성걸(柳性杰),94,139,233,0
9845,김병욱B(金炳旭),류호정(柳好貞),3,5,8,1
9846,김병욱B(金炳旭),맹성규(孟聖奎),42,8,50,1
9847,김병욱B(金炳旭),문정복(文貞福),44,4,48,1
9848,김병욱B(金炳旭),문진석(文振碩),42,7,49,1
9849,김병욱B(金炳旭),민병덕(閔炳德),43,7,50,1
9850,김병욱B(金炳旭),민형배(閔馨培),26,7,33,1
9851,김병욱B(金炳旭),민홍철(閔洪喆),42,4,46,1
9852,김병욱B(金炳旭),박광온(朴洸瑥),42,7,49,1
9853,김병욱B(金炳旭),박대수(朴大壽),99,266,365,0
9854,김병욱B(金炳旭),박대출(朴大出),70,76,146,0
9855,김병욱B(金炳旭),박덕흠(朴德欽),92,226,318,0
9856,김병욱B(金炳旭),박범계(朴範界),42,4,46,1
9857,김병욱B(金炳旭),박병석(朴炳錫),25,3,28,1
9858,김병욱B(金炳旭),박상혁(朴商赫),45,10,55,1
9859,김병욱B(金炳旭),박성민(朴聖敏),97,208,305,0
9860,김병욱B(金炳旭),박성준(朴省俊),43,6,49,1
9861,김병욱B(金炳旭),박성중(朴成重),70,104,174,0
9862,김병욱B(金炳旭),박수영(朴洙瑩),65,55,120,0
9863,김병욱B(金炳旭),박영순(朴英淳),42,8,50,1
9864,김병욱B(金炳旭),박완주(朴完柱),17,0,17,1
9865,김병욱B(金炳旭),박용진(朴用鎭),42,6,48,1
9866,김병욱B(金炳旭),박재호(朴在昊),44,5,49,1
9867,김병욱B(金炳旭),박정(朴釘),42,8,50,1
9868,김병욱B(金炳旭),박정하(朴正河),39,43,82,0
9869,김병욱B(金炳旭),박주민(朴柱民),42,4,46,1
9870,김병욱B(金炳旭),박진(朴振),67,107,174,0
9871,김병욱B(金炳旭),박찬대(朴贊大),42,11,53,1
9872,김병욱B(金炳旭),박형수(朴亨修),62,62,124,0
9873,김병욱B(金炳旭),박홍근(朴洪根),44,4,48,1
9874,김병욱B(金炳旭),배준영(裵俊英),86,145,231,0
9875,김병욱B(金炳旭),배진교(裵晋敎),1,3,4,1
9876,김병욱B(金炳旭),배현진(裵賢鎭),75,60,135,0
9877,김병욱B(金炳旭),백종헌(白宗憲),98,214,312,0
9878,김병욱B(金炳旭),백혜련(白惠蓮),44,4,48,1
9879,김병욱B(金炳旭),변재일(卞在一),43,6,49,1
9880,김병욱B(金炳旭),서동용(徐東榕),42,15,57,1
9881,김병욱B(金炳旭),서범수(徐範洙),69,91,160,0
9882,김병욱B(金炳旭),서병수(徐秉洙),100,155,255,0
9883,김병욱B(金炳旭),서삼석(徐參錫),43,9,52,1
9884,김병욱B(金炳旭),서영교(徐瑛敎),42,4,46,1
9885,김병욱B(金炳旭),서영석(徐暎錫),42,6,48,1
9886,김병욱B(金炳旭),서일준(徐一俊),134,234,368,0
9887,김병욱B(金炳旭),서정숙(徐正淑),78,78,156,0
9888,김병욱B(金炳旭),설훈(薛勳),43,7,50,1
9889,김병욱B(金炳旭),성일종(成一鍾),102,165,267,0
9890,김병욱B(金炳旭),소병철(蘇秉哲),43,6,49,1
9891,김병욱B(金炳旭),소병훈(蘇秉勳),42,4,46,1
9892,김병욱B(金炳旭),송갑석(宋甲錫),42,6,48,1
9893,김병욱B(金炳旭),송기헌(宋基憲),42,7,49,1
9894,김병욱B(金炳旭),송석준(宋錫俊),77,122,199,0
9895,김병욱B(金炳旭),송언석(宋彦錫),134,134,268,0
9896,김병욱B(金炳旭),송옥주(宋玉珠),42,6,48,1
9897,김병욱B(金炳旭),송재호(宋在祜),43,10,53,1
9898,김병욱B(金炳旭),신동근(申東根),42,6,48,1
9899,김병욱B(金炳旭),신영대(申榮大),42,6,48,1
9900,김병욱B(金炳旭),신원식(申源湜),77,131,208,0
9901,김병욱B(金炳旭),신정훈(辛正勳),42,9,51,1
9902,김병욱B(金炳旭),신현영(申賢榮),42,4,46,1
9903,김병욱B(金炳旭),심상정(沈相奵),1,3,4,1
9904,김병욱B(金炳旭),안규백(安圭伯),46,7,53,1
9905,김병욱B(金炳旭),안민석(安敏錫),43,6,49,1
9906,김병욱B(金炳旭),안병길(安炳吉),87,150,237,0
9907,김병욱B(金炳旭),안철수(安哲秀),30,30,60,0
9908,김병욱B(金炳旭),안호영(安浩永),43,6,49,1
9909,김병욱B(金炳旭),양경숙(梁敬淑),42,4,46,1
9910,김병욱B(金炳旭),양금희(梁琴喜),111,175,286,0
9911,김병욱B(金炳旭),양기대(梁基大),42,6,48,1
9912,김병욱B(金炳旭),양이원영(梁李媛瑛),38,4,42,1
9913,김병욱B(金炳旭),양정숙(梁貞淑),4,18,22,1
9914,김병욱B(金炳旭),양향자(梁香子),15,11,26,1
9915,김병욱B(金炳旭),어기구(魚基龜),43,13,56,1
9916,김병욱B(金炳旭),엄태영(嚴泰永),77,106,183,0
9917,김병욱B(金炳旭),오기형(吳奇炯),42,4,46,1
9918,김병욱B(金炳旭),오영환(吳永煥),42,12,54,1
9919,김병욱B(金炳旭),용혜인(龍慧仁),1,4,5,1
9920,김병욱B(金炳旭),우상호(禹相虎),42,4,46,1
9921,김병욱B(金炳旭),우원식(禹元植),42,4,46,1
9922,김병욱B(金炳旭),위성곤(魏聖坤),42,7,49,1
9923,김병욱B(金炳旭),유경준(兪京濬),89,144,233,0
9924,김병욱B(金炳旭),유기홍(柳基洪),43,5,48,1
9925,김병욱B(金炳旭),유동수(柳東秀),43,5,48,1
9926,김병욱B(金炳旭),유상범(劉相凡),71,91,162,0
9927,김병욱B(金炳旭),유의동(兪義東),92,165,257,0
9928,김병욱B(金炳旭),유정주(兪訂炷),42,5,47,1
9929,김병욱B(金炳旭),윤건영(尹建永),42,4,46,1
9930,김병욱B(金炳旭),윤관석(尹官石),33,0,33,1
9931,김병욱B(金炳旭),윤두현(尹斗鉉),89,149,238,0
9932,김병욱B(金炳旭),윤미향(尹美香),13,2,15,1
9933,김병욱B(金炳旭),윤상현(尹相現),38,56,94,0
9934,김병욱B(金炳旭),윤영덕(尹永德),42,6,48,1
9935,김병욱B(金炳旭),윤영석(尹永碩),70,70,140,0
9936,김병욱B(金炳旭),윤영찬(尹永燦),42,5,47,1
9937,김병욱B(金炳旭),윤재갑(尹才鉀),47,14,61,1
9938,김병욱B(金炳旭),윤재옥(尹在玉),71,66,137,0
9939,김병욱B(金炳旭),윤주경(尹柱卿),76,114,190,0
9940,김병욱B(金炳旭),윤준병(尹準炳),42,6,48,1
9941,김병욱B(金炳旭),윤창현(尹暢賢),98,132,230,0
9942,김병욱B(金炳旭),윤한홍(尹漢洪),67,80,147,0
9943,김병욱B(金炳旭),윤호중(尹昊重),43,4,47,1
9944,김병욱B(金炳旭),윤후덕(尹厚德),42,5,47,1
9945,김병욱B(金炳旭),이개호(李介昊),42,10,52,1
9946,김병욱B(金炳旭),이달곤(李達坤),53,64,117,0
9947,김병욱B(金炳旭),이동주(李東洲),42,6,48,1
9948,김병욱B(金炳旭),이만희(李晩熙),71,73,144,0
9949,김병욱B(金炳旭),이명수(李明洙),119,213,332,0
9950,김병욱B(金炳旭),이병훈(李炳勳),44,5,49,1
9951,김병욱B(金炳旭),이상민(李相珉),43,6,49,1
9952,김병욱B(金炳旭),이상헌(李相憲),42,7,49,1
9953,김병욱B(金炳旭),이성만(李成萬),33,0,33,1
9954,김병욱B(金炳旭),이소영(李素永),42,5,47,1
9955,김병욱B(金炳旭),이수진(李壽珍),43,6,49,1
9956,김병욱B(金炳旭),이수진(李秀眞),42,6,48,1
9957,김병욱B(金炳旭),이양수(李亮壽),76,75,151,0
9958,김병욱B(金炳旭),이용(李鏞),87,154,241,0
9959,김병욱B(金炳旭),이용빈(李龍彬),42,6,48,1
9960,김병욱B(金炳旭),이용선(李庸瑄),42,6,48,1
9961,김병욱B(金炳旭),이용우(李龍雨),42,6,48,1
9962,김병욱B(金炳旭),이용호(李容鎬),38,30,68,0
9963,김병욱B(金炳旭),이원욱(李元旭),43,4,47,1
9964,김병욱B(金炳旭),이원택(李源澤),42,5,47,1
9965,김병욱B(金炳旭),이은주(李恩周),2,2,4,1
9966,김병욱B(金炳旭),이인선(李仁善),34,127,161,0
9967,김병욱B(金炳旭),이인영(李仁榮),42,5,47,1
9968,김병욱B(金炳旭),이장섭(李將燮),42,4,46,1
9969,김병욱B(金炳旭),이재명(李在明),25,4,29,1
9970,김병욱B(金炳旭),이재정(李在汀),42,4,46,1
9971,김병욱B(金炳旭),이정문(李楨文),43,5,48,1
9972,김병욱B(金炳旭),이종배(李鍾培),90,156,246,0
9973,김병욱B(金炳旭),이종성(李鍾成),94,197,291,0
9974,김병욱B(金炳旭),이주환(李周桓),111,168,279,0
9975,김병욱B(金炳旭),이채익(李埰益),101,166,267,0
9976,김병욱B(金炳旭),이철규(李喆圭),77,81,158,0
9977,김병욱B(金炳旭),이탄희(李誕熙),42,5,47,1
9978,김병욱B(金炳旭),이태규(李泰珪),68,101,169,0
9979,김병욱B(金炳旭),이학영(李學永),42,4,46,1
9980,김병욱B(金炳旭),이해식(李海植),44,5,49,1
9981,김병욱B(金炳旭),이헌승(李憲昇),76,146,222,0
9982,김병욱B(金炳旭),이형석(李炯錫),42,4,46,1
9983,김병욱B(金炳旭),인재근(印在謹),45,9,54,1
9984,김병욱B(金炳旭),임병헌(林炳憲),33,79,112,0
9985,김병욱B(金炳旭),임오경(林五卿),42,6,48,1
9986,김병욱B(金炳旭),임이자(林利子),127,155,282,0
9987,김병욱B(金炳旭),임종성(林鍾聲),42,7,49,1
9988,김병욱B(金炳旭),임호선(林昊宣),44,6,50,1
9989,김병욱B(金炳旭),장경태(張耿態),43,6,49,1
9990,김병욱B(金炳旭),장동혁(張東赫),30,59,89,0
9991,김병욱B(金炳旭),장제원(張濟元),58,49,107,0
9992,김병욱B(金炳旭),장철민(張喆敏),42,12,54,1
9993,김병욱B(金炳旭),장혜영(張惠英),1,4,5,1
9994,김병욱B(金炳旭),전봉민(田奉珉),64,93,157,0
9995,김병욱B(金炳旭),전용기(田溶冀),42,5,47,1
9996,김병욱B(金炳旭),전재수(田載秀),42,4,46,1
9997,김병욱B(金炳旭),전주혜(全珠惠),72,100,172,0
9998,김병욱B(金炳旭),전해철(全海澈),43,4,47,1
9999,김병욱B(金炳旭),전혜숙(全惠淑),43,8,51,1
10000,김병욱B(金炳旭),정경희(丁慶姬),79,115,194,0
10001,김병욱B(金炳旭),정동만(鄭東萬),83,143,226,0
10002,김병욱B(金炳旭),정성호(鄭成湖),44,4,48,1
10003,김병욱B(金炳旭),정우택(鄭宇澤),38,91,129,0
10004,김병욱B(金炳旭),정운천(鄭雲天),92,145,237,0
10005,김병욱B(金炳旭),정일영(鄭日永),42,8,50,1
10006,김병욱B(金炳旭),정점식(鄭点植),67,52,119,0
10007,김병욱B(金炳旭),정진석(鄭鎭碩),96,119,215,0
10008,김병욱B(金炳旭),정청래(鄭淸來),43,4,47,1
10009,김병욱B(金炳旭),정춘숙(鄭春淑),43,4,47,1
10010,김병욱B(金炳旭),정태호(鄭泰浩),42,4,46,1
10011,김병욱B(金炳旭),정필모(鄭必模),42,4,46,1
10012,김병욱B(金炳旭),정희용(鄭熙溶),118,207,325,0
10013,김병욱B(金炳旭),조경태(趙慶泰),87,130,217,0
10014,김병욱B(金炳旭),조명희(曺明姬),93,164,257,0
10015,김병욱B(金炳旭),조수진(趙修眞),81,147,228,0
10016,김병욱B(金炳旭),조승래(趙承來),42,7,49,1
10017,김병욱B(金炳旭),조오섭(曺五燮),44,8,52,1
10018,김병욱B(金炳旭),조은희(趙恩禧),36,68,104,0
10019,김병욱B(金炳旭),조응천(趙應天),42,3,45,1
10020,김병욱B(金炳旭),조정식(趙正湜),42,4,46,1
10021,김병욱B(金炳旭),조정훈(趙廷訓),3,5,8,1
10022,김병욱B(金炳旭),조해진(曺海珍),67,56,123,0
10023,김병욱B(金炳旭),주철현(朱哲鉉),43,9,52,1
10024,김병욱B(金炳旭),주호영(朱豪英),84,117,201,0
10025,김병욱B(金炳旭),지성호(池成浩),104,198,302,0
10026,김병욱B(金炳旭),진선미(陳善美),42,4,46,1
10027,김병욱B(金炳旭),진성준(陳聲準),44,6,50,1
10028,김병욱B(金炳旭),천준호(千俊鎬),42,4,46,1
10029,김병욱B(金炳旭),최기상(崔基相),42,4,46,1
10030,김병욱B(金炳旭),최승재(崔承宰),93,104,197,0
10031,김병욱B(金炳旭),최연숙(崔姸淑),50,89,139,0
10032,김병욱B(金炳旭),최영희(崔英姬),36,80,116,0
10033,김병욱B(金炳旭),최인호(崔仁昊),43,4,47,1
10034,김병욱B(金炳旭),최재형(崔在亨),29,15,44,0
10035,김병욱B(金炳旭),최종윤(崔鍾允),42,4,46,1
10036,김병욱B(金炳旭),최춘식(崔春植),86,139,225,0
10037,김병욱B(金炳旭),최형두(崔炯斗),89,79,168,0
10038,김병욱B(金炳旭),최혜영(崔惠英),42,7,49,1
10039,김병욱B(金炳旭),추경호(秋慶鎬),148,193,341,0
10040,김병욱B(金炳旭),태영호(太永浩),127,254,381,0
10041,김병욱B(金炳旭),하영제(河榮帝),82,148,230,1
10042,김병욱B(金炳旭),하태경(河泰慶),68,74,142,0
10043,김병욱B(金炳旭),한기호(韓起鎬),72,87,159,0
10044,김병욱B(金炳旭),한무경(韓茂景),137,247,384,0
10045,김병욱B(金炳旭),한병도(韓秉道),42,6,48,1
10046,김병욱B(金炳旭),한정애(韓貞愛),42,9,51,1
10047,김병욱B(金炳旭),한준호(韓俊鎬),43,4,47,1
10048,김병욱B(金炳旭),허숙정(許淑湞),0,0,0,1
10049,김병욱B(金炳旭),허영(許榮),42,6,48,1
10050,김병욱B(金炳旭),허은아(許垠娥),97,131,228,0
10051,김병욱B(金炳旭),허종식(許琮植),43,24,67,1
10052,김병욱B(金炳旭),홍기원(洪起元),43,10,53,1
10053,김병욱B(金炳旭),홍문표(洪文杓),79,115,194,0
10054,김병욱B(金炳旭),홍석준(洪碩晙),73,115,188,0
10055,김병욱B(金炳旭),홍성국(洪性國),42,8,50,1
10056,김병욱B(金炳旭),홍영표(洪永杓),43,9,52,1
10057,김병욱B(金炳旭),홍익표(洪翼杓),42,4,46,1
10058,김병욱B(金炳旭),홍정민(洪貞敏),44,6,50,1
10059,김병욱B(金炳旭),황보승희(皇甫承希),90,159,249,1
10060,김병욱B(金炳旭),황운하(黃雲夏),43,5,48,1
10061,김병욱B(金炳旭),황희(黃熙),42,8,50,1
10062,김병주(金柄周),김상훈(金相勳),55,4,59,1
10063,김병주(金柄周),김상희(金相姬),87,48,135,0
10064,김병주(金柄周),김석기(金碩基),53,3,56,1
10065,김병주(金柄周),김성원(金成願),54,4,58,1
10066,김병주(金柄周),김성주(金成柱),88,41,129,0
10067,김병주(金柄周),김성환(金星煥),85,46,131,0
10068,김병주(金柄周),김수흥(金洙興),94,55,149,0
10069,김병주(金柄周),김승남(金承南),87,80,167,0
10070,김병주(金柄周),김승수(金承洙),52,3,55,1
10071,김병주(金柄周),김승원(金勝源),98,89,187,0
10072,김병주(金柄周),김영배(金永培),98,68,166,0
10073,김병주(金柄周),김영선(金映宣),26,3,29,1
10074,김병주(金柄周),김영식(金英植),52,4,56,1
10075,김병주(金柄周),김영주(金榮珠),86,58,144,0
10076,김병주(金柄周),김영진(金榮鎭),81,32,113,0
10077,김병주(金柄周),김영호(金映豪),88,46,134,0
10078,김병주(金柄周),김예지(金睿智),53,3,56,1
10079,김병주(金柄周),김용민(金容民),86,44,130,0
10080,김병주(金柄周),김용판(金用判),53,3,56,1
10081,김병주(金柄周),김웅(金雄),51,4,55,1
10082,김병주(金柄周),김원이(金元二),85,40,125,0
10083,김병주(金柄周),김윤덕(金潤德),87,38,125,0
10084,김병주(金柄周),김의겸(金宜謙),49,39,88,0
10085,김병주(金柄周),김정재(金汀才),54,4,58,1
10086,김병주(金柄周),김정호(金禎鎬),101,94,195,0
10087,김병주(金柄周),김종민(金鐘民),81,50,131,0
10088,김병주(金柄周),김주영(金周暎),98,76,174,0
10089,김병주(金柄周),김진표(金振杓),64,67,131,1
10090,김병주(金柄周),김철민(金哲玟),86,46,132,0
10091,김병주(金柄周),김태년(金太年),77,37,114,0
10092,김병주(金柄周),김태호(金台鎬),41,3,44,1
10093,김병주(金柄周),김학용(金學容),26,3,29,1
10094,김병주(金柄周),김한규(金翰奎),45,33,78,0
10095,김병주(金柄周),김한정(金漢正),78,35,113,0
10096,김병주(金柄周),김형동(金亨東),54,4,58,1
10097,김병주(金柄周),김홍걸(金弘傑),41,89,130,0
10098,김병주(金柄周),김회재(金會在),87,53,140,0
10099,김병주(金柄周),김희곤(金熙坤),50,3,53,1
10100,김병주(金柄周),김희국(金熙國),51,3,54,1
10101,김병주(金柄周),남인순(南仁順),84,45,129,0
10102,김병주(金柄周),노용호(魯容昊),26,3,29,1
10103,김병주(金柄周),노웅래(盧雄來),85,59,144,0
10104,김병주(金柄周),도종환(都鍾煥),84,39,123,0
10105,김병주(金柄周),류성걸(柳性杰),49,3,52,1
10106,김병주(金柄周),류호정(柳好貞),16,11,27,1
10107,김병주(金柄周),맹성규(孟聖奎),84,54,138,0
10108,김병주(金柄周),문정복(文貞福),82,44,126,0
10109,김병주(金柄周),문진석(文振碩),85,61,146,0
10110,김병주(金柄周),민병덕(閔炳德),84,80,164,0
10111,김병주(金柄周),민형배(閔馨培),71,79,150,0
10112,김병주(金柄周),민홍철(閔洪喆),87,66,153,0
10113,김병주(金柄周),박광온(朴洸瑥),79,45,124,0
10114,김병주(金柄周),박대수(朴大壽),50,3,53,1
10115,김병주(金柄周),박대출(朴大出),52,3,55,1
10116,김병주(金柄周),박덕흠(朴德欽),36,4,40,1
10117,김병주(金柄周),박범계(朴範界),75,32,107,0
10118,김병주(金柄周),박병석(朴炳錫),40,18,58,0
10119,김병주(金柄周),박상혁(朴商赫),78,47,125,0
10120,김병주(金柄周),박성민(朴聖敏),52,3,55,1
10121,김병주(金柄周),박성준(朴省俊),94,78,172,0
10122,김병주(金柄周),박성중(朴成重),49,5,54,1
10123,김병주(金柄周),박수영(朴洙瑩),50,4,54,1
10124,김병주(金柄周),박영순(朴英淳),84,61,145,0
10125,김병주(金柄周),박완주(朴完柱),41,34,75,1
10126,김병주(金柄周),박용진(朴用鎭),75,34,109,0
10127,김병주(金柄周),박재호(朴在昊),81,53,134,0
10128,김병주(金柄周),박정(朴釘),83,63,146,0
10129,김병주(金柄周),박정하(朴正河),26,3,29,1
10130,김병주(金柄周),박주민(朴柱民),79,38,117,0
10131,김병주(金柄周),박진(朴振),50,4,54,1
10132,김병주(金柄周),박찬대(朴贊大),81,44,125,0
10133,김병주(金柄周),박형수(朴亨修),50,3,53,1
10134,김병주(金柄周),박홍근(朴洪根),87,58,145,0
10135,김병주(金柄周),배준영(裵俊英),49,3,52,1
10136,김병주(金柄周),배진교(裵晋敎),15,10,25,1
10137,김병주(金柄周),배현진(裵賢鎭),50,4,54,1
10138,김병주(金柄周),백종헌(白宗憲),52,4,56,1
10139,김병주(金柄周),백혜련(白惠蓮),88,37,125,0
10140,김병주(金柄周),변재일(卞在一),80,35,115,0
10141,김병주(金柄周),서동용(徐東榕),82,52,134,0
10142,김병주(金柄周),서범수(徐範洙),51,3,54,1
10143,김병주(金柄周),서병수(徐秉洙),53,3,56,1
10144,김병주(金柄周),서삼석(徐參錫),83,44,127,0
10145,김병주(金柄周),서영교(徐瑛敎),93,70,163,0
10146,김병주(金柄周),서영석(徐暎錫),88,51,139,0
10147,김병주(金柄周),서일준(徐一俊),52,3,55,1
10148,김병주(金柄周),서정숙(徐正淑),50,4,54,1
10149,김병주(金柄周),설훈(薛勳),87,78,165,0
10150,김병주(金柄周),성일종(成一鍾),54,7,61,1
10151,김병주(金柄周),소병철(蘇秉哲),84,71,155,0
10152,김병주(金柄周),소병훈(蘇秉勳),84,50,134,0
10153,김병주(金柄周),송갑석(宋甲錫),95,81,176,0
10154,김병주(金柄周),송기헌(宋基憲),83,50,133,0
10155,김병주(金柄周),송석준(宋錫俊),50,3,53,1
10156,김병주(金柄周),송언석(宋彦錫),46,3,49,1
10157,김병주(金柄周),송옥주(宋玉珠),85,63,148,0
10158,김병주(金柄周),송재호(宋在祜),94,57,151,0
10159,김병주(金柄周),신동근(申東根),80,44,124,0
10160,김병주(金柄周),신영대(申榮大),77,40,117,0
10161,김병주(金柄周),신원식(申源湜),55,4,59,1
10162,김병주(金柄周),신정훈(辛正勳),97,82,179,0
10163,김병주(金柄周),신현영(申賢榮),121,96,217,0
10164,김병주(金柄周),심상정(沈相奵),15,8,23,1
10165,김병주(金柄周),안규백(安圭伯),110,79,189,0
10166,김병주(金柄周),안민석(安敏錫),83,43,126,0
10167,김병주(金柄周),안병길(安炳吉),50,3,53,1
10168,김병주(金柄周),안철수(安哲秀),27,3,30,1
10169,김병주(金柄周),안호영(安浩永),80,61,141,0
10170,김병주(金柄周),양경숙(梁敬淑),87,78,165,0
10171,김병주(金柄周),양금희(梁琴喜),52,4,56,1
10172,김병주(金柄周),양기대(梁基大),88,67,155,0
10173,김병주(金柄周),양이원영(梁李媛瑛),79,46,125,0
10174,김병주(金柄周),양정숙(梁貞淑),34,78,112,1
10175,김병주(金柄周),양향자(梁香子),40,36,76,1
10176,김병주(金柄周),어기구(魚基龜),76,41,117,0
10177,김병주(金柄周),엄태영(嚴泰永),50,3,53,1
10178,김병주(金柄周),오기형(吳奇炯),96,45,141,0
10179,김병주(金柄周),오영환(吳永煥),146,169,315,0
10180,김병주(金柄周),용혜인(龍慧仁),12,15,27,1
10181,김병주(金柄周),우상호(禹相虎),75,33,108,0
10182,김병주(金柄周),우원식(禹元植),88,52,140,0
10183,김병주(金柄周),위성곤(魏聖坤),84,75,159,0
10184,김병주(金柄周),유경준(兪京濬),49,3,52,1
10185,김병주(金柄周),유기홍(柳基洪),77,39,116,0
10186,김병주(金柄周),유동수(柳東秀),79,42,121,0
10187,김병주(金柄周),유상범(劉相凡),52,4,56,1
10188,김병주(金柄周),유의동(兪義東),50,3,53,1
10189,김병주(金柄周),유정주(兪訂炷),92,84,176,0
10190,김병주(金柄周),윤건영(尹建永),86,63,149,0
10191,김병주(金柄周),윤관석(尹官石),66,34,100,1
10192,김병주(金柄周),윤두현(尹斗鉉),51,3,54,1
10193,김병주(金柄周),윤미향(尹美香),37,30,67,1
10194,김병주(金柄周),윤상현(尹相現),32,3,35,1
10195,김병주(金柄周),윤영덕(尹永德),91,77,168,0
10196,김병주(金柄周),윤영석(尹永碩),50,3,53,1
10197,김병주(金柄周),윤영찬(尹永燦),80,41,121,0
10198,김병주(金柄周),윤재갑(尹才鉀),92,82,174,0
10199,김병주(金柄周),윤재옥(尹在玉),50,3,53,1
10200,김병주(金柄周),윤주경(尹柱卿),53,5,58,1
10201,김병주(金柄周),윤준병(尹準炳),88,109,197,0
10202,김병주(金柄周),윤창현(尹暢賢),52,4,56,1
10203,김병주(金柄周),윤한홍(尹漢洪),52,3,55,1
10204,김병주(金柄周),윤호중(尹昊重),78,39,117,0
10205,김병주(金柄周),윤후덕(尹厚德),85,55,140,0
10206,김병주(金柄周),이개호(李介昊),79,48,127,0
10207,김병주(金柄周),이달곤(李達坤),52,6,58,1
10208,김병주(金柄周),이동주(李東洲),78,47,125,0
10209,김병주(金柄周),이만희(李晩熙),50,3,53,1
10210,김병주(金柄周),이명수(李明洙),52,5,57,1
10211,김병주(金柄周),이병훈(李炳勳),94,102,196,0
10212,김병주(金柄周),이상민(李相珉),74,33,107,0
10213,김병주(金柄周),이상헌(李相憲),85,65,150,0
10214,김병주(金柄周),이성만(李成萬),96,75,171,1
10215,김병주(金柄周),이소영(李素永),86,40,126,0
10216,김병주(金柄周),이수진(李壽珍),89,74,163,0
10217,김병주(金柄周),이수진(李秀眞),121,95,216,0
10218,김병주(金柄周),이양수(李亮壽),56,3,59,1
10219,김병주(金柄周),이용(李鏞),51,3,54,1
10220,김병주(金柄周),이용빈(李龍彬),90,75,165,0
10221,김병주(金柄周),이용선(李庸瑄),85,48,133,0
10222,김병주(金柄周),이용우(李龍雨),120,104,224,0
10223,김병주(金柄周),이용호(李容鎬),29,5,34,1
10224,김병주(金柄周),이원욱(李元旭),85,60,145,0
10225,김병주(金柄周),이원택(李源澤),127,107,234,0
10226,김병주(金柄周),이은주(李恩周),16,10,26,1
10227,김병주(金柄周),이인선(李仁善),25,3,28,1
10228,김병주(金柄周),이인영(李仁榮),75,37,112,0
10229,김병주(金柄周),이장섭(李將燮),82,39,121,0
10230,김병주(金柄周),이재명(李在明),40,21,61,0
10231,김병주(金柄周),이재정(李在汀),79,50,129,0
10232,김병주(金柄周),이정문(李楨文),82,41,123,0
10233,김병주(金柄周),이종배(李鍾培),52,4,56,1
10234,김병주(金柄周),이종성(李鍾成),51,3,54,1
10235,김병주(金柄周),이주환(李周桓),52,4,56,1
10236,김병주(金柄周),이채익(李埰益),54,4,58,1
10237,김병주(金柄周),이철규(李喆圭),53,5,58,1
10238,김병주(金柄周),이탄희(李誕熙),81,46,127,0
10239,김병주(金柄周),이태규(李泰珪),29,4,33,1
10240,김병주(金柄周),이학영(李學永),84,43,127,0
10241,김병주(金柄周),이해식(李海植),88,45,133,0
10242,김병주(金柄周),이헌승(李憲昇),52,6,58,1
10243,김병주(金柄周),이형석(李炯錫),98,60,158,0
10244,김병주(金柄周),인재근(印在謹),82,42,124,0
10245,김병주(金柄周),임병헌(林炳憲),27,5,32,1
10246,김병주(金柄周),임오경(林五卿),126,96,222,0
10247,김병주(金柄周),임이자(林利子),51,3,54,1
10248,김병주(金柄周),임종성(林鍾聲),89,55,144,0
10249,김병주(金柄周),임호선(林昊宣),145,148,293,0
10250,김병주(金柄周),장경태(張耿態),121,117,238,0
10251,김병주(金柄周),장동혁(張東赫),25,3,28,1
10252,김병주(金柄周),장제원(張濟元),49,3,52,1
10253,김병주(金柄周),장철민(張喆敏),117,96,213,0
10254,김병주(金柄周),장혜영(張惠英),12,5,17,1
10255,김병주(金柄周),전봉민(田奉珉),37,4,41,1
10256,김병주(金柄周),전용기(田溶冀),87,77,164,0
10257,김병주(金柄周),전재수(田載秀),76,46,122,0
10258,김병주(金柄周),전주혜(全珠惠),54,4,58,1
10259,김병주(金柄周),전해철(全海澈),74,34,108,0
10260,김병주(金柄周),전혜숙(全惠淑),81,72,153,0
10261,김병주(金柄周),정경희(丁慶姬),51,3,54,1
10262,김병주(金柄周),정동만(鄭東萬),50,3,53,1
10263,김병주(金柄周),정성호(鄭成湖),86,65,151,0
10264,김병주(金柄周),정우택(鄭宇澤),26,3,29,1
10265,김병주(金柄周),정운천(鄭雲天),50,3,53,1
10266,김병주(金柄周),정일영(鄭日永),83,68,151,0
10267,김병주(金柄周),정점식(鄭点植),50,3,53,1
10268,김병주(金柄周),정진석(鄭鎭碩),50,3,53,1
10269,김병주(金柄周),정청래(鄭淸來),127,104,231,0
10270,김병주(金柄周),정춘숙(鄭春淑),79,37,116,0
10271,김병주(金柄周),정태호(鄭泰浩),81,62,143,0
10272,김병주(金柄周),정필모(鄭必模),92,63,155,0
10273,김병주(金柄周),정희용(鄭熙溶),51,5,56,1
10274,김병주(金柄周),조경태(趙慶泰),52,3,55,1
10275,김병주(金柄周),조명희(曺明姬),52,4,56,1
10276,김병주(金柄周),조수진(趙修眞),52,3,55,1
10277,김병주(金柄周),조승래(趙承來),84,43,127,0
10278,김병주(金柄周),조오섭(曺五燮),88,65,153,0
10279,김병주(金柄周),조은희(趙恩禧),27,4,31,1
10280,김병주(金柄周),조응천(趙應天),72,30,102,0
10281,김병주(金柄周),조정식(趙正湜),75,34,109,0
10282,김병주(金柄周),조정훈(趙廷訓),0,5,5,1
10283,김병주(金柄周),조해진(曺海珍),52,4,56,1
10284,김병주(金柄周),주철현(朱哲鉉),139,145,284,0
10285,김병주(金柄周),주호영(朱豪英),50,4,54,1
10286,김병주(金柄周),지성호(池成浩),50,3,53,1
10287,김병주(金柄周),진선미(陳善美),81,37,118,0
10288,김병주(金柄周),진성준(陳聲準),83,53,136,0
10289,김병주(金柄周),천준호(千俊鎬),81,38,119,0
10290,김병주(金柄周),최기상(崔基相),82,45,127,0
10291,김병주(金柄周),최승재(崔承宰),50,5,55,1
10292,김병주(金柄周),최연숙(崔姸淑),31,6,37,1
10293,김병주(金柄周),최영희(崔英姬),26,3,29,1
10294,김병주(金柄周),최인호(崔仁昊),77,45,122,0
10295,김병주(金柄周),최재형(崔在亨),25,3,28,1
10296,김병주(金柄周),최종윤(崔鍾允),92,73,165,0
10297,김병주(金柄周),최춘식(崔春植),50,3,53,1
10298,김병주(金柄周),최형두(崔炯斗),51,10,61,1
10299,김병주(金柄周),최혜영(崔惠英),131,116,247,0
10300,김병주(金柄周),추경호(秋慶鎬),50,3,53,1
10301,김병주(金柄周),태영호(太永浩),50,4,54,1
10302,김병주(金柄周),하영제(河榮帝),42,2,44,1
10303,김병주(金柄周),하태경(河泰慶),51,4,55,1
10304,김병주(金柄周),한기호(韓起鎬),57,6,63,1
10305,김병주(金柄周),한무경(韓茂景),49,4,53,1
10306,김병주(金柄周),한병도(韓秉道),88,49,137,0
10307,김병주(金柄周),한정애(韓貞愛),77,35,112,0
10308,김병주(金柄周),한준호(韓俊鎬),123,115,238,0
10309,김병주(金柄周),허숙정(許淑湞),1,2,3,0
10310,김병주(金柄周),허영(許榮),102,78,180,0
10311,김병주(金柄周),허은아(許垠娥),50,4,54,1
10312,김병주(金柄周),허종식(許琮植),89,63,152,0
10313,김병주(金柄周),홍기원(洪起元),87,71,158,0
10314,김병주(金柄周),홍문표(洪文杓),50,8,58,1
10315,김병주(金柄周),홍석준(洪碩晙),50,3,53,1
10316,김병주(金柄周),홍성국(洪性國),140,139,279,0
10317,김병주(金柄周),홍영표(洪永杓),94,50,144,0
10318,김병주(金柄周),홍익표(洪翼杓),83,38,121,0
10319,김병주(金柄周),홍정민(洪貞敏),93,70,163,0
10320,김병주(金柄周),황보승희(皇甫承希),46,1,47,1
10321,김병주(金柄周),황운하(黃雲夏),86,64,150,0
10322,김병주(金柄周),황희(黃熙),78,36,114,0
10323,김상훈(金相勳),김상희(金相姬),52,5,57,1
10324,김상훈(金相勳),김석기(金碩基),115,157,272,0
10325,김상훈(金相勳),김성원(金成願),87,136,223,0
10326,김상훈(金相勳),김성주(金成柱),53,6,59,1
10327,김상훈(金相勳),김성환(金星煥),54,5,59,1
10328,김상훈(金相勳),김수흥(金洙興),54,10,64,1
10329,김상훈(金相勳),김승남(金承南),53,5,58,1
10330,김상훈(金相勳),김승수(金承洙),118,157,275,0
10331,김상훈(金相勳),김승원(金勝源),53,6,59,1
10332,김상훈(金相勳),김영배(金永培),52,5,57,1
10333,김상훈(金相勳),김영선(金映宣),32,53,85,0
10334,김상훈(金相勳),김영식(金英植),112,143,255,0
10335,김상훈(金相勳),김영주(金榮珠),54,5,59,1
10336,김상훈(金相勳),김영진(金榮鎭),54,4,58,1
10337,김상훈(金相勳),김영호(金映豪),52,6,58,1
10338,김상훈(金相勳),김예지(金睿智),138,182,320,0
10339,김상훈(金相勳),김용민(金容民),53,5,58,1
10340,김상훈(金相勳),김용판(金用判),142,183,325,0
10341,김상훈(金相勳),김웅(金雄),69,53,122,0
10342,김상훈(金相勳),김원이(金元二),53,6,59,1
10343,김상훈(金相勳),김윤덕(金潤德),55,7,62,1
10344,김상훈(金相勳),김의겸(金宜謙),26,6,32,1
10345,김상훈(金相勳),김정재(金汀才),102,126,228,0
10346,김상훈(金相勳),김정호(金禎鎬),54,6,60,1
10347,김상훈(金相勳),김종민(金鐘民),52,4,56,1
10348,김상훈(金相勳),김주영(金周暎),52,7,59,1
10349,김상훈(金相勳),김진표(金振杓),27,1,28,1
10350,김상훈(金相勳),김철민(金哲玟),51,4,55,1
10351,김상훈(金相勳),김태년(金太年),51,5,56,1
10352,김상훈(金相勳),김태호(金台鎬),68,73,141,0
10353,김상훈(金相勳),김학용(金學容),42,51,93,0
10354,김상훈(金相勳),김한규(金翰奎),26,5,31,1
10355,김상훈(金相勳),김한정(金漢正),50,5,55,1
10356,김상훈(金相勳),김형동(金亨東),100,116,216,0
10357,김상훈(金相勳),김홍걸(金弘傑),17,5,22,1
10358,김상훈(金相勳),김회재(金會在),52,5,57,1
10359,김상훈(金相勳),김희곤(金熙坤),82,138,220,0
10360,김상훈(金相勳),김희국(金熙國),95,91,186,0
10361,김상훈(金相勳),남인순(南仁順),50,8,58,1
10362,김상훈(金相勳),노용호(魯容昊),40,43,83,0
10363,김상훈(金相勳),노웅래(盧雄來),51,6,57,1
10364,김상훈(金相勳),도종환(都鍾煥),51,6,57,1
10365,김상훈(金相勳),류성걸(柳性杰),93,97,190,0
10366,김상훈(金相勳),류호정(柳好貞),8,10,18,1
10367,김상훈(金相勳),맹성규(孟聖奎),51,5,56,1
10368,김상훈(金相勳),문정복(文貞福),49,4,53,1
10369,김상훈(金相勳),문진석(文振碩),51,6,57,1
10370,김상훈(金相勳),민병덕(閔炳德),54,10,64,1
10371,김상훈(金相勳),민형배(閔馨培),35,6,41,1
10372,김상훈(金相勳),민홍철(閔洪喆),51,5,56,1
10373,김상훈(金相勳),박광온(朴洸瑥),51,5,56,1
10374,김상훈(金相勳),박대수(朴大壽),107,171,278,0
10375,김상훈(金相勳),박대출(朴大出),97,103,200,0
10376,김상훈(金相勳),박덕흠(朴德欽),67,135,202,0
10377,김상훈(金相勳),박범계(朴範界),50,4,54,1
10378,김상훈(金相勳),박병석(朴炳錫),26,4,30,1
10379,김상훈(金相勳),박상혁(朴商赫),51,5,56,1
10380,김상훈(金相勳),박성민(朴聖敏),89,128,217,0
10381,김상훈(金相勳),박성준(朴省俊),51,6,57,1
10382,김상훈(金相勳),박성중(朴成重),77,76,153,0
10383,김상훈(金相勳),박수영(朴洙瑩),78,54,132,0
10384,김상훈(金相勳),박영순(朴英淳),52,4,56,1
10385,김상훈(金相勳),박완주(朴完柱),25,0,25,1
10386,김상훈(金相勳),박용진(朴用鎭),50,7,57,1
10387,김상훈(金相勳),박재호(朴在昊),53,6,59,1
10388,김상훈(金相勳),박정(朴釘),51,6,57,1
10389,김상훈(金相勳),박정하(朴正河),38,43,81,0
10390,김상훈(金相勳),박주민(朴柱民),51,6,57,1
10391,김상훈(金相勳),박진(朴振),80,88,168,0
10392,김상훈(金相勳),박찬대(朴贊大),52,5,57,1
10393,김상훈(金相勳),박형수(朴亨修),81,84,165,0
10394,김상훈(金相勳),박홍근(朴洪根),51,6,57,1
10395,김상훈(金相勳),배준영(裵俊英),102,109,211,0
10396,김상훈(金相勳),배진교(裵晋敎),7,7,14,1
10397,김상훈(金相勳),배현진(裵賢鎭),78,51,129,0
10398,김상훈(金相勳),백종헌(白宗憲),92,128,220,0
10399,김상훈(金相勳),백혜련(白惠蓮),51,5,56,1
10400,김상훈(金相勳),변재일(卞在一),51,6,57,1
10401,김상훈(金相勳),서동용(徐東榕),51,5,56,1
10402,김상훈(金相勳),서범수(徐範洙),78,83,161,0
10403,김상훈(金相勳),서병수(徐秉洙),90,103,193,0
10404,김상훈(金相勳),서삼석(徐參錫),50,7,57,1
10405,김상훈(金相勳),서영교(徐瑛敎),53,6,59,1
10406,김상훈(金相勳),서영석(徐暎錫),51,6,57,1
10407,김상훈(金相勳),서일준(徐一俊),106,137,243,0
10408,김상훈(金相勳),서정숙(徐正淑),78,78,156,0
10409,김상훈(金相勳),설훈(薛勳),52,6,58,1
10410,김상훈(金相勳),성일종(成一鍾),116,134,250,0
10411,김상훈(金相勳),소병철(蘇秉哲),52,5,57,1
10412,김상훈(金相勳),소병훈(蘇秉勳),56,7,63,1
10413,김상훈(金相勳),송갑석(宋甲錫),51,5,56,1
10414,김상훈(金相勳),송기헌(宋基憲),51,5,56,1
10415,김상훈(金相勳),송석준(宋錫俊),82,110,192,0
10416,김상훈(金相勳),송언석(宋彦錫),95,110,205,0
10417,김상훈(金相勳),송옥주(宋玉珠),51,4,55,1
10418,김상훈(金相勳),송재호(宋在祜),51,5,56,1
10419,김상훈(金相勳),신동근(申東根),51,5,56,1
10420,김상훈(金相勳),신영대(申榮大),51,6,57,1
10421,김상훈(金相勳),신원식(申源湜),86,95,181,0
10422,김상훈(金相勳),신정훈(辛正勳),52,5,57,1
10423,김상훈(金相勳),신현영(申賢榮),50,5,55,1
10424,김상훈(金相勳),심상정(沈相奵),7,6,13,1
10425,김상훈(金相勳),안규백(安圭伯),54,9,63,1
10426,김상훈(金相勳),안민석(安敏錫),51,4,55,1
10427,김상훈(金相勳),안병길(安炳吉),90,104,194,0
10428,김상훈(金相勳),안철수(安哲秀),29,35,64,0
10429,김상훈(金相勳),안호영(安浩永),51,7,58,1
10430,김상훈(金相勳),양경숙(梁敬淑),52,5,57,1
10431,김상훈(金相勳),양금희(梁琴喜),124,146,270,0
10432,김상훈(金相勳),양기대(梁基大),51,5,56,1
10433,김상훈(金相勳),양이원영(梁李媛瑛),46,5,51,1
10434,김상훈(金相勳),양정숙(梁貞淑),6,12,18,1
10435,김상훈(金相勳),양향자(梁香子),21,7,28,1
10436,김상훈(金相勳),어기구(魚基龜),51,5,56,1
10437,김상훈(金相勳),엄태영(嚴泰永),93,103,196,0
10438,김상훈(金相勳),오기형(吳奇炯),49,4,53,1
10439,김상훈(金相勳),오영환(吳永煥),51,8,59,1
10440,김상훈(金相勳),용혜인(龍慧仁),2,6,8,1
10441,김상훈(金相勳),우상호(禹相虎),50,4,54,1
10442,김상훈(金相勳),우원식(禹元植),50,5,55,1
10443,김상훈(金相勳),위성곤(魏聖坤),51,5,56,1
10444,김상훈(金相勳),유경준(兪京濬),102,106,208,0
10445,김상훈(金相勳),유기홍(柳基洪),51,5,56,1
10446,김상훈(金相勳),유동수(柳東秀),53,5,58,1
10447,김상훈(金相勳),유상범(劉相凡),72,94,166,0
10448,김상훈(金相勳),유의동(兪義東),69,61,130,0
10449,김상훈(金相勳),유정주(兪訂炷),50,8,58,1
10450,김상훈(金相勳),윤건영(尹建永),50,5,55,1
10451,김상훈(金相勳),윤관석(尹官石),42,1,43,1
10452,김상훈(金相勳),윤두현(尹斗鉉),101,124,225,0
10453,김상훈(金相勳),윤미향(尹美香),20,0,20,1
10454,김상훈(金相勳),윤상현(尹相現),47,42,89,0
10455,김상훈(金相勳),윤영덕(尹永德),50,5,55,1
10456,김상훈(金相勳),윤영석(尹永碩),75,61,136,0
10457,김상훈(金相勳),윤영찬(尹永燦),50,5,55,1
10458,김상훈(金相勳),윤재갑(尹才鉀),53,12,65,1
10459,김상훈(金相勳),윤재옥(尹在玉),95,83,178,0
10460,김상훈(金相勳),윤주경(尹柱卿),68,91,159,0
10461,김상훈(金相勳),윤준병(尹準炳),51,6,57,1
10462,김상훈(金相勳),윤창현(尹暢賢),109,128,237,0
10463,김상훈(金相勳),윤한홍(尹漢洪),76,93,169,0
10464,김상훈(金相勳),윤호중(尹昊重),52,5,57,1
10465,김상훈(金相勳),윤후덕(尹厚德),51,5,56,1
10466,김상훈(金相勳),이개호(李介昊),51,5,56,1
10467,김상훈(金相勳),이달곤(李達坤),69,80,149,0
10468,김상훈(金相勳),이동주(李東洲),50,7,57,1
10469,김상훈(金相勳),이만희(李晩熙),84,99,183,0
10470,김상훈(金相勳),이명수(李明洙),91,163,254,0
10471,김상훈(金相勳),이병훈(李炳勳),53,7,60,1
10472,김상훈(金相勳),이상민(李相珉),51,5,56,1
10473,김상훈(金相勳),이상헌(李相憲),55,9,64,1
10474,김상훈(金相勳),이성만(李成萬),43,2,45,1
10475,김상훈(金相勳),이소영(李素永),52,5,57,1
10476,김상훈(金相勳),이수진(李壽珍),53,8,61,1
10477,김상훈(金相勳),이수진(李秀眞),51,7,58,1
10478,김상훈(金相勳),이양수(李亮壽),78,85,163,0
10479,김상훈(金相勳),이용(李鏞),83,114,197,0
10480,김상훈(金相勳),이용빈(李龍彬),54,10,64,1
10481,김상훈(金相勳),이용선(李庸瑄),51,5,56,1
10482,김상훈(金相勳),이용우(李龍雨),50,5,55,1
10483,김상훈(金相勳),이용호(李容鎬),35,31,66,0
10484,김상훈(金相勳),이원욱(李元旭),51,5,56,1
10485,김상훈(金相勳),이원택(李源澤),50,4,54,1
10486,김상훈(金相勳),이은주(李恩周),7,5,12,1
10487,김상훈(金相勳),이인선(李仁善),43,58,101,0
10488,김상훈(金相勳),이인영(李仁榮),51,5,56,1
10489,김상훈(金相勳),이장섭(李將燮),51,5,56,1
10490,김상훈(金相勳),이재명(李在明),26,5,31,1
10491,김상훈(金相勳),이재정(李在汀),51,5,56,1
10492,김상훈(金相勳),이정문(李楨文),50,4,54,1
10493,김상훈(金相勳),이종배(李鍾培),125,142,267,0
10494,김상훈(金相勳),이종성(李鍾成),100,138,238,0
10495,김상훈(金相勳),이주환(李周桓),96,104,200,0
10496,김상훈(金相勳),이채익(李埰益),88,102,190,0
10497,김상훈(金相勳),이철규(李喆圭),78,62,140,0
10498,김상훈(金相勳),이탄희(李誕熙),51,5,56,1
10499,김상훈(金相勳),이태규(李泰珪),51,63,114,0
10500,김상훈(金相勳),이학영(李學永),50,5,55,1
10501,김상훈(金相勳),이해식(李海植),52,5,57,1
10502,김상훈(金相勳),이헌승(李憲昇),73,99,172,0
10503,김상훈(金相勳),이형석(李炯錫),50,5,55,1
10504,김상훈(金相勳),인재근(印在謹),53,7,60,1
10505,김상훈(金相勳),임병헌(林炳憲),49,87,136,0
10506,김상훈(金相勳),임오경(林五卿),51,5,56,1
10507,김상훈(金相勳),임이자(林利子),86,91,177,0
10508,김상훈(金相勳),임종성(林鍾聲),53,5,58,1
10509,김상훈(金相勳),임호선(林昊宣),51,6,57,1
10510,김상훈(金相勳),장경태(張耿態),51,8,59,1
10511,김상훈(金相勳),장동혁(張東赫),32,41,73,0
10512,김상훈(金相勳),장제원(張濟元),66,44,110,0
10513,김상훈(金相勳),장철민(張喆敏),51,5,56,1
10514,김상훈(金相勳),장혜영(張惠英),9,5,14,1
10515,김상훈(金相勳),전봉민(田奉珉),57,69,126,0
10516,김상훈(金相勳),전용기(田溶冀),50,5,55,1
10517,김상훈(金相勳),전재수(田載秀),50,4,54,1
10518,김상훈(金相勳),전주혜(全珠惠),80,103,183,0
10519,김상훈(金相勳),전해철(全海澈),52,5,57,1
10520,김상훈(金相勳),전혜숙(全惠淑),52,5,57,1
10521,김상훈(金相勳),정경희(丁慶姬),89,82,171,0
10522,김상훈(金相勳),정동만(鄭東萬),81,79,160,0
10523,김상훈(金相勳),정성호(鄭成湖),54,8,62,1
10524,김상훈(金相勳),정우택(鄭宇澤),58,92,150,0
10525,김상훈(金相勳),정운천(鄭雲天),77,88,165,0
10526,김상훈(金相勳),정일영(鄭日永),50,6,56,1
10527,김상훈(金相勳),정점식(鄭点植),75,53,128,0
10528,김상훈(金相勳),정진석(鄭鎭碩),93,88,181,0
10529,김상훈(金相勳),정청래(鄭淸來),50,5,55,1
10530,김상훈(金相勳),정춘숙(鄭春淑),51,7,58,1
10531,김상훈(金相勳),정태호(鄭泰浩),51,6,57,1
10532,김상훈(金相勳),정필모(鄭必模),51,5,56,1
10533,김상훈(金相勳),정희용(鄭熙溶),101,105,206,0
10534,김상훈(金相勳),조경태(趙慶泰),89,78,167,0
10535,김상훈(金相勳),조명희(曺明姬),120,147,267,0
10536,김상훈(金相勳),조수진(趙修眞),119,151,270,0
10537,김상훈(金相勳),조승래(趙承來),51,7,58,1
10538,김상훈(金相勳),조오섭(曺五燮),52,7,59,1
10539,김상훈(金相勳),조은희(趙恩禧),46,45,91,0
10540,김상훈(金相勳),조응천(趙應天),50,3,53,1
10541,김상훈(金相勳),조정식(趙正湜),50,4,54,1
10542,김상훈(金相勳),조정훈(趙廷訓),3,11,14,1
10543,김상훈(金相勳),조해진(曺海珍),69,59,128,0
10544,김상훈(金相勳),주철현(朱哲鉉),53,7,60,1
10545,김상훈(金相勳),주호영(朱豪英),72,73,145,0
10546,김상훈(金相勳),지성호(池成浩),90,151,241,0
10547,김상훈(金相勳),진선미(陳善美),51,5,56,1
10548,김상훈(金相勳),진성준(陳聲準),51,6,57,1
10549,김상훈(金相勳),천준호(千俊鎬),50,4,54,1
10550,김상훈(金相勳),최기상(崔基相),50,5,55,1
10551,김상훈(金相勳),최승재(崔承宰),92,89,181,0
10552,김상훈(金相勳),최연숙(崔姸淑),50,71,121,0
10553,김상훈(金相勳),최영희(崔英姬),36,52,88,0
10554,김상훈(金相勳),최인호(崔仁昊),52,7,59,1
10555,김상훈(金相勳),최재형(崔在亨),28,17,45,0
10556,김상훈(金相勳),최종윤(崔鍾允),52,7,59,1
10557,김상훈(金相勳),최춘식(崔春植),104,112,216,0
10558,김상훈(金相勳),최형두(崔炯斗),81,75,156,0
10559,김상훈(金相勳),최혜영(崔惠英),51,13,64,1
10560,김상훈(金相勳),추경호(秋慶鎬),122,121,243,0
10561,김상훈(金相勳),태영호(太永浩),118,171,289,0
10562,김상훈(金相勳),하영제(河榮帝),84,119,203,1
10563,김상훈(金相勳),하태경(河泰慶),67,54,121,0
10564,김상훈(金相勳),한기호(韓起鎬),67,59,126,0
10565,김상훈(金相勳),한무경(韓茂景),89,118,207,0
10566,김상훈(金相勳),한병도(韓秉道),52,7,59,1
10567,김상훈(金相勳),한정애(韓貞愛),51,5,56,1
10568,김상훈(金相勳),한준호(韓俊鎬),52,6,58,1
10569,김상훈(金相勳),허숙정(許淑湞),0,0,0,1
10570,김상훈(金相勳),허영(許榮),52,6,58,1
10571,김상훈(金相勳),허은아(許垠娥),72,59,131,0
10572,김상훈(金相勳),허종식(許琮植),52,8,60,1
10573,김상훈(金相勳),홍기원(洪起元),51,5,56,1
10574,김상훈(金相勳),홍문표(洪文杓),88,76,164,0
10575,김상훈(金相勳),홍석준(洪碩晙),83,87,170,0
10576,김상훈(金相勳),홍성국(洪性國),51,5,56,1
10577,김상훈(金相勳),홍영표(洪永杓),51,5,56,1
10578,김상훈(金相勳),홍익표(洪翼杓),51,5,56,1
10579,김상훈(金相勳),홍정민(洪貞敏),51,5,56,1
10580,김상훈(金相勳),황보승희(皇甫承希),80,105,185,1
10581,김상훈(金相勳),황운하(黃雲夏),51,10,61,1
10582,김상훈(金相勳),황희(黃熙),50,5,55,1
10583,김상희(金相姬),김석기(金碩基),51,4,55,1
10584,김상희(金相姬),김성원(金成願),51,5,56,1
10585,김상희(金相姬),김성주(金成柱),98,72,170,0
10586,김상희(金相姬),김성환(金星煥),91,66,157,0
10587,김상희(金相姬),김수흥(金洙興),98,72,170,0
10588,김상희(金相姬),김승남(金承南),95,80,175,0
10589,김상희(金相姬),김승수(金承洙),54,10,64,1
10590,김상희(金相姬),김승원(金勝源),118,110,228,0
10591,김상희(金相姬),김영배(金永培),101,85,186,0
10592,김상희(金相姬),김영선(金映宣),26,4,30,1
10593,김상희(金相姬),김영식(金英植),51,5,56,1
10594,김상희(金相姬),김영주(金榮珠),92,93,185,0
10595,김상희(金相姬),김영진(金榮鎭),92,75,167,0
10596,김상희(金相姬),김영호(金映豪),89,55,144,0
10597,김상희(金相姬),김예지(金睿智),54,8,62,1
10598,김상희(金相姬),김용민(金容民),93,89,182,0
10599,김상희(金相姬),김용판(金用判),51,5,56,1
10600,김상희(金相姬),김웅(金雄),52,4,56,1
10601,김상희(金相姬),김원이(金元二),102,119,221,0
10602,김상희(金相姬),김윤덕(金潤德),98,73,171,0
10603,김상희(金相姬),김의겸(金宜謙),50,77,127,0
10604,김상희(金相姬),김정재(金汀才),52,5,57,1
10605,김상희(金相姬),김정호(金禎鎬),111,152,263,0
10606,김상희(金相姬),김종민(金鐘民),80,82,162,0
10607,김상희(金相姬),김주영(金周暎),104,102,206,0
10608,김상희(金相姬),김진표(金振杓),46,45,91,1
10609,김상희(金相姬),김철민(金哲玟),98,100,198,0
10610,김상희(金相姬),김태년(金太年),79,61,140,0
10611,김상희(金相姬),김태호(金台鎬),40,6,46,1
10612,김상희(金相姬),김학용(金學容),25,5,30,1
10613,김상희(金相姬),김한규(金翰奎),43,52,95,0
10614,김상희(金相姬),김한정(金漢正),77,58,135,0
10615,김상희(金相姬),김형동(金亨東),50,5,55,1
10616,김상희(金相姬),김홍걸(金弘傑),40,129,169,0
10617,김상희(金相姬),김회재(金會在),95,55,150,0
10618,김상희(金相姬),김희곤(金熙坤),49,5,54,1
10619,김상희(金相姬),김희국(金熙國),49,4,53,1
10620,김상희(金相姬),남인순(南仁順),118,148,266,0
10621,김상희(金相姬),노용호(魯容昊),25,4,29,1
10622,김상희(金相姬),노웅래(盧雄來),89,80,169,0
10623,김상희(金相姬),도종환(都鍾煥),87,75,162,0
10624,김상희(金相姬),류성걸(柳性杰),49,4,53,1
10625,김상희(金相姬),류호정(柳好貞),27,64,91,1
10626,김상희(金相姬),맹성규(孟聖奎),89,80,169,0
10627,김상희(金相姬),문정복(文貞福),85,74,159,0
10628,김상희(金相姬),문진석(文振碩),93,96,189,0
10629,김상희(金相姬),민병덕(閔炳德),93,140,233,0
10630,김상희(金相姬),민형배(閔馨培),73,123,196,0
10631,김상희(金相姬),민홍철(閔洪喆),78,55,133,0
10632,김상희(金相姬),박광온(朴洸瑥),85,77,162,0
10633,김상희(金相姬),박대수(朴大壽),51,8,59,1
10634,김상희(金相姬),박대출(朴大出),49,4,53,1
10635,김상희(金相姬),박덕흠(朴德欽),35,7,42,1
10636,김상희(金相姬),박범계(朴範界),78,44,122,0
10637,김상희(金相姬),박병석(朴炳錫),42,27,69,0
10638,김상희(金相姬),박상혁(朴商赫),94,97,191,0
10639,김상희(金相姬),박성민(朴聖敏),50,5,55,1
10640,김상희(金相姬),박성준(朴省俊),107,106,213,0
10641,김상희(金相姬),박성중(朴成重),49,4,53,1
10642,김상희(金相姬),박수영(朴洙瑩),49,4,53,1
10643,김상희(金相姬),박영순(朴英淳),99,75,174,0
10644,김상희(金相姬),박완주(朴完柱),45,44,89,1
10645,김상희(金相姬),박용진(朴用鎭),78,56,134,0
10646,김상희(金相姬),박재호(朴在昊),90,62,152,0
10647,김상희(金相姬),박정(朴釘),89,87,176,0
10648,김상희(金相姬),박정하(朴正河),25,5,30,1
10649,김상희(金相姬),박주민(朴柱民),84,82,166,0
10650,김상희(金相姬),박진(朴振),49,4,53,1
10651,김상희(金相姬),박찬대(朴贊大),90,55,145,0
10652,김상희(金相姬),박형수(朴亨修),49,4,53,1
10653,김상희(金相姬),박홍근(朴洪根),102,135,237,0
10654,김상희(金相姬),배준영(裵俊英),49,5,54,1
10655,김상희(金相姬),배진교(裵晋敎),17,44,61,1
10656,김상희(金相姬),배현진(裵賢鎭),50,5,55,1
10657,김상희(金相姬),백종헌(白宗憲),50,5,55,1
10658,김상희(金相姬),백혜련(白惠蓮),92,82,174,0
10659,김상희(金相姬),변재일(卞在一),82,67,149,0
10660,김상희(金相姬),서동용(徐東榕),87,86,173,0
10661,김상희(金相姬),서범수(徐範洙),51,6,57,1
10662,김상희(金相姬),서병수(徐秉洙),49,5,54,1
10663,김상희(金相姬),서삼석(徐參錫),87,60,147,0
10664,김상희(金相姬),서영교(徐瑛敎),95,126,221,0
10665,김상희(金相姬),서영석(徐暎錫),100,129,229,0
10666,김상희(金相姬),서일준(徐一俊),49,4,53,1
10667,김상희(金相姬),서정숙(徐正淑),49,7,56,1
10668,김상희(金相姬),설훈(薛勳),84,69,153,0
10669,김상희(金相姬),성일종(成一鍾),49,6,55,1
10670,김상희(金相姬),소병철(蘇秉哲),84,66,150,0
10671,김상희(金相姬),소병훈(蘇秉勳),87,86,173,0
10672,김상희(金相姬),송갑석(宋甲錫),93,90,183,0
10673,김상희(金相姬),송기헌(宋基憲),81,45,126,0
10674,김상희(金相姬),송석준(宋錫俊),51,6,57,1
10675,김상희(金相姬),송언석(宋彦錫),45,4,49,1
10676,김상희(金相姬),송옥주(宋玉珠),87,93,180,0
10677,김상희(金相姬),송재호(宋在祜),95,82,177,0
10678,김상희(金相姬),신동근(申東根),87,73,160,0
10679,김상희(金相姬),신영대(申榮大),79,63,142,0
10680,김상희(金相姬),신원식(申源湜),49,4,53,1
10681,김상희(金相姬),신정훈(辛正勳),102,129,231,0
10682,김상희(金相姬),신현영(申賢榮),80,71,151,0
10683,김상희(金相姬),심상정(沈相奵),18,43,61,1
10684,김상희(金相姬),안규백(安圭伯),86,80,166,0
10685,김상희(金相姬),안민석(安敏錫),86,60,146,0
10686,김상희(金相姬),안병길(安炳吉),49,4,53,1
10687,김상희(金相姬),안철수(安哲秀),25,4,29,1
10688,김상희(金相姬),안호영(安浩永),83,91,174,0
10689,김상희(金相姬),양경숙(梁敬淑),89,95,184,0
10690,김상희(金相姬),양금희(梁琴喜),50,6,56,1
10691,김상희(金相姬),양기대(梁基大),87,63,150,0
10692,김상희(金相姬),양이원영(梁李媛瑛),88,95,183,0
10693,김상희(金相姬),양정숙(梁貞淑),46,120,166,1
10694,김상희(金相姬),양향자(梁香子),43,51,94,1
10695,김상희(金相姬),어기구(魚基龜),83,50,133,0
10696,김상희(金相姬),엄태영(嚴泰永),49,4,53,1
10697,김상희(金相姬),오기형(吳奇炯),83,41,124,0
10698,김상희(金相姬),오영환(吳永煥),122,155,277,0
10699,김상희(金相姬),용혜인(龍慧仁),19,45,64,1
10700,김상희(金相姬),우상호(禹相虎),76,50,126,0
10701,김상희(金相姬),우원식(禹元植),86,79,165,0
10702,김상희(金相姬),위성곤(魏聖坤),84,77,161,0
10703,김상희(金相姬),유경준(兪京濬),49,5,54,1
10704,김상희(金相姬),유기홍(柳基洪),80,64,144,0
10705,김상희(金相姬),유동수(柳東秀),84,59,143,0
10706,김상희(金相姬),유상범(劉相凡),49,4,53,1
10707,김상희(金相姬),유의동(兪義東),50,4,54,1
10708,김상희(金相姬),유정주(兪訂炷),98,124,222,0
10709,김상희(金相姬),윤건영(尹建永),87,80,167,0
10710,김상희(金相姬),윤관석(尹官石),72,91,163,1
10711,김상희(金相姬),윤두현(尹斗鉉),49,5,54,1
10712,김상희(金相姬),윤미향(尹美香),57,120,177,1
10713,김상희(金相姬),윤상현(尹相現),29,4,33,1
10714,김상희(金相姬),윤영덕(尹永德),95,104,199,0
10715,김상희(金相姬),윤영석(尹永碩),49,5,54,1
10716,김상희(金相姬),윤영찬(尹永燦),90,76,166,0
10717,김상희(金相姬),윤재갑(尹才鉀),100,89,189,0
10718,김상희(金相姬),윤재옥(尹在玉),50,5,55,1
10719,김상희(金相姬),윤주경(尹柱卿),49,5,54,1
10720,김상희(金相姬),윤준병(尹準炳),94,125,219,0
10721,김상희(金相姬),윤창현(尹暢賢),49,5,54,1
10722,김상희(金相姬),윤한홍(尹漢洪),49,5,54,1
10723,김상희(金相姬),윤호중(尹昊重),77,87,164,0
10724,김상희(金相姬),윤후덕(尹厚德),88,79,167,0
10725,김상희(金相姬),이개호(李介昊),80,61,141,0
10726,김상희(金相姬),이달곤(李達坤),51,5,56,1
10727,김상희(金相姬),이동주(李東洲),88,95,183,0
10728,김상희(金相姬),이만희(李晩熙),50,4,54,1
10729,김상희(金相姬),이명수(李明洙),50,12,62,1
10730,김상희(金相姬),이병훈(李炳勳),91,101,192,0
10731,김상희(金相姬),이상민(李相珉),75,44,119,0
10732,김상희(金相姬),이상헌(李相憲),85,66,151,0
10733,김상희(金相姬),이성만(李成萬),91,113,204,1
10734,김상희(金相姬),이소영(李素永),89,61,150,0
10735,김상희(金相姬),이수진(李壽珍),112,140,252,0
10736,김상희(金相姬),이수진(李秀眞),96,105,201,0
10737,김상희(金相姬),이양수(李亮壽),49,6,55,1
10738,김상희(金相姬),이용(李鏞),49,4,53,1
10739,김상희(金相姬),이용빈(李龍彬),112,144,256,0
10740,김상희(金相姬),이용선(李庸瑄),93,99,192,0
10741,김상희(金相姬),이용우(李龍雨),103,93,196,0
10742,김상희(金相姬),이용호(李容鎬),30,11,41,1
10743,김상희(金相姬),이원욱(李元旭),92,110,202,0
10744,김상희(金相姬),이원택(李源澤),84,71,155,0
10745,김상희(金相姬),이은주(李恩周),26,77,103,1
10746,김상희(金相姬),이인선(李仁善),25,5,30,1
10747,김상희(金相姬),이인영(李仁榮),73,46,119,0
10748,김상희(金相姬),이장섭(李將燮),84,76,160,0
10749,김상희(金相姬),이재명(李在明),40,28,68,0
10750,김상희(金相姬),이재정(李在汀),84,60,144,0
10751,김상희(金相姬),이정문(李楨文),91,105,196,0
10752,김상희(金相姬),이종배(李鍾培),50,6,56,1
10753,김상희(金相姬),이종성(李鍾成),49,8,57,1
10754,김상희(金相姬),이주환(李周桓),49,4,53,1
10755,김상희(金相姬),이채익(李埰益),51,5,56,1
10756,김상희(金相姬),이철규(李喆圭),49,5,54,1
10757,김상희(金相姬),이탄희(李誕熙),99,91,190,0
10758,김상희(金相姬),이태규(李泰珪),29,6,35,1
10759,김상희(金相姬),이학영(李學永),96,96,192,0
10760,김상희(金相姬),이해식(李海植),99,72,171,0
10761,김상희(金相姬),이헌승(李憲昇),49,7,56,1
10762,김상희(金相姬),이형석(李炯錫),96,95,191,0
10763,김상희(金相姬),인재근(印在謹),106,158,264,0
10764,김상희(金相姬),임병헌(林炳憲),25,5,30,1
10765,김상희(金相姬),임오경(林五卿),86,82,168,0
10766,김상희(金相姬),임이자(林利子),49,5,54,1
10767,김상희(金相姬),임종성(林鍾聲),101,136,237,0
10768,김상희(金相姬),임호선(林昊宣),106,151,257,0
10769,김상희(金相姬),장경태(張耿態),94,100,194,0
10770,김상희(金相姬),장동혁(張東赫),25,4,29,1
10771,김상희(金相姬),장제원(張濟元),49,4,53,1
10772,김상희(金相姬),장철민(張喆敏),90,94,184,0
10773,김상희(金相姬),장혜영(張惠英),19,30,49,1
10774,김상희(金相姬),전봉민(田奉珉),35,6,41,1
10775,김상희(金相姬),전용기(田溶冀),85,100,185,0
10776,김상희(金相姬),전재수(田載秀),81,52,133,0
10777,김상희(金相姬),전주혜(全珠惠),50,5,55,1
10778,김상희(金相姬),전해철(全海澈),74,62,136,0
10779,김상희(金相姬),전혜숙(全惠淑),91,99,190,0
10780,김상희(金相姬),정경희(丁慶姬),50,5,55,1
10781,김상희(金相姬),정동만(鄭東萬),49,5,54,1
10782,김상희(金相姬),정성호(鄭成湖),84,81,165,0
10783,김상희(金相姬),정우택(鄭宇澤),25,5,30,1
10784,김상희(金相姬),정운천(鄭雲天),49,4,53,1
10785,김상희(金相姬),정일영(鄭日永),87,90,177,0
10786,김상희(金相姬),정점식(鄭点植),49,4,53,1
10787,김상희(金相姬),정진석(鄭鎭碩),49,5,54,1
10788,김상희(金相姬),정청래(鄭淸來),81,57,138,0
10789,김상희(金相姬),정춘숙(鄭春淑),102,167,269,0
10790,김상희(金相姬),정태호(鄭泰浩),87,114,201,0
10791,김상희(金相姬),정필모(鄭必模),95,101,196,0
10792,김상희(金相姬),정희용(鄭熙溶),51,6,57,1
10793,김상희(金相姬),조경태(趙慶泰),49,4,53,1
10794,김상희(金相姬),조명희(曺明姬),50,6,56,1
10795,김상희(金相姬),조수진(趙修眞),49,4,53,1
10796,김상희(金相姬),조승래(趙承來),98,73,171,0
10797,김상희(金相姬),조오섭(曺五燮),95,116,211,0
10798,김상희(金相姬),조은희(趙恩禧),25,4,29,1
10799,김상희(金相姬),조응천(趙應天),76,40,116,0
10800,김상희(金相姬),조정식(趙正湜),77,51,128,0
10801,김상희(金相姬),조정훈(趙廷訓),3,8,11,1
10802,김상희(金相姬),조해진(曺海珍),50,6,56,1
10803,김상희(金相姬),주철현(朱哲鉉),89,88,177,0
10804,김상희(金相姬),주호영(朱豪英),49,4,53,1
10805,김상희(金相姬),지성호(池成浩),49,4,53,1
10806,김상희(金相姬),진선미(陳善美),85,71,156,0
10807,김상희(金相姬),진성준(陳聲準),95,90,185,0
10808,김상희(金相姬),천준호(千俊鎬),83,62,145,0
10809,김상희(金相姬),최기상(崔基相),86,74,160,0
10810,김상희(金相姬),최승재(崔承宰),49,6,55,1
10811,김상희(金相姬),최연숙(崔姸淑),35,19,54,1
10812,김상희(金相姬),최영희(崔英姬),25,5,30,1
10813,김상희(金相姬),최인호(崔仁昊),83,62,145,0
10814,김상희(金相姬),최재형(崔在亨),25,5,30,1
10815,김상희(金相姬),최종윤(崔鍾允),99,133,232,0
10816,김상희(金相姬),최춘식(崔春植),50,6,56,1
10817,김상희(金相姬),최형두(崔炯斗),49,6,55,1
10818,김상희(金相姬),최혜영(崔惠英),127,240,367,0
10819,김상희(金相姬),추경호(秋慶鎬),50,4,54,1
10820,김상희(金相姬),태영호(太永浩),49,6,55,1
10821,김상희(金相姬),하영제(河榮帝),41,2,43,1
10822,김상희(金相姬),하태경(河泰慶),51,5,56,1
10823,김상희(金相姬),한기호(韓起鎬),49,5,54,1
10824,김상희(金相姬),한무경(韓茂景),49,5,54,1
10825,김상희(金相姬),한병도(韓秉道),85,77,162,0
10826,김상희(金相姬),한정애(韓貞愛),87,110,197,0
10827,김상희(金相姬),한준호(韓俊鎬),98,105,203,0
10828,김상희(金相姬),허숙정(許淑湞),1,2,3,0
10829,김상희(金相姬),허영(許榮),96,94,190,0
10830,김상희(金相姬),허은아(許垠娥),49,4,53,1
10831,김상희(金相姬),허종식(許琮植),106,99,205,0
10832,김상희(金相姬),홍기원(洪起元),100,82,182,0
10833,김상희(金相姬),홍문표(洪文杓),49,4,53,1
10834,김상희(金相姬),홍석준(洪碩晙),49,4,53,1
10835,김상희(金相姬),홍성국(洪性國),110,149,259,0
10836,김상희(金相姬),홍영표(洪永杓),82,69,151,0
10837,김상희(金相姬),홍익표(洪翼杓),88,98,186,0
10838,김상희(金相姬),홍정민(洪貞敏),103,124,227,0
10839,김상희(金相姬),황보승희(皇甫承希),46,2,48,1
10840,김상희(金相姬),황운하(黃雲夏),111,106,217,0
10841,김상희(金相姬),황희(黃熙),80,51,131,0
10842,김석기(金碩基),김성원(金成願),120,193,313,0
10843,김석기(金碩基),김성주(金成柱),52,4,56,1
10844,김석기(金碩基),김성환(金星煥),52,4,56,1
10845,김석기(金碩基),김수흥(金洙興),53,5,58,1
10846,김석기(金碩基),김승남(金承南),52,4,56,1
10847,김석기(金碩基),김승수(金承洙),112,161,273,0
10848,김석기(金碩基),김승원(金勝源),52,8,60,1
10849,김석기(金碩基),김영배(金永培),53,4,57,1
10850,김석기(金碩基),김영선(金映宣),30,33,63,0
10851,김석기(金碩基),김영식(金英植),152,249,401,0
10852,김석기(金碩基),김영주(金榮珠),52,5,57,1
10853,김석기(金碩基),김영진(金榮鎭),52,3,55,1
10854,김석기(金碩基),김영호(金映豪),51,7,58,1
10855,김석기(金碩基),김예지(金睿智),137,257,394,0
10856,김석기(金碩基),김용민(金容民),52,6,58,1
10857,김석기(金碩基),김용판(金用判),146,224,370,0
10858,김석기(金碩基),김웅(金雄),70,59,129,0
10859,김석기(金碩基),김원이(金元二),52,6,58,1
10860,김석기(金碩基),김윤덕(金潤德),52,3,55,1
10861,김석기(金碩基),김의겸(金宜謙),26,5,31,1
10862,김석기(金碩基),김정재(金汀才),143,223,366,0
10863,김석기(金碩基),김정호(金禎鎬),52,5,57,1
10864,김석기(金碩基),김종민(金鐘民),52,6,58,1
10865,김석기(金碩基),김주영(金周暎),52,6,58,1
10866,김석기(金碩基),김진표(金振杓),27,0,27,1
10867,김석기(金碩基),김철민(金哲玟),51,5,56,1
10868,김석기(金碩基),김태년(金太年),50,4,54,1
10869,김석기(金碩基),김태호(金台鎬),69,72,141,0
10870,김석기(金碩基),김학용(金學容),32,39,71,0
10871,김석기(金碩基),김한규(金翰奎),25,6,31,1
10872,김석기(金碩基),김한정(金漢正),50,4,54,1
10873,김석기(金碩基),김형동(金亨東),125,179,304,0
10874,김석기(金碩基),김홍걸(金弘傑),15,4,19,1
10875,김석기(金碩基),김회재(金會在),52,6,58,1
10876,김석기(金碩基),김희곤(金熙坤),78,131,209,0
10877,김석기(金碩基),김희국(金熙國),99,106,205,0
10878,김석기(金碩基),남인순(南仁順),49,4,53,1
10879,김석기(金碩基),노용호(魯容昊),31,52,83,0
10880,김석기(金碩基),노웅래(盧雄來),50,5,55,1
10881,김석기(金碩基),도종환(都鍾煥),51,4,55,1
10882,김석기(金碩基),류성걸(柳性杰),83,83,166,0
10883,김석기(金碩基),류호정(柳好貞),5,4,9,1
10884,김석기(金碩基),맹성규(孟聖奎),50,5,55,1
10885,김석기(金碩基),문정복(文貞福),49,4,53,1
10886,김석기(金碩基),문진석(文振碩),50,4,54,1
10887,김석기(金碩基),민병덕(閔炳德),51,9,60,1
10888,김석기(金碩基),민형배(閔馨培),34,4,38,1
10889,김석기(金碩基),민홍철(閔洪喆),50,5,55,1
10890,김석기(金碩基),박광온(朴洸瑥),50,5,55,1
10891,김석기(金碩基),박대수(朴大壽),136,246,382,0
10892,김석기(金碩基),박대출(朴大出),73,88,161,0
10893,김석기(金碩基),박덕흠(朴德欽),99,191,290,0
10894,김석기(金碩基),박범계(朴範界),51,4,55,1
10895,김석기(金碩基),박병석(朴炳錫),25,3,28,1
10896,김석기(金碩基),박상혁(朴商赫),49,6,55,1
10897,김석기(金碩基),박성민(朴聖敏),99,170,269,0
10898,김석기(金碩基),박성준(朴省俊),50,6,56,1
10899,김석기(金碩基),박성중(朴成重),91,109,200,0
10900,김석기(金碩基),박수영(朴洙瑩),68,64,132,0
10901,김석기(金碩基),박영순(朴英淳),51,4,55,1
10902,김석기(金碩基),박완주(朴完柱),25,1,26,1
10903,김석기(金碩基),박용진(朴用鎭),49,4,53,1
10904,김석기(金碩基),박재호(朴在昊),51,5,56,1
10905,김석기(金碩基),박정(朴釘),52,6,58,1
10906,김석기(金碩基),박정하(朴正河),31,21,52,0
10907,김석기(金碩基),박주민(朴柱民),50,4,54,1
10908,김석기(金碩基),박진(朴振),85,112,197,0
10909,김석기(金碩基),박찬대(朴贊大),50,4,54,1
10910,김석기(金碩基),박형수(朴亨修),82,90,172,0
10911,김석기(金碩基),박홍근(朴洪根),51,4,55,1
10912,김석기(金碩基),배준영(裵俊英),73,89,162,0
10913,김석기(金碩基),배진교(裵晋敎),5,7,12,1
10914,김석기(金碩基),배현진(裵賢鎭),78,71,149,0
10915,김석기(金碩基),백종헌(白宗憲),82,122,204,0
10916,김석기(金碩基),백혜련(白惠蓮),50,4,54,1
10917,김석기(金碩基),변재일(卞在一),50,5,55,1
10918,김석기(金碩基),서동용(徐東榕),50,5,55,1
10919,김석기(金碩基),서범수(徐範洙),86,106,192,0
10920,김석기(金碩基),서병수(徐秉洙),90,121,211,0
10921,김석기(金碩基),서삼석(徐參錫),50,7,57,1
10922,김석기(金碩基),서영교(徐瑛敎),50,5,55,1
10923,김석기(金碩基),서영석(徐暎錫),49,5,54,1
10924,김석기(金碩基),서일준(徐一俊),110,180,290,0
10925,김석기(金碩基),서정숙(徐正淑),95,97,192,0
10926,김석기(金碩基),설훈(薛勳),51,6,57,1
10927,김석기(金碩基),성일종(成一鍾),126,214,340,0
10928,김석기(金碩基),소병철(蘇秉哲),51,5,56,1
10929,김석기(金碩基),소병훈(蘇秉勳),51,5,56,1
10930,김석기(金碩基),송갑석(宋甲錫),50,4,54,1
10931,김석기(金碩基),송기헌(宋基憲),52,6,58,1
10932,김석기(金碩基),송석준(宋錫俊),78,78,156,0
10933,김석기(金碩基),송언석(宋彦錫),108,150,258,0
10934,김석기(金碩基),송옥주(宋玉珠),50,3,53,1
10935,김석기(金碩基),송재호(宋在祜),50,7,57,1
10936,김석기(金碩基),신동근(申東根),50,3,53,1
10937,김석기(金碩基),신영대(申榮大),50,6,56,1
10938,김석기(金碩基),신원식(申源湜),83,102,185,0
10939,김석기(金碩基),신정훈(辛正勳),53,5,58,1
10940,김석기(金碩基),신현영(申賢榮),49,4,53,1
10941,김석기(金碩基),심상정(沈相奵),5,3,8,1
10942,김석기(金碩基),안규백(安圭伯),52,5,57,1
10943,김석기(金碩基),안민석(安敏錫),51,3,54,1
10944,김석기(金碩基),안병길(安炳吉),97,151,248,0
10945,김석기(金碩基),안철수(安哲秀),28,26,54,0
10946,김석기(金碩基),안호영(安浩永),50,5,55,1
10947,김석기(金碩基),양경숙(梁敬淑),50,4,54,1
10948,김석기(金碩基),양금희(梁琴喜),104,170,274,0
10949,김석기(金碩基),양기대(梁基大),50,5,55,1
10950,김석기(金碩基),양이원영(梁李媛瑛),45,4,49,1
10951,김석기(金碩基),양정숙(梁貞淑),6,11,17,1
10952,김석기(金碩基),양향자(梁香子),26,19,45,1
10953,김석기(金碩基),어기구(魚基龜),51,5,56,1
10954,김석기(金碩基),엄태영(嚴泰永),85,105,190,0
10955,김석기(金碩基),오기형(吳奇炯),49,4,53,1
10956,김석기(金碩基),오영환(吳永煥),49,12,61,1
10957,김석기(金碩基),용혜인(龍慧仁),1,8,9,1
10958,김석기(金碩基),우상호(禹相虎),50,4,54,1
10959,김석기(金碩基),우원식(禹元植),49,5,54,1
10960,김석기(金碩基),위성곤(魏聖坤),52,6,58,1
10961,김석기(金碩基),유경준(兪京濬),87,98,185,0
10962,김석기(金碩基),유기홍(柳基洪),50,5,55,1
10963,김석기(金碩基),유동수(柳東秀),51,12,63,1
10964,김석기(金碩基),유상범(劉相凡),79,89,168,0
10965,김석기(金碩基),유의동(兪義東),77,63,140,0
10966,김석기(金碩基),유정주(兪訂炷),50,4,54,1
10967,김석기(金碩基),윤건영(尹建永),49,4,53,1
10968,김석기(金碩基),윤관석(尹官石),41,0,41,1
10969,김석기(金碩基),윤두현(尹斗鉉),113,156,269,0
10970,김석기(金碩基),윤미향(尹美香),20,0,20,1
10971,김석기(金碩基),윤상현(尹相現),44,62,106,0
10972,김석기(金碩基),윤영덕(尹永德),49,5,54,1
10973,김석기(金碩基),윤영석(尹永碩),74,76,150,0
10974,김석기(金碩基),윤영찬(尹永燦),50,5,55,1
10975,김석기(金碩基),윤재갑(尹才鉀),52,6,58,1
10976,김석기(金碩基),윤재옥(尹在玉),81,75,156,0
10977,김석기(金碩基),윤주경(尹柱卿),85,80,165,0
10978,김석기(金碩基),윤준병(尹準炳),50,4,54,1
10979,김석기(金碩基),윤창현(尹暢賢),111,134,245,0
10980,김석기(金碩基),윤한홍(尹漢洪),76,80,156,0
10981,김석기(金碩基),윤호중(尹昊重),51,5,56,1
10982,김석기(金碩基),윤후덕(尹厚德),50,8,58,1
10983,김석기(金碩基),이개호(李介昊),50,6,56,1
10984,김석기(金碩基),이달곤(李達坤),72,69,141,0
10985,김석기(金碩基),이동주(李東洲),49,4,53,1
10986,김석기(金碩基),이만희(李晩熙),89,97,186,0
10987,김석기(金碩基),이명수(李明洙),103,149,252,0
10988,김석기(金碩基),이병훈(李炳勳),55,5,60,1
10989,김석기(金碩基),이상민(李相珉),50,5,55,1
10990,김석기(金碩基),이상헌(李相憲),52,12,64,1
10991,김석기(金碩基),이성만(李成萬),42,1,43,1
10992,김석기(金碩基),이소영(李素永),50,5,55,1
10993,김석기(金碩基),이수진(李壽珍),51,6,57,1
10994,김석기(金碩基),이수진(李秀眞),50,4,54,1
10995,김석기(金碩基),이양수(李亮壽),81,99,180,0
10996,김석기(金碩基),이용(李鏞),91,130,221,0
10997,김석기(金碩基),이용빈(李龍彬),52,5,57,1
10998,김석기(金碩基),이용선(李庸瑄),51,5,56,1
10999,김석기(金碩基),이용우(李龍雨),49,4,53,1
11000,김석기(金碩基),이용호(李容鎬),35,27,62,0
11001,김석기(金碩基),이원욱(李元旭),51,5,56,1
11002,김석기(金碩基),이원택(李源澤),50,4,54,1
11003,김석기(金碩基),이은주(李恩周),6,4,10,1
11004,김석기(金碩基),이인선(李仁善),32,42,74,0
11005,김석기(金碩基),이인영(李仁榮),50,4,54,1
11006,김석기(金碩基),이장섭(李將燮),50,5,55,1
11007,김석기(金碩基),이재명(李在明),25,4,29,1
11008,김석기(金碩基),이재정(李在汀),50,5,55,1
11009,김석기(金碩基),이정문(李楨文),50,4,54,1
11010,김석기(金碩基),이종배(李鍾培),117,183,300,0
11011,김석기(金碩基),이종성(李鍾成),110,172,282,0
11012,김석기(金碩基),이주환(李周桓),90,155,245,0
11013,김석기(金碩基),이채익(李埰益),90,115,205,0
11014,김석기(金碩基),이철규(李喆圭),108,129,237,0
11015,김석기(金碩基),이탄희(李誕熙),50,4,54,1
11016,김석기(金碩基),이태규(李泰珪),52,92,144,0
11017,김석기(金碩基),이학영(李學永),49,4,53,1
11018,김석기(金碩基),이해식(李海植),50,4,54,1
11019,김석기(金碩基),이헌승(李憲昇),73,90,163,0
11020,김석기(金碩基),이형석(李炯錫),49,5,54,1
11021,김석기(金碩基),인재근(印在謹),52,5,57,1
11022,김석기(金碩基),임병헌(林炳憲),35,52,87,0
11023,김석기(金碩基),임오경(林五卿),50,6,56,1
11024,김석기(金碩基),임이자(林利子),121,170,291,0
11025,김석기(金碩基),임종성(林鍾聲),52,7,59,1
11026,김석기(金碩基),임호선(林昊宣),51,6,57,1
11027,김석기(金碩基),장경태(張耿態),50,5,55,1
11028,김석기(金碩基),장동혁(張東赫),33,45,78,0
11029,김석기(金碩基),장제원(張濟元),70,49,119,0
11030,김석기(金碩基),장철민(張喆敏),50,5,55,1
11031,김석기(金碩基),장혜영(張惠英),6,4,10,1
11032,김석기(金碩基),전봉민(田奉珉),56,69,125,0
11033,김석기(金碩基),전용기(田溶冀),50,4,54,1
11034,김석기(金碩基),전재수(田載秀),50,4,54,1
11035,김석기(金碩基),전주혜(全珠惠),81,96,177,0
11036,김석기(金碩基),전해철(全海澈),51,4,55,1
11037,김석기(金碩基),전혜숙(全惠淑),50,8,58,1
11038,김석기(金碩基),정경희(丁慶姬),79,87,166,0
11039,김석기(金碩基),정동만(鄭東萬),85,97,182,0
11040,김석기(金碩基),정성호(鄭成湖),52,5,57,1
11041,김석기(金碩基),정우택(鄭宇澤),35,55,90,0
11042,김석기(金碩基),정운천(鄭雲天),93,136,229,0
11043,김석기(金碩基),정일영(鄭日永),49,4,53,1
11044,김석기(金碩基),정점식(鄭点植),80,59,139,0
11045,김석기(金碩基),정진석(鄭鎭碩),103,185,288,0
11046,김석기(金碩基),정청래(鄭淸來),49,4,53,1
11047,김석기(金碩基),정춘숙(鄭春淑),50,4,54,1
11048,김석기(金碩基),정태호(鄭泰浩),50,5,55,1
11049,김석기(金碩基),정필모(鄭必模),50,4,54,1
11050,김석기(金碩基),정희용(鄭熙溶),119,170,289,0
11051,김석기(金碩基),조경태(趙慶泰),96,104,200,0
11052,김석기(金碩基),조명희(曺明姬),104,154,258,0
11053,김석기(金碩基),조수진(趙修眞),96,141,237,0
11054,김석기(金碩基),조승래(趙承來),50,6,56,1
11055,김석기(金碩基),조오섭(曺五燮),52,7,59,1
11056,김석기(金碩基),조은희(趙恩禧),34,36,70,0
11057,김석기(金碩基),조응천(趙應天),50,3,53,1
11058,김석기(金碩基),조정식(趙正湜),49,4,53,1
11059,김석기(金碩基),조정훈(趙廷訓),3,12,15,1
11060,김석기(金碩基),조해진(曺海珍),65,41,106,0
11061,김석기(金碩基),주철현(朱哲鉉),52,8,60,1
11062,김석기(金碩基),주호영(朱豪英),70,88,158,0
11063,김석기(金碩基),지성호(池成浩),116,216,332,0
11064,김석기(金碩基),진선미(陳善美),50,4,54,1
11065,김석기(金碩基),진성준(陳聲準),50,4,54,1
11066,김석기(金碩基),천준호(千俊鎬),49,3,52,1
11067,김석기(金碩基),최기상(崔基相),49,4,53,1
11068,김석기(金碩基),최승재(崔承宰),99,106,205,0
11069,김석기(金碩基),최연숙(崔姸淑),50,66,116,0
11070,김석기(金碩基),최영희(崔英姬),32,53,85,0
11071,김석기(金碩基),최인호(崔仁昊),52,5,57,1
11072,김석기(金碩基),최재형(崔在亨),27,16,43,0
11073,김석기(金碩基),최종윤(崔鍾允),50,5,55,1
11074,김석기(金碩基),최춘식(崔春植),89,130,219,0
11075,김석기(金碩基),최형두(崔炯斗),84,90,174,0
11076,김석기(金碩基),최혜영(崔惠英),50,6,56,1
11077,김석기(金碩基),추경호(秋慶鎬),139,205,344,0
11078,김석기(金碩基),태영호(太永浩),124,226,350,0
11079,김석기(金碩基),하영제(河榮帝),99,115,214,1
11080,김석기(金碩基),하태경(河泰慶),67,73,140,0
11081,김석기(金碩基),한기호(韓起鎬),71,70,141,0
11082,김석기(金碩基),한무경(韓茂景),111,158,269,0
11083,김석기(金碩基),한병도(韓秉道),50,7,57,1
11084,김석기(金碩基),한정애(韓貞愛),50,4,54,1
11085,김석기(金碩基),한준호(韓俊鎬),50,5,55,1
11086,김석기(金碩基),허숙정(許淑湞),0,0,0,1
11087,김석기(金碩基),허영(許榮),51,5,56,1
11088,김석기(金碩基),허은아(許垠娥),98,108,206,0
11089,김석기(金碩基),허종식(許琮植),50,6,56,1
11090,김석기(金碩基),홍기원(洪起元),50,5,55,1
11091,김석기(金碩基),홍문표(洪文杓),93,110,203,0
11092,김석기(金碩基),홍석준(洪碩晙),83,89,172,0
11093,김석기(金碩基),홍성국(洪性國),50,5,55,1
11094,김석기(金碩基),홍영표(洪永杓),50,4,54,1
11095,김석기(金碩基),홍익표(洪翼杓),50,4,54,1
11096,김석기(金碩基),홍정민(洪貞敏),50,5,55,1
11097,김석기(金碩基),황보승희(皇甫承希),79,139,218,1
11098,김석기(金碩基),황운하(黃雲夏),50,5,55,1
11099,김석기(金碩基),황희(黃熙),49,4,53,1
11100,김성원(金成願),김성주(金成柱),52,4,56,1
11101,김성원(金成願),김성환(金星煥),52,5,57,1
11102,김성원(金成願),김수흥(金洙興),53,5,58,1
11103,김성원(金成願),김승남(金承南),52,5,57,1
11104,김성원(金成願),김승수(金承洙),120,186,306,0
11105,김성원(金成願),김승원(金勝源),52,8,60,1
11106,김성원(金成願),김영배(金永培),55,6,61,1
11107,김성원(金成願),김영선(金映宣),30,28,58,0
11108,김성원(金成願),김영식(金英植),132,223,355,0
11109,김성원(金成願),김영주(金榮珠),52,5,57,1
11110,김성원(金成願),김영진(金榮鎭),52,9,61,1
11111,김성원(金成願),김영호(金映豪),51,5,56,1
11112,김성원(金成願),김예지(金睿智),138,215,353,0
11113,김성원(金成願),김용민(金容民),52,6,58,1
11114,김성원(金成願),김용판(金用判),173,439,612,0
11115,김성원(金成願),김웅(金雄),77,60,137,0
11116,김성원(金成願),김원이(金元二),52,7,59,1
11117,김성원(金成願),김윤덕(金潤德),53,3,56,1
11118,김성원(金成願),김의겸(金宜謙),26,4,30,1
11119,김성원(金成願),김정재(金汀才),142,197,339,0
11120,김성원(金成願),김정호(金禎鎬),54,6,60,1
11121,김성원(金成願),김종민(金鐘民),52,8,60,1
11122,김성원(金成願),김주영(金周暎),51,8,59,1
11123,김성원(金成願),김진표(金振杓),28,3,31,1
11124,김성원(金成願),김철민(金哲玟),50,7,57,1
11125,김성원(金成願),김태년(金太年),50,6,56,1
11126,김성원(金成願),김태호(金台鎬),96,107,203,0
11127,김성원(金成願),김학용(金學容),47,132,179,0
11128,김성원(金成願),김한규(金翰奎),25,12,37,1
11129,김성원(金成願),김한정(金漢正),50,5,55,1
11130,김성원(金成願),김형동(金亨東),139,221,360,0
11131,김성원(金成願),김홍걸(金弘傑),15,10,25,1
11132,김성원(金成願),김회재(金會在),52,10,62,1
11133,김성원(金成願),김희곤(金熙坤),98,226,324,0
11134,김성원(金成願),김희국(金熙國),85,76,161,0
11135,김성원(金成願),남인순(南仁順),49,8,57,1
11136,김성원(金成願),노용호(魯容昊),43,93,136,0
11137,김성원(金成願),노웅래(盧雄來),51,4,55,1
11138,김성원(金成願),도종환(都鍾煥),50,5,55,1
11139,김성원(金成願),류성걸(柳性杰),72,81,153,0
11140,김성원(金成願),류호정(柳好貞),4,2,6,1
11141,김성원(金成願),맹성규(孟聖奎),50,8,58,1
11142,김성원(金成願),문정복(文貞福),49,7,56,1
11143,김성원(金成願),문진석(文振碩),51,7,58,1
11144,김성원(金成願),민병덕(閔炳德),50,11,61,1
11145,김성원(金成願),민형배(閔馨培),35,6,41,1
11146,김성원(金成願),민홍철(閔洪喆),50,6,56,1
11147,김성원(金成願),박광온(朴洸瑥),50,5,55,1
11148,김성원(金成願),박대수(朴大壽),168,467,635,0
11149,김성원(金成願),박대출(朴大出),68,83,151,0
11150,김성원(金成願),박덕흠(朴德欽),133,301,434,0
11151,김성원(金成願),박범계(朴範界),50,4,54,1
11152,김성원(金成願),박병석(朴炳錫),25,3,28,1
11153,김성원(金成願),박상혁(朴商赫),49,13,62,1
11154,김성원(金成願),박성민(朴聖敏),116,226,342,0
11155,김성원(金成願),박성준(朴省俊),51,12,63,1
11156,김성원(金成願),박성중(朴成重),86,111,197,0
11157,김성원(金成願),박수영(朴洙瑩),84,80,164,0
11158,김성원(金成願),박영순(朴英淳),51,7,58,1
11159,김성원(金成願),박완주(朴完柱),25,0,25,1
11160,김성원(金成願),박용진(朴用鎭),49,6,55,1
11161,김성원(金成願),박재호(朴在昊),51,5,56,1
11162,김성원(金成願),박정(朴釘),51,7,58,1
11163,김성원(金成願),박정하(朴正河),42,55,97,0
11164,김성원(金成願),박주민(朴柱民),50,4,54,1
11165,김성원(金成願),박진(朴振),80,100,180,0
11166,김성원(金成願),박찬대(朴贊大),50,8,58,1
11167,김성원(金成願),박형수(朴亨修),67,62,129,0
11168,김성원(金成願),박홍근(朴洪根),53,6,59,1
11169,김성원(金成願),배준영(裵俊英),96,136,232,0
11170,김성원(金成願),배진교(裵晋敎),6,4,10,1
11171,김성원(金成願),배현진(裵賢鎭),117,102,219,0
11172,김성원(金成願),백종헌(白宗憲),91,188,279,0
11173,김성원(金成願),백혜련(白惠蓮),51,6,57,1
11174,김성원(金成願),변재일(卞在一),50,6,56,1
11175,김성원(金成願),서동용(徐東榕),50,5,55,1
11176,김성원(金成願),서범수(徐範洙),95,139,234,0
11177,김성원(金成願),서병수(徐秉洙),99,159,258,0
11178,김성원(金成願),서삼석(徐參錫),55,7,62,1
11179,김성원(金成願),서영교(徐瑛敎),52,8,60,1
11180,김성원(金成願),서영석(徐暎錫),52,8,60,1
11181,김성원(金成願),서일준(徐一俊),144,203,347,0
11182,김성원(金成願),서정숙(徐正淑),88,78,166,0
11183,김성원(金成願),설훈(薛勳),52,8,60,1
11184,김성원(金成願),성일종(成一鍾),127,240,367,0
11185,김성원(金成願),소병철(蘇秉哲),51,5,56,1
11186,김성원(金成願),소병훈(蘇秉勳),51,6,57,1
11187,김성원(金成願),송갑석(宋甲錫),50,5,55,1
11188,김성원(金成願),송기헌(宋基憲),51,12,63,1
11189,김성원(金成願),송석준(宋錫俊),83,114,197,0
11190,김성원(金成願),송언석(宋彦錫),111,120,231,0
11191,김성원(金成願),송옥주(宋玉珠),50,5,55,1
11192,김성원(金成願),송재호(宋在祜),50,9,59,1
11193,김성원(金成願),신동근(申東根),50,9,59,1
11194,김성원(金成願),신영대(申榮大),50,5,55,1
11195,김성원(金成願),신원식(申源湜),86,100,186,0
11196,김성원(金成願),신정훈(辛正勳),51,5,56,1
11197,김성원(金成願),신현영(申賢榮),49,4,53,1
11198,김성원(金成願),심상정(沈相奵),7,6,13,1
11199,김성원(金成願),안규백(安圭伯),54,15,69,1
11200,김성원(金成願),안민석(安敏錫),51,4,55,1
11201,김성원(金成願),안병길(安炳吉),106,156,262,0
11202,김성원(金成願),안철수(安哲秀),28,53,81,0
11203,김성원(金成願),안호영(安浩永),51,5,56,1
11204,김성원(金成願),양경숙(梁敬淑),50,6,56,1
11205,김성원(金成願),양금희(梁琴喜),100,149,249,0
11206,김성원(金成願),양기대(梁基大),51,5,56,1
11207,김성원(金成願),양이원영(梁李媛瑛),45,5,50,1
11208,김성원(金成願),양정숙(梁貞淑),6,14,20,1
11209,김성원(金成願),양향자(梁香子),24,12,36,1
11210,김성원(金成願),어기구(魚基龜),50,4,54,1
11211,김성원(金成願),엄태영(嚴泰永),118,163,281,0
11212,김성원(金成願),오기형(吳奇炯),49,6,55,1
11213,김성원(金成願),오영환(吳永煥),51,13,64,1
11214,김성원(金成願),용혜인(龍慧仁),1,5,6,1
11215,김성원(金成願),우상호(禹相虎),50,4,54,1
11216,김성원(金成願),우원식(禹元植),49,6,55,1
11217,김성원(金成願),위성곤(魏聖坤),51,8,59,1
11218,김성원(金成願),유경준(兪京濬),104,141,245,0
11219,김성원(金成願),유기홍(柳基洪),50,5,55,1
11220,김성원(金成願),유동수(柳東秀),51,12,63,1
11221,김성원(金成願),유상범(劉相凡),83,113,196,0
11222,김성원(金成願),유의동(兪義東),80,83,163,0
11223,김성원(金成願),유정주(兪訂炷),50,4,54,1
11224,김성원(金成願),윤건영(尹建永),49,3,52,1
11225,김성원(金成願),윤관석(尹官石),42,2,44,1
11226,김성원(金成願),윤두현(尹斗鉉),84,102,186,0
11227,김성원(金成願),윤미향(尹美香),21,1,22,1
11228,김성원(金成願),윤상현(尹相現),50,85,135,0
11229,김성원(金成願),윤영덕(尹永德),49,8,57,1
11230,김성원(金成願),윤영석(尹永碩),87,88,175,0
11231,김성원(金成願),윤영찬(尹永燦),50,6,56,1
11232,김성원(金成願),윤재갑(尹才鉀),51,9,60,1
11233,김성원(金成願),윤재옥(尹在玉),78,63,141,0
11234,김성원(金成願),윤주경(尹柱卿),85,69,154,0
11235,김성원(金成願),윤준병(尹準炳),50,6,56,1
11236,김성원(金成願),윤창현(尹暢賢),107,159,266,0
11237,김성원(金成願),윤한홍(尹漢洪),79,93,172,0
11238,김성원(金成願),윤호중(尹昊重),51,6,57,1
11239,김성원(金成願),윤후덕(尹厚德),50,7,57,1
11240,김성원(金成願),이개호(李介昊),54,5,59,1
11241,김성원(金成願),이달곤(李達坤),72,82,154,0
11242,김성원(金成願),이동주(李東洲),49,4,53,1
11243,김성원(金成願),이만희(李晩熙),84,78,162,0
11244,김성원(金成願),이명수(李明洙),129,211,340,0
11245,김성원(金成願),이병훈(李炳勳),53,8,61,1
11246,김성원(金成願),이상민(李相珉),50,5,55,1
11247,김성원(金成願),이상헌(李相憲),51,8,59,1
11248,김성원(金成願),이성만(李成萬),41,1,42,1
11249,김성원(金成願),이소영(李素永),51,12,63,1
11250,김성원(金成願),이수진(李壽珍),51,6,57,1
11251,김성원(金成願),이수진(李秀眞),50,7,57,1
11252,김성원(金成願),이양수(李亮壽),109,122,231,0
11253,김성원(金成願),이용(李鏞),120,157,277,0
11254,김성원(金成願),이용빈(李龍彬),52,15,67,1
11255,김성원(金成願),이용선(李庸瑄),50,7,57,1
11256,김성원(金成願),이용우(李龍雨),49,10,59,1
11257,김성원(金成願),이용호(李容鎬),40,32,72,0
11258,김성원(金成願),이원욱(李元旭),52,5,57,1
11259,김성원(金成願),이원택(李源澤),50,4,54,1
11260,김성원(金成願),이은주(李恩周),6,2,8,1
11261,김성원(金成願),이인선(李仁善),36,108,144,0
11262,김성원(金成願),이인영(李仁榮),50,4,54,1
11263,김성원(金成願),이장섭(李將燮),50,4,54,1
11264,김성원(金成願),이재명(李在明),25,5,30,1
11265,김성원(金成願),이재정(李在汀),50,5,55,1
11266,김성원(金成願),이정문(李楨文),51,5,56,1
11267,김성원(金成願),이종배(李鍾培),138,243,381,0
11268,김성원(金成願),이종성(李鍾成),146,252,398,0
11269,김성원(金成願),이주환(李周桓),153,299,452,0
11270,김성원(金成願),이채익(李埰益),88,161,249,0
11271,김성원(金成願),이철규(李喆圭),105,92,197,0
11272,김성원(金成願),이탄희(李誕熙),50,5,55,1
11273,김성원(金成願),이태규(李泰珪),43,58,101,0
11274,김성원(金成願),이학영(李學永),49,5,54,1
11275,김성원(金成願),이해식(李海植),50,5,55,1
11276,김성원(金成願),이헌승(李憲昇),93,206,299,0
11277,김성원(金成願),이형석(李炯錫),49,6,55,1
11278,김성원(金成願),인재근(印在謹),49,8,57,1
11279,김성원(金成願),임병헌(林炳憲),42,34,76,0
11280,김성원(金成願),임오경(林五卿),50,7,57,1
11281,김성원(金成願),임이자(林利子),161,211,372,0
11282,김성원(金成願),임종성(林鍾聲),50,10,60,1
11283,김성원(金成願),임호선(林昊宣),51,7,58,1
11284,김성원(金成願),장경태(張耿態),51,6,57,1
11285,김성원(金成願),장동혁(張東赫),32,59,91,0
11286,김성원(金成願),장제원(張濟元),67,54,121,0
11287,김성원(金成願),장철민(張喆敏),50,11,61,1
11288,김성원(金成願),장혜영(張惠英),7,2,9,1
11289,김성원(金成願),전봉민(田奉珉),58,164,222,0
11290,김성원(金成願),전용기(田溶冀),51,7,58,1
11291,김성원(金成願),전재수(田載秀),50,6,56,1
11292,김성원(金成願),전주혜(全珠惠),84,92,176,0
11293,김성원(金成願),전해철(全海澈),52,5,57,1
11294,김성원(金成願),전혜숙(全惠淑),50,6,56,1
11295,김성원(金成願),정경희(丁慶姬),82,82,164,0
11296,김성원(金成願),정동만(鄭東萬),80,144,224,0
11297,김성원(金成願),정성호(鄭成湖),53,12,65,1
11298,김성원(金成願),정우택(鄭宇澤),38,139,177,0
11299,김성원(金成願),정운천(鄭雲天),121,171,292,0
11300,김성원(金成願),정일영(鄭日永),49,9,58,1
11301,김성원(金成願),정점식(鄭点植),97,75,172,0
11302,김성원(金成願),정진석(鄭鎭碩),93,110,203,0
11303,김성원(金成願),정청래(鄭淸來),49,5,54,1
11304,김성원(金成願),정춘숙(鄭春淑),52,5,57,1
11305,김성원(金成願),정태호(鄭泰浩),50,8,58,1
11306,김성원(金成願),정필모(鄭必模),50,4,54,1
11307,김성원(金成願),정희용(鄭熙溶),144,205,349,0
11308,김성원(金成願),조경태(趙慶泰),97,106,203,0
11309,김성원(金成願),조명희(曺明姬),132,213,345,0
11310,김성원(金成願),조수진(趙修眞),108,160,268,0
11311,김성원(金成願),조승래(趙承來),50,7,57,1
11312,김성원(金成願),조오섭(曺五燮),50,6,56,1
11313,김성원(金成願),조은희(趙恩禧),29,31,60,0
11314,김성원(金成願),조응천(趙應天),50,5,55,1
11315,김성원(金成願),조정식(趙正湜),49,4,53,1
11316,김성원(金成願),조정훈(趙廷訓),1,12,13,1
11317,김성원(金成願),조해진(曺海珍),75,62,137,0
11318,김성원(金成願),주철현(朱哲鉉),55,8,63,1
11319,김성원(金成願),주호영(朱豪英),82,82,164,0
11320,김성원(金成願),지성호(池成浩),116,252,368,0
11321,김성원(金成願),진선미(陳善美),50,4,54,1
11322,김성원(金成願),진성준(陳聲準),50,5,55,1
11323,김성원(金成願),천준호(千俊鎬),49,3,52,1
11324,김성원(金成願),최기상(崔基相),49,4,53,1
11325,김성원(金成願),최승재(崔承宰),106,142,248,0
11326,김성원(金成願),최연숙(崔姸淑),39,45,84,0
11327,김성원(金成願),최영희(崔英姬),42,147,189,0
11328,김성원(金成願),최인호(崔仁昊),51,6,57,1
11329,김성원(金成願),최재형(崔在亨),29,24,53,0
11330,김성원(金成願),최종윤(崔鍾允),50,7,57,1
11331,김성원(金成願),최춘식(崔春植),122,271,393,0
11332,김성원(金成願),최형두(崔炯斗),146,165,311,0
11333,김성원(金成願),최혜영(崔惠英),50,8,58,1
11334,김성원(金成願),추경호(秋慶鎬),175,222,397,0
11335,김성원(金成願),태영호(太永浩),145,297,442,0
11336,김성원(金成願),하영제(河榮帝),113,214,327,1
11337,김성원(金成願),하태경(河泰慶),75,63,138,0
11338,김성원(金成願),한기호(韓起鎬),85,92,177,0
11339,김성원(金成願),한무경(韓茂景),112,179,291,0
11340,김성원(金成願),한병도(韓秉道),49,7,56,1
11341,김성원(金成願),한정애(韓貞愛),50,9,59,1
11342,김성원(金成願),한준호(韓俊鎬),52,9,61,1
11343,김성원(金成願),허숙정(許淑湞),0,0,0,1
11344,김성원(金成願),허영(許榮),52,13,65,1
11345,김성원(金成願),허은아(許垠娥),97,92,189,0
11346,김성원(金成願),허종식(許琮植),51,15,66,1
11347,김성원(金成願),홍기원(洪起元),50,6,56,1
11348,김성원(金成願),홍문표(洪文杓),108,159,267,0
11349,김성원(金成願),홍석준(洪碩晙),92,105,197,0
11350,김성원(金成願),홍성국(洪性國),50,8,58,1
11351,김성원(金成願),홍영표(洪永杓),50,5,55,1
11352,김성원(金成願),홍익표(洪翼杓),51,7,58,1
11353,김성원(金成願),홍정민(洪貞敏),53,8,61,1
11354,김성원(金成願),황보승희(皇甫承希),100,144,244,1
11355,김성원(金成願),황운하(黃雲夏),50,8,58,1
11356,김성원(金成願),황희(黃熙),49,6,55,1
11357,김성주(金成柱),김성환(金星煥),104,95,199,0
11358,김성주(金成柱),김수흥(金洙興),129,133,262,0
11359,김성주(金成柱),김승남(金承南),95,95,190,0
11360,김성주(金成柱),김승수(金承洙),53,8,61,1
11361,김성주(金成柱),김승원(金勝源),112,94,206,0
11362,김성주(金成柱),김영배(金永培),108,95,203,0
11363,김성주(金成柱),김영선(金映宣),26,4,30,1
11364,김성주(金成柱),김영식(金英植),52,7,59,1
11365,김성주(金成柱),김영주(金榮珠),89,57,146,0
11366,김성주(金成柱),김영진(金榮鎭),96,64,160,0
11367,김성주(金成柱),김영호(金映豪),87,57,144,0
11368,김성주(金成柱),김예지(金睿智),52,6,58,1
11369,김성주(金成柱),김용민(金容民),94,71,165,0
11370,김성주(金成柱),김용판(金用判),52,4,56,1
11371,김성주(金成柱),김웅(金雄),52,6,58,1
11372,김성주(金成柱),김원이(金元二),124,113,237,0
11373,김성주(金成柱),김윤덕(金潤德),120,132,252,0
11374,김성주(金成柱),김의겸(金宜謙),48,37,85,0
11375,김성주(金成柱),김정재(金汀才),54,5,59,1
11376,김성주(金成柱),김정호(金禎鎬),135,165,300,0
11377,김성주(金成柱),김종민(金鐘民),88,68,156,0
11378,김성주(金成柱),김주영(金周暎),106,99,205,0
11379,김성주(金成柱),김진표(金振杓),57,34,91,1
11380,김성주(金成柱),김철민(金哲玟),103,96,199,0
11381,김성주(金成柱),김태년(金太年),78,51,129,0
11382,김성주(金成柱),김태호(金台鎬),44,8,52,1
11383,김성주(金成柱),김학용(金學容),25,6,31,1
11384,김성주(金成柱),김한규(金翰奎),44,52,96,0
11385,김성주(金成柱),김한정(金漢正),80,42,122,0
11386,김성주(金成柱),김형동(金亨東),51,6,57,1
11387,김성주(金成柱),김홍걸(金弘傑),53,118,171,0
11388,김성주(金成柱),김회재(金會在),92,74,166,0
11389,김성주(金成柱),김희곤(金熙坤),52,15,67,1
11390,김성주(金成柱),김희국(金熙國),49,4,53,1
11391,김성주(金成柱),남인순(南仁順),121,108,229,0
11392,김성주(金成柱),노용호(魯容昊),25,10,35,1
11393,김성주(金成柱),노웅래(盧雄來),91,71,162,0
11394,김성주(金成柱),도종환(都鍾煥),90,73,163,0
11395,김성주(金成柱),류성걸(柳性杰),49,4,53,1
11396,김성주(金成柱),류호정(柳好貞),14,28,42,1
11397,김성주(金成柱),맹성규(孟聖奎),96,53,149,0
11398,김성주(金成柱),문정복(文貞福),84,52,136,0
11399,김성주(金成柱),문진석(文振碩),113,116,229,0
11400,김성주(金成柱),민병덕(閔炳德),105,133,238,0
11401,김성주(金成柱),민형배(閔馨培),92,134,226,0
11402,김성주(金成柱),민홍철(閔洪喆),87,73,160,0
11403,김성주(金成柱),박광온(朴洸瑥),99,78,177,0
11404,김성주(金成柱),박대수(朴大壽),49,11,60,1
11405,김성주(金成柱),박대출(朴大出),50,5,55,1
11406,김성주(金成柱),박덕흠(朴德欽),36,7,43,1
11407,김성주(金成柱),박범계(朴範界),77,45,122,0
11408,김성주(金成柱),박병석(朴炳錫),40,17,57,0
11409,김성주(金成柱),박상혁(朴商赫),118,122,240,0
11410,김성주(金成柱),박성민(朴聖敏),50,8,58,1
11411,김성주(金成柱),박성준(朴省俊),97,81,178,0
11412,김성주(金成柱),박성중(朴成重),49,4,53,1
11413,김성주(金成柱),박수영(朴洙瑩),49,6,55,1
11414,김성주(金成柱),박영순(朴英淳),92,77,169,0
11415,김성주(金成柱),박완주(朴完柱),52,42,94,1
11416,김성주(金成柱),박용진(朴用鎭),81,62,143,0
11417,김성주(金成柱),박재호(朴在昊),101,73,174,0
11418,김성주(金成柱),박정(朴釘),110,75,185,0
11419,김성주(金成柱),박정하(朴正河),25,5,30,1
11420,김성주(金成柱),박주민(朴柱民),83,65,148,0
11421,김성주(金成柱),박진(朴振),50,4,54,1
11422,김성주(金成柱),박찬대(朴贊大),91,64,155,0
11423,김성주(金成柱),박형수(朴亨修),49,6,55,1
11424,김성주(金成柱),박홍근(朴洪根),114,92,206,0
11425,김성주(金成柱),배준영(裵俊英),52,13,65,1
11426,김성주(金成柱),배진교(裵晋敎),21,44,65,1
11427,김성주(金成柱),배현진(裵賢鎭),49,6,55,1
11428,김성주(金成柱),백종헌(白宗憲),50,11,61,1
11429,김성주(金成柱),백혜련(白惠蓮),89,51,140,0
11430,김성주(金成柱),변재일(卞在一),96,59,155,0
11431,김성주(金成柱),서동용(徐東榕),92,80,172,0
11432,김성주(金成柱),서범수(徐範洙),52,10,62,1
11433,김성주(金成柱),서병수(徐秉洙),50,6,56,1
11434,김성주(金成柱),서삼석(徐參錫),92,74,166,0
11435,김성주(金成柱),서영교(徐瑛敎),101,99,200,0
11436,김성주(金成柱),서영석(徐暎錫),124,141,265,0
11437,김성주(金成柱),서일준(徐一俊),50,6,56,1
11438,김성주(金成柱),서정숙(徐正淑),49,11,60,1
11439,김성주(金成柱),설훈(薛勳),82,55,137,0
11440,김성주(金成柱),성일종(成一鍾),50,6,56,1
11441,김성주(金成柱),소병철(蘇秉哲),83,60,143,0
11442,김성주(金成柱),소병훈(蘇秉勳),89,81,170,0
11443,김성주(金成柱),송갑석(宋甲錫),87,96,183,0
11444,김성주(金成柱),송기헌(宋基憲),95,71,166,0
11445,김성주(金成柱),송석준(宋錫俊),50,7,57,1
11446,김성주(金成柱),송언석(宋彦錫),49,16,65,1
11447,김성주(金成柱),송옥주(宋玉珠),108,68,176,0
11448,김성주(金成柱),송재호(宋在祜),110,113,223,0
11449,김성주(金成柱),신동근(申東根),102,87,189,0
11450,김성주(金成柱),신영대(申榮大),116,102,218,0
11451,김성주(金成柱),신원식(申源湜),49,10,59,1
11452,김성주(金成柱),신정훈(辛正勳),130,172,302,0
11453,김성주(金成柱),신현영(申賢榮),91,53,144,0
11454,김성주(金成柱),심상정(沈相奵),18,33,51,1
11455,김성주(金成柱),안규백(安圭伯),90,74,164,0
11456,김성주(金成柱),안민석(安敏錫),93,59,152,0
11457,김성주(金成柱),안병길(安炳吉),50,5,55,1
11458,김성주(金成柱),안철수(安哲秀),25,4,29,1
11459,김성주(金成柱),안호영(安浩永),107,132,239,0
11460,김성주(金成柱),양경숙(梁敬淑),102,104,206,0
11461,김성주(金成柱),양금희(梁琴喜),50,11,61,1
11462,김성주(金成柱),양기대(梁基大),104,68,172,0
11463,김성주(金成柱),양이원영(梁李媛瑛),97,86,183,0
11464,김성주(金成柱),양정숙(梁貞淑),61,161,222,1
11465,김성주(金成柱),양향자(梁香子),36,36,72,1
11466,김성주(金成柱),어기구(魚基龜),94,78,172,0
11467,김성주(金成柱),엄태영(嚴泰永),51,5,56,1
11468,김성주(金成柱),오기형(吳奇炯),78,50,128,0
11469,김성주(金成柱),오영환(吳永煥),129,147,276,0
11470,김성주(金成柱),용혜인(龍慧仁),15,35,50,1
11471,김성주(金成柱),우상호(禹相虎),80,43,123,0
11472,김성주(金成柱),우원식(禹元植),104,80,184,0
11473,김성주(金成柱),위성곤(魏聖坤),121,131,252,0
11474,김성주(金成柱),유경준(兪京濬),49,4,53,1
11475,김성주(金成柱),유기홍(柳基洪),80,48,128,0
11476,김성주(金成柱),유동수(柳東秀),93,62,155,0
11477,김성주(金成柱),유상범(劉相凡),49,10,59,1
11478,김성주(金成柱),유의동(兪義東),50,10,60,1
11479,김성주(金成柱),유정주(兪訂炷),113,89,202,0
11480,김성주(金成柱),윤건영(尹建永),90,68,158,0
11481,김성주(金成柱),윤관석(尹官石),85,54,139,1
11482,김성주(金成柱),윤두현(尹斗鉉),49,11,60,1
11483,김성주(金成柱),윤미향(尹美香),49,60,109,1
11484,김성주(金成柱),윤상현(尹相現),32,10,42,1
11485,김성주(金成柱),윤영덕(尹永德),89,79,168,0
11486,김성주(金成柱),윤영석(尹永碩),50,5,55,1
11487,김성주(金成柱),윤영찬(尹永燦),86,56,142,0
11488,김성주(金成柱),윤재갑(尹才鉀),102,96,198,0
11489,김성주(金成柱),윤재옥(尹在玉),50,5,55,1
11490,김성주(金成柱),윤주경(尹柱卿),49,11,60,1
11491,김성주(金成柱),윤준병(尹準炳),165,233,398,0
11492,김성주(金成柱),윤창현(尹暢賢),49,12,61,1
11493,김성주(金成柱),윤한홍(尹漢洪),50,10,60,1
11494,김성주(金成柱),윤호중(尹昊重),78,56,134,0
11495,김성주(金成柱),윤후덕(尹厚德),84,74,158,0
11496,김성주(金成柱),이개호(李介昊),87,67,154,0
11497,김성주(金成柱),이달곤(李達坤),51,8,59,1
11498,김성주(金成柱),이동주(李東洲),92,99,191,0
11499,김성주(金成柱),이만희(李晩熙),50,4,54,1
11500,김성주(金成柱),이명수(李明洙),53,14,67,1
11501,김성주(金成柱),이병훈(李炳勳),102,99,201,0
11502,김성주(金成柱),이상민(李相珉),81,38,119,0
11503,김성주(金成柱),이상헌(李相憲),106,100,206,0
11504,김성주(金成柱),이성만(李成萬),87,77,164,1
11505,김성주(金成柱),이소영(李素永),89,56,145,0
11506,김성주(金成柱),이수진(李壽珍),110,109,219,0
11507,김성주(金成柱),이수진(李秀眞),101,78,179,0
11508,김성주(金成柱),이양수(李亮壽),50,5,55,1
11509,김성주(金成柱),이용(李鏞),49,7,56,1
11510,김성주(金成柱),이용빈(李龍彬),163,177,340,0
11511,김성주(金成柱),이용선(李庸瑄),98,106,204,0
11512,김성주(金成柱),이용우(李龍雨),105,73,178,0
11513,김성주(金成柱),이용호(李容鎬),52,52,104,1
11514,김성주(金成柱),이원욱(李元旭),95,66,161,0
11515,김성주(金成柱),이원택(李源澤),102,94,196,0
11516,김성주(金成柱),이은주(李恩周),21,29,50,1
11517,김성주(金成柱),이인선(李仁善),25,5,30,1
11518,김성주(金成柱),이인영(李仁榮),75,47,122,0
11519,김성주(金成柱),이장섭(李將燮),98,87,185,0
11520,김성주(金成柱),이재명(李在明),40,22,62,0
11521,김성주(金成柱),이재정(李在汀),80,47,127,0
11522,김성주(金成柱),이정문(李楨文),104,105,209,0
11523,김성주(金成柱),이종배(李鍾培),50,8,58,1
11524,김성주(金成柱),이종성(李鍾成),49,11,60,1
11525,김성주(金成柱),이주환(李周桓),49,6,55,1
11526,김성주(金成柱),이채익(李埰益),51,6,57,1
11527,김성주(金成柱),이철규(李喆圭),53,13,66,1
11528,김성주(金成柱),이탄희(李誕熙),102,81,183,0
11529,김성주(金成柱),이태규(李泰珪),28,10,38,1
11530,김성주(金成柱),이학영(李學永),121,88,209,0
11531,김성주(金成柱),이해식(李海植),105,96,201,0
11532,김성주(金成柱),이헌승(李憲昇),50,4,54,1
11533,김성주(金成柱),이형석(李炯錫),115,101,216,0
11534,김성주(金成柱),인재근(印在謹),121,121,242,0
11535,김성주(金成柱),임병헌(林炳憲),25,6,31,1
11536,김성주(金成柱),임오경(林五卿),91,81,172,0
11537,김성주(金成柱),임이자(林利子),49,4,53,1
11538,김성주(金成柱),임종성(林鍾聲),107,90,197,0
11539,김성주(金成柱),임호선(林昊宣),140,149,289,0
11540,김성주(金成柱),장경태(張耿態),95,85,180,0
11541,김성주(金成柱),장동혁(張東赫),25,5,30,1
11542,김성주(金成柱),장제원(張濟元),49,4,53,1
11543,김성주(金成柱),장철민(張喆敏),91,80,171,0
11544,김성주(金成柱),장혜영(張惠英),15,27,42,1
11545,김성주(金成柱),전봉민(田奉珉),35,6,41,1
11546,김성주(金成柱),전용기(田溶冀),104,101,205,0
11547,김성주(金成柱),전재수(田載秀),90,60,150,0
11548,김성주(金成柱),전주혜(全珠惠),51,7,58,1
11549,김성주(金成柱),전해철(全海澈),75,46,121,0
11550,김성주(金成柱),전혜숙(全惠淑),88,72,160,0
11551,김성주(金成柱),정경희(丁慶姬),49,9,58,1
11552,김성주(金成柱),정동만(鄭東萬),49,4,53,1
11553,김성주(金成柱),정성호(鄭成湖),80,75,155,0
11554,김성주(金成柱),정우택(鄭宇澤),25,4,29,1
11555,김성주(金成柱),정운천(鄭雲天),51,10,61,1
11556,김성주(金成柱),정일영(鄭日永),101,79,180,0
11557,김성주(金成柱),정점식(鄭点植),50,4,54,1
11558,김성주(金成柱),정진석(鄭鎭碩),50,7,57,1
11559,김성주(金成柱),정청래(鄭淸來),82,46,128,0
11560,김성주(金成柱),정춘숙(鄭春淑),118,114,232,0
11561,김성주(金成柱),정태호(鄭泰浩),92,87,179,0
11562,김성주(金成柱),정필모(鄭必模),118,94,212,0
11563,김성주(金成柱),정희용(鄭熙溶),50,6,56,1
11564,김성주(金成柱),조경태(趙慶泰),49,5,54,1
11565,김성주(金成柱),조명희(曺明姬),49,12,61,1
11566,김성주(金成柱),조수진(趙修眞),49,13,62,1
11567,김성주(金成柱),조승래(趙承來),96,65,161,0
11568,김성주(金成柱),조오섭(曺五燮),101,142,243,0
11569,김성주(金成柱),조은희(趙恩禧),25,5,30,1
11570,김성주(金成柱),조응천(趙應天),75,43,118,0
11571,김성주(金成柱),조정식(趙正湜),79,64,143,0
11572,김성주(金成柱),조정훈(趙廷訓),4,13,17,1
11573,김성주(金成柱),조해진(曺海珍),51,5,56,1
11574,김성주(金成柱),주철현(朱哲鉉),89,74,163,0
11575,김성주(金成柱),주호영(朱豪英),49,4,53,1
11576,김성주(金成柱),지성호(池成浩),49,4,53,1
11577,김성주(金成柱),진선미(陳善美),80,47,127,0
11578,김성주(金成柱),진성준(陳聲準),99,91,190,0
11579,김성주(金成柱),천준호(千俊鎬),99,59,158,0
11580,김성주(金成柱),최기상(崔基相),82,69,151,0
11581,김성주(金成柱),최승재(崔承宰),49,11,60,1
11582,김성주(金成柱),최연숙(崔姸淑),38,24,62,1
11583,김성주(金成柱),최영희(崔英姬),25,5,30,1
11584,김성주(金成柱),최인호(崔仁昊),85,65,150,0
11585,김성주(金成柱),최재형(崔在亨),25,4,29,1
11586,김성주(金成柱),최종윤(崔鍾允),129,148,277,0
11587,김성주(金成柱),최춘식(崔春植),49,10,59,1
11588,김성주(金成柱),최형두(崔炯斗),50,8,58,1
11589,김성주(金成柱),최혜영(崔惠英),138,164,302,0
11590,김성주(金成柱),추경호(秋慶鎬),49,3,52,1
11591,김성주(金成柱),태영호(太永浩),49,7,56,1
11592,김성주(金成柱),하영제(河榮帝),41,4,45,1
11593,김성주(金成柱),하태경(河泰慶),49,4,53,1
11594,김성주(金成柱),한기호(韓起鎬),50,7,57,1
11595,김성주(金成柱),한무경(韓茂景),50,7,57,1
11596,김성주(金成柱),한병도(韓秉道),124,159,283,0
11597,김성주(金成柱),한정애(韓貞愛),88,50,138,0
11598,김성주(金成柱),한준호(韓俊鎬),116,95,211,0
11599,김성주(金成柱),허숙정(許淑湞),1,2,3,0
11600,김성주(金成柱),허영(許榮),125,132,257,0
11601,김성주(金成柱),허은아(許垠娥),49,6,55,1
11602,김성주(金成柱),허종식(許琮植),144,127,271,0
11603,김성주(金成柱),홍기원(洪起元),91,73,164,0
11604,김성주(金成柱),홍문표(洪文杓),50,6,56,1
11605,김성주(金成柱),홍석준(洪碩晙),51,4,55,1
11606,김성주(金成柱),홍성국(洪性國),130,144,274,0
11607,김성주(金成柱),홍영표(洪永杓),88,66,154,0
11608,김성주(金成柱),홍익표(洪翼杓),94,77,171,0
11609,김성주(金成柱),홍정민(洪貞敏),110,83,193,0
11610,김성주(金成柱),황보승희(皇甫承希),46,8,54,1
11611,김성주(金成柱),황운하(黃雲夏),112,95,207,0
11612,김성주(金成柱),황희(黃熙),79,59,138,0
11613,김성환(金星煥),김수흥(金洙興),104,68,172,0
11614,김성환(金星煥),김승남(金承南),90,83,173,0
11615,김성환(金星煥),김승수(金承洙),52,8,60,1
11616,김성환(金星煥),김승원(金勝源),107,114,221,0
11617,김성환(金星煥),김영배(金永培),109,117,226,0
11618,김성환(金星煥),김영선(金映宣),26,4,30,1
11619,김성환(金星煥),김영식(金英植),51,6,57,1
11620,김성환(金星煥),김영주(金榮珠),85,60,145,0
11621,김성환(金星煥),김영진(金榮鎭),90,57,147,0
11622,김성환(金星煥),김영호(金映豪),87,53,140,0
11623,김성환(金星煥),김예지(金睿智),51,4,55,1
11624,김성환(金星煥),김용민(金容民),95,91,186,0
11625,김성환(金星煥),김용판(金用判),52,4,56,1
11626,김성환(金星煥),김웅(金雄),51,5,56,1
11627,김성환(金星煥),김원이(金元二),109,94,203,0
11628,김성환(金星煥),김윤덕(金潤德),90,77,167,0
11629,김성환(金星煥),김의겸(金宜謙),47,49,96,0
11630,김성환(金星煥),김정재(金汀才),53,5,58,1
11631,김성환(金星煥),김정호(金禎鎬),136,235,371,0
11632,김성환(金星煥),김종민(金鐘民),87,72,159,0
11633,김성환(金星煥),김주영(金周暎),101,80,181,0
11634,김성환(金星煥),김진표(金振杓),49,39,88,1
11635,김성환(金星煥),김철민(金哲玟),109,109,218,0
11636,김성환(金星煥),김태년(金太年),80,61,141,0
11637,김성환(金星煥),김태호(金台鎬),42,4,46,1
11638,김성환(金星煥),김학용(金學容),25,4,29,1
11639,김성환(金星煥),김한규(金翰奎),42,63,105,0
11640,김성환(金星煥),김한정(金漢正),79,64,143,0
11641,김성환(金星煥),김형동(金亨東),51,5,56,1
11642,김성환(金星煥),김홍걸(金弘傑),43,80,123,0
11643,김성환(金星煥),김회재(金會在),95,72,167,0
11644,김성환(金星煥),김희곤(金熙坤),50,4,54,1
11645,김성환(金星煥),김희국(金熙國),49,4,53,1
11646,김성환(金星煥),남인순(南仁順),96,62,158,0
11647,김성환(金星煥),노용호(魯容昊),25,4,29,1
11648,김성환(金星煥),노웅래(盧雄來),94,67,161,0
11649,김성환(金星煥),도종환(都鍾煥),85,70,155,0
11650,김성환(金星煥),류성걸(柳性杰),49,4,53,1
11651,김성환(金星煥),류호정(柳好貞),17,27,44,1
11652,김성환(金星煥),맹성규(孟聖奎),87,56,143,0
11653,김성환(金星煥),문정복(文貞福),84,69,153,0
11654,김성환(金星煥),문진석(文振碩),93,84,177,0
11655,김성환(金星煥),민병덕(閔炳德),88,168,256,0
11656,김성환(金星煥),민형배(閔馨培),102,204,306,0
11657,김성환(金星煥),민홍철(閔洪喆),80,53,133,0
11658,김성환(金星煥),박광온(朴洸瑥),84,58,142,0
11659,김성환(金星煥),박대수(朴大壽),50,6,56,1
11660,김성환(金星煥),박대출(朴大出),50,4,54,1
11661,김성환(金星煥),박덕흠(朴德欽),36,5,41,1
11662,김성환(金星煥),박범계(朴範界),78,38,116,0
11663,김성환(金星煥),박병석(朴炳錫),40,18,58,0
11664,김성환(金星煥),박상혁(朴商赫),95,127,222,0
11665,김성환(金星煥),박성민(朴聖敏),49,7,56,1
11666,김성환(金星煥),박성준(朴省俊),86,69,155,0
11667,김성환(金星煥),박성중(朴成重),49,4,53,1
11668,김성환(金星煥),박수영(朴洙瑩),49,5,54,1
11669,김성환(金星煥),박영순(朴英淳),100,79,179,0
11670,김성환(金星煥),박완주(朴完柱),50,43,93,1
11671,김성환(金星煥),박용진(朴用鎭),80,46,126,0
11672,김성환(金星煥),박재호(朴在昊),88,56,144,0
11673,김성환(金星煥),박정(朴釘),106,84,190,0
11674,김성환(金星煥),박정하(朴正河),25,4,29,1
11675,김성환(金星煥),박주민(朴柱民),84,63,147,0
11676,김성환(金星煥),박진(朴振),50,4,54,1
11677,김성환(金星煥),박찬대(朴贊大),88,62,150,0
11678,김성환(金星煥),박형수(朴亨修),49,4,53,1
11679,김성환(金星煥),박홍근(朴洪根),104,122,226,0
11680,김성환(金星煥),배준영(裵俊英),49,4,53,1
11681,김성환(金星煥),배진교(裵晋敎),18,24,42,1
11682,김성환(金星煥),배현진(裵賢鎭),49,5,54,1
11683,김성환(金星煥),백종헌(白宗憲),50,4,54,1
11684,김성환(金星煥),백혜련(白惠蓮),86,56,142,0
11685,김성환(金星煥),변재일(卞在一),77,54,131,0
11686,김성환(金星煥),서동용(徐東榕),93,90,183,0
11687,김성환(金星煥),서범수(徐範洙),50,4,54,1
11688,김성환(金星煥),서병수(徐秉洙),50,5,55,1
11689,김성환(金星煥),서삼석(徐參錫),92,80,172,0
11690,김성환(金星煥),서영교(徐瑛敎),99,135,234,0
11691,김성환(金星煥),서영석(徐暎錫),86,90,176,0
11692,김성환(金星煥),서일준(徐一俊),50,5,55,1
11693,김성환(金星煥),서정숙(徐正淑),49,5,54,1
11694,김성환(金星煥),설훈(薛勳),82,56,138,0
11695,김성환(金星煥),성일종(成一鍾),50,6,56,1
11696,김성환(金星煥),소병철(蘇秉哲),84,58,142,0
11697,김성환(金星煥),소병훈(蘇秉勳),89,86,175,0
11698,김성환(金星煥),송갑석(宋甲錫),96,128,224,0
11699,김성환(金星煥),송기헌(宋基憲),88,49,137,0
11700,김성환(金星煥),송석준(宋錫俊),49,4,53,1
11701,김성환(金星煥),송언석(宋彦錫),45,4,49,1
11702,김성환(金星煥),송옥주(宋玉珠),88,65,153,0
11703,김성환(金星煥),송재호(宋在祜),87,82,169,0
11704,김성환(金星煥),신동근(申東根),83,65,148,0
11705,김성환(金星煥),신영대(申榮大),101,77,178,0
11706,김성환(金星煥),신원식(申源湜),49,4,53,1
11707,김성환(金星煥),신정훈(辛正勳),124,216,340,0
11708,김성환(金星煥),신현영(申賢榮),78,65,143,0
11709,김성환(金星煥),심상정(沈相奵),15,28,43,1
11710,김성환(金星煥),안규백(安圭伯),100,66,166,0
11711,김성환(金星煥),안민석(安敏錫),85,63,148,0
11712,김성환(金星煥),안병길(安炳吉),50,4,54,1
11713,김성환(金星煥),안철수(安哲秀),25,4,29,1
11714,김성환(金星煥),안호영(安浩永),85,78,163,0
11715,김성환(金星煥),양경숙(梁敬淑),90,117,207,0
11716,김성환(金星煥),양금희(梁琴喜),50,5,55,1
11717,김성환(金星煥),양기대(梁基大),89,68,157,0
11718,김성환(金星煥),양이원영(梁李媛瑛),108,130,238,0
11719,김성환(金星煥),양정숙(梁貞淑),51,135,186,1
11720,김성환(金星煥),양향자(梁香子),35,28,63,1
11721,김성환(金星煥),어기구(魚基龜),91,85,176,0
11722,김성환(金星煥),엄태영(嚴泰永),51,4,55,1
11723,김성환(金星煥),오기형(吳奇炯),78,42,120,0
11724,김성환(金星煥),오영환(吳永煥),109,189,298,0
11725,김성환(金星煥),용혜인(龍慧仁),19,33,52,1
11726,김성환(金星煥),우상호(禹相虎),80,42,122,0
11727,김성환(金星煥),우원식(禹元植),100,92,192,0
11728,김성환(金星煥),위성곤(魏聖坤),108,141,249,0
11729,김성환(金星煥),유경준(兪京濬),49,4,53,1
11730,김성환(金星煥),유기홍(柳基洪),82,67,149,0
11731,김성환(金星煥),유동수(柳東秀),86,44,130,0
11732,김성환(金星煥),유상범(劉相凡),49,4,53,1
11733,김성환(金星煥),유의동(兪義東),49,4,53,1
11734,김성환(金星煥),유정주(兪訂炷),102,130,232,0
11735,김성환(金星煥),윤건영(尹建永),81,80,161,0
11736,김성환(金星煥),윤관석(尹官石),70,54,124,1
11737,김성환(金星煥),윤두현(尹斗鉉),49,5,54,1
11738,김성환(金星煥),윤미향(尹美香),45,59,104,1
11739,김성환(金星煥),윤상현(尹相現),30,4,34,1
11740,김성환(金星煥),윤영덕(尹永德),102,108,210,0
11741,김성환(金星煥),윤영석(尹永碩),50,5,55,1
11742,김성환(金星煥),윤영찬(尹永燦),85,56,141,0
11743,김성환(金星煥),윤재갑(尹才鉀),101,95,196,0
11744,김성환(金星煥),윤재옥(尹在玉),49,4,53,1
11745,김성환(金星煥),윤주경(尹柱卿),50,6,56,1
11746,김성환(金星煥),윤준병(尹準炳),128,217,345,0
11747,김성환(金星煥),윤창현(尹暢賢),49,5,54,1
11748,김성환(金星煥),윤한홍(尹漢洪),50,5,55,1
11749,김성환(金星煥),윤호중(尹昊重),82,51,133,0
11750,김성환(金星煥),윤후덕(尹厚德),83,87,170,0
11751,김성환(金星煥),이개호(李介昊),89,76,165,0
11752,김성환(金星煥),이달곤(李達坤),52,7,59,1
11753,김성환(金星煥),이동주(李東洲),107,145,252,0
11754,김성환(金星煥),이만희(李晩熙),49,4,53,1
11755,김성환(金星煥),이명수(李明洙),52,8,60,1
11756,김성환(金星煥),이병훈(李炳勳),95,114,209,0
11757,김성환(金星煥),이상민(李相珉),76,34,110,0
11758,김성환(金星煥),이상헌(李相憲),88,58,146,0
11759,김성환(金星煥),이성만(李成萬),80,80,160,1
11760,김성환(金星煥),이소영(李素永),110,124,234,0
11761,김성환(金星煥),이수진(李壽珍),107,145,252,0
11762,김성환(金星煥),이수진(李秀眞),94,83,177,0
11763,김성환(金星煥),이양수(李亮壽),50,4,54,1
11764,김성환(金星煥),이용(李鏞),49,4,53,1
11765,김성환(金星煥),이용빈(李龍彬),114,185,299,0
11766,김성환(金星煥),이용선(李庸瑄),109,106,215,0
11767,김성환(金星煥),이용우(李龍雨),95,82,177,0
11768,김성환(金星煥),이용호(李容鎬),29,13,42,1
11769,김성환(金星煥),이원욱(李元旭),85,83,168,0
11770,김성환(金星煥),이원택(李源澤),99,85,184,0
11771,김성환(金星煥),이은주(李恩周),19,21,40,1
11772,김성환(金星煥),이인선(李仁善),25,4,29,1
11773,김성환(金星煥),이인영(李仁榮),75,46,121,0
11774,김성환(金星煥),이장섭(李將燮),89,80,169,0
11775,김성환(金星煥),이재명(李在明),40,24,64,0
11776,김성환(金星煥),이재정(李在汀),79,50,129,0
11777,김성환(金星煥),이정문(李楨文),89,87,176,0
11778,김성환(金星煥),이종배(李鍾培),50,6,56,1
11779,김성환(金星煥),이종성(李鍾成),49,4,53,1
11780,김성환(金星煥),이주환(李周桓),49,5,54,1
11781,김성환(金星煥),이채익(李埰益),51,5,56,1
11782,김성환(金星煥),이철규(李喆圭),50,5,55,1
11783,김성환(金星煥),이탄희(李誕熙),94,67,161,0
11784,김성환(金星煥),이태규(李泰珪),28,5,33,1
11785,김성환(金星煥),이학영(李學永),102,92,194,0
11786,김성환(金星煥),이해식(李海植),104,94,198,0
11787,김성환(金星煥),이헌승(李憲昇),51,5,56,1
11788,김성환(金星煥),이형석(李炯錫),94,92,186,0
11789,김성환(金星煥),인재근(印在謹),84,85,169,0
11790,김성환(金星煥),임병헌(林炳憲),25,4,29,1
11791,김성환(金星煥),임오경(林五卿),86,73,159,0
11792,김성환(金星煥),임이자(林利子),49,4,53,1
11793,김성환(金星煥),임종성(林鍾聲),92,88,180,0
11794,김성환(金星煥),임호선(林昊宣),100,115,215,0
11795,김성환(金星煥),장경태(張耿態),97,145,242,0
11796,김성환(金星煥),장동혁(張東赫),25,4,29,1
11797,김성환(金星煥),장제원(張濟元),49,5,54,1
11798,김성환(金星煥),장철민(張喆敏),88,74,162,0
11799,김성환(金星煥),장혜영(張惠英),16,14,30,1
11800,김성환(金星煥),전봉민(田奉珉),35,5,40,1
11801,김성환(金星煥),전용기(田溶冀),86,92,178,0
11802,김성환(金星煥),전재수(田載秀),86,57,143,0
11803,김성환(金星煥),전주혜(全珠惠),51,5,56,1
11804,김성환(金星煥),전해철(全海澈),78,57,135,0
11805,김성환(金星煥),전혜숙(全惠淑),90,74,164,0
11806,김성환(金星煥),정경희(丁慶姬),49,4,53,1
11807,김성환(金星煥),정동만(鄭東萬),49,4,53,1
11808,김성환(金星煥),정성호(鄭成湖),81,68,149,0
11809,김성환(金星煥),정우택(鄭宇澤),25,4,29,1
11810,김성환(金星煥),정운천(鄭雲天),49,4,53,1
11811,김성환(金星煥),정일영(鄭日永),88,72,160,0
11812,김성환(金星煥),정점식(鄭点植),50,4,54,1
11813,김성환(金星煥),정진석(鄭鎭碩),50,5,55,1
11814,김성환(金星煥),정청래(鄭淸來),86,42,128,0
11815,김성환(金星煥),정춘숙(鄭春淑),94,81,175,0
11816,김성환(金星煥),정태호(鄭泰浩),83,90,173,0
11817,김성환(金星煥),정필모(鄭必模),91,83,174,0
11818,김성환(金星煥),정희용(鄭熙溶),50,6,56,1
11819,김성환(金星煥),조경태(趙慶泰),49,4,53,1
11820,김성환(金星煥),조명희(曺明姬),49,7,56,1
11821,김성환(金星煥),조수진(趙修眞),49,4,53,1
11822,김성환(金星煥),조승래(趙承來),79,54,133,0
11823,김성환(金星煥),조오섭(曺五燮),93,170,263,0
11824,김성환(金星煥),조은희(趙恩禧),25,4,29,1
11825,김성환(金星煥),조응천(趙應天),76,37,113,0
11826,김성환(金星煥),조정식(趙正湜),74,44,118,0
11827,김성환(金星煥),조정훈(趙廷訓),6,4,10,1
11828,김성환(金星煥),조해진(曺海珍),51,5,56,1
11829,김성환(金星煥),주철현(朱哲鉉),93,87,180,0
11830,김성환(金星煥),주호영(朱豪英),49,4,53,1
11831,김성환(金星煥),지성호(池成浩),49,4,53,1
11832,김성환(金星煥),진선미(陳善美),83,45,128,0
11833,김성환(金星煥),진성준(陳聲準),101,97,198,0
11834,김성환(金星煥),천준호(千俊鎬),95,56,151,0
11835,김성환(金星煥),최기상(崔基相),83,76,159,0
11836,김성환(金星煥),최승재(崔承宰),49,6,55,1
11837,김성환(金星煥),최연숙(崔姸淑),32,11,43,1
11838,김성환(金星煥),최영희(崔英姬),25,4,29,1
11839,김성환(金星煥),최인호(崔仁昊),86,58,144,0
11840,김성환(金星煥),최재형(崔在亨),25,4,29,1
11841,김성환(金星煥),최종윤(崔鍾允),90,100,190,0
11842,김성환(金星煥),최춘식(崔春植),49,4,53,1
11843,김성환(金星煥),최형두(崔炯斗),51,6,57,1
11844,김성환(金星煥),최혜영(崔惠英),87,85,172,0
11845,김성환(金星煥),추경호(秋慶鎬),49,3,52,1
11846,김성환(金星煥),태영호(太永浩),49,7,56,1
11847,김성환(金星煥),하영제(河榮帝),41,2,43,1
11848,김성환(金星煥),하태경(河泰慶),49,5,54,1
11849,김성환(金星煥),한기호(韓起鎬),50,4,54,1
11850,김성환(金星煥),한무경(韓茂景),49,6,55,1
11851,김성환(金星煥),한병도(韓秉道),99,105,204,0
11852,김성환(金星煥),한정애(韓貞愛),77,44,121,0
11853,김성환(金星煥),한준호(韓俊鎬),92,79,171,0
11854,김성환(金星煥),허숙정(許淑湞),1,2,3,0
11855,김성환(金星煥),허영(許榮),116,144,260,0
11856,김성환(金星煥),허은아(許垠娥),49,5,54,1
11857,김성환(金星煥),허종식(許琮植),92,87,179,0
11858,김성환(金星煥),홍기원(洪起元),97,78,175,0
11859,김성환(金星煥),홍문표(洪文杓),51,4,55,1
11860,김성환(金星煥),홍석준(洪碩晙),50,4,54,1
11861,김성환(金星煥),홍성국(洪性國),100,102,202,0
11862,김성환(金星煥),홍영표(洪永杓),80,49,129,0
11863,김성환(金星煥),홍익표(洪翼杓),88,65,153,0
11864,김성환(金星煥),홍정민(洪貞敏),95,130,225,0
11865,김성환(金星煥),황보승희(皇甫承希),46,2,48,1
11866,김성환(金星煥),황운하(黃雲夏),98,86,184,0
11867,김성환(金星煥),황희(黃熙),84,44,128,0
11868,김수흥(金洙興),김승남(金承南),100,110,210,0
11869,김수흥(金洙興),김승수(金承洙),53,11,64,1
11870,김수흥(金洙興),김승원(金勝源),118,117,235,0
11871,김수흥(金洙興),김영배(金永培),117,106,223,0
11872,김수흥(金洙興),김영선(金映宣),26,4,30,1
11873,김수흥(金洙興),김영식(金英植),52,5,57,1
11874,김수흥(金洙興),김영주(金榮珠),95,60,155,0
11875,김수흥(金洙興),김영진(金榮鎭),97,65,162,0
11876,김수흥(金洙興),김영호(金映豪),95,63,158,0
11877,김수흥(金洙興),김예지(金睿智),54,5,59,1
11878,김수흥(金洙興),김용민(金容民),91,57,148,0
11879,김수흥(金洙興),김용판(金用判),52,4,56,1
11880,김수흥(金洙興),김웅(金雄),51,4,55,1
11881,김수흥(金洙興),김원이(金元二),110,75,185,0
11882,김수흥(金洙興),김윤덕(金潤德),129,159,288,0
11883,김수흥(金洙興),김의겸(金宜謙),51,45,96,0
11884,김수흥(金洙興),김정재(金汀才),54,5,59,1
11885,김수흥(金洙興),김정호(金禎鎬),147,184,331,0
11886,김수흥(金洙興),김종민(金鐘民),91,67,158,0
11887,김수흥(金洙興),김주영(金周暎),139,135,274,0
11888,김수흥(金洙興),김진표(金振杓),87,80,167,1
11889,김수흥(金洙興),김철민(金哲玟),110,109,219,0
11890,김수흥(金洙興),김태년(金太年),82,50,132,0
11891,김수흥(金洙興),김태호(金台鎬),46,11,57,1
11892,김수흥(金洙興),김학용(金學容),27,5,32,1
11893,김수흥(金洙興),김한규(金翰奎),45,38,83,0
11894,김수흥(金洙興),김한정(金漢正),86,53,139,0
11895,김수흥(金洙興),김형동(金亨東),52,9,61,1
11896,김수흥(金洙興),김홍걸(金弘傑),73,146,219,0
11897,김수흥(金洙興),김회재(金會在),111,96,207,0
11898,김수흥(金洙興),김희곤(金熙坤),51,8,59,1
11899,김수흥(金洙興),김희국(金熙國),50,4,54,1
11900,김수흥(金洙興),남인순(南仁順),107,69,176,0
11901,김수흥(金洙興),노용호(魯容昊),25,4,29,1
11902,김수흥(金洙興),노웅래(盧雄來),113,111,224,0
11903,김수흥(金洙興),도종환(都鍾煥),93,63,156,0
11904,김수흥(金洙興),류성걸(柳性杰),49,5,54,1
11905,김수흥(金洙興),류호정(柳好貞),19,33,52,1
11906,김수흥(金洙興),맹성규(孟聖奎),102,61,163,0
11907,김수흥(金洙興),문정복(文貞福),92,53,145,0
11908,김수흥(金洙興),문진석(文振碩),119,133,252,0
11909,김수흥(金洙興),민병덕(閔炳德),109,135,244,0
11910,김수흥(金洙興),민형배(閔馨培),103,177,280,0
11911,김수흥(金洙興),민홍철(閔洪喆),91,90,181,0
11912,김수흥(金洙興),박광온(朴洸瑥),85,60,145,0
11913,김수흥(金洙興),박대수(朴大壽),52,6,58,1
11914,김수흥(金洙興),박대출(朴大出),51,5,56,1
11915,김수흥(金洙興),박덕흠(朴德欽),40,11,51,1
11916,김수흥(金洙興),박범계(朴範界),81,39,120,0
11917,김수흥(金洙興),박병석(朴炳錫),41,19,60,0
11918,김수흥(金洙興),박상혁(朴商赫),121,162,283,0
11919,김수흥(金洙興),박성민(朴聖敏),50,7,57,1
11920,김수흥(金洙興),박성준(朴省俊),112,106,218,0
11921,김수흥(金洙興),박성중(朴成重),50,4,54,1
11922,김수흥(金洙興),박수영(朴洙瑩),50,4,54,1
11923,김수흥(金洙興),박영순(朴英淳),119,118,237,0
11924,김수흥(金洙興),박완주(朴完柱),62,55,117,1
11925,김수흥(金洙興),박용진(朴用鎭),87,72,159,0
11926,김수흥(金洙興),박재호(朴在昊),113,86,199,0
11927,김수흥(金洙興),박정(朴釘),111,85,196,0
11928,김수흥(金洙興),박정하(朴正河),25,4,29,1
11929,김수흥(金洙興),박주민(朴柱民),81,42,123,0
11930,김수흥(金洙興),박진(朴振),50,4,54,1
11931,김수흥(金洙興),박찬대(朴贊大),106,61,167,0
11932,김수흥(金洙興),박형수(朴亨修),49,6,55,1
11933,김수흥(金洙興),박홍근(朴洪根),127,109,236,0
11934,김수흥(金洙興),배준영(裵俊英),50,9,59,1
11935,김수흥(金洙興),배진교(裵晋敎),21,26,47,1
11936,김수흥(金洙興),배현진(裵賢鎭),51,4,55,1
11937,김수흥(金洙興),백종헌(白宗憲),52,5,57,1
11938,김수흥(金洙興),백혜련(白惠蓮),104,51,155,0
11939,김수흥(金洙興),변재일(卞在一),83,48,131,0
11940,김수흥(金洙興),서동용(徐東榕),98,80,178,0
11941,김수흥(金洙興),서범수(徐範洙),55,12,67,1
11942,김수흥(金洙興),서병수(徐秉洙),51,5,56,1
11943,김수흥(金洙興),서삼석(徐參錫),108,82,190,0
11944,김수흥(金洙興),서영교(徐瑛敎),111,126,237,0
11945,김수흥(金洙興),서영석(徐暎錫),97,86,183,0
11946,김수흥(金洙興),서일준(徐一俊),51,7,58,1
11947,김수흥(金洙興),서정숙(徐正淑),50,5,55,1
11948,김수흥(金洙興),설훈(薛勳),87,71,158,0
11949,김수흥(金洙興),성일종(成一鍾),50,11,61,1
11950,김수흥(金洙興),소병철(蘇秉哲),89,59,148,0
11951,김수흥(金洙興),소병훈(蘇秉勳),102,81,183,0
11952,김수흥(金洙興),송갑석(宋甲錫),98,93,191,0
11953,김수흥(金洙興),송기헌(宋基憲),89,57,146,0
11954,김수흥(金洙興),송석준(宋錫俊),51,6,57,1
11955,김수흥(金洙興),송언석(宋彦錫),47,7,54,1
11956,김수흥(金洙興),송옥주(宋玉珠),114,117,231,0
11957,김수흥(金洙興),송재호(宋在祜),108,114,222,0
11958,김수흥(金洙興),신동근(申東根),99,69,168,0
11959,김수흥(金洙興),신영대(申榮大),107,112,219,0
11960,김수흥(金洙興),신원식(申源湜),49,4,53,1
11961,김수흥(金洙興),신정훈(辛正勳),134,166,300,0
11962,김수흥(金洙興),신현영(申賢榮),80,43,123,0
11963,김수흥(金洙興),심상정(沈相奵),16,27,43,1
11964,김수흥(金洙興),안규백(安圭伯),143,133,276,0
11965,김수흥(金洙興),안민석(安敏錫),95,63,158,0
11966,김수흥(金洙興),안병길(安炳吉),53,5,58,1
11967,김수흥(金洙興),안철수(安哲秀),25,5,30,1
11968,김수흥(金洙興),안호영(安浩永),132,178,310,0
11969,김수흥(金洙興),양경숙(梁敬淑),116,112,228,0
11970,김수흥(金洙興),양금희(梁琴喜),50,4,54,1
11971,김수흥(金洙興),양기대(梁基大),97,101,198,0
11972,김수흥(金洙興),양이원영(梁李媛瑛),107,67,174,0
11973,김수흥(金洙興),양정숙(梁貞淑),99,260,359,1
11974,김수흥(金洙興),양향자(梁香子),70,65,135,1
11975,김수흥(金洙興),어기구(魚基龜),91,86,177,0
11976,김수흥(金洙興),엄태영(嚴泰永),53,10,63,1
11977,김수흥(金洙興),오기형(吳奇炯),79,44,123,0
11978,김수흥(金洙興),오영환(吳永煥),127,185,312,0
11979,김수흥(金洙興),용혜인(龍慧仁),23,28,51,1
11980,김수흥(金洙興),우상호(禹相虎),83,44,127,0
11981,김수흥(金洙興),우원식(禹元植),103,70,173,0
11982,김수흥(金洙興),위성곤(魏聖坤),119,163,282,0
11983,김수흥(金洙興),유경준(兪京濬),49,7,56,1
11984,김수흥(金洙興),유기홍(柳基洪),80,54,134,0
11985,김수흥(金洙興),유동수(柳東秀),102,77,179,0
11986,김수흥(金洙興),유상범(劉相凡),49,8,57,1
11987,김수흥(金洙興),유의동(兪義東),52,5,57,1
11988,김수흥(金洙興),유정주(兪訂炷),101,85,186,0
11989,김수흥(金洙興),윤건영(尹建永),90,52,142,0
11990,김수흥(金洙興),윤관석(尹官石),100,63,163,1
11991,김수흥(金洙興),윤두현(尹斗鉉),50,4,54,1
11992,김수흥(金洙興),윤미향(尹美香),68,59,127,1
11993,김수흥(金洙興),윤상현(尹相現),31,6,37,1
11994,김수흥(金洙興),윤영덕(尹永德),97,81,178,0
11995,김수흥(金洙興),윤영석(尹永碩),52,7,59,1
11996,김수흥(金洙興),윤영찬(尹永燦),89,62,151,0
11997,김수흥(金洙興),윤재갑(尹才鉀),116,133,249,0
11998,김수흥(金洙興),윤재옥(尹在玉),52,5,57,1
11999,김수흥(金洙興),윤주경(尹柱卿),50,7,57,1
12000,김수흥(金洙興),윤준병(尹準炳),170,301,471,0
12001,김수흥(金洙興),윤창현(尹暢賢),49,6,55,1
12002,김수흥(金洙興),윤한홍(尹漢洪),52,5,57,1
12003,김수흥(金洙興),윤호중(尹昊重),80,66,146,0
12004,김수흥(金洙興),윤후덕(尹厚德),117,112,229,0
12005,김수흥(金洙興),이개호(李介昊),100,88,188,0
12006,김수흥(金洙興),이달곤(李達坤),53,6,59,1
12007,김수흥(金洙興),이동주(李東洲),99,128,227,0
12008,김수흥(金洙興),이만희(李晩熙),50,4,54,1
12009,김수흥(金洙興),이명수(李明洙),70,33,103,1
12010,김수흥(金洙興),이병훈(李炳勳),109,110,219,0
12011,김수흥(金洙興),이상민(李相珉),81,41,122,0
12012,김수흥(金洙興),이상헌(李相憲),116,137,253,0
12013,김수흥(金洙興),이성만(李成萬),101,76,177,1
12014,김수흥(金洙興),이소영(李素永),90,56,146,0
12015,김수흥(金洙興),이수진(李壽珍),127,150,277,0
12016,김수흥(金洙興),이수진(李秀眞),98,83,181,0
12017,김수흥(金洙興),이양수(李亮壽),51,4,55,1
12018,김수흥(金洙興),이용(李鏞),49,6,55,1
12019,김수흥(金洙興),이용빈(李龍彬),142,210,352,0
12020,김수흥(金洙興),이용선(李庸瑄),107,96,203,0
12021,김수흥(金洙興),이용우(李龍雨),97,71,168,0
12022,김수흥(金洙興),이용호(李容鎬),70,82,152,1
12023,김수흥(金洙興),이원욱(李元旭),113,91,204,0
12024,김수흥(金洙興),이원택(李源澤),105,95,200,0
12025,김수흥(金洙興),이은주(李恩周),23,27,50,1
12026,김수흥(金洙興),이인선(李仁善),25,4,29,1
12027,김수흥(金洙興),이인영(李仁榮),77,43,120,0
12028,김수흥(金洙興),이장섭(李將燮),92,92,184,0
12029,김수흥(金洙興),이재명(李在明),41,19,60,0
12030,김수흥(金洙興),이재정(李在汀),78,43,121,0
12031,김수흥(金洙興),이정문(李楨文),107,108,215,0
12032,김수흥(金洙興),이종배(李鍾培),51,6,57,1
12033,김수흥(金洙興),이종성(李鍾成),50,5,55,1
12034,김수흥(金洙興),이주환(李周桓),49,4,53,1
12035,김수흥(金洙興),이채익(李埰益),51,13,64,1
12036,김수흥(金洙興),이철규(李喆圭),54,8,62,1
12037,김수흥(金洙興),이탄희(李誕熙),97,56,153,0
12038,김수흥(金洙興),이태규(李泰珪),29,7,36,1
12039,김수흥(金洙興),이학영(李學永),103,92,195,0
12040,김수흥(金洙興),이해식(李海植),114,89,203,0
12041,김수흥(金洙興),이헌승(李憲昇),50,4,54,1
12042,김수흥(金洙興),이형석(李炯錫),113,101,214,0
12043,김수흥(金洙興),인재근(印在謹),106,92,198,0
12044,김수흥(金洙興),임병헌(林炳憲),25,4,29,1
12045,김수흥(金洙興),임오경(林五卿),101,92,193,0
12046,김수흥(金洙興),임이자(林利子),50,4,54,1
12047,김수흥(金洙興),임종성(林鍾聲),121,149,270,0
12048,김수흥(金洙興),임호선(林昊宣),131,141,272,0
12049,김수흥(金洙興),장경태(張耿態),100,96,196,0
12050,김수흥(金洙興),장동혁(張東赫),25,4,29,1
12051,김수흥(金洙興),장제원(張濟元),49,4,53,1
12052,김수흥(金洙興),장철민(張喆敏),113,105,218,0
12053,김수흥(金洙興),장혜영(張惠英),16,14,30,1
12054,김수흥(金洙興),전봉민(田奉珉),35,5,40,1
12055,김수흥(金洙興),전용기(田溶冀),118,122,240,0
12056,김수흥(金洙興),전재수(田載秀),105,76,181,0
12057,김수흥(金洙興),전주혜(全珠惠),51,5,56,1
12058,김수흥(金洙興),전해철(全海澈),81,76,157,0
12059,김수흥(金洙興),전혜숙(全惠淑),91,78,169,0
12060,김수흥(金洙興),정경희(丁慶姬),49,4,53,1
12061,김수흥(金洙興),정동만(鄭東萬),49,5,54,1
12062,김수흥(金洙興),정성호(鄭成湖),101,120,221,0
12063,김수흥(金洙興),정우택(鄭宇澤),25,5,30,1
12064,김수흥(金洙興),정운천(鄭雲天),51,12,63,1
12065,김수흥(金洙興),정일영(鄭日永),137,137,274,0
12066,김수흥(金洙興),정점식(鄭点植),52,4,56,1
12067,김수흥(金洙興),정진석(鄭鎭碩),52,9,61,1
12068,김수흥(金洙興),정청래(鄭淸來),89,49,138,0
12069,김수흥(金洙興),정춘숙(鄭春淑),105,78,183,0
12070,김수흥(金洙興),정태호(鄭泰浩),93,73,166,0
12071,김수흥(金洙興),정필모(鄭必模),97,66,163,0
12072,김수흥(金洙興),정희용(鄭熙溶),50,5,55,1
12073,김수흥(金洙興),조경태(趙慶泰),51,7,58,1
12074,김수흥(金洙興),조명희(曺明姬),52,13,65,1
12075,김수흥(金洙興),조수진(趙修眞),52,6,58,1
12076,김수흥(金洙興),조승래(趙承來),105,72,177,0
12077,김수흥(金洙興),조오섭(曺五燮),100,130,230,0
12078,김수흥(金洙興),조은희(趙恩禧),25,5,30,1
12079,김수흥(金洙興),조응천(趙應天),86,50,136,0
12080,김수흥(金洙興),조정식(趙正湜),90,57,147,0
12081,김수흥(金洙興),조정훈(趙廷訓),5,9,14,1
12082,김수흥(金洙興),조해진(曺海珍),51,6,57,1
12083,김수흥(金洙興),주철현(朱哲鉉),93,84,177,0
12084,김수흥(金洙興),주호영(朱豪英),50,4,54,1
12085,김수흥(金洙興),지성호(池成浩),50,4,54,1
12086,김수흥(金洙興),진선미(陳善美),91,59,150,0
12087,김수흥(金洙興),진성준(陳聲準),107,113,220,0
12088,김수흥(金洙興),천준호(千俊鎬),103,63,166,0
12089,김수흥(金洙興),최기상(崔基相),88,65,153,0
12090,김수흥(金洙興),최승재(崔承宰),51,10,61,1
12091,김수흥(金洙興),최연숙(崔姸淑),33,17,50,1
12092,김수흥(金洙興),최영희(崔英姬),25,5,30,1
12093,김수흥(金洙興),최인호(崔仁昊),121,115,236,0
12094,김수흥(金洙興),최재형(崔在亨),26,5,31,1
12095,김수흥(金洙興),최종윤(崔鍾允),112,136,248,0
12096,김수흥(金洙興),최춘식(崔春植),50,11,61,1
12097,김수흥(金洙興),최형두(崔炯斗),52,5,57,1
12098,김수흥(金洙興),최혜영(崔惠英),103,82,185,0
12099,김수흥(金洙興),추경호(秋慶鎬),51,7,58,1
12100,김수흥(金洙興),태영호(太永浩),51,13,64,1
12101,김수흥(金洙興),하영제(河榮帝),43,5,48,1
12102,김수흥(金洙興),하태경(河泰慶),51,5,56,1
12103,김수흥(金洙興),한기호(韓起鎬),53,8,61,1
12104,김수흥(金洙興),한무경(韓茂景),52,5,57,1
12105,김수흥(金洙興),한병도(韓秉道),166,186,352,0
12106,김수흥(金洙興),한정애(韓貞愛),84,44,128,0
12107,김수흥(金洙興),한준호(韓俊鎬),95,110,205,0
12108,김수흥(金洙興),허숙정(許淑湞),1,1,2,0
12109,김수흥(金洙興),허영(許榮),149,142,291,0
12110,김수흥(金洙興),허은아(許垠娥),49,4,53,1
12111,김수흥(金洙興),허종식(許琮植),120,106,226,0
12112,김수흥(金洙興),홍기원(洪起元),106,102,208,0
12113,김수흥(金洙興),홍문표(洪文杓),54,11,65,1
12114,김수흥(金洙興),홍석준(洪碩晙),51,4,55,1
12115,김수흥(金洙興),홍성국(洪性國),130,129,259,0
12116,김수흥(金洙興),홍영표(洪永杓),93,54,147,0
12117,김수흥(金洙興),홍익표(洪翼杓),94,73,167,0
12118,김수흥(金洙興),홍정민(洪貞敏),100,88,188,0
12119,김수흥(金洙興),황보승희(皇甫承希),49,2,51,1
12120,김수흥(金洙興),황운하(黃雲夏),114,117,231,0
12121,김수흥(金洙興),황희(黃熙),83,65,148,0
12122,김승남(金承南),김승수(金承洙),53,9,62,1
12123,김승남(金承南),김승원(金勝源),116,153,269,0
12124,김승남(金承南),김영배(金永培),100,119,219,0
12125,김승남(金承南),김영선(金映宣),26,4,30,1
12126,김승남(金承南),김영식(金英植),51,4,55,1
12127,김승남(金承南),김영주(金榮珠),89,92,181,0
12128,김승남(金承南),김영진(金榮鎭),89,92,181,0
12129,김승남(金承南),김영호(金映豪),98,127,225,0
12130,김승남(金承南),김예지(金睿智),53,4,57,1
12131,김승남(金承南),김용민(金容民),100,88,188,0
12132,김승남(金承南),김용판(金用判),52,5,57,1
12133,김승남(金承南),김웅(金雄),51,4,55,1
12134,김승남(金承南),김원이(金元二),115,157,272,0
12135,김승남(金承南),김윤덕(金潤德),95,90,185,0
12136,김승남(金承南),김의겸(金宜謙),53,96,149,0
12137,김승남(金承南),김정재(金汀才),53,5,58,1
12138,김승남(金承南),김정호(金禎鎬),145,241,386,0
12139,김승남(金承南),김종민(金鐘民),87,93,180,0
12140,김승남(金承南),김주영(金周暎),88,129,217,0
12141,김승남(金承南),김진표(金振杓),55,61,116,1
12142,김승남(金承南),김철민(金哲玟),109,152,261,0
12143,김승남(金承南),김태년(金太年),85,94,179,0
12144,김승남(金承南),김태호(金台鎬),43,7,50,1
12145,김승남(金承南),김학용(金學容),26,7,33,1
12146,김승남(金承南),김한규(金翰奎),44,52,96,0
12147,김승남(金承南),김한정(金漢正),84,55,139,0
12148,김승남(金承南),김형동(金亨東),53,5,58,1
12149,김승남(金承南),김홍걸(金弘傑),61,194,255,0
12150,김승남(金承南),김회재(金會在),118,143,261,0
12151,김승남(金承南),김희곤(金熙坤),50,6,56,1
12152,김승남(金承南),김희국(金熙國),49,4,53,1
12153,김승남(金承南),남인순(南仁順),123,140,263,0
12154,김승남(金承南),노용호(魯容昊),25,4,29,1
12155,김승남(金承南),노웅래(盧雄來),100,120,220,0
12156,김승남(金承南),도종환(都鍾煥),93,109,202,0
12157,김승남(金承南),류성걸(柳性杰),49,4,53,1
12158,김승남(金承南),류호정(柳好貞),22,56,78,1
12159,김승남(金承南),맹성규(孟聖奎),104,103,207,0
12160,김승남(金承南),문정복(文貞福),89,75,164,0
12161,김승남(金承南),문진석(文振碩),108,116,224,0
12162,김승남(金承南),민병덕(閔炳德),99,211,310,0
12163,김승남(金承南),민형배(閔馨培),99,174,273,0
12164,김승남(金承南),민홍철(閔洪喆),99,124,223,0
12165,김승남(金承南),박광온(朴洸瑥),92,94,186,0
12166,김승남(金承南),박대수(朴大壽),49,6,55,1
12167,김승남(金承南),박대출(朴大出),50,4,54,1
12168,김승남(金承南),박덕흠(朴德欽),39,8,47,1
12169,김승남(金承南),박범계(朴範界),81,37,118,0
12170,김승남(金承南),박병석(朴炳錫),41,18,59,0
12171,김승남(金承南),박상혁(朴商赫),93,172,265,0
12172,김승남(金承南),박성민(朴聖敏),49,10,59,1
12173,김승남(金承南),박성준(朴省俊),118,166,284,0
12174,김승남(金承南),박성중(朴成重),49,5,54,1
12175,김승남(金承南),박수영(朴洙瑩),49,4,53,1
12176,김승남(金承南),박영순(朴英淳),101,119,220,0
12177,김승남(金承南),박완주(朴完柱),57,61,118,1
12178,김승남(金承南),박용진(朴用鎭),81,64,145,0
12179,김승남(金承南),박재호(朴在昊),86,76,162,0
12180,김승남(金承南),박정(朴釘),110,174,284,0
12181,김승남(金承南),박정하(朴正河),25,4,29,1
12182,김승남(金承南),박주민(朴柱民),86,70,156,0
12183,김승남(金承南),박진(朴振),50,4,54,1
12184,김승남(金承南),박찬대(朴贊大),90,82,172,0
12185,김승남(金承南),박형수(朴亨修),49,4,53,1
12186,김승남(金承南),박홍근(朴洪根),107,107,214,0
12187,김승남(金承南),배준영(裵俊英),49,5,54,1
12188,김승남(金承南),배진교(裵晋敎),17,31,48,1
12189,김승남(金承南),배현진(裵賢鎭),49,4,53,1
12190,김승남(金承南),백종헌(白宗憲),50,4,54,1
12191,김승남(金承南),백혜련(白惠蓮),102,81,183,0
12192,김승남(金承南),변재일(卞在一),84,54,138,0
12193,김승남(金承南),서동용(徐東榕),117,204,321,0
12194,김승남(金承南),서범수(徐範洙),51,8,59,1
12195,김승남(金承南),서병수(徐秉洙),50,5,55,1
12196,김승남(金承南),서삼석(徐參錫),135,181,316,0
12197,김승남(金承南),서영교(徐瑛敎),109,200,309,0
12198,김승남(金承南),서영석(徐暎錫),86,116,202,0
12199,김승남(金承南),서일준(徐一俊),51,6,57,1
12200,김승남(金承南),서정숙(徐正淑),49,4,53,1
12201,김승남(金承南),설훈(薛勳),84,85,169,0
12202,김승남(金承南),성일종(成一鍾),50,6,56,1
12203,김승남(金承南),소병철(蘇秉哲),109,122,231,0
12204,김승남(金承南),소병훈(蘇秉勳),124,218,342,0
12205,김승남(金承南),송갑석(宋甲錫),134,202,336,0
12206,김승남(金承南),송기헌(宋基憲),88,56,144,0
12207,김승남(金承南),송석준(宋錫俊),51,11,62,1
12208,김승남(金承南),송언석(宋彦錫),45,4,49,1
12209,김승남(金承南),송옥주(宋玉珠),91,132,223,0
12210,김승남(金承南),송재호(宋在祜),106,153,259,0
12211,김승남(金承南),신동근(申東根),86,81,167,0
12212,김승남(金承南),신영대(申榮大),89,96,185,0
12213,김승남(金承南),신원식(申源湜),49,4,53,1
12214,김승남(金承南),신정훈(辛正勳),167,381,548,0
12215,김승남(金承南),신현영(申賢榮),84,67,151,0
12216,김승남(金承南),심상정(沈相奵),15,29,44,1
12217,김승남(金承南),안규백(安圭伯),102,116,218,0
12218,김승남(金承南),안민석(安敏錫),97,97,194,0
12219,김승남(金承南),안병길(安炳吉),51,5,56,1
12220,김승남(金承南),안철수(安哲秀),25,4,29,1
12221,김승남(金承南),안호영(安浩永),104,157,261,0
12222,김승남(金承南),양경숙(梁敬淑),102,127,229,0
12223,김승남(金承南),양금희(梁琴喜),50,6,56,1
12224,김승남(金承南),양기대(梁基大),85,98,183,0
12225,김승남(金承南),양이원영(梁李媛瑛),96,83,179,0
12226,김승남(金承南),양정숙(梁貞淑),68,180,248,1
12227,김승남(金承南),양향자(梁香子),57,80,137,1
12228,김승남(金承南),어기구(魚基龜),101,191,292,0
12229,김승남(金承南),엄태영(嚴泰永),50,5,55,1
12230,김승남(金承南),오기형(吳奇炯),75,47,122,0
12231,김승남(金承南),오영환(吳永煥),129,240,369,0
12232,김승남(金承南),용혜인(龍慧仁),21,60,81,1
12233,김승남(金承南),우상호(禹相虎),82,53,135,0
12234,김승남(金承南),우원식(禹元植),93,106,199,0
12235,김승남(金承南),위성곤(魏聖坤),148,270,418,0
12236,김승남(金承南),유경준(兪京濬),49,5,54,1
12237,김승남(金承南),유기홍(柳基洪),81,73,154,0
12238,김승남(金承南),유동수(柳東秀),91,73,164,0
12239,김승남(金承南),유상범(劉相凡),49,4,53,1
12240,김승남(金承南),유의동(兪義東),49,6,55,1
12241,김승남(金承南),유정주(兪訂炷),109,133,242,0
12242,김승남(金承南),윤건영(尹建永),86,98,184,0
12243,김승남(金承南),윤관석(尹官石),92,75,167,1
12244,김승남(金承南),윤두현(尹斗鉉),49,4,53,1
12245,김승남(金承南),윤미향(尹美香),63,131,194,1
12246,김승남(金承南),윤상현(尹相現),30,6,36,1
12247,김승남(金承南),윤영덕(尹永德),118,155,273,0
12248,김승남(金承南),윤영석(尹永碩),50,10,60,1
12249,김승남(金承南),윤영찬(尹永燦),83,70,153,0
12250,김승남(金承南),윤재갑(尹才鉀),168,270,438,0
12251,김승남(金承南),윤재옥(尹在玉),49,4,53,1
12252,김승남(金承南),윤주경(尹柱卿),49,8,57,1
12253,김승남(金承南),윤준병(尹準炳),116,279,395,0
12254,김승남(金承南),윤창현(尹暢賢),49,6,55,1
12255,김승남(金承南),윤한홍(尹漢洪),50,5,55,1
12256,김승남(金承南),윤호중(尹昊重),81,77,158,0
12257,김승남(金承南),윤후덕(尹厚德),84,66,150,0
12258,김승남(金承南),이개호(李介昊),147,260,407,0
12259,김승남(金承南),이달곤(李達坤),53,7,60,1
12260,김승남(金承南),이동주(李東洲),95,142,237,0
12261,김승남(金承南),이만희(李晩熙),51,4,55,1
12262,김승남(金承南),이명수(李明洙),50,16,66,1
12263,김승남(金承南),이병훈(李炳勳),108,212,320,0
12264,김승남(金承南),이상민(李相珉),81,50,131,0
12265,김승남(金承南),이상헌(李相憲),102,175,277,0
12266,김승남(金承南),이성만(李成萬),92,169,261,1
12267,김승남(金承南),이소영(李素永),79,53,132,0
12268,김승남(金承南),이수진(李壽珍),120,142,262,0
12269,김승남(金承南),이수진(李秀眞),95,105,200,0
12270,김승남(金承南),이양수(李亮壽),52,6,58,1
12271,김승남(金承南),이용(李鏞),49,5,54,1
12272,김승남(金承南),이용빈(李龍彬),123,197,320,0
12273,김승남(金承南),이용선(李庸瑄),95,94,189,0
12274,김승남(金承南),이용우(李龍雨),93,95,188,0
12275,김승남(金承南),이용호(李容鎬),32,25,57,1
12276,김승남(金承南),이원욱(李元旭),87,102,189,0
12277,김승남(金承南),이원택(李源澤),119,155,274,0
12278,김승남(金承南),이은주(李恩周),18,31,49,1
12279,김승남(金承南),이인선(李仁善),25,4,29,1
12280,김승남(金承南),이인영(李仁榮),95,114,209,0
12281,김승남(金承南),이장섭(李將燮),87,93,180,0
12282,김승남(金承南),이재명(李在明),40,19,59,0
12283,김승남(金承南),이재정(李在汀),85,49,134,0
12284,김승남(金承南),이정문(李楨文),97,102,199,0
12285,김승남(金承南),이종배(李鍾培),50,7,57,1
12286,김승남(金承南),이종성(李鍾成),49,5,54,1
12287,김승남(金承南),이주환(李周桓),49,4,53,1
12288,김승남(金承南),이채익(李埰益),51,12,63,1
12289,김승남(金承南),이철규(李喆圭),50,4,54,1
12290,김승남(金承南),이탄희(李誕熙),90,75,165,0
12291,김승남(金承南),이태규(李泰珪),28,4,32,1
12292,김승남(金承南),이학영(李學永),106,148,254,0
12293,김승남(金承南),이해식(李海植),110,106,216,0
12294,김승남(金承南),이헌승(李憲昇),51,5,56,1
12295,김승남(金承南),이형석(李炯錫),113,119,232,0
12296,김승남(金承南),인재근(印在謹),117,197,314,0
12297,김승남(金承南),임병헌(林炳憲),25,4,29,1
12298,김승남(金承南),임오경(林五卿),84,86,170,0
12299,김승남(金承南),임이자(林利子),49,4,53,1
12300,김승남(金承南),임종성(林鍾聲),100,178,278,0
12301,김승남(金承南),임호선(林昊宣),100,215,315,0
12302,김승남(金承南),장경태(張耿態),103,124,227,0
12303,김승남(金承南),장동혁(張東赫),25,4,29,1
12304,김승남(金承南),장제원(張濟元),49,4,53,1
12305,김승남(金承南),장철민(張喆敏),93,118,211,0
12306,김승남(金承南),장혜영(張惠英),13,17,30,1
12307,김승남(金承南),전봉민(田奉珉),35,5,40,1
12308,김승남(金承南),전용기(田溶冀),100,108,208,0
12309,김승남(金承南),전재수(田載秀),95,94,189,0
12310,김승남(金承南),전주혜(全珠惠),51,4,55,1
12311,김승남(金承南),전해철(全海澈),86,113,199,0
12312,김승남(金承南),전혜숙(全惠淑),98,120,218,0
12313,김승남(金承南),정경희(丁慶姬),49,4,53,1
12314,김승남(金承南),정동만(鄭東萬),49,4,53,1
12315,김승남(金承南),정성호(鄭成湖),87,113,200,0
12316,김승남(金承南),정우택(鄭宇澤),25,4,29,1
12317,김승남(金承南),정운천(鄭雲天),51,12,63,1
12318,김승남(金承南),정일영(鄭日永),87,123,210,0
12319,김승남(金承南),정점식(鄭点植),50,5,55,1
12320,김승남(金承南),정진석(鄭鎭碩),50,6,56,1
12321,김승남(金承南),정청래(鄭淸來),100,83,183,0
12322,김승남(金承南),정춘숙(鄭春淑),92,96,188,0
12323,김승남(金承南),정태호(鄭泰浩),89,147,236,0
12324,김승남(金承南),정필모(鄭必模),92,88,180,0
12325,김승남(金承南),정희용(鄭熙溶),52,6,58,1
12326,김승남(金承南),조경태(趙慶泰),50,9,59,1
12327,김승남(金承南),조명희(曺明姬),49,5,54,1
12328,김승남(金承南),조수진(趙修眞),49,4,53,1
12329,김승남(金承南),조승래(趙承來),93,99,192,0
12330,김승남(金承南),조오섭(曺五燮),149,326,475,0
12331,김승남(金承南),조은희(趙恩禧),26,7,33,1
12332,김승남(金承南),조응천(趙應天),74,48,122,0
12333,김승남(金承南),조정식(趙正湜),78,68,146,0
12334,김승남(金承南),조정훈(趙廷訓),4,18,22,1
12335,김승남(金承南),조해진(曺海珍),51,6,57,1
12336,김승남(金承南),주철현(朱哲鉉),134,223,357,0
12337,김승남(金承南),주호영(朱豪英),49,5,54,1
12338,김승남(金承南),지성호(池成浩),49,4,53,1
12339,김승남(金承南),진선미(陳善美),86,63,149,0
12340,김승남(金承南),진성준(陳聲準),92,96,188,0
12341,김승남(金承南),천준호(千俊鎬),88,55,143,0
12342,김승남(金承南),최기상(崔基相),87,78,165,0
12343,김승남(金承南),최승재(崔承宰),49,5,54,1
12344,김승남(金承南),최연숙(崔姸淑),34,13,47,1
12345,김승남(金承南),최영희(崔英姬),25,5,30,1
12346,김승남(金承南),최인호(崔仁昊),98,124,222,0
12347,김승남(金承南),최재형(崔在亨),25,4,29,1
12348,김승남(金承南),최종윤(崔鍾允),130,222,352,0
12349,김승남(金承南),최춘식(崔春植),50,6,56,1
12350,김승남(金承南),최형두(崔炯斗),51,9,60,1
12351,김승남(金承南),최혜영(崔惠英),97,136,233,0
12352,김승남(金承南),추경호(秋慶鎬),50,5,55,1
12353,김승남(金承南),태영호(太永浩),49,5,54,1
12354,김승남(金承南),하영제(河榮帝),41,7,48,1
12355,김승남(金承南),하태경(河泰慶),51,4,55,1
12356,김승남(金承南),한기호(韓起鎬),50,7,57,1
12357,김승남(金承南),한무경(韓茂景),49,4,53,1
12358,김승남(金承南),한병도(韓秉道),111,143,254,0
12359,김승남(金承南),한정애(韓貞愛),88,105,193,0
12360,김승남(金承南),한준호(韓俊鎬),97,155,252,0
12361,김승남(金承南),허숙정(許淑湞),1,2,3,0
12362,김승남(金承南),허영(許榮),107,185,292,0
12363,김승남(金承南),허은아(許垠娥),49,5,54,1
12364,김승남(金承南),허종식(許琮植),100,138,238,0
12365,김승남(金承南),홍기원(洪起元),84,91,175,0
12366,김승남(金承南),홍문표(洪文杓),57,21,78,1
12367,김승남(金承南),홍석준(洪碩晙),50,4,54,1
12368,김승남(金承南),홍성국(洪性國),111,163,274,0
12369,김승남(金承南),홍영표(洪永杓),87,89,176,0
12370,김승남(金承南),홍익표(洪翼杓),92,102,194,0
12371,김승남(金承南),홍정민(洪貞敏),112,130,242,0
12372,김승남(金承南),황보승희(皇甫承希),46,2,48,1
12373,김승남(金承南),황운하(黃雲夏),101,138,239,0
12374,김승남(金承南),황희(黃熙),78,76,154,0
12375,김승수(金承洙),김승원(金勝源),53,9,62,1
12376,김승수(金承洙),김영배(金永培),53,13,66,1
12377,김승수(金承洙),김영선(金映宣),28,26,54,0
12378,김승수(金承洙),김영식(金英植),114,196,310,0
12379,김승수(金承洙),김영주(金榮珠),54,8,62,1
12380,김승수(金承洙),김영진(金榮鎭),54,4,58,1
12381,김승수(金承洙),김영호(金映豪),52,6,58,1
12382,김승수(金承洙),김예지(金睿智),139,327,466,0
12383,김승수(金承洙),김용민(金容民),52,5,57,1
12384,김승수(金承洙),김용판(金用判),160,317,477,0
12385,김승수(金承洙),김웅(金雄),75,74,149,0
12386,김승수(金承洙),김원이(金元二),52,9,61,1
12387,김승수(金承洙),김윤덕(金潤德),52,6,58,1
12388,김승수(金承洙),김의겸(金宜謙),26,8,34,1
12389,김승수(金承洙),김정재(金汀才),106,127,233,0
12390,김승수(金承洙),김정호(金禎鎬),53,14,67,1
12391,김승수(金承洙),김종민(金鐘民),51,8,59,1
12392,김승수(金承洙),김주영(金周暎),53,9,62,1
12393,김승수(金承洙),김진표(金振杓),27,4,31,1
12394,김승수(金承洙),김철민(金哲玟),52,4,56,1
12395,김승수(金承洙),김태년(金太年),51,6,57,1
12396,김승수(金承洙),김태호(金台鎬),70,73,143,0
12397,김승수(金承洙),김학용(金學容),45,57,102,0
12398,김승수(金承洙),김한규(金翰奎),26,5,31,1
12399,김승수(金承洙),김한정(金漢正),52,6,58,1
12400,김승수(金承洙),김형동(金亨東),110,149,259,0
12401,김승수(金承洙),김홍걸(金弘傑),15,8,23,1
12402,김승수(金承洙),김회재(金會在),52,9,61,1
12403,김승수(金承洙),김희곤(金熙坤),87,114,201,0
12404,김승수(金承洙),김희국(金熙國),90,100,190,0
12405,김승수(金承洙),남인순(南仁順),50,11,61,1
12406,김승수(金承洙),노용호(魯容昊),33,44,77,0
12407,김승수(金承洙),노웅래(盧雄來),52,8,60,1
12408,김승수(金承洙),도종환(都鍾煥),54,12,66,1
12409,김승수(金承洙),류성걸(柳性杰),87,88,175,0
12410,김승수(金承洙),류호정(柳好貞),9,15,24,1
12411,김승수(金承洙),맹성규(孟聖奎),50,6,56,1
12412,김승수(金承洙),문정복(文貞福),49,5,54,1
12413,김승수(金承洙),문진석(文振碩),50,8,58,1
12414,김승수(金承洙),민병덕(閔炳德),52,13,65,1
12415,김승수(金承洙),민형배(閔馨培),34,9,43,1
12416,김승수(金承洙),민홍철(閔洪喆),51,6,57,1
12417,김승수(金承洙),박광온(朴洸瑥),50,6,56,1
12418,김승수(金承洙),박대수(朴大壽),106,243,349,0
12419,김승수(金承洙),박대출(朴大出),79,103,182,0
12420,김승수(金承洙),박덕흠(朴德欽),85,175,260,0
12421,김승수(金承洙),박범계(朴範界),49,4,53,1
12422,김승수(金承洙),박병석(朴炳錫),26,3,29,1
12423,김승수(金承洙),박상혁(朴商赫),51,8,59,1
12424,김승수(金承洙),박성민(朴聖敏),85,187,272,0
12425,김승수(金承洙),박성준(朴省俊),51,6,57,1
12426,김승수(金承洙),박성중(朴成重),86,85,171,0
12427,김승수(金承洙),박수영(朴洙瑩),70,68,138,0
12428,김승수(金承洙),박영순(朴英淳),51,7,58,1
12429,김승수(金承洙),박완주(朴完柱),24,2,26,1
12430,김승수(金承洙),박용진(朴用鎭),50,7,57,1
12431,김승수(金承洙),박재호(朴在昊),51,8,59,1
12432,김승수(金承洙),박정(朴釘),52,11,63,1
12433,김승수(金承洙),박정하(朴正河),38,32,70,0
12434,김승수(金承洙),박주민(朴柱民),51,7,58,1
12435,김승수(金承洙),박진(朴振),85,127,212,0
12436,김승수(金承洙),박찬대(朴贊大),51,7,58,1
12437,김승수(金承洙),박형수(朴亨修),74,78,152,0
12438,김승수(金承洙),박홍근(朴洪根),50,6,56,1
12439,김승수(金承洙),배준영(裵俊英),84,88,172,0
12440,김승수(金承洙),배진교(裵晋敎),5,6,11,1
12441,김승수(金承洙),배현진(裵賢鎭),91,85,176,0
12442,김승수(金承洙),백종헌(白宗憲),92,171,263,0
12443,김승수(金承洙),백혜련(白惠蓮),50,10,60,1
12444,김승수(金承洙),변재일(卞在一),51,6,57,1
12445,김승수(金承洙),서동용(徐東榕),51,7,58,1
12446,김승수(金承洙),서범수(徐範洙),78,96,174,0
12447,김승수(金承洙),서병수(徐秉洙),98,113,211,0
12448,김승수(金承洙),서삼석(徐參錫),52,6,58,1
12449,김승수(金承洙),서영교(徐瑛敎),50,11,61,1
12450,김승수(金承洙),서영석(徐暎錫),50,10,60,1
12451,김승수(金承洙),서일준(徐一俊),130,235,365,0
12452,김승수(金承洙),서정숙(徐正淑),94,141,235,0
12453,김승수(金承洙),설훈(薛勳),50,8,58,1
12454,김승수(金承洙),성일종(成一鍾),96,158,254,0
12455,김승수(金承洙),소병철(蘇秉哲),52,6,58,1
12456,김승수(金承洙),소병훈(蘇秉勳),51,8,59,1
12457,김승수(金承洙),송갑석(宋甲錫),50,9,59,1
12458,김승수(金承洙),송기헌(宋基憲),51,8,59,1
12459,김승수(金承洙),송석준(宋錫俊),79,104,183,0
12460,김승수(金承洙),송언석(宋彦錫),77,87,164,0
12461,김승수(金承洙),송옥주(宋玉珠),51,7,58,1
12462,김승수(金承洙),송재호(宋在祜),50,7,57,1
12463,김승수(金承洙),신동근(申東根),50,4,54,1
12464,김승수(金承洙),신영대(申榮大),51,5,56,1
12465,김승수(金承洙),신원식(申源湜),99,157,256,0
12466,김승수(金承洙),신정훈(辛正勳),52,9,61,1
12467,김승수(金承洙),신현영(申賢榮),51,8,59,1
12468,김승수(金承洙),심상정(沈相奵),6,6,12,1
12469,김승수(金承洙),안규백(安圭伯),54,11,65,1
12470,김승수(金承洙),안민석(安敏錫),51,6,57,1
12471,김승수(金承洙),안병길(安炳吉),93,111,204,0
12472,김승수(金承洙),안철수(安哲秀),27,19,46,0
12473,김승수(金承洙),안호영(安浩永),50,8,58,1
12474,김승수(金承洙),양경숙(梁敬淑),50,7,57,1
12475,김승수(金承洙),양금희(梁琴喜),140,210,350,0
12476,김승수(金承洙),양기대(梁基大),51,8,59,1
12477,김승수(金承洙),양이원영(梁李媛瑛),46,7,53,1
12478,김승수(金承洙),양정숙(梁貞淑),3,8,11,1
12479,김승수(金承洙),양향자(梁香子),20,12,32,1
12480,김승수(金承洙),어기구(魚基龜),52,9,61,1
12481,김승수(金承洙),엄태영(嚴泰永),82,115,197,0
12482,김승수(金承洙),오기형(吳奇炯),49,7,56,1
12483,김승수(金承洙),오영환(吳永煥),52,18,70,1
12484,김승수(金承洙),용혜인(龍慧仁),3,9,12,1
12485,김승수(金承洙),우상호(禹相虎),49,4,53,1
12486,김승수(金承洙),우원식(禹元植),51,9,60,1
12487,김승수(金承洙),위성곤(魏聖坤),50,11,61,1
12488,김승수(金承洙),유경준(兪京濬),101,116,217,0
12489,김승수(金承洙),유기홍(柳基洪),50,6,56,1
12490,김승수(金承洙),유동수(柳東秀),52,6,58,1
12491,김승수(金承洙),유상범(劉相凡),81,94,175,0
12492,김승수(金承洙),유의동(兪義東),87,104,191,0
12493,김승수(金承洙),유정주(兪訂炷),53,7,60,1
12494,김승수(金承洙),윤건영(尹建永),50,9,59,1
12495,김승수(金承洙),윤관석(尹官石),41,3,44,1
12496,김승수(金承洙),윤두현(尹斗鉉),97,149,246,0
12497,김승수(金承洙),윤미향(尹美香),21,7,28,1
12498,김승수(金承洙),윤상현(尹相現),39,51,90,0
12499,김승수(金承洙),윤영덕(尹永德),50,8,58,1
12500,김승수(金承洙),윤영석(尹永碩),69,75,144,0
12501,김승수(金承洙),윤영찬(尹永燦),49,5,54,1
12502,김승수(金承洙),윤재갑(尹才鉀),54,12,66,1
12503,김승수(金承洙),윤재옥(尹在玉),108,93,201,0
12504,김승수(金承洙),윤주경(尹柱卿),77,80,157,0
12505,김승수(金承洙),윤준병(尹準炳),51,11,62,1
12506,김승수(金承洙),윤창현(尹暢賢),91,134,225,0
12507,김승수(金承洙),윤한홍(尹漢洪),105,137,242,0
12508,김승수(金承洙),윤호중(尹昊重),51,6,57,1
12509,김승수(金承洙),윤후덕(尹厚德),51,4,55,1
12510,김승수(金承洙),이개호(李介昊),50,6,56,1
12511,김승수(金承洙),이달곤(李達坤),70,105,175,0
12512,김승수(金承洙),이동주(李東洲),50,6,56,1
12513,김승수(金承洙),이만희(李晩熙),82,84,166,0
12514,김승수(金承洙),이명수(李明洙),105,183,288,0
12515,김승수(金承洙),이병훈(李炳勳),56,13,69,1
12516,김승수(金承洙),이상민(李相珉),51,8,59,1
12517,김승수(金承洙),이상헌(李相憲),55,14,69,1
12518,김승수(金承洙),이성만(李成萬),42,5,47,1
12519,김승수(金承洙),이소영(李素永),50,6,56,1
12520,김승수(金承洙),이수진(李壽珍),50,7,57,1
12521,김승수(金承洙),이수진(李秀眞),50,5,55,1
12522,김승수(金承洙),이양수(李亮壽),87,100,187,0
12523,김승수(金承洙),이용(李鏞),113,178,291,0
12524,김승수(金承洙),이용빈(李龍彬),52,13,65,1
12525,김승수(金承洙),이용선(李庸瑄),51,8,59,1
12526,김승수(金承洙),이용우(李龍雨),51,7,58,1
12527,김승수(金承洙),이용호(李容鎬),36,33,69,0
12528,김승수(金承洙),이원욱(李元旭),50,5,55,1
12529,김승수(金承洙),이원택(李源澤),49,6,55,1
12530,김승수(金承洙),이은주(李恩周),5,4,9,1
12531,김승수(金承洙),이인선(李仁善),32,60,92,0
12532,김승수(金承洙),이인영(李仁榮),50,5,55,1
12533,김승수(金承洙),이장섭(李將燮),50,5,55,1
12534,김승수(金承洙),이재명(李在明),26,4,30,1
12535,김승수(金承洙),이재정(李在汀),50,4,54,1
12536,김승수(金承洙),이정문(李楨文),49,8,57,1
12537,김승수(金承洙),이종배(李鍾培),125,188,313,0
12538,김승수(金承洙),이종성(李鍾成),127,241,368,0
12539,김승수(金承洙),이주환(李周桓),127,190,317,0
12540,김승수(金承洙),이채익(李埰益),87,132,219,0
12541,김승수(金承洙),이철규(李喆圭),78,75,153,0
12542,김승수(金承洙),이탄희(李誕熙),50,9,59,1
12543,김승수(金承洙),이태규(李泰珪),47,53,100,0
12544,김승수(金承洙),이학영(李學永),50,7,57,1
12545,김승수(金承洙),이해식(李海植),51,8,59,1
12546,김승수(金承洙),이헌승(李憲昇),74,113,187,0
12547,김승수(金承洙),이형석(李炯錫),51,9,60,1
12548,김승수(金承洙),인재근(印在謹),53,11,64,1
12549,김승수(金承洙),임병헌(林炳憲),32,54,86,0
12550,김승수(金承洙),임오경(林五卿),51,9,60,1
12551,김승수(金承洙),임이자(林利子),103,132,235,0
12552,김승수(金承洙),임종성(林鍾聲),52,10,62,1
12553,김승수(金承洙),임호선(林昊宣),52,9,61,1
12554,김승수(金承洙),장경태(張耿態),52,9,61,1
12555,김승수(金承洙),장동혁(張東赫),31,38,69,0
12556,김승수(金承洙),장제원(張濟元),70,50,120,0
12557,김승수(金承洙),장철민(張喆敏),50,8,58,1
12558,김승수(金承洙),장혜영(張惠英),6,11,17,1
12559,김승수(金承洙),전봉민(田奉珉),66,94,160,0
12560,김승수(金承洙),전용기(田溶冀),49,10,59,1
12561,김승수(金承洙),전재수(田載秀),49,5,54,1
12562,김승수(金承洙),전주혜(全珠惠),90,127,217,0
12563,김승수(金承洙),전해철(全海澈),50,5,55,1
12564,김승수(金承洙),전혜숙(全惠淑),51,9,60,1
12565,김승수(金承洙),정경희(丁慶姬),80,92,172,0
12566,김승수(金承洙),정동만(鄭東萬),70,106,176,0
12567,김승수(金承洙),정성호(鄭成湖),51,6,57,1
12568,김승수(金承洙),정우택(鄭宇澤),38,58,96,0
12569,김승수(金承洙),정운천(鄭雲天),86,145,231,0
12570,김승수(金承洙),정일영(鄭日永),51,13,64,1
12571,김승수(金承洙),정점식(鄭点植),76,51,127,0
12572,김승수(金承洙),정진석(鄭鎭碩),97,107,204,0
12573,김승수(金承洙),정청래(鄭淸來),51,5,56,1
12574,김승수(金承洙),정춘숙(鄭春淑),50,6,56,1
12575,김승수(金承洙),정태호(鄭泰浩),50,9,59,1
12576,김승수(金承洙),정필모(鄭必模),50,7,57,1
12577,김승수(金承洙),정희용(鄭熙溶),111,171,282,0
12578,김승수(金承洙),조경태(趙慶泰),89,96,185,0
12579,김승수(金承洙),조명희(曺明姬),118,227,345,0
12580,김승수(金承洙),조수진(趙修眞),96,146,242,0
12581,김승수(金承洙),조승래(趙承來),51,5,56,1
12582,김승수(金承洙),조오섭(曺五燮),53,12,65,1
12583,김승수(金承洙),조은희(趙恩禧),30,34,64,0
12584,김승수(金承洙),조응천(趙應天),50,4,54,1
12585,김승수(金承洙),조정식(趙正湜),50,3,53,1
12586,김승수(金承洙),조정훈(趙廷訓),1,9,10,1
12587,김승수(金承洙),조해진(曺海珍),69,47,116,0
12588,김승수(金承洙),주철현(朱哲鉉),51,10,61,1
12589,김승수(金承洙),주호영(朱豪英),79,97,176,0
12590,김승수(金承洙),지성호(池成浩),90,194,284,0
12591,김승수(金承洙),진선미(陳善美),51,5,56,1
12592,김승수(金承洙),진성준(陳聲準),50,5,55,1
12593,김승수(金承洙),천준호(千俊鎬),51,6,57,1
12594,김승수(金承洙),최기상(崔基相),50,5,55,1
12595,김승수(金承洙),최승재(崔承宰),89,127,216,0
12596,김승수(金承洙),최연숙(崔姸淑),42,65,107,0
12597,김승수(金承洙),최영희(崔英姬),30,67,97,0
12598,김승수(金承洙),최인호(崔仁昊),52,9,61,1
12599,김승수(金承洙),최재형(崔在亨),29,21,50,0
12600,김승수(金承洙),최종윤(崔鍾允),51,7,58,1
12601,김승수(金承洙),최춘식(崔春植),94,109,203,0
12602,김승수(金承洙),최형두(崔炯斗),101,155,256,0
12603,김승수(金承洙),최혜영(崔惠英),53,13,66,1
12604,김승수(金承洙),추경호(秋慶鎬),137,225,362,0
12605,김승수(金承洙),태영호(太永浩),94,159,253,0
12606,김승수(金承洙),하영제(河榮帝),108,195,303,1
12607,김승수(金承洙),하태경(河泰慶),71,51,122,0
12608,김승수(金承洙),한기호(韓起鎬),82,66,148,0
12609,김승수(金承洙),한무경(韓茂景),106,153,259,0
12610,김승수(金承洙),한병도(韓秉道),50,6,56,1
12611,김승수(金承洙),한정애(韓貞愛),50,6,56,1
12612,김승수(金承洙),한준호(韓俊鎬),50,5,55,1
12613,김승수(金承洙),허숙정(許淑湞),0,0,0,1
12614,김승수(金承洙),허영(許榮),51,11,62,1
12615,김승수(金承洙),허은아(許垠娥),76,89,165,0
12616,김승수(金承洙),허종식(許琮植),54,10,64,1
12617,김승수(金承洙),홍기원(洪起元),50,6,56,1
12618,김승수(金承洙),홍문표(洪文杓),91,126,217,0
12619,김승수(金承洙),홍석준(洪碩晙),103,115,218,0
12620,김승수(金承洙),홍성국(洪性國),50,10,60,1
12621,김승수(金承洙),홍영표(洪永杓),52,6,58,1
12622,김승수(金承洙),홍익표(洪翼杓),51,8,59,1
12623,김승수(金承洙),홍정민(洪貞敏),50,9,59,1
12624,김승수(金承洙),황보승희(皇甫承希),87,136,223,1
12625,김승수(金承洙),황운하(黃雲夏),50,10,60,1
12626,김승수(金承洙),황희(黃熙),50,6,56,1
12627,김승원(金勝源),김영배(金永培),151,218,369,0
12628,김승원(金勝源),김영선(金映宣),26,4,30,1
12629,김승원(金勝源),김영식(金英植),52,5,57,1
12630,김승원(金勝源),김영주(金榮珠),108,109,217,0
12631,김승원(金勝源),김영진(金榮鎭),92,72,164,0
12632,김승원(金勝源),김영호(金映豪),126,135,261,0
12633,김승원(金勝源),김예지(金睿智),54,8,62,1
12634,김승원(金勝源),김용민(金容民),128,248,376,0
12635,김승원(金勝源),김용판(金用判),54,5,59,1
12636,김승원(金勝源),김웅(金雄),51,4,55,1
12637,김승원(金勝源),김원이(金元二),128,112,240,0
12638,김승원(金勝源),김윤덕(金潤德),105,74,179,0
12639,김승원(金勝源),김의겸(金宜謙),58,142,200,0
12640,김승원(金勝源),김정재(金汀才),53,5,58,1
12641,김승원(金勝源),김정호(金禎鎬),157,253,410,0
12642,김승원(金勝源),김종민(金鐘民),112,120,232,0
12643,김승원(金勝源),김주영(金周暎),145,197,342,0
12644,김승원(金勝源),김진표(金振杓),76,120,196,1
12645,김승원(金勝源),김철민(金哲玟),134,144,278,0
12646,김승원(金勝源),김태년(金太年),84,61,145,0
12647,김승원(金勝源),김태호(金台鎬),42,6,48,1
12648,김승원(金勝源),김학용(金學容),25,4,29,1
12649,김승원(金勝源),김한규(金翰奎),47,64,111,0
12650,김승원(金勝源),김한정(金漢正),92,70,162,0
12651,김승원(金勝源),김형동(金亨東),51,13,64,1
12652,김승원(金勝源),김홍걸(金弘傑),70,142,212,0
12653,김승원(金勝源),김회재(金會在),137,134,271,0
12654,김승원(金勝源),김희곤(金熙坤),51,4,55,1
12655,김승원(金勝源),김희국(金熙國),49,5,54,1
12656,김승원(金勝源),남인순(南仁順),154,189,343,0
12657,김승원(金勝源),노용호(魯容昊),25,4,29,1
12658,김승원(金勝源),노웅래(盧雄來),117,124,241,0
12659,김승원(金勝源),도종환(都鍾煥),137,116,253,0
12660,김승원(金勝源),류성걸(柳性杰),49,5,54,1
12661,김승원(金勝源),류호정(柳好貞),28,48,76,1
12662,김승원(金勝源),맹성규(孟聖奎),119,127,246,0
12663,김승원(金勝源),문정복(文貞福),116,134,250,0
12664,김승원(金勝源),문진석(文振碩),134,136,270,0
12665,김승원(金勝源),민병덕(閔炳德),111,192,303,0
12666,김승원(金勝源),민형배(閔馨培),146,406,552,0
12667,김승원(金勝源),민홍철(閔洪喆),96,72,168,0
12668,김승원(金勝源),박광온(朴洸瑥),101,117,218,0
12669,김승원(金勝源),박대수(朴大壽),50,10,60,1
12670,김승원(金勝源),박대출(朴大出),50,5,55,1
12671,김승원(金勝源),박덕흠(朴德欽),38,5,43,1
12672,김승원(金勝源),박범계(朴範界),82,59,141,0
12673,김승원(金勝源),박병석(朴炳錫),40,15,55,0
12674,김승원(金勝源),박상혁(朴商赫),129,170,299,0
12675,김승원(金勝源),박성민(朴聖敏),50,5,55,1
12676,김승원(金勝源),박성준(朴省俊),185,252,437,0
12677,김승원(金勝源),박성중(朴成重),49,5,54,1
12678,김승원(金勝源),박수영(朴洙瑩),49,4,53,1
12679,김승원(金勝源),박영순(朴英淳),136,176,312,0
12680,김승원(金勝源),박완주(朴完柱),67,90,157,1
12681,김승원(金勝源),박용진(朴用鎭),85,52,137,0
12682,김승원(金勝源),박재호(朴在昊),106,95,201,0
12683,김승원(金勝源),박정(朴釘),153,165,318,0
12684,김승원(金勝源),박정하(朴正河),25,4,29,1
12685,김승원(金勝源),박주민(朴柱民),97,111,208,0
12686,김승원(金勝源),박진(朴振),50,7,57,1
12687,김승원(金勝源),박찬대(朴贊大),96,89,185,0
12688,김승원(金勝源),박형수(朴亨修),50,5,55,1
12689,김승원(金勝源),박홍근(朴洪根),146,196,342,0
12690,김승원(金勝源),배준영(裵俊英),49,4,53,1
12691,김승원(金勝源),배진교(裵晋敎),22,18,40,1
12692,김승원(金勝源),배현진(裵賢鎭),49,5,54,1
12693,김승원(金勝源),백종헌(白宗憲),50,4,54,1
12694,김승원(金勝源),백혜련(白惠蓮),101,97,198,0
12695,김승원(金勝源),변재일(卞在一),84,64,148,0
12696,김승원(金勝源),서동용(徐東榕),112,123,235,0
12697,김승원(金勝源),서범수(徐範洙),50,6,56,1
12698,김승원(金勝源),서병수(徐秉洙),50,5,55,1
12699,김승원(金勝源),서삼석(徐參錫),131,132,263,0
12700,김승원(金勝源),서영교(徐瑛敎),137,197,334,0
12701,김승원(金勝源),서영석(徐暎錫),145,184,329,0
12702,김승원(金勝源),서일준(徐一俊),50,9,59,1
12703,김승원(金勝源),서정숙(徐正淑),49,5,54,1
12704,김승원(金勝源),설훈(薛勳),89,86,175,0
12705,김승원(金勝源),성일종(成一鍾),50,5,55,1
12706,김승원(金勝源),소병철(蘇秉哲),103,121,224,0
12707,김승원(金勝源),소병훈(蘇秉勳),108,152,260,0
12708,김승원(金勝源),송갑석(宋甲錫),136,219,355,0
12709,김승원(金勝源),송기헌(宋基憲),101,63,164,0
12710,김승원(金勝源),송석준(宋錫俊),50,6,56,1
12711,김승원(金勝源),송언석(宋彦錫),45,4,49,1
12712,김승원(金勝源),송옥주(宋玉珠),114,120,234,0
12713,김승원(金勝源),송재호(宋在祜),149,228,377,0
12714,김승원(金勝源),신동근(申東根),97,85,182,0
12715,김승원(金勝源),신영대(申榮大),113,77,190,0
12716,김승원(金勝源),신원식(申源湜),50,6,56,1
12717,김승원(金勝源),신정훈(辛正勳),181,342,523,0
12718,김승원(金勝源),신현영(申賢榮),103,93,196,0
12719,김승원(金勝源),심상정(沈相奵),24,41,65,1
12720,김승원(金勝源),안규백(安圭伯),124,144,268,0
12721,김승원(金勝源),안민석(安敏錫),122,116,238,0
12722,김승원(金勝源),안병길(安炳吉),50,5,55,1
12723,김승원(金勝源),안철수(安哲秀),25,5,30,1
12724,김승원(金勝源),안호영(安浩永),89,92,181,0
12725,김승원(金勝源),양경숙(梁敬淑),126,187,313,0
12726,김승원(金勝源),양금희(梁琴喜),50,4,54,1
12727,김승원(金勝源),양기대(梁基大),104,126,230,0
12728,김승원(金勝源),양이원영(梁李媛瑛),139,202,341,0
12729,김승원(金勝源),양정숙(梁貞淑),149,348,497,1
12730,김승원(金勝源),양향자(梁香子),54,44,98,1
12731,김승원(金勝源),어기구(魚基龜),101,87,188,0
12732,김승원(金勝源),엄태영(嚴泰永),53,4,57,1
12733,김승원(金勝源),오기형(吳奇炯),87,71,158,0
12734,김승원(金勝源),오영환(吳永煥),243,423,666,0
12735,김승원(金勝源),용혜인(龍慧仁),24,61,85,1
12736,김승원(金勝源),우상호(禹相虎),83,48,131,0
12737,김승원(金勝源),우원식(禹元植),100,107,207,0
12738,김승원(金勝源),위성곤(魏聖坤),126,207,333,0
12739,김승원(金勝源),유경준(兪京濬),49,4,53,1
12740,김승원(金勝源),유기홍(柳基洪),85,56,141,0
12741,김승원(金勝源),유동수(柳東秀),89,67,156,0
12742,김승원(金勝源),유상범(劉相凡),50,4,54,1
12743,김승원(金勝源),유의동(兪義東),49,4,53,1
12744,김승원(金勝源),유정주(兪訂炷),192,334,526,0
12745,김승원(金勝源),윤건영(尹建永),119,182,301,0
12746,김승원(金勝源),윤관석(尹官石),104,90,194,1
12747,김승원(金勝源),윤두현(尹斗鉉),49,4,53,1
12748,김승원(金勝源),윤미향(尹美香),96,144,240,1
12749,김승원(金勝源),윤상현(尹相現),32,6,38,1
12750,김승원(金勝源),윤영덕(尹永德),142,278,420,0
12751,김승원(金勝源),윤영석(尹永碩),50,5,55,1
12752,김승원(金勝源),윤영찬(尹永燦),100,77,177,0
12753,김승원(金勝源),윤재갑(尹才鉀),168,214,382,0
12754,김승원(金勝源),윤재옥(尹在玉),49,5,54,1
12755,김승원(金勝源),윤주경(尹柱卿),49,4,53,1
12756,김승원(金勝源),윤준병(尹準炳),149,264,413,0
12757,김승원(金勝源),윤창현(尹暢賢),49,4,53,1
12758,김승원(金勝源),윤한홍(尹漢洪),50,4,54,1
12759,김승원(金勝源),윤호중(尹昊重),84,55,139,0
12760,김승원(金勝源),윤후덕(尹厚德),100,83,183,0
12761,김승원(金勝源),이개호(李介昊),103,110,213,0
12762,김승원(金勝源),이달곤(李達坤),52,6,58,1
12763,김승원(金勝源),이동주(李東洲),103,133,236,0
12764,김승원(金勝源),이만희(李晩熙),49,4,53,1
12765,김승원(金勝源),이명수(李明洙),51,15,66,1
12766,김승원(金勝源),이병훈(李炳勳),168,245,413,0
12767,김승원(金勝源),이상민(李相珉),83,54,137,0
12768,김승원(金勝源),이상헌(李相憲),181,155,336,0
12769,김승원(金勝源),이성만(李成萬),178,239,417,1
12770,김승원(金勝源),이소영(李素永),105,68,173,0
12771,김승원(金勝源),이수진(李壽珍),183,330,513,0
12772,김승원(金勝源),이수진(李秀眞),169,249,418,0
12773,김승원(金勝源),이양수(李亮壽),53,4,57,1
12774,김승원(金勝源),이용(李鏞),49,5,54,1
12775,김승원(金勝源),이용빈(李龍彬),177,292,469,0
12776,김승원(金勝源),이용선(李庸瑄),127,142,269,0
12777,김승원(金勝源),이용우(李龍雨),141,188,329,0
12778,김승원(金勝源),이용호(李容鎬),39,34,73,1
12779,김승원(金勝源),이원욱(李元旭),107,97,204,0
12780,김승원(金勝源),이원택(李源澤),136,175,311,0
12781,김승원(金勝源),이은주(李恩周),32,31,63,1
12782,김승원(金勝源),이인선(李仁善),25,4,29,1
12783,김승원(金勝源),이인영(李仁榮),88,64,152,0
12784,김승원(金勝源),이장섭(李將燮),106,103,209,0
12785,김승원(金勝源),이재명(李在明),40,26,66,0
12786,김승원(金勝源),이재정(李在汀),100,96,196,0
12787,김승원(金勝源),이정문(李楨文),105,107,212,0
12788,김승원(金勝源),이종배(李鍾培),50,6,56,1
12789,김승원(金勝源),이종성(李鍾成),50,5,55,1
12790,김승원(金勝源),이주환(李周桓),49,4,53,1
12791,김승원(金勝源),이채익(李埰益),53,7,60,1
12792,김승원(金勝源),이철규(李喆圭),53,6,59,1
12793,김승원(金勝源),이탄희(李誕熙),113,165,278,0
12794,김승원(金勝源),이태규(李泰珪),29,5,34,1
12795,김승원(金勝源),이학영(李學永),112,98,210,0
12796,김승원(金勝源),이해식(李海植),126,155,281,0
12797,김승원(金勝源),이헌승(李憲昇),51,4,55,1
12798,김승원(金勝源),이형석(李炯錫),131,172,303,0
12799,김승원(金勝源),인재근(印在謹),121,128,249,0
12800,김승원(金勝源),임병헌(林炳憲),25,4,29,1
12801,김승원(金勝源),임오경(林五卿),124,154,278,0
12802,김승원(金勝源),임이자(林利子),49,5,54,1
12803,김승원(金勝源),임종성(林鍾聲),130,129,259,0
12804,김승원(金勝源),임호선(林昊宣),161,255,416,0
12805,김승원(金勝源),장경태(張耿態),155,259,414,0
12806,김승원(金勝源),장동혁(張東赫),25,4,29,1
12807,김승원(金勝源),장제원(張濟元),49,4,53,1
12808,김승원(金勝源),장철민(張喆敏),102,83,185,0
12809,김승원(金勝源),장혜영(張惠英),20,13,33,1
12810,김승원(金勝源),전봉민(田奉珉),35,5,40,1
12811,김승원(金勝源),전용기(田溶冀),142,154,296,0
12812,김승원(金勝源),전재수(田載秀),102,69,171,0
12813,김승원(金勝源),전주혜(全珠惠),51,5,56,1
12814,김승원(金勝源),전해철(全海澈),76,61,137,0
12815,김승원(金勝源),전혜숙(全惠淑),137,169,306,0
12816,김승원(金勝源),정경희(丁慶姬),49,4,53,1
12817,김승원(金勝源),정동만(鄭東萬),49,4,53,1
12818,김승원(金勝源),정성호(鄭成湖),104,134,238,0
12819,김승원(金勝源),정우택(鄭宇澤),26,5,31,1
12820,김승원(金勝源),정운천(鄭雲天),51,6,57,1
12821,김승원(金勝源),정일영(鄭日永),136,149,285,0
12822,김승원(金勝源),정점식(鄭点植),50,4,54,1
12823,김승원(金勝源),정진석(鄭鎭碩),50,8,58,1
12824,김승원(金勝源),정청래(鄭淸來),116,156,272,0
12825,김승원(金勝源),정춘숙(鄭春淑),116,117,233,0
12826,김승원(金勝源),정태호(鄭泰浩),89,115,204,0
12827,김승원(金勝源),정필모(鄭必模),122,197,319,0
12828,김승원(金勝源),정희용(鄭熙溶),50,6,56,1
12829,김승원(金勝源),조경태(趙慶泰),49,5,54,1
12830,김승원(金勝源),조명희(曺明姬),49,6,55,1
12831,김승원(金勝源),조수진(趙修眞),50,4,54,1
12832,김승원(金勝源),조승래(趙承來),115,83,198,0
12833,김승원(金勝源),조오섭(曺五燮),120,181,301,0
12834,김승원(金勝源),조은희(趙恩禧),25,4,29,1
12835,김승원(金勝源),조응천(趙應天),84,48,132,0
12836,김승원(金勝源),조정식(趙正湜),85,73,158,0
12837,김승원(金勝源),조정훈(趙廷訓),4,14,18,1
12838,김승원(金勝源),조해진(曺海珍),52,5,57,1
12839,김승원(金勝源),주철현(朱哲鉉),146,209,355,0
12840,김승원(金勝源),주호영(朱豪英),50,4,54,1
12841,김승원(金勝源),지성호(池成浩),49,5,54,1
12842,김승원(金勝源),진선미(陳善美),90,62,152,0
12843,김승원(金勝源),진성준(陳聲準),125,155,280,0
12844,김승원(金勝源),천준호(千俊鎬),108,80,188,0
12845,김승원(金勝源),최기상(崔基相),99,106,205,0
12846,김승원(金勝源),최승재(崔承宰),52,7,59,1
12847,김승원(金勝源),최연숙(崔姸淑),34,12,46,1
12848,김승원(金勝源),최영희(崔英姬),25,6,31,1
12849,김승원(金勝源),최인호(崔仁昊),90,92,182,0
12850,김승원(金勝源),최재형(崔在亨),25,5,30,1
12851,김승원(金勝源),최종윤(崔鍾允),136,202,338,0
12852,김승원(金勝源),최춘식(崔春植),49,7,56,1
12853,김승원(金勝源),최형두(崔炯斗),51,6,57,1
12854,김승원(金勝源),최혜영(崔惠英),147,183,330,0
12855,김승원(金勝源),추경호(秋慶鎬),49,4,53,1
12856,김승원(金勝源),태영호(太永浩),49,4,53,1
12857,김승원(金勝源),하영제(河榮帝),42,1,43,1
12858,김승원(金勝源),하태경(河泰慶),50,5,55,1
12859,김승원(金勝源),한기호(韓起鎬),51,5,56,1
12860,김승원(金勝源),한무경(韓茂景),50,4,54,1
12861,김승원(金勝源),한병도(韓秉道),156,202,358,0
12862,김승원(金勝源),한정애(韓貞愛),82,57,139,0
12863,김승원(金勝源),한준호(韓俊鎬),126,152,278,0
12864,김승원(金勝源),허숙정(許淑湞),1,2,3,0
12865,김승원(金勝源),허영(許榮),161,187,348,0
12866,김승원(金勝源),허은아(許垠娥),49,5,54,1
12867,김승원(金勝源),허종식(許琮植),139,153,292,0
12868,김승원(金勝源),홍기원(洪起元),131,166,297,0
12869,김승원(金勝源),홍문표(洪文杓),51,14,65,1
12870,김승원(金勝源),홍석준(洪碩晙),50,4,54,1
12871,김승원(金勝源),홍성국(洪性國),164,226,390,0
12872,김승원(金勝源),홍영표(洪永杓),90,79,169,0
12873,김승원(金勝源),홍익표(洪翼杓),99,88,187,0
12874,김승원(金勝源),홍정민(洪貞敏),163,240,403,0
12875,김승원(金勝源),황보승희(皇甫承希),46,2,48,1
12876,김승원(金勝源),황운하(黃雲夏),211,323,534,0
12877,김승원(金勝源),황희(黃熙),88,54,142,0
12878,김영배(金永培),김영선(金映宣),26,4,30,1
12879,김영배(金永培),김영식(金英植),54,6,60,1
12880,김영배(金永培),김영주(金榮珠),97,101,198,0
12881,김영배(金永培),김영진(金榮鎭),95,63,158,0
12882,김영배(金永培),김영호(金映豪),105,87,192,0
12883,김영배(金永培),김예지(金睿智),52,4,56,1
12884,김영배(金永培),김용민(金容民),101,115,216,0
12885,김영배(金永培),김용판(金用判),53,5,58,1
12886,김영배(金永培),김웅(金雄),52,5,57,1
12887,김영배(金永培),김원이(金元二),138,168,306,0
12888,김영배(金永培),김윤덕(金潤德),104,122,226,0
12889,김영배(金永培),김의겸(金宜謙),52,98,150,0
12890,김영배(金永培),김정재(金汀才),53,4,57,1
12891,김영배(金永培),김정호(金禎鎬),129,224,353,0
12892,김영배(金永培),김종민(金鐘民),104,156,260,0
12893,김영배(金永培),김주영(金周暎),116,119,235,0
12894,김영배(金永培),김진표(金振杓),67,74,141,1
12895,김영배(金永培),김철민(金哲玟),143,203,346,0
12896,김영배(金永培),김태년(金太年),86,50,136,0
12897,김영배(金永培),김태호(金台鎬),43,6,49,1
12898,김영배(金永培),김학용(金學容),25,4,29,1
12899,김영배(金永培),김한규(金翰奎),46,59,105,0
12900,김영배(金永培),김한정(金漢正),86,65,151,0
12901,김영배(金永培),김형동(金亨東),54,9,63,1
12902,김영배(金永培),김홍걸(金弘傑),59,122,181,0
12903,김영배(金永培),김회재(金會在),115,97,212,0
12904,김영배(金永培),김희곤(金熙坤),52,5,57,1
12905,김영배(金永培),김희국(金熙國),49,4,53,1
12906,김영배(金永培),남인순(南仁順),125,116,241,0
12907,김영배(金永培),노용호(魯容昊),25,4,29,1
12908,김영배(金永培),노웅래(盧雄來),106,94,200,0
12909,김영배(金永培),도종환(都鍾煥),112,97,209,0
12910,김영배(金永培),류성걸(柳性杰),49,6,55,1
12911,김영배(金永培),류호정(柳好貞),28,56,84,1
12912,김영배(金永培),맹성규(孟聖奎),106,90,196,0
12913,김영배(金永培),문정복(文貞福),108,73,181,0
12914,김영배(金永培),문진석(文振碩),106,98,204,0
12915,김영배(金永培),민병덕(閔炳德),110,195,305,0
12916,김영배(金永培),민형배(閔馨培),122,275,397,0
12917,김영배(金永培),민홍철(閔洪喆),91,80,171,0
12918,김영배(金永培),박광온(朴洸瑥),119,198,317,0
12919,김영배(金永培),박대수(朴大壽),49,12,61,1
12920,김영배(金永培),박대출(朴大出),50,4,54,1
12921,김영배(金永培),박덕흠(朴德欽),36,4,40,1
12922,김영배(金永培),박범계(朴範界),80,48,128,0
12923,김영배(金永培),박병석(朴炳錫),40,15,55,0
12924,김영배(金永培),박상혁(朴商赫),117,171,288,0
12925,김영배(金永培),박성민(朴聖敏),53,13,66,1
12926,김영배(金永培),박성준(朴省俊),133,179,312,0
12927,김영배(金永培),박성중(朴成重),49,4,53,1
12928,김영배(金永培),박수영(朴洙瑩),52,5,57,1
12929,김영배(金永培),박영순(朴英淳),111,121,232,0
12930,김영배(金永培),박완주(朴完柱),75,58,133,1
12931,김영배(金永培),박용진(朴用鎭),93,101,194,0
12932,김영배(金永培),박재호(朴在昊),119,94,213,0
12933,김영배(金永培),박정(朴釘),130,152,282,0
12934,김영배(金永培),박정하(朴正河),25,6,31,1
12935,김영배(金永培),박주민(朴柱民),95,100,195,0
12936,김영배(金永培),박진(朴振),51,6,57,1
12937,김영배(金永培),박찬대(朴贊大),98,63,161,0
12938,김영배(金永培),박형수(朴亨修),50,5,55,1
12939,김영배(金永培),박홍근(朴洪根),139,161,300,0
12940,김영배(金永培),배준영(裵俊英),50,8,58,1
12941,김영배(金永培),배진교(裵晋敎),25,42,67,1
12942,김영배(金永培),배현진(裵賢鎭),50,6,56,1
12943,김영배(金永培),백종헌(白宗憲),51,5,56,1
12944,김영배(金永培),백혜련(白惠蓮),104,72,176,0
12945,김영배(金永培),변재일(卞在一),86,60,146,0
12946,김영배(金永培),서동용(徐東榕),112,120,232,0
12947,김영배(金永培),서범수(徐範洙),53,7,60,1
12948,김영배(金永培),서병수(徐秉洙),51,4,55,1
12949,김영배(金永培),서삼석(徐參錫),107,94,201,0
12950,김영배(金永培),서영교(徐瑛敎),163,156,319,0
12951,김영배(金永培),서영석(徐暎錫),104,122,226,0
12952,김영배(金永培),서일준(徐一俊),51,7,58,1
12953,김영배(金永培),서정숙(徐正淑),50,6,56,1
12954,김영배(金永培),설훈(薛勳),89,87,176,0
12955,김영배(金永培),성일종(成一鍾),52,7,59,1
12956,김영배(金永培),소병철(蘇秉哲),97,109,206,0
12957,김영배(金永培),소병훈(蘇秉勳),93,93,186,0
12958,김영배(金永培),송갑석(宋甲錫),119,253,372,0
12959,김영배(金永培),송기헌(宋基憲),100,87,187,0
12960,김영배(金永培),송석준(宋錫俊),50,5,55,1
12961,김영배(金永培),송언석(宋彦錫),47,7,54,1
12962,김영배(金永培),송옥주(宋玉珠),98,100,198,0
12963,김영배(金永培),송재호(宋在祜),128,176,304,0
12964,김영배(金永培),신동근(申東根),99,80,179,0
12965,김영배(金永培),신영대(申榮大),94,90,184,0
12966,김영배(金永培),신원식(申源湜),50,4,54,1
12967,김영배(金永培),신정훈(辛正勳),157,204,361,0
12968,김영배(金永培),신현영(申賢榮),92,66,158,0
12969,김영배(金永培),심상정(沈相奵),24,44,68,1
12970,김영배(金永培),안규백(安圭伯),99,94,193,0
12971,김영배(金永培),안민석(安敏錫),87,87,174,0
12972,김영배(金永培),안병길(安炳吉),52,4,56,1
12973,김영배(金永培),안철수(安哲秀),25,4,29,1
12974,김영배(金永培),안호영(安浩永),95,113,208,0
12975,김영배(金永培),양경숙(梁敬淑),103,109,212,0
12976,김영배(金永培),양금희(梁琴喜),50,7,57,1
12977,김영배(金永培),양기대(梁基大),127,114,241,0
12978,김영배(金永培),양이원영(梁李媛瑛),120,125,245,0
12979,김영배(金永培),양정숙(梁貞淑),95,236,331,1
12980,김영배(金永培),양향자(梁香子),50,43,93,1
12981,김영배(金永培),어기구(魚基龜),87,65,152,0
12982,김영배(金永培),엄태영(嚴泰永),53,4,57,1
12983,김영배(金永培),오기형(吳奇炯),106,70,176,0
12984,김영배(金永培),오영환(吳永煥),194,289,483,0
12985,김영배(金永培),용혜인(龍慧仁),25,51,76,1
12986,김영배(金永培),우상호(禹相虎),80,38,118,0
12987,김영배(金永培),우원식(禹元植),122,107,229,0
12988,김영배(金永培),위성곤(魏聖坤),108,151,259,0
12989,김영배(金永培),유경준(兪京濬),49,4,53,1
12990,김영배(金永培),유기홍(柳基洪),84,61,145,0
12991,김영배(金永培),유동수(柳東秀),93,51,144,0
12992,김영배(金永培),유상범(劉相凡),51,4,55,1
12993,김영배(金永培),유의동(兪義東),51,5,56,1
12994,김영배(金永培),유정주(兪訂炷),130,181,311,0
12995,김영배(金永培),윤건영(尹建永),92,101,193,0
12996,김영배(金永培),윤관석(尹官石),84,70,154,1
12997,김영배(金永培),윤두현(尹斗鉉),50,5,55,1
12998,김영배(金永培),윤미향(尹美香),70,93,163,1
12999,김영배(金永培),윤상현(尹相現),30,5,35,1
13000,김영배(金永培),윤영덕(尹永德),109,138,247,0
13001,김영배(金永培),윤영석(尹永碩),50,5,55,1
13002,김영배(金永培),윤영찬(尹永燦),108,141,249,0
13003,김영배(金永培),윤재갑(尹才鉀),136,152,288,0
13004,김영배(金永培),윤재옥(尹在玉),52,5,57,1
13005,김영배(金永培),윤주경(尹柱卿),49,6,55,1
13006,김영배(金永培),윤준병(尹準炳),127,227,354,0
13007,김영배(金永培),윤창현(尹暢賢),49,6,55,1
13008,김영배(金永培),윤한홍(尹漢洪),50,5,55,1
13009,김영배(金永培),윤호중(尹昊重),82,74,156,0
13010,김영배(金永培),윤후덕(尹厚德),95,90,185,0
13011,김영배(金永培),이개호(李介昊),91,81,172,0
13012,김영배(金永培),이달곤(李達坤),52,4,56,1
13013,김영배(金永培),이동주(李東洲),112,130,242,0
13014,김영배(金永培),이만희(李晩熙),51,4,55,1
13015,김영배(金永培),이명수(李明洙),54,11,65,1
13016,김영배(金永培),이병훈(李炳勳),136,180,316,0
13017,김영배(金永培),이상민(李相珉),87,48,135,0
13018,김영배(金永培),이상헌(李相憲),104,120,224,0
13019,김영배(金永培),이성만(李成萬),115,102,217,1
13020,김영배(金永培),이소영(李素永),115,97,212,0
13021,김영배(金永培),이수진(李壽珍),135,193,328,0
13022,김영배(金永培),이수진(李秀眞),137,143,280,0
13023,김영배(金永培),이양수(李亮壽),54,4,58,1
13024,김영배(金永培),이용(李鏞),50,5,55,1
13025,김영배(金永培),이용빈(李龍彬),139,199,338,0
13026,김영배(金永培),이용선(李庸瑄),113,119,232,0
13027,김영배(金永培),이용우(李龍雨),125,117,242,0
13028,김영배(金永培),이용호(李容鎬),36,19,55,1
13029,김영배(金永培),이원욱(李元旭),103,153,256,0
13030,김영배(金永培),이원택(李源澤),114,85,199,0
13031,김영배(金永培),이은주(李恩周),28,37,65,1
13032,김영배(金永培),이인선(李仁善),25,5,30,1
13033,김영배(金永培),이인영(李仁榮),76,56,132,0
13034,김영배(金永培),이장섭(李將燮),117,209,326,0
13035,김영배(金永培),이재명(李在明),38,23,61,0
13036,김영배(金永培),이재정(李在汀),87,69,156,0
13037,김영배(金永培),이정문(李楨文),115,151,266,0
13038,김영배(金永培),이종배(李鍾培),49,5,54,1
13039,김영배(金永培),이종성(李鍾成),50,4,54,1
13040,김영배(金永培),이주환(李周桓),50,5,55,1
13041,김영배(金永培),이채익(李埰益),51,7,58,1
13042,김영배(金永培),이철규(李喆圭),54,8,62,1
13043,김영배(金永培),이탄희(李誕熙),123,137,260,0
13044,김영배(金永培),이태규(李泰珪),29,6,35,1
13045,김영배(金永培),이학영(李學永),106,139,245,0
13046,김영배(金永培),이해식(李海植),157,190,347,0
13047,김영배(金永培),이헌승(李憲昇),51,6,57,1
13048,김영배(金永培),이형석(李炯錫),140,133,273,0
13049,김영배(金永培),인재근(印在謹),107,125,232,0
13050,김영배(金永培),임병헌(林炳憲),25,5,30,1
13051,김영배(金永培),임오경(林五卿),108,96,204,0
13052,김영배(金永培),임이자(林利子),49,6,55,1
13053,김영배(金永培),임종성(林鍾聲),109,120,229,0
13054,김영배(金永培),임호선(林昊宣),169,322,491,0
13055,김영배(金永培),장경태(張耿態),127,153,280,0
13056,김영배(金永培),장동혁(張東赫),25,4,29,1
13057,김영배(金永培),장제원(張濟元),50,4,54,1
13058,김영배(金永培),장철민(張喆敏),106,119,225,0
13059,김영배(金永培),장혜영(張惠英),26,30,56,1
13060,김영배(金永培),전봉민(田奉珉),35,5,40,1
13061,김영배(金永培),전용기(田溶冀),118,157,275,0
13062,김영배(金永培),전재수(田載秀),104,108,212,0
13063,김영배(金永培),전주혜(全珠惠),51,6,57,1
13064,김영배(金永培),전해철(全海澈),82,75,157,0
13065,김영배(金永培),전혜숙(全惠淑),114,113,227,0
13066,김영배(金永培),정경희(丁慶姬),50,5,55,1
13067,김영배(金永培),정동만(鄭東萬),50,5,55,1
13068,김영배(金永培),정성호(鄭成湖),87,102,189,0
13069,김영배(金永培),정우택(鄭宇澤),25,5,30,1
13070,김영배(金永培),정운천(鄭雲天),50,6,56,1
13071,김영배(金永培),정일영(鄭日永),103,115,218,0
13072,김영배(金永培),정점식(鄭点植),53,4,57,1
13073,김영배(金永培),정진석(鄭鎭碩),51,7,58,1
13074,김영배(金永培),정청래(鄭淸來),94,74,168,0
13075,김영배(金永培),정춘숙(鄭春淑),113,105,218,0
13076,김영배(金永培),정태호(鄭泰浩),102,114,216,0
13077,김영배(金永培),정필모(鄭必模),100,132,232,0
13078,김영배(金永培),정희용(鄭熙溶),50,6,56,1
13079,김영배(金永培),조경태(趙慶泰),51,4,55,1
13080,김영배(金永培),조명희(曺明姬),50,8,58,1
13081,김영배(金永培),조수진(趙修眞),50,5,55,1
13082,김영배(金永培),조승래(趙承來),99,83,182,0
13083,김영배(金永培),조오섭(曺五燮),133,180,313,0
13084,김영배(金永培),조은희(趙恩禧),26,4,30,1
13085,김영배(金永培),조응천(趙應天),76,43,119,0
13086,김영배(金永培),조정식(趙正湜),81,49,130,0
13087,김영배(金永培),조정훈(趙廷訓),9,9,18,1
13088,김영배(金永培),조해진(曺海珍),53,4,57,1
13089,김영배(金永培),주철현(朱哲鉉),110,117,227,0
13090,김영배(金永培),주호영(朱豪英),50,4,54,1
13091,김영배(金永培),지성호(池成浩),49,5,54,1
13092,김영배(金永培),진선미(陳善美),98,88,186,0
13093,김영배(金永培),진성준(陳聲準),120,153,273,0
13094,김영배(金永培),천준호(千俊鎬),105,74,179,0
13095,김영배(金永培),최기상(崔基相),97,90,187,0
13096,김영배(金永培),최승재(崔承宰),52,6,58,1
13097,김영배(金永培),최연숙(崔姸淑),32,12,44,1
13098,김영배(金永培),최영희(崔英姬),25,5,30,1
13099,김영배(金永培),최인호(崔仁昊),86,87,173,0
13100,김영배(金永培),최재형(崔在亨),25,5,30,1
13101,김영배(金永培),최종윤(崔鍾允),110,141,251,0
13102,김영배(金永培),최춘식(崔春植),51,6,57,1
13103,김영배(金永培),최형두(崔炯斗),51,8,59,1
13104,김영배(金永培),최혜영(崔惠英),115,119,234,0
13105,김영배(金永培),추경호(秋慶鎬),50,3,53,1
13106,김영배(金永培),태영호(太永浩),49,6,55,1
13107,김영배(金永培),하영제(河榮帝),42,4,46,1
13108,김영배(金永培),하태경(河泰慶),53,7,60,1
13109,김영배(金永培),한기호(韓起鎬),50,5,55,1
13110,김영배(金永培),한무경(韓茂景),53,8,61,1
13111,김영배(金永培),한병도(韓秉道),167,182,349,0
13112,김영배(金永培),한정애(韓貞愛),82,61,143,0
13113,김영배(金永培),한준호(韓俊鎬),112,145,257,0
13114,김영배(金永培),허숙정(許淑湞),1,2,3,0
13115,김영배(金永培),허영(許榮),146,169,315,0
13116,김영배(金永培),허은아(許垠娥),50,6,56,1
13117,김영배(金永培),허종식(許琮植),101,103,204,0
13118,김영배(金永培),홍기원(洪起元),109,115,224,0
13119,김영배(金永培),홍문표(洪文杓),50,4,54,1
13120,김영배(金永培),홍석준(洪碩晙),50,5,55,1
13121,김영배(金永培),홍성국(洪性國),147,191,338,0
13122,김영배(金永培),홍영표(洪永杓),96,66,162,0
13123,김영배(金永培),홍익표(洪翼杓),112,121,233,0
13124,김영배(金永培),홍정민(洪貞敏),127,129,256,0
13125,김영배(金永培),황보승희(皇甫承希),49,4,53,1
13126,김영배(金永培),황운하(黃雲夏),142,189,331,0
13127,김영배(金永培),황희(黃熙),88,62,150,0
13128,김영선(金映宣),김영식(金英植),28,23,51,0
13129,김영선(金映宣),김영주(金榮珠),26,4,30,1
13130,김영선(金映宣),김영진(金榮鎭),26,3,29,1
13131,김영선(金映宣),김영호(金映豪),26,4,30,1
13132,김영선(金映宣),김예지(金睿智),33,51,84,0
13133,김영선(金映宣),김용민(金容民),26,4,30,1
13134,김영선(金映宣),김용판(金用判),30,65,95,0
13135,김영선(金映宣),김웅(金雄),26,13,39,0
13136,김영선(金映宣),김원이(金元二),26,5,31,1
13137,김영선(金映宣),김윤덕(金潤德),26,3,29,1
13138,김영선(金映宣),김의겸(金宜謙),26,4,30,1
13139,김영선(金映宣),김정재(金汀才),27,22,49,0
13140,김영선(金映宣),김정호(金禎鎬),26,4,30,1
13141,김영선(金映宣),김종민(金鐘民),26,4,30,1
13142,김영선(金映宣),김주영(金周暎),25,5,30,1
13143,김영선(金映宣),김진표(金振杓),0,0,0,1
13144,김영선(金映宣),김철민(金哲玟),25,3,28,1
13145,김영선(金映宣),김태년(金太年),25,4,29,1
13146,김영선(金映宣),김태호(金台鎬),27,30,57,0
13147,김영선(金映宣),김학용(金學容),26,17,43,0
13148,김영선(金映宣),김한규(金翰奎),25,5,30,1
13149,김영선(金映宣),김한정(金漢正),25,4,29,1
13150,김영선(金映宣),김형동(金亨東),29,36,65,0
13151,김영선(金映宣),김홍걸(金弘傑),5,4,9,1
13152,김영선(金映宣),김회재(金會在),25,3,28,1
13153,김영선(金映宣),김희곤(金熙坤),27,53,80,0
13154,김영선(金映宣),김희국(金熙國),25,18,43,0
13155,김영선(金映宣),남인순(南仁順),25,4,29,1
13156,김영선(金映宣),노용호(魯容昊),30,23,53,0
13157,김영선(金映宣),노웅래(盧雄來),25,3,28,1
13158,김영선(金映宣),도종환(都鍾煥),25,4,29,1
13159,김영선(金映宣),류성걸(柳性杰),29,29,58,0
13160,김영선(金映宣),류호정(柳好貞),0,0,0,1
13161,김영선(金映宣),맹성규(孟聖奎),25,4,29,1
13162,김영선(金映宣),문정복(文貞福),25,6,31,1
13163,김영선(金映宣),문진석(文振碩),25,4,29,1
13164,김영선(金映宣),민병덕(閔炳德),25,4,29,1
13165,김영선(金映宣),민형배(閔馨培),9,4,13,1
13166,김영선(金映宣),민홍철(閔洪喆),25,4,29,1
13167,김영선(金映宣),박광온(朴洸瑥),25,4,29,1
13168,김영선(金映宣),박대수(朴大壽),30,61,91,0
13169,김영선(金映宣),박대출(朴大出),26,19,45,0
13170,김영선(金映宣),박덕흠(朴德欽),25,64,89,0
13171,김영선(金映宣),박범계(朴範界),25,4,29,1
13172,김영선(金映宣),박병석(朴炳錫),25,3,28,1
13173,김영선(金映宣),박상혁(朴商赫),25,4,29,1
13174,김영선(金映宣),박성민(朴聖敏),26,42,68,0
13175,김영선(金映宣),박성준(朴省俊),25,4,29,1
13176,김영선(金映宣),박성중(朴成重),26,20,46,0
13177,김영선(金映宣),박수영(朴洙瑩),25,10,35,0
13178,김영선(金映宣),박영순(朴英淳),25,3,28,1
13179,김영선(金映宣),박완주(朴完柱),0,0,0,1
13180,김영선(金映宣),박용진(朴用鎭),25,4,29,1
13181,김영선(金映宣),박재호(朴在昊),25,4,29,1
13182,김영선(金映宣),박정(朴釘),25,4,29,1
13183,김영선(金映宣),박정하(朴正河),25,28,53,0
13184,김영선(金映宣),박주민(朴柱民),25,4,29,1
13185,김영선(金映宣),박진(朴振),26,16,42,0
13186,김영선(金映宣),박찬대(朴贊大),25,4,29,1
13187,김영선(金映宣),박형수(朴亨修),28,47,75,0
13188,김영선(金映宣),박홍근(朴洪根),26,4,30,1
13189,김영선(金映宣),배준영(裵俊英),30,28,58,0
13190,김영선(金映宣),배진교(裵晋敎),0,0,0,1
13191,김영선(金映宣),배현진(裵賢鎭),27,11,38,0
13192,김영선(金映宣),백종헌(白宗憲),27,57,84,0
13193,김영선(金映宣),백혜련(白惠蓮),25,4,29,1
13194,김영선(金映宣),변재일(卞在一),25,4,29,1
13195,김영선(金映宣),서동용(徐東榕),25,4,29,1
13196,김영선(金映宣),서범수(徐範洙),28,31,59,0
13197,김영선(金映宣),서병수(徐秉洙),27,21,48,0
13198,김영선(金映宣),서삼석(徐參錫),25,5,30,1
13199,김영선(金映宣),서영교(徐瑛敎),25,4,29,1
13200,김영선(金映宣),서영석(徐暎錫),25,5,30,1
13201,김영선(金映宣),서일준(徐一俊),25,41,66,0
13202,김영선(金映宣),서정숙(徐正淑),25,27,52,0
13203,김영선(金映宣),설훈(薛勳),25,5,30,1
13204,김영선(金映宣),성일종(成一鍾),27,61,88,0
13205,김영선(金映宣),소병철(蘇秉哲),25,5,30,1
13206,김영선(金映宣),소병훈(蘇秉勳),25,4,29,1
13207,김영선(金映宣),송갑석(宋甲錫),25,4,29,1
13208,김영선(金映宣),송기헌(宋基憲),25,4,29,1
13209,김영선(金映宣),송석준(宋錫俊),27,27,54,0
13210,김영선(金映宣),송언석(宋彦錫),25,19,44,0
13211,김영선(金映宣),송옥주(宋玉珠),25,3,28,1
13212,김영선(金映宣),송재호(宋在祜),25,4,29,1
13213,김영선(金映宣),신동근(申東根),25,3,28,1
13214,김영선(金映宣),신영대(申榮大),25,4,29,1
13215,김영선(金映宣),신원식(申源湜),28,16,44,0
13216,김영선(金映宣),신정훈(辛正勳),25,4,29,1
13217,김영선(金映宣),신현영(申賢榮),25,4,29,1
13218,김영선(金映宣),심상정(沈相奵),0,0,0,1
13219,김영선(金映宣),안규백(安圭伯),26,4,30,1
13220,김영선(金映宣),안민석(安敏錫),25,3,28,1
13221,김영선(金映宣),안병길(安炳吉),28,26,54,0
13222,김영선(金映宣),안철수(安哲秀),25,32,57,0
13223,김영선(金映宣),안호영(安浩永),25,4,29,1
13224,김영선(金映宣),양경숙(梁敬淑),25,4,29,1
13225,김영선(金映宣),양금희(梁琴喜),29,43,72,0
13226,김영선(金映宣),양기대(梁基大),25,4,29,1
13227,김영선(金映宣),양이원영(梁李媛瑛),25,4,29,1
13228,김영선(金映宣),양정숙(梁貞淑),0,4,4,1
13229,김영선(金映宣),양향자(梁香子),0,7,7,1
13230,김영선(金映宣),어기구(魚基龜),25,5,30,1
13231,김영선(金映宣),엄태영(嚴泰永),34,52,86,0
13232,김영선(金映宣),오기형(吳奇炯),25,4,29,1
13233,김영선(金映宣),오영환(吳永煥),25,5,30,1
13234,김영선(金映宣),용혜인(龍慧仁),0,0,0,1
13235,김영선(金映宣),우상호(禹相虎),25,4,29,1
13236,김영선(金映宣),우원식(禹元植),25,4,29,1
13237,김영선(金映宣),위성곤(魏聖坤),25,4,29,1
13238,김영선(金映宣),유경준(兪京濬),28,35,63,0
13239,김영선(金映宣),유기홍(柳基洪),25,4,29,1
13240,김영선(金映宣),유동수(柳東秀),25,4,29,1
13241,김영선(金映宣),유상범(劉相凡),27,19,46,0
13242,김영선(金映宣),유의동(兪義東),26,12,38,0
13243,김영선(金映宣),유정주(兪訂炷),25,4,29,1
13244,김영선(金映宣),윤건영(尹建永),25,3,28,1
13245,김영선(金映宣),윤관석(尹官石),16,0,16,1
13246,김영선(金映宣),윤두현(尹斗鉉),27,34,61,0
13247,김영선(金映宣),윤미향(尹美香),0,0,0,1
13248,김영선(金映宣),윤상현(尹相現),26,33,59,0
13249,김영선(金映宣),윤영덕(尹永德),25,4,29,1
13250,김영선(金映宣),윤영석(尹永碩),28,32,60,0
13251,김영선(金映宣),윤영찬(尹永燦),25,4,29,1
13252,김영선(金映宣),윤재갑(尹才鉀),25,5,30,1
13253,김영선(金映宣),윤재옥(尹在玉),25,23,48,0
13254,김영선(金映宣),윤주경(尹柱卿),26,14,40,0
13255,김영선(金映宣),윤준병(尹準炳),25,4,29,1
13256,김영선(金映宣),윤창현(尹暢賢),31,29,60,0
13257,김영선(金映宣),윤한홍(尹漢洪),25,34,59,0
13258,김영선(金映宣),윤호중(尹昊重),25,4,29,1
13259,김영선(金映宣),윤후덕(尹厚德),25,5,30,1
13260,김영선(金映宣),이개호(李介昊),25,5,30,1
13261,김영선(金映宣),이달곤(李達坤),28,45,73,0
13262,김영선(金映宣),이동주(李東洲),25,4,29,1
13263,김영선(金映宣),이만희(李晩熙),26,16,42,0
13264,김영선(金映宣),이명수(李明洙),28,73,101,0
13265,김영선(金映宣),이병훈(李炳勳),25,4,29,1
13266,김영선(金映宣),이상민(李相珉),25,4,29,1
13267,김영선(金映宣),이상헌(李相憲),25,6,31,1
13268,김영선(金映宣),이성만(李成萬),16,0,16,1
13269,김영선(金映宣),이소영(李素永),25,4,29,1
13270,김영선(金映宣),이수진(李壽珍),25,5,30,1
13271,김영선(金映宣),이수진(李秀眞),25,4,29,1
13272,김영선(金映宣),이양수(李亮壽),26,13,39,0
13273,김영선(金映宣),이용(李鏞),26,31,57,0
13274,김영선(金映宣),이용빈(李龍彬),25,4,29,1
13275,김영선(金映宣),이용선(李庸瑄),25,4,29,1
13276,김영선(金映宣),이용우(李龍雨),25,4,29,1
13277,김영선(金映宣),이용호(李容鎬),26,18,44,0
13278,김영선(金映宣),이원욱(李元旭),25,4,29,1
13279,김영선(金映宣),이원택(李源澤),25,4,29,1
13280,김영선(金映宣),이은주(李恩周),0,0,0,1
13281,김영선(金映宣),이인선(李仁善),28,31,59,0
13282,김영선(金映宣),이인영(李仁榮),25,4,29,1
13283,김영선(金映宣),이장섭(李將燮),25,5,30,1
13284,김영선(金映宣),이재명(李在明),25,4,29,1
13285,김영선(金映宣),이재정(李在汀),25,4,29,1
13286,김영선(金映宣),이정문(李楨文),25,4,29,1
13287,김영선(金映宣),이종배(李鍾培),25,29,54,0
13288,김영선(金映宣),이종성(李鍾成),25,62,87,0
13289,김영선(金映宣),이주환(李周桓),26,23,49,0
13290,김영선(金映宣),이채익(李埰益),31,65,96,0
13291,김영선(金映宣),이철규(李喆圭),28,24,52,0
13292,김영선(金映宣),이탄희(李誕熙),25,4,29,1
13293,김영선(金映宣),이태규(李泰珪),28,27,55,0
13294,김영선(金映宣),이학영(李學永),25,4,29,1
13295,김영선(金映宣),이해식(李海植),25,4,29,1
13296,김영선(金映宣),이헌승(李憲昇),28,33,61,0
13297,김영선(金映宣),이형석(李炯錫),25,4,29,1
13298,김영선(金映宣),인재근(印在謹),25,5,30,1
13299,김영선(金映宣),임병헌(林炳憲),30,73,103,0
13300,김영선(金映宣),임오경(林五卿),25,4,29,1
13301,김영선(金映宣),임이자(林利子),29,25,54,0
13302,김영선(金映宣),임종성(林鍾聲),25,5,30,1
13303,김영선(金映宣),임호선(林昊宣),25,5,30,1
13304,김영선(金映宣),장경태(張耿態),25,5,30,1
13305,김영선(金映宣),장동혁(張東赫),27,23,50,0
13306,김영선(金映宣),장제원(張濟元),26,9,35,0
13307,김영선(金映宣),장철민(張喆敏),25,4,29,1
13308,김영선(金映宣),장혜영(張惠英),0,0,0,1
13309,김영선(金映宣),전봉민(田奉珉),26,15,41,0
13310,김영선(金映宣),전용기(田溶冀),25,4,29,1
13311,김영선(金映宣),전재수(田載秀),25,4,29,1
13312,김영선(金映宣),전주혜(全珠惠),26,14,40,0
13313,김영선(金映宣),전해철(全海澈),25,4,29,1
13314,김영선(金映宣),전혜숙(全惠淑),25,4,29,1
13315,김영선(金映宣),정경희(丁慶姬),27,21,48,0
13316,김영선(金映宣),정동만(鄭東萬),26,23,49,0
13317,김영선(金映宣),정성호(鄭成湖),25,6,31,1
13318,김영선(金映宣),정우택(鄭宇澤),25,33,58,0
13319,김영선(金映宣),정운천(鄭雲天),26,37,63,0
13320,김영선(金映宣),정일영(鄭日永),25,4,29,1
13321,김영선(金映宣),정점식(鄭点植),26,15,41,0
13322,김영선(金映宣),정진석(鄭鎭碩),26,10,36,0
13323,김영선(金映宣),정청래(鄭淸來),25,4,29,1
13324,김영선(金映宣),정춘숙(鄭春淑),25,4,29,1
13325,김영선(金映宣),정태호(鄭泰浩),25,4,29,1
13326,김영선(金映宣),정필모(鄭必模),25,4,29,1
13327,김영선(金映宣),정희용(鄭熙溶),26,15,41,0
13328,김영선(金映宣),조경태(趙慶泰),27,25,52,0
13329,김영선(金映宣),조명희(曺明姬),34,57,91,0
13330,김영선(金映宣),조수진(趙修眞),27,20,47,0
13331,김영선(金映宣),조승래(趙承來),25,3,28,1
13332,김영선(金映宣),조오섭(曺五燮),25,4,29,1
13333,김영선(金映宣),조은희(趙恩禧),27,29,56,0
13334,김영선(金映宣),조응천(趙應天),25,3,28,1
13335,김영선(金映宣),조정식(趙正湜),25,3,28,1
13336,김영선(金映宣),조정훈(趙廷訓),0,11,11,1
13337,김영선(金映宣),조해진(曺海珍),28,53,81,0
13338,김영선(金映宣),주철현(朱哲鉉),25,4,29,1
13339,김영선(金映宣),주호영(朱豪英),26,21,47,0
13340,김영선(金映宣),지성호(池成浩),30,48,78,0
13341,김영선(金映宣),진선미(陳善美),25,4,29,1
13342,김영선(金映宣),진성준(陳聲準),25,4,29,1
13343,김영선(金映宣),천준호(千俊鎬),25,3,28,1
13344,김영선(金映宣),최기상(崔基相),25,4,29,1
13345,김영선(金映宣),최승재(崔承宰),26,26,52,0
13346,김영선(金映宣),최연숙(崔姸淑),26,43,69,0
13347,김영선(金映宣),최영희(崔英姬),28,51,79,0
13348,김영선(金映宣),최인호(崔仁昊),25,4,29,1
13349,김영선(金映宣),최재형(崔在亨),27,20,47,0
13350,김영선(金映宣),최종윤(崔鍾允),25,4,29,1
13351,김영선(金映宣),최춘식(崔春植),30,43,73,0
13352,김영선(金映宣),최형두(崔炯斗),27,35,62,0
13353,김영선(金映宣),최혜영(崔惠英),25,4,29,1
13354,김영선(金映宣),추경호(秋慶鎬),25,8,33,0
13355,김영선(金映宣),태영호(太永浩),28,70,98,0
13356,김영선(金映宣),하영제(河榮帝),17,44,61,1
13357,김영선(金映宣),하태경(河泰慶),27,21,48,0
13358,김영선(金映宣),한기호(韓起鎬),28,47,75,0
13359,김영선(金映宣),한무경(韓茂景),27,37,64,0
13360,김영선(金映宣),한병도(韓秉道),25,5,30,1
13361,김영선(金映宣),한정애(韓貞愛),25,4,29,1
13362,김영선(金映宣),한준호(韓俊鎬),25,4,29,1
13363,김영선(金映宣),허숙정(許淑湞),0,0,0,1
13364,김영선(金映宣),허영(許榮),25,4,29,1
13365,김영선(金映宣),허은아(許垠娥),25,17,42,0
13366,김영선(金映宣),허종식(許琮植),25,4,29,1
13367,김영선(金映宣),홍기원(洪起元),25,4,29,1
13368,김영선(金映宣),홍문표(洪文杓),28,28,56,0
13369,김영선(金映宣),홍석준(洪碩晙),26,28,54,0
13370,김영선(金映宣),홍성국(洪性國),25,4,29,1
13371,김영선(金映宣),홍영표(洪永杓),25,5,30,1
13372,김영선(金映宣),홍익표(洪翼杓),25,4,29,1
13373,김영선(金映宣),홍정민(洪貞敏),25,4,29,1
13374,김영선(金映宣),황보승희(皇甫承希),22,19,41,1
13375,김영선(金映宣),황운하(黃雲夏),25,4,29,1
13376,김영선(金映宣),황희(黃熙),25,4,29,1
13377,김영식(金英植),김영주(金榮珠),51,6,57,1
13378,김영식(金英植),김영진(金榮鎭),53,4,57,1
13379,김영식(金英植),김영호(金映豪),51,4,55,1
13380,김영식(金英植),김예지(金睿智),124,204,328,0
13381,김영식(金英植),김용민(金容民),51,4,55,1
13382,김영식(金英植),김용판(金用判),165,316,481,0
13383,김영식(金英植),김웅(金雄),73,70,143,0
13384,김영식(金英植),김원이(金元二),51,4,55,1
13385,김영식(金英植),김윤덕(金潤德),51,3,54,1
13386,김영식(金英植),김의겸(金宜謙),26,4,30,1
13387,김영식(金英植),김정재(金汀才),140,203,343,0
13388,김영식(金英植),김정호(金禎鎬),51,10,61,1
13389,김영식(金英植),김종민(金鐘民),51,6,57,1
13390,김영식(金英植),김주영(金周暎),53,8,61,1
13391,김영식(金英植),김진표(金振杓),25,2,27,1
13392,김영식(金英植),김철민(金哲玟),50,5,55,1
13393,김영식(金英植),김태년(金太年),50,5,55,1
13394,김영식(金英植),김태호(金台鎬),69,78,147,0
13395,김영식(金英植),김학용(金學容),35,46,81,0
13396,김영식(金英植),김한규(金翰奎),25,7,32,1
13397,김영식(金英植),김한정(金漢正),50,4,54,1
13398,김영식(金英植),김형동(金亨東),129,191,320,0
13399,김영식(金英植),김홍걸(金弘傑),14,7,21,1
13400,김영식(金英植),김회재(金會在),51,4,55,1
13401,김영식(金英植),김희곤(金熙坤),84,161,245,0
13402,김영식(金英植),김희국(金熙國),87,90,177,0
13403,김영식(金英植),남인순(南仁順),50,5,55,1
13404,김영식(金英植),노용호(魯容昊),38,62,100,0
13405,김영식(金英植),노웅래(盧雄來),51,7,58,1
13406,김영식(金英植),도종환(都鍾煥),50,5,55,1
13407,김영식(金英植),류성걸(柳性杰),76,85,161,0
13408,김영식(金英植),류호정(柳好貞),5,8,13,1
13409,김영식(金英植),맹성규(孟聖奎),49,5,54,1
13410,김영식(金英植),문정복(文貞福),49,4,53,1
13411,김영식(金英植),문진석(文振碩),49,6,55,1
13412,김영식(金英植),민병덕(閔炳德),49,8,57,1
13413,김영식(金英植),민형배(閔馨培),33,5,38,1
13414,김영식(金英植),민홍철(閔洪喆),51,5,56,1
13415,김영식(金英植),박광온(朴洸瑥),49,4,53,1
13416,김영식(金英植),박대수(朴大壽),138,308,446,0
13417,김영식(金英植),박대출(朴大出),86,116,202,0
13418,김영식(金英植),박덕흠(朴德欽),90,172,262,0
13419,김영식(金英植),박범계(朴範界),49,4,53,1
13420,김영식(金英植),박병석(朴炳錫),25,3,28,1
13421,김영식(金英植),박상혁(朴商赫),52,5,57,1
13422,김영식(金英植),박성민(朴聖敏),128,242,370,0
13423,김영식(金英植),박성준(朴省俊),50,6,56,1
13424,김영식(金英植),박성중(朴成重),101,164,265,0
13425,김영식(金英植),박수영(朴洙瑩),72,74,146,0
13426,김영식(金英植),박영순(朴英淳),50,8,58,1
13427,김영식(金英植),박완주(朴完柱),24,0,24,1
13428,김영식(金英植),박용진(朴用鎭),49,5,54,1
13429,김영식(金英植),박재호(朴在昊),49,5,54,1
13430,김영식(金英植),박정(朴釘),52,5,57,1
13431,김영식(金英植),박정하(朴正河),31,31,62,0
13432,김영식(金英植),박주민(朴柱民),49,4,53,1
13433,김영식(金英植),박진(朴振),88,108,196,0
13434,김영식(金英植),박찬대(朴贊大),50,5,55,1
13435,김영식(金英植),박형수(朴亨修),81,89,170,0
13436,김영식(金英植),박홍근(朴洪根),50,5,55,1
13437,김영식(金英植),배준영(裵俊英),89,119,208,0
13438,김영식(金英植),배진교(裵晋敎),5,3,8,1
13439,김영식(金英植),배현진(裵賢鎭),77,69,146,0
13440,김영식(金英植),백종헌(白宗憲),101,192,293,0
13441,김영식(金英植),백혜련(白惠蓮),49,5,54,1
13442,김영식(金英植),변재일(卞在一),51,7,58,1
13443,김영식(金英植),서동용(徐東榕),50,4,54,1
13444,김영식(金英植),서범수(徐範洙),90,145,235,0
13445,김영식(金英植),서병수(徐秉洙),101,117,218,0
13446,김영식(金英植),서삼석(徐參錫),51,7,58,1
13447,김영식(金英植),서영교(徐瑛敎),50,8,58,1
13448,김영식(金英植),서영석(徐暎錫),49,5,54,1
13449,김영식(金英植),서일준(徐一俊),161,282,443,0
13450,김영식(金英植),서정숙(徐正淑),89,131,220,0
13451,김영식(金英植),설훈(薛勳),49,7,56,1
13452,김영식(金英植),성일종(成一鍾),110,165,275,0
13453,김영식(金英植),소병철(蘇秉哲),51,6,57,1
13454,김영식(金英植),소병훈(蘇秉勳),50,6,56,1
13455,김영식(金英植),송갑석(宋甲錫),49,5,54,1
13456,김영식(金英植),송기헌(宋基憲),49,6,55,1
13457,김영식(金英植),송석준(宋錫俊),95,115,210,0
13458,김영식(金英植),송언석(宋彦錫),125,151,276,0
13459,김영식(金英植),송옥주(宋玉珠),50,4,54,1
13460,김영식(金英植),송재호(宋在祜),49,6,55,1
13461,김영식(金英植),신동근(申東根),49,3,52,1
13462,김영식(金英植),신영대(申榮大),50,4,54,1
13463,김영식(金英植),신원식(申源湜),94,122,216,0
13464,김영식(金英植),신정훈(辛正勳),51,5,56,1
13465,김영식(金英植),신현영(申賢榮),49,4,53,1
13466,김영식(金英植),심상정(沈相奵),6,3,9,1
13467,김영식(金英植),안규백(安圭伯),52,6,58,1
13468,김영식(金英植),안민석(安敏錫),50,3,53,1
13469,김영식(金英植),안병길(安炳吉),84,126,210,0
13470,김영식(金英植),안철수(安哲秀),27,20,47,0
13471,김영식(金英植),안호영(安浩永),51,6,57,1
13472,김영식(金英植),양경숙(梁敬淑),49,5,54,1
13473,김영식(金英植),양금희(梁琴喜),145,205,350,0
13474,김영식(金英植),양기대(梁基大),50,5,55,1
13475,김영식(金英植),양이원영(梁李媛瑛),45,5,50,1
13476,김영식(金英植),양정숙(梁貞淑),4,17,21,1
13477,김영식(金英植),양향자(梁香子),24,24,48,1
13478,김영식(金英植),어기구(魚基龜),49,6,55,1
13479,김영식(金英植),엄태영(嚴泰永),94,114,208,0
13480,김영식(金英植),오기형(吳奇炯),49,5,54,1
13481,김영식(金英植),오영환(吳永煥),50,8,58,1
13482,김영식(金英植),용혜인(龍慧仁),1,8,9,1
13483,김영식(金英植),우상호(禹相虎),49,4,53,1
13484,김영식(金英植),우원식(禹元植),49,4,53,1
13485,김영식(金英植),위성곤(魏聖坤),50,6,56,1
13486,김영식(金英植),유경준(兪京濬),107,141,248,0
13487,김영식(金英植),유기홍(柳基洪),49,4,53,1
13488,김영식(金英植),유동수(柳東秀),53,10,63,1
13489,김영식(金英植),유상범(劉相凡),72,79,151,0
13490,김영식(金英植),유의동(兪義東),82,96,178,0
13491,김영식(金英植),유정주(兪訂炷),50,5,55,1
13492,김영식(金英植),윤건영(尹建永),49,4,53,1
13493,김영식(金英植),윤관석(尹官石),40,0,40,1
13494,김영식(金英植),윤두현(尹斗鉉),124,204,328,0
13495,김영식(金英植),윤미향(尹美香),21,1,22,1
13496,김영식(金英植),윤상현(尹相現),42,46,88,0
13497,김영식(金英植),윤영덕(尹永德),49,5,54,1
13498,김영식(金英植),윤영석(尹永碩),76,83,159,0
13499,김영식(金英植),윤영찬(尹永燦),49,7,56,1
13500,김영식(金英植),윤재갑(尹才鉀),53,7,60,1
13501,김영식(金英植),윤재옥(尹在玉),77,79,156,0
13502,김영식(金英植),윤주경(尹柱卿),90,96,186,0
13503,김영식(金英植),윤준병(尹準炳),49,4,53,1
13504,김영식(金英植),윤창현(尹暢賢),107,156,263,0
13505,김영식(金英植),윤한홍(尹漢洪),90,129,219,0
13506,김영식(金英植),윤호중(尹昊重),50,4,54,1
13507,김영식(金英植),윤후덕(尹厚德),51,6,57,1
13508,김영식(金英植),이개호(李介昊),49,5,54,1
13509,김영식(金英植),이달곤(李達坤),71,80,151,0
13510,김영식(金英植),이동주(李東洲),49,5,54,1
13511,김영식(金英植),이만희(李晩熙),97,93,190,0
13512,김영식(金英植),이명수(李明洙),113,169,282,0
13513,김영식(金英植),이병훈(李炳勳),53,6,59,1
13514,김영식(金英植),이상민(李相珉),49,6,55,1
13515,김영식(金英植),이상헌(李相憲),51,10,61,1
13516,김영식(金英植),이성만(李成萬),41,1,42,1
13517,김영식(金英植),이소영(李素永),50,5,55,1
13518,김영식(金英植),이수진(李壽珍),49,5,54,1
13519,김영식(金英植),이수진(李秀眞),50,7,57,1
13520,김영식(金英植),이양수(李亮壽),82,109,191,0
13521,김영식(金英植),이용(李鏞),91,114,205,0
13522,김영식(金英植),이용빈(李龍彬),51,6,57,1
13523,김영식(金英植),이용선(李庸瑄),49,8,57,1
13524,김영식(金英植),이용우(李龍雨),50,5,55,1
13525,김영식(金英植),이용호(李容鎬),32,19,51,0
13526,김영식(金英植),이원욱(李元旭),51,7,58,1
13527,김영식(金英植),이원택(李源澤),49,4,53,1
13528,김영식(金英植),이은주(李恩周),5,3,8,1
13529,김영식(金英植),이인선(李仁善),34,69,103,0
13530,김영식(金英植),이인영(李仁榮),49,4,53,1
13531,김영식(金英植),이장섭(李將燮),49,5,54,1
13532,김영식(金英植),이재명(李在明),25,4,29,1
13533,김영식(金英植),이재정(李在汀),49,4,53,1
13534,김영식(金英植),이정문(李楨文),49,5,54,1
13535,김영식(金英植),이종배(李鍾培),105,157,262,0
13536,김영식(金英植),이종성(李鍾成),153,261,414,0
13537,김영식(金英植),이주환(李周桓),107,190,297,0
13538,김영식(金英植),이채익(李埰益),97,143,240,0
13539,김영식(金英植),이철규(李喆圭),78,103,181,0
13540,김영식(金英植),이탄희(李誕熙),49,5,54,1
13541,김영식(金英植),이태규(李泰珪),51,86,137,0
13542,김영식(金英植),이학영(李學永),49,5,54,1
13543,김영식(金英植),이해식(李海植),50,5,55,1
13544,김영식(金英植),이헌승(李憲昇),72,91,163,0
13545,김영식(金英植),이형석(李炯錫),49,5,54,1
13546,김영식(金英植),인재근(印在謹),50,5,55,1
13547,김영식(金英植),임병헌(林炳憲),38,50,88,0
13548,김영식(金英植),임오경(林五卿),49,5,54,1
13549,김영식(金英植),임이자(林利子),141,203,344,0
13550,김영식(金英植),임종성(林鍾聲),52,9,61,1
13551,김영식(金英植),임호선(林昊宣),49,5,54,1
13552,김영식(金英植),장경태(張耿態),50,11,61,1
13553,김영식(金英植),장동혁(張東赫),30,49,79,0
13554,김영식(金英植),장제원(張濟元),72,55,127,0
13555,김영식(金英植),장철민(張喆敏),49,5,54,1
13556,김영식(金英植),장혜영(張惠英),6,3,9,1
13557,김영식(金英植),전봉민(田奉珉),58,103,161,0
13558,김영식(金英植),전용기(田溶冀),49,5,54,1
13559,김영식(金英植),전재수(田載秀),49,4,53,1
13560,김영식(金英植),전주혜(全珠惠),98,142,240,0
13561,김영식(金英植),전해철(全海澈),49,4,53,1
13562,김영식(金英植),전혜숙(全惠淑),51,15,66,1
13563,김영식(金英植),정경희(丁慶姬),83,112,195,0
13564,김영식(金英植),정동만(鄭東萬),84,87,171,0
13565,김영식(金英植),정성호(鄭成湖),54,6,60,1
13566,김영식(金英植),정우택(鄭宇澤),49,81,130,0
13567,김영식(金英植),정운천(鄭雲天),111,149,260,0
13568,김영식(金英植),정일영(鄭日永),50,9,59,1
13569,김영식(金英植),정점식(鄭点植),77,64,141,0
13570,김영식(金英植),정진석(鄭鎭碩),92,127,219,0
13571,김영식(金英植),정청래(鄭淸來),49,4,53,1
13572,김영식(金英植),정춘숙(鄭春淑),49,5,54,1
13573,김영식(金英植),정태호(鄭泰浩),49,5,54,1
13574,김영식(金英植),정필모(鄭必模),50,5,55,1
13575,김영식(金英植),정희용(鄭熙溶),131,239,370,0
13576,김영식(金英植),조경태(趙慶泰),96,112,208,0
13577,김영식(金英植),조명희(曺明姬),102,197,299,0
13578,김영식(金英植),조수진(趙修眞),105,150,255,0
13579,김영식(金英植),조승래(趙承來),50,7,57,1
13580,김영식(金英植),조오섭(曺五燮),50,7,57,1
13581,김영식(金英植),조은희(趙恩禧),36,44,80,0
13582,김영식(金英植),조응천(趙應天),50,5,55,1
13583,김영식(金英植),조정식(趙正湜),49,3,52,1
13584,김영식(金英植),조정훈(趙廷訓),3,21,24,1
13585,김영식(金英植),조해진(曺海珍),60,41,101,0
13586,김영식(金英植),주철현(朱哲鉉),51,4,55,1
13587,김영식(金英植),주호영(朱豪英),73,88,161,0
13588,김영식(金英植),지성호(池成浩),111,192,303,0
13589,김영식(金英植),진선미(陳善美),49,5,54,1
13590,김영식(金英植),진성준(陳聲準),49,4,53,1
13591,김영식(金英植),천준호(千俊鎬),49,3,52,1
13592,김영식(金英植),최기상(崔基相),49,5,54,1
13593,김영식(金英植),최승재(崔承宰),91,114,205,0
13594,김영식(金英植),최연숙(崔姸淑),48,68,116,0
13595,김영식(金英植),최영희(崔英姬),33,53,86,0
13596,김영식(金英植),최인호(崔仁昊),49,4,53,1
13597,김영식(金英植),최재형(崔在亨),31,17,48,0
13598,김영식(金英植),최종윤(崔鍾允),50,4,54,1
13599,김영식(金英植),최춘식(崔春植),98,140,238,0
13600,김영식(金英植),최형두(崔炯斗),115,138,253,0
13601,김영식(金英植),최혜영(崔惠英),51,5,56,1
13602,김영식(金英植),추경호(秋慶鎬),141,183,324,0
13603,김영식(金英植),태영호(太永浩),152,254,406,0
13604,김영식(金英植),하영제(河榮帝),103,198,301,1
13605,김영식(金英植),하태경(河泰慶),67,50,117,0
13606,김영식(金英植),한기호(韓起鎬),76,68,144,0
13607,김영식(金英植),한무경(韓茂景),150,235,385,0
13608,김영식(金英植),한병도(韓秉道),49,5,54,1
13609,김영식(金英植),한정애(韓貞愛),49,4,53,1
13610,김영식(金英植),한준호(韓俊鎬),51,5,56,1
13611,김영식(金英植),허숙정(許淑湞),0,0,0,1
13612,김영식(金英植),허영(許榮),50,5,55,1
13613,김영식(金英植),허은아(許垠娥),126,179,305,0
13614,김영식(金英植),허종식(許琮植),50,5,55,1
13615,김영식(金英植),홍기원(洪起元),49,5,54,1
13616,김영식(金英植),홍문표(洪文杓),76,84,160,0
13617,김영식(金英植),홍석준(洪碩晙),78,98,176,0
13618,김영식(金英植),홍성국(洪性國),49,6,55,1
13619,김영식(金英植),홍영표(洪永杓),49,6,55,1
13620,김영식(金英植),홍익표(洪翼杓),50,6,56,1
13621,김영식(金英植),홍정민(洪貞敏),50,8,58,1
13622,김영식(金英植),황보승희(皇甫承希),97,176,273,1
13623,김영식(金英植),황운하(黃雲夏),50,6,56,1
13624,김영식(金英植),황희(黃熙),49,6,55,1
13625,김영주(金榮珠),김영진(金榮鎭),87,54,141,0
13626,김영주(金榮珠),김영호(金映豪),91,55,146,0
13627,김영주(金榮珠),김예지(金睿智),51,7,58,1
13628,김영주(金榮珠),김용민(金容民),86,62,148,0
13629,김영주(金榮珠),김용판(金用判),53,5,58,1
13630,김영주(金榮珠),김웅(金雄),52,5,57,1
13631,김영주(金榮珠),김원이(金元二),96,81,177,0
13632,김영주(金榮珠),김윤덕(金潤德),84,48,132,0
13633,김영주(金榮珠),김의겸(金宜謙),47,48,95,0
13634,김영주(金榮珠),김정재(金汀才),54,5,59,1
13635,김영주(金榮珠),김정호(金禎鎬),106,143,249,0
13636,김영주(金榮珠),김종민(金鐘民),90,65,155,0
13637,김영주(金榮珠),김주영(金周暎),96,118,214,0
13638,김영주(金榮珠),김진표(金振杓),60,58,118,1
13639,김영주(金榮珠),김철민(金哲玟),109,95,204,0
13640,김영주(金榮珠),김태년(金太年),80,53,133,0
13641,김영주(金榮珠),김태호(金台鎬),42,6,48,1
13642,김영주(金榮珠),김학용(金學容),25,5,30,1
13643,김영주(金榮珠),김한규(金翰奎),44,29,73,0
13644,김영주(金榮珠),김한정(金漢正),80,49,129,0
13645,김영주(金榮珠),김형동(金亨東),52,5,57,1
13646,김영주(金榮珠),김홍걸(金弘傑),39,118,157,0
13647,김영주(金榮珠),김회재(金會在),90,70,160,0
13648,김영주(金榮珠),김희곤(金熙坤),50,5,55,1
13649,김영주(金榮珠),김희국(金熙國),49,4,53,1
13650,김영주(金榮珠),남인순(南仁順),86,78,164,0
13651,김영주(金榮珠),노용호(魯容昊),26,4,30,1
13652,김영주(金榮珠),노웅래(盧雄來),94,80,174,0
13653,김영주(金榮珠),도종환(都鍾煥),96,82,178,0
13654,김영주(金榮珠),류성걸(柳性杰),50,4,54,1
13655,김영주(金榮珠),류호정(柳好貞),16,27,43,1
13656,김영주(金榮珠),맹성규(孟聖奎),81,69,150,0
13657,김영주(金榮珠),문정복(文貞福),78,47,125,0
13658,김영주(金榮珠),문진석(文振碩),89,89,178,0
13659,김영주(金榮珠),민병덕(閔炳德),85,102,187,0
13660,김영주(金榮珠),민형배(閔馨培),66,91,157,0
13661,김영주(金榮珠),민홍철(閔洪喆),84,57,141,0
13662,김영주(金榮珠),박광온(朴洸瑥),95,89,184,0
13663,김영주(金榮珠),박대수(朴大壽),53,21,74,1
13664,김영주(金榮珠),박대출(朴大出),51,4,55,1
13665,김영주(金榮珠),박덕흠(朴德欽),36,6,42,1
13666,김영주(金榮珠),박범계(朴範界),74,34,108,0
13667,김영주(金榮珠),박병석(朴炳錫),41,19,60,0
13668,김영주(金榮珠),박상혁(朴商赫),87,79,166,0
13669,김영주(金榮珠),박성민(朴聖敏),49,4,53,1
13670,김영주(金榮珠),박성준(朴省俊),99,88,187,0
13671,김영주(金榮珠),박성중(朴成重),49,6,55,1
13672,김영주(金榮珠),박수영(朴洙瑩),50,5,55,1
13673,김영주(金榮珠),박영순(朴英淳),87,79,166,0
13674,김영주(金榮珠),박완주(朴完柱),46,38,84,1
13675,김영주(金榮珠),박용진(朴用鎭),89,78,167,0
13676,김영주(金榮珠),박재호(朴在昊),83,56,139,0
13677,김영주(金榮珠),박정(朴釘),116,110,226,0
13678,김영주(金榮珠),박정하(朴正河),26,5,31,1
13679,김영주(金榮珠),박주민(朴柱民),79,51,130,0
13680,김영주(金榮珠),박진(朴振),50,5,55,1
13681,김영주(金榮珠),박찬대(朴贊大),84,65,149,0
13682,김영주(金榮珠),박형수(朴亨修),49,4,53,1
13683,김영주(金榮珠),박홍근(朴洪根),96,98,194,0
13684,김영주(金榮珠),배준영(裵俊英),51,4,55,1
13685,김영주(金榮珠),배진교(裵晋敎),13,18,31,1
13686,김영주(金榮珠),배현진(裵賢鎭),49,5,54,1
13687,김영주(金榮珠),백종헌(白宗憲),52,6,58,1
13688,김영주(金榮珠),백혜련(白惠蓮),98,85,183,0
13689,김영주(金榮珠),변재일(卞在一),79,63,142,0
13690,김영주(金榮珠),서동용(徐東榕),85,73,158,0
13691,김영주(金榮珠),서범수(徐範洙),52,5,57,1
13692,김영주(金榮珠),서병수(徐秉洙),52,5,57,1
13693,김영주(金榮珠),서삼석(徐參錫),108,91,199,0
13694,김영주(金榮珠),서영교(徐瑛敎),97,115,212,0
13695,김영주(金榮珠),서영석(徐暎錫),83,74,157,0
13696,김영주(金榮珠),서일준(徐一俊),52,4,56,1
13697,김영주(金榮珠),서정숙(徐正淑),50,6,56,1
13698,김영주(金榮珠),설훈(薛勳),83,70,153,0
13699,김영주(金榮珠),성일종(成一鍾),50,6,56,1
13700,김영주(金榮珠),소병철(蘇秉哲),86,72,158,0
13701,김영주(金榮珠),소병훈(蘇秉勳),82,67,149,0
13702,김영주(金榮珠),송갑석(宋甲錫),87,77,164,0
13703,김영주(金榮珠),송기헌(宋基憲),82,50,132,0
13704,김영주(金榮珠),송석준(宋錫俊),50,6,56,1
13705,김영주(金榮珠),송언석(宋彦錫),45,4,49,1
13706,김영주(金榮珠),송옥주(宋玉珠),104,128,232,0
13707,김영주(金榮珠),송재호(宋在祜),91,77,168,0
13708,김영주(金榮珠),신동근(申東根),94,61,155,0
13709,김영주(金榮珠),신영대(申榮大),80,64,144,0
13710,김영주(金榮珠),신원식(申源湜),53,5,58,1
13711,김영주(金榮珠),신정훈(辛正勳),102,121,223,0
13712,김영주(金榮珠),신현영(申賢榮),83,61,144,0
13713,김영주(金榮珠),심상정(沈相奵),12,23,35,1
13714,김영주(金榮珠),안규백(安圭伯),84,61,145,0
13715,김영주(金榮珠),안민석(安敏錫),95,63,158,0
13716,김영주(金榮珠),안병길(安炳吉),51,4,55,1
13717,김영주(金榮珠),안철수(安哲秀),26,5,31,1
13718,김영주(金榮珠),안호영(安浩永),95,98,193,0
13719,김영주(金榮珠),양경숙(梁敬淑),80,63,143,0
13720,김영주(金榮珠),양금희(梁琴喜),51,5,56,1
13721,김영주(金榮珠),양기대(梁基大),86,52,138,0
13722,김영주(金榮珠),양이원영(梁李媛瑛),86,88,174,0
13723,김영주(金榮珠),양정숙(梁貞淑),28,83,111,1
13724,김영주(金榮珠),양향자(梁香子),38,37,75,1
13725,김영주(金榮珠),어기구(魚基龜),83,47,130,0
13726,김영주(金榮珠),엄태영(嚴泰永),51,4,55,1
13727,김영주(金榮珠),오기형(吳奇炯),79,38,117,0
13728,김영주(金榮珠),오영환(吳永煥),101,155,256,0
13729,김영주(金榮珠),용혜인(龍慧仁),13,28,41,1
13730,김영주(金榮珠),우상호(禹相虎),81,46,127,0
13731,김영주(金榮珠),우원식(禹元植),88,81,169,0
13732,김영주(金榮珠),위성곤(魏聖坤),92,83,175,0
13733,김영주(金榮珠),유경준(兪京濬),49,4,53,1
13734,김영주(金榮珠),유기홍(柳基洪),76,58,134,0
13735,김영주(金榮珠),유동수(柳東秀),92,68,160,0
13736,김영주(金榮珠),유상범(劉相凡),51,4,55,1
13737,김영주(金榮珠),유의동(兪義東),50,4,54,1
13738,김영주(金榮珠),유정주(兪訂炷),96,105,201,0
13739,김영주(金榮珠),윤건영(尹建永),87,82,169,0
13740,김영주(金榮珠),윤관석(尹官石),81,71,152,1
13741,김영주(金榮珠),윤두현(尹斗鉉),50,6,56,1
13742,김영주(金榮珠),윤미향(尹美香),49,79,128,1
13743,김영주(金榮珠),윤상현(尹相現),31,7,38,1
13744,김영주(金榮珠),윤영덕(尹永德),91,100,191,0
13745,김영주(金榮珠),윤영석(尹永碩),53,5,58,1
13746,김영주(金榮珠),윤영찬(尹永燦),80,76,156,0
13747,김영주(金榮珠),윤재갑(尹才鉀),101,89,190,0
13748,김영주(金榮珠),윤재옥(尹在玉),50,4,54,1
13749,김영주(金榮珠),윤주경(尹柱卿),49,6,55,1
13750,김영주(金榮珠),윤준병(尹準炳),93,113,206,0
13751,김영주(金榮珠),윤창현(尹暢賢),49,6,55,1
13752,김영주(金榮珠),윤한홍(尹漢洪),50,4,54,1
13753,김영주(金榮珠),윤호중(尹昊重),80,59,139,0
13754,김영주(金榮珠),윤후덕(尹厚德),95,92,187,0
13755,김영주(金榮珠),이개호(李介昊),88,67,155,0
13756,김영주(金榮珠),이달곤(李達坤),52,7,59,1
13757,김영주(金榮珠),이동주(李東洲),85,84,169,0
13758,김영주(金榮珠),이만희(李晩熙),52,4,56,1
13759,김영주(金榮珠),이명수(李明洙),53,10,63,1
13760,김영주(金榮珠),이병훈(李炳勳),85,92,177,0
13761,김영주(金榮珠),이상민(李相珉),78,46,124,0
13762,김영주(金榮珠),이상헌(李相憲),93,69,162,0
13763,김영주(金榮珠),이성만(李成萬),77,86,163,1
13764,김영주(金榮珠),이소영(李素永),79,56,135,0
13765,김영주(金榮珠),이수진(李壽珍),98,131,229,0
13766,김영주(金榮珠),이수진(李秀眞),107,85,192,0
13767,김영주(金榮珠),이양수(李亮壽),52,4,56,1
13768,김영주(金榮珠),이용(李鏞),50,4,54,1
13769,김영주(金榮珠),이용빈(李龍彬),97,140,237,0
13770,김영주(金榮珠),이용선(李庸瑄),91,93,184,0
13771,김영주(金榮珠),이용우(李龍雨),96,76,172,0
13772,김영주(金榮珠),이용호(李容鎬),28,6,34,1
13773,김영주(金榮珠),이원욱(李元旭),98,156,254,0
13774,김영주(金榮珠),이원택(李源澤),86,68,154,0
13775,김영주(金榮珠),이은주(李恩周),14,24,38,1
13776,김영주(金榮珠),이인선(李仁善),25,5,30,1
13777,김영주(金榮珠),이인영(李仁榮),77,44,121,0
13778,김영주(金榮珠),이장섭(李將燮),84,75,159,0
13779,김영주(金榮珠),이재명(李在明),40,20,60,0
13780,김영주(金榮珠),이재정(李在汀),82,57,139,0
13781,김영주(金榮珠),이정문(李楨文),86,94,180,0
13782,김영주(金榮珠),이종배(李鍾培),51,6,57,1
13783,김영주(金榮珠),이종성(李鍾成),51,4,55,1
13784,김영주(金榮珠),이주환(李周桓),51,7,58,1
13785,김영주(金榮珠),이채익(李埰益),51,5,56,1
13786,김영주(金榮珠),이철규(李喆圭),53,5,58,1
13787,김영주(金榮珠),이탄희(李誕熙),80,61,141,0
13788,김영주(金榮珠),이태규(李泰珪),28,6,34,1
13789,김영주(金榮珠),이학영(李學永),84,102,186,0
13790,김영주(金榮珠),이해식(李海植),83,73,156,0
13791,김영주(金榮珠),이헌승(李憲昇),50,7,57,1
13792,김영주(金榮珠),이형석(李炯錫),87,77,164,0
13793,김영주(金榮珠),인재근(印在謹),79,67,146,0
13794,김영주(金榮珠),임병헌(林炳憲),25,4,29,1
13795,김영주(金榮珠),임오경(林五卿),98,82,180,0
13796,김영주(金榮珠),임이자(林利子),49,4,53,1
13797,김영주(金榮珠),임종성(林鍾聲),97,109,206,0
13798,김영주(金榮珠),임호선(林昊宣),106,123,229,0
13799,김영주(金榮珠),장경태(張耿態),95,100,195,0
13800,김영주(金榮珠),장동혁(張東赫),25,4,29,1
13801,김영주(金榮珠),장제원(張濟元),49,4,53,1
13802,김영주(金榮珠),장철민(張喆敏),101,94,195,0
13803,김영주(金榮珠),장혜영(張惠英),11,14,25,1
13804,김영주(金榮珠),전봉민(田奉珉),35,5,40,1
13805,김영주(金榮珠),전용기(田溶冀),96,81,177,0
13806,김영주(金榮珠),전재수(田載秀),80,52,132,0
13807,김영주(金榮珠),전주혜(全珠惠),52,5,57,1
13808,김영주(金榮珠),전해철(全海澈),83,69,152,0
13809,김영주(金榮珠),전혜숙(全惠淑),88,76,164,0
13810,김영주(金榮珠),정경희(丁慶姬),51,4,55,1
13811,김영주(金榮珠),정동만(鄭東萬),50,4,54,1
13812,김영주(金榮珠),정성호(鄭成湖),83,87,170,0
13813,김영주(金榮珠),정우택(鄭宇澤),26,4,30,1
13814,김영주(金榮珠),정운천(鄭雲天),50,4,54,1
13815,김영주(金榮珠),정일영(鄭日永),89,96,185,0
13816,김영주(金榮珠),정점식(鄭点植),50,4,54,1
13817,김영주(金榮珠),정진석(鄭鎭碩),51,9,60,1
13818,김영주(金榮珠),정청래(鄭淸來),88,86,174,0
13819,김영주(金榮珠),정춘숙(鄭春淑),91,85,176,0
13820,김영주(金榮珠),정태호(鄭泰浩),79,96,175,0
13821,김영주(金榮珠),정필모(鄭必模),88,91,179,0
13822,김영주(金榮珠),정희용(鄭熙溶),51,8,59,1
13823,김영주(金榮珠),조경태(趙慶泰),50,4,54,1
13824,김영주(金榮珠),조명희(曺明姬),52,6,58,1
13825,김영주(金榮珠),조수진(趙修眞),50,4,54,1
13826,김영주(金榮珠),조승래(趙承來),102,95,197,0
13827,김영주(金榮珠),조오섭(曺五燮),88,114,202,0
13828,김영주(金榮珠),조은희(趙恩禧),27,5,32,1
13829,김영주(金榮珠),조응천(趙應天),75,41,116,0
13830,김영주(金榮珠),조정식(趙正湜),75,37,112,0
13831,김영주(金榮珠),조정훈(趙廷訓),2,7,9,1
13832,김영주(金榮珠),조해진(曺海珍),52,5,57,1
13833,김영주(金榮珠),주철현(朱哲鉉),87,85,172,0
13834,김영주(金榮珠),주호영(朱豪英),50,5,55,1
13835,김영주(金榮珠),지성호(池成浩),50,6,56,1
13836,김영주(金榮珠),진선미(陳善美),80,43,123,0
13837,김영주(金榮珠),진성준(陳聲準),84,67,151,0
13838,김영주(金榮珠),천준호(千俊鎬),82,61,143,0
13839,김영주(金榮珠),최기상(崔基相),82,54,136,0
13840,김영주(金榮珠),최승재(崔承宰),50,7,57,1
13841,김영주(金榮珠),최연숙(崔姸淑),32,13,45,1
13842,김영주(金榮珠),최영희(崔英姬),26,5,31,1
13843,김영주(金榮珠),최인호(崔仁昊),84,80,164,0
13844,김영주(金榮珠),최재형(崔在亨),25,4,29,1
13845,김영주(金榮珠),최종윤(崔鍾允),88,94,182,0
13846,김영주(金榮珠),최춘식(崔春植),50,5,55,1
13847,김영주(金榮珠),최형두(崔炯斗),50,10,60,1
13848,김영주(金榮珠),최혜영(崔惠英),83,95,178,0
13849,김영주(金榮珠),추경호(秋慶鎬),49,3,52,1
13850,김영주(金榮珠),태영호(太永浩),49,8,57,1
13851,김영주(金榮珠),하영제(河榮帝),44,4,48,1
13852,김영주(金榮珠),하태경(河泰慶),53,8,61,1
13853,김영주(金榮珠),한기호(韓起鎬),52,4,56,1
13854,김영주(金榮珠),한무경(韓茂景),49,5,54,1
13855,김영주(金榮珠),한병도(韓秉道),87,71,158,0
13856,김영주(金榮珠),한정애(韓貞愛),87,98,185,0
13857,김영주(金榮珠),한준호(韓俊鎬),91,109,200,0
13858,김영주(金榮珠),허숙정(許淑湞),1,2,3,0
13859,김영주(金榮珠),허영(許榮),99,103,202,0
13860,김영주(金榮珠),허은아(許垠娥),49,6,55,1
13861,김영주(金榮珠),허종식(許琮植),103,101,204,0
13862,김영주(金榮珠),홍기원(洪起元),92,84,176,0
13863,김영주(金榮珠),홍문표(洪文杓),50,8,58,1
13864,김영주(金榮珠),홍석준(洪碩晙),51,6,57,1
13865,김영주(金榮珠),홍성국(洪性國),91,105,196,0
13866,김영주(金榮珠),홍영표(洪永杓),83,63,146,0
13867,김영주(金榮珠),홍익표(洪翼杓),87,75,162,0
13868,김영주(金榮珠),홍정민(洪貞敏),96,135,231,0
13869,김영주(金榮珠),황보승희(皇甫承希),49,4,53,1
13870,김영주(金榮珠),황운하(黃雲夏),101,107,208,0
13871,김영주(金榮珠),황희(黃熙),78,51,129,0
13872,김영진(金榮鎭),김영호(金映豪),80,40,120,0
13873,김영진(金榮鎭),김예지(金睿智),52,6,58,1
13874,김영진(金榮鎭),김용민(金容民),81,46,127,0
13875,김영진(金榮鎭),김용판(金用判),53,4,57,1
13876,김영진(金榮鎭),김웅(金雄),51,3,54,1
13877,김영진(金榮鎭),김원이(金元二),92,58,150,0
13878,김영진(金榮鎭),김윤덕(金潤德),96,98,194,0
13879,김영진(金榮鎭),김의겸(金宜謙),46,29,75,0
13880,김영진(金榮鎭),김정재(金汀才),53,4,57,1
13881,김영진(金榮鎭),김정호(金禎鎬),108,113,221,0
13882,김영진(金榮鎭),김종민(金鐘民),87,58,145,0
13883,김영진(金榮鎭),김주영(金周暎),101,125,226,0
13884,김영진(金榮鎭),김진표(金振杓),51,39,90,1
13885,김영진(金榮鎭),김철민(金哲玟),93,100,193,0
13886,김영진(金榮鎭),김태년(金太年),78,66,144,0
13887,김영진(金榮鎭),김태호(金台鎬),41,5,46,1
13888,김영진(金榮鎭),김학용(金學容),27,4,31,1
13889,김영진(金榮鎭),김한규(金翰奎),41,29,70,0
13890,김영진(金榮鎭),김한정(金漢正),76,41,117,0
13891,김영진(金榮鎭),김형동(金亨東),50,4,54,1
13892,김영진(金榮鎭),김홍걸(金弘傑),27,73,100,0
13893,김영진(金榮鎭),김회재(金會在),78,43,121,0
13894,김영진(金榮鎭),김희곤(金熙坤),49,3,52,1
13895,김영진(金榮鎭),김희국(金熙國),51,3,54,1
13896,김영진(金榮鎭),남인순(南仁順),81,48,129,0
13897,김영진(金榮鎭),노용호(魯容昊),26,3,29,1
13898,김영진(金榮鎭),노웅래(盧雄來),90,99,189,0
13899,김영진(金榮鎭),도종환(都鍾煥),85,50,135,0
13900,김영진(金榮鎭),류성걸(柳性杰),50,3,53,1
13901,김영진(金榮鎭),류호정(柳好貞),11,12,23,1
13902,김영진(金榮鎭),맹성규(孟聖奎),80,48,128,0
13903,김영진(金榮鎭),문정복(文貞福),79,47,126,0
13904,김영진(金榮鎭),문진석(文振碩),79,74,153,0
13905,김영진(金榮鎭),민병덕(閔炳德),80,82,162,0
13906,김영진(金榮鎭),민형배(閔馨培),65,79,144,0
13907,김영진(金榮鎭),민홍철(閔洪喆),74,48,122,0
13908,김영진(金榮鎭),박광온(朴洸瑥),82,55,137,0
13909,김영진(金榮鎭),박대수(朴大壽),52,4,56,1
13910,김영진(金榮鎭),박대출(朴大出),50,3,53,1
13911,김영진(金榮鎭),박덕흠(朴德欽),37,6,43,1
13912,김영진(金榮鎭),박범계(朴範界),74,33,107,0
13913,김영진(金榮鎭),박병석(朴炳錫),40,21,61,0
13914,김영진(金榮鎭),박상혁(朴商赫),87,152,239,0
13915,김영진(金榮鎭),박성민(朴聖敏),50,3,53,1
13916,김영진(金榮鎭),박성준(朴省俊),79,74,153,0
13917,김영진(金榮鎭),박성중(朴成重),50,3,53,1
13918,김영진(金榮鎭),박수영(朴洙瑩),49,3,52,1
13919,김영진(金榮鎭),박영순(朴英淳),79,56,135,0
13920,김영진(金榮鎭),박완주(朴完柱),45,39,84,1
13921,김영진(金榮鎭),박용진(朴用鎭),73,51,124,0
13922,김영진(金榮鎭),박재호(朴在昊),84,47,131,0
13923,김영진(金榮鎭),박정(朴釘),89,68,157,0
13924,김영진(金榮鎭),박정하(朴正河),27,4,31,1
13925,김영진(金榮鎭),박주민(朴柱民),75,45,120,0
13926,김영진(金榮鎭),박진(朴振),51,3,54,1
13927,김영진(金榮鎭),박찬대(朴贊大),82,64,146,0
13928,김영진(金榮鎭),박형수(朴亨修),50,3,53,1
13929,김영진(金榮鎭),박홍근(朴洪根),82,78,160,0
13930,김영진(金榮鎭),배준영(裵俊英),49,3,52,1
13931,김영진(金榮鎭),배진교(裵晋敎),10,10,20,1
13932,김영진(金榮鎭),배현진(裵賢鎭),51,9,60,1
13933,김영진(金榮鎭),백종헌(白宗憲),51,3,54,1
13934,김영진(金榮鎭),백혜련(白惠蓮),95,89,184,0
13935,김영진(金榮鎭),변재일(卞在一),76,48,124,0
13936,김영진(金榮鎭),서동용(徐東榕),83,50,133,0
13937,김영진(金榮鎭),서범수(徐範洙),50,3,53,1
13938,김영진(金榮鎭),서병수(徐秉洙),49,3,52,1
13939,김영진(金榮鎭),서삼석(徐參錫),95,58,153,0
13940,김영진(金榮鎭),서영교(徐瑛敎),91,64,155,0
13941,김영진(金榮鎭),서영석(徐暎錫),84,86,170,0
13942,김영진(金榮鎭),서일준(徐一俊),50,3,53,1
13943,김영진(金榮鎭),서정숙(徐正淑),50,3,53,1
13944,김영진(金榮鎭),설훈(薛勳),76,53,129,0
13945,김영진(金榮鎭),성일종(成一鍾),49,3,52,1
13946,김영진(金榮鎭),소병철(蘇秉哲),79,51,130,0
13947,김영진(金榮鎭),소병훈(蘇秉勳),85,85,170,0
13948,김영진(金榮鎭),송갑석(宋甲錫),83,78,161,0
13949,김영진(金榮鎭),송기헌(宋基憲),85,55,140,0
13950,김영진(金榮鎭),송석준(宋錫俊),53,3,56,1
13951,김영진(金榮鎭),송언석(宋彦錫),48,3,51,1
13952,김영진(金榮鎭),송옥주(宋玉珠),83,60,143,0
13953,김영진(金榮鎭),송재호(宋在祜),83,54,137,0
13954,김영진(金榮鎭),신동근(申東根),85,63,148,0
13955,김영진(金榮鎭),신영대(申榮大),83,69,152,0
13956,김영진(金榮鎭),신원식(申源湜),51,3,54,1
13957,김영진(金榮鎭),신정훈(辛正勳),89,86,175,0
13958,김영진(金榮鎭),신현영(申賢榮),73,46,119,0
13959,김영진(金榮鎭),심상정(沈相奵),11,15,26,1
13960,김영진(金榮鎭),안규백(安圭伯),82,58,140,0
13961,김영진(金榮鎭),안민석(安敏錫),78,55,133,0
13962,김영진(金榮鎭),안병길(安炳吉),49,3,52,1
13963,김영진(金榮鎭),안철수(安哲秀),27,3,30,1
13964,김영진(金榮鎭),안호영(安浩永),76,51,127,0
13965,김영진(金榮鎭),양경숙(梁敬淑),88,68,156,0
13966,김영진(金榮鎭),양금희(梁琴喜),51,3,54,1
13967,김영진(金榮鎭),양기대(梁基大),85,63,148,0
13968,김영진(金榮鎭),양이원영(梁李媛瑛),74,47,121,0
13969,김영진(金榮鎭),양정숙(梁貞淑),23,30,53,1
13970,김영진(金榮鎭),양향자(梁香子),35,13,48,1
13971,김영진(金榮鎭),어기구(魚基龜),83,39,122,0
13972,김영진(金榮鎭),엄태영(嚴泰永),51,9,60,1
13973,김영진(金榮鎭),오기형(吳奇炯),74,33,107,0
13974,김영진(金榮鎭),오영환(吳永煥),91,85,176,0
13975,김영진(金榮鎭),용혜인(龍慧仁),13,13,26,1
13976,김영진(金榮鎭),우상호(禹相虎),74,33,107,0
13977,김영진(金榮鎭),우원식(禹元植),91,68,159,0
13978,김영진(金榮鎭),위성곤(魏聖坤),90,88,178,0
13979,김영진(金榮鎭),유경준(兪京濬),50,3,53,1
13980,김영진(金榮鎭),유기홍(柳基洪),77,76,153,0
13981,김영진(金榮鎭),유동수(柳東秀),81,57,138,0
13982,김영진(金榮鎭),유상범(劉相凡),51,3,54,1
13983,김영진(金榮鎭),유의동(兪義東),50,4,54,1
13984,김영진(金榮鎭),유정주(兪訂炷),82,95,177,0
13985,김영진(金榮鎭),윤건영(尹建永),79,60,139,0
13986,김영진(金榮鎭),윤관석(尹官石),68,54,122,1
13987,김영진(金榮鎭),윤두현(尹斗鉉),51,3,54,1
13988,김영진(金榮鎭),윤미향(尹美香),38,41,79,1
13989,김영진(金榮鎭),윤상현(尹相現),32,3,35,1
13990,김영진(金榮鎭),윤영덕(尹永德),79,55,134,0
13991,김영진(金榮鎭),윤영석(尹永碩),50,4,54,1
13992,김영진(金榮鎭),윤영찬(尹永燦),77,59,136,0
13993,김영진(金榮鎭),윤재갑(尹才鉀),88,63,151,0
13994,김영진(金榮鎭),윤재옥(尹在玉),50,3,53,1
13995,김영진(金榮鎭),윤주경(尹柱卿),50,4,54,1
13996,김영진(金榮鎭),윤준병(尹準炳),86,78,164,0
13997,김영진(金榮鎭),윤창현(尹暢賢),50,3,53,1
13998,김영진(金榮鎭),윤한홍(尹漢洪),51,3,54,1
13999,김영진(金榮鎭),윤호중(尹昊重),75,60,135,0
14000,김영진(金榮鎭),윤후덕(尹厚德),92,113,205,0
14001,김영진(金榮鎭),이개호(李介昊),90,70,160,0
14002,김영진(金榮鎭),이달곤(李達坤),51,5,56,1
14003,김영진(金榮鎭),이동주(李東洲),80,109,189,0
14004,김영진(金榮鎭),이만희(李晩熙),52,3,55,1
14005,김영진(金榮鎭),이명수(李明洙),49,6,55,1
14006,김영진(金榮鎭),이병훈(李炳勳),84,65,149,0
14007,김영진(金榮鎭),이상민(李相珉),74,31,105,0
14008,김영진(金榮鎭),이상헌(李相憲),86,54,140,0
14009,김영진(金榮鎭),이성만(李成萬),69,64,133,1
14010,김영진(金榮鎭),이소영(李素永),79,46,125,0
14011,김영진(金榮鎭),이수진(李壽珍),86,87,173,0
14012,김영진(金榮鎭),이수진(李秀眞),81,51,132,0
14013,김영진(金榮鎭),이양수(李亮壽),54,3,57,1
14014,김영진(金榮鎭),이용(李鏞),51,9,60,1
14015,김영진(金榮鎭),이용빈(李龍彬),88,77,165,0
14016,김영진(金榮鎭),이용선(李庸瑄),82,51,133,0
14017,김영진(金榮鎭),이용우(李龍雨),83,45,128,0
14018,김영진(金榮鎭),이용호(李容鎬),28,6,34,1
14019,김영진(金榮鎭),이원욱(李元旭),92,103,195,0
14020,김영진(金榮鎭),이원택(李源澤),81,45,126,0
14021,김영진(金榮鎭),이은주(李恩周),12,11,23,1
14022,김영진(金榮鎭),이인선(李仁善),26,3,29,1
14023,김영진(金榮鎭),이인영(李仁榮),73,66,139,0
14024,김영진(金榮鎭),이장섭(李將燮),83,51,134,0
14025,김영진(金榮鎭),이재명(李在明),40,18,58,0
14026,김영진(金榮鎭),이재정(李在汀),77,40,117,0
14027,김영진(金榮鎭),이정문(李楨文),83,108,191,0
14028,김영진(金榮鎭),이종배(李鍾培),54,5,59,1
14029,김영진(金榮鎭),이종성(李鍾成),51,3,54,1
14030,김영진(金榮鎭),이주환(李周桓),52,9,61,1
14031,김영진(金榮鎭),이채익(李埰益),50,4,54,1
14032,김영진(金榮鎭),이철규(李喆圭),52,3,55,1
14033,김영진(金榮鎭),이탄희(李誕熙),78,52,130,0
14034,김영진(金榮鎭),이태규(李泰珪),28,4,32,1
14035,김영진(金榮鎭),이학영(李學永),90,102,192,0
14036,김영진(金榮鎭),이해식(李海植),90,62,152,0
14037,김영진(金榮鎭),이헌승(李憲昇),51,3,54,1
14038,김영진(金榮鎭),이형석(李炯錫),83,74,157,0
14039,김영진(金榮鎭),인재근(印在謹),90,111,201,0
14040,김영진(金榮鎭),임병헌(林炳憲),26,3,29,1
14041,김영진(金榮鎭),임오경(林五卿),82,46,128,0
14042,김영진(金榮鎭),임이자(林利子),51,3,54,1
14043,김영진(金榮鎭),임종성(林鍾聲),94,87,181,0
14044,김영진(金榮鎭),임호선(林昊宣),98,124,222,0
14045,김영진(金榮鎭),장경태(張耿態),89,73,162,0
14046,김영진(金榮鎭),장동혁(張東赫),26,3,29,1
14047,김영진(金榮鎭),장제원(張濟元),49,3,52,1
14048,김영진(金榮鎭),장철민(張喆敏),84,81,165,0
14049,김영진(金榮鎭),장혜영(張惠英),9,7,16,1
14050,김영진(金榮鎭),전봉민(田奉珉),35,4,39,1
14051,김영진(金榮鎭),전용기(田溶冀),86,82,168,0
14052,김영진(金榮鎭),전재수(田載秀),73,40,113,0
14053,김영진(金榮鎭),전주혜(全珠惠),52,9,61,1
14054,김영진(金榮鎭),전해철(全海澈),75,56,131,0
14055,김영진(金榮鎭),전혜숙(全惠淑),76,44,120,0
14056,김영진(金榮鎭),정경희(丁慶姬),50,4,54,1
14057,김영진(金榮鎭),정동만(鄭東萬),51,3,54,1
14058,김영진(金榮鎭),정성호(鄭成湖),82,91,173,0
14059,김영진(金榮鎭),정우택(鄭宇澤),26,3,29,1
14060,김영진(金榮鎭),정운천(鄭雲天),52,5,57,1
14061,김영진(金榮鎭),정일영(鄭日永),92,98,190,0
14062,김영진(金榮鎭),정점식(鄭点植),50,3,53,1
14063,김영진(金榮鎭),정진석(鄭鎭碩),49,4,53,1
14064,김영진(金榮鎭),정청래(鄭淸來),77,37,114,0
14065,김영진(金榮鎭),정춘숙(鄭春淑),93,86,179,0
14066,김영진(金榮鎭),정태호(鄭泰浩),79,68,147,0
14067,김영진(金榮鎭),정필모(鄭必模),78,46,124,0
14068,김영진(金榮鎭),정희용(鄭熙溶),51,10,61,1
14069,김영진(金榮鎭),조경태(趙慶泰),50,3,53,1
14070,김영진(金榮鎭),조명희(曺明姬),53,5,58,1
14071,김영진(金榮鎭),조수진(趙修眞),50,3,53,1
14072,김영진(金榮鎭),조승래(趙承來),85,88,173,0
14073,김영진(金榮鎭),조오섭(曺五燮),83,99,182,0
14074,김영진(金榮鎭),조은희(趙恩禧),27,3,30,1
14075,김영진(金榮鎭),조응천(趙應天),76,66,142,0
14076,김영진(金榮鎭),조정식(趙正湜),75,70,145,0
14077,김영진(金榮鎭),조정훈(趙廷訓),0,11,11,1
14078,김영진(金榮鎭),조해진(曺海珍),51,4,55,1
14079,김영진(金榮鎭),주철현(朱哲鉉),91,66,157,0
14080,김영진(金榮鎭),주호영(朱豪英),51,3,54,1
14081,김영진(金榮鎭),지성호(池成浩),52,3,55,1
14082,김영진(金榮鎭),진선미(陳善美),74,54,128,0
14083,김영진(金榮鎭),진성준(陳聲準),87,88,175,0
14084,김영진(金榮鎭),천준호(千俊鎬),81,49,130,0
14085,김영진(金榮鎭),최기상(崔基相),83,50,133,0
14086,김영진(金榮鎭),최승재(崔承宰),52,10,62,1
14087,김영진(金榮鎭),최연숙(崔姸淑),30,10,40,1
14088,김영진(金榮鎭),최영희(崔英姬),26,4,30,1
14089,김영진(金榮鎭),최인호(崔仁昊),80,81,161,0
14090,김영진(金榮鎭),최재형(崔在亨),27,4,31,1
14091,김영진(金榮鎭),최종윤(崔鍾允),103,162,265,0
14092,김영진(金榮鎭),최춘식(崔春植),51,3,54,1
14093,김영진(金榮鎭),최형두(崔炯斗),51,8,59,1
14094,김영진(金榮鎭),최혜영(崔惠英),85,83,168,0
14095,김영진(金榮鎭),추경호(秋慶鎬),49,10,59,1
14096,김영진(金榮鎭),태영호(太永浩),51,4,55,1
14097,김영진(金榮鎭),하영제(河榮帝),44,0,44,1
14098,김영진(金榮鎭),하태경(河泰慶),51,3,54,1
14099,김영진(金榮鎭),한기호(韓起鎬),52,3,55,1
14100,김영진(金榮鎭),한무경(韓茂景),50,3,53,1
14101,김영진(金榮鎭),한병도(韓秉道),92,74,166,0
14102,김영진(金榮鎭),한정애(韓貞愛),77,69,146,0
14103,김영진(金榮鎭),한준호(韓俊鎬),84,109,193,0
14104,김영진(金榮鎭),허숙정(許淑湞),1,1,2,0
14105,김영진(金榮鎭),허영(許榮),89,105,194,0
14106,김영진(金榮鎭),허은아(許垠娥),50,3,53,1
14107,김영진(金榮鎭),허종식(許琮植),82,55,137,0
14108,김영진(金榮鎭),홍기원(洪起元),81,82,163,0
14109,김영진(金榮鎭),홍문표(洪文杓),49,4,53,1
14110,김영진(金榮鎭),홍석준(洪碩晙),50,3,53,1
14111,김영진(金榮鎭),홍성국(洪性國),85,69,154,0
14112,김영진(金榮鎭),홍영표(洪永杓),83,50,133,0
14113,김영진(金榮鎭),홍익표(洪翼杓),79,54,133,0
14114,김영진(金榮鎭),홍정민(洪貞敏),90,73,163,0
14115,김영진(金榮鎭),황보승희(皇甫承希),46,0,46,1
14116,김영진(金榮鎭),황운하(黃雲夏),82,64,146,0
14117,김영진(金榮鎭),황희(黃熙),73,41,114,0
14118,김영호(金映豪),김예지(金睿智),52,5,57,1
14119,김영호(金映豪),김용민(金容民),100,100,200,0
14120,김영호(金映豪),김용판(金用判),51,4,55,1
14121,김영호(金映豪),김웅(金雄),51,4,55,1
14122,김영호(金映豪),김원이(金元二),92,68,160,0
14123,김영호(金映豪),김윤덕(金潤德),88,54,142,0
14124,김영호(金映豪),김의겸(金宜謙),55,46,101,0
14125,김영호(金映豪),김정재(金汀才),52,5,57,1
14126,김영호(金映豪),김정호(金禎鎬),100,100,200,0
14127,김영호(金映豪),김종민(金鐘民),87,59,146,0
14128,김영호(金映豪),김주영(金周暎),89,60,149,0
14129,김영호(金映豪),김진표(金振杓),53,34,87,1
14130,김영호(金映豪),김철민(金哲玟),99,88,187,0
14131,김영호(金映豪),김태년(金太年),79,44,123,0
14132,김영호(金映豪),김태호(金台鎬),40,5,45,1
14133,김영호(金映豪),김학용(金學容),25,5,30,1
14134,김영호(金映豪),김한규(金翰奎),44,28,72,0
14135,김영호(金映豪),김한정(金漢正),85,43,128,0
14136,김영호(金映豪),김형동(金亨東),49,5,54,1
14137,김영호(金映豪),김홍걸(金弘傑),54,103,157,0
14138,김영호(金映豪),김회재(金會在),100,94,194,0
14139,김영호(金映豪),김희곤(金熙坤),49,5,54,1
14140,김영호(金映豪),김희국(金熙國),49,4,53,1
14141,김영호(金映豪),남인순(南仁順),122,116,238,0
14142,김영호(金映豪),노용호(魯容昊),25,4,29,1
14143,김영호(金映豪),노웅래(盧雄來),91,71,162,0
14144,김영호(金映豪),도종환(都鍾煥),98,77,175,0
14145,김영호(金映豪),류성걸(柳性杰),49,6,55,1
14146,김영호(金映豪),류호정(柳好貞),19,36,55,1
14147,김영호(金映豪),맹성규(孟聖奎),108,86,194,0
14148,김영호(金映豪),문정복(文貞福),96,81,177,0
14149,김영호(金映豪),문진석(文振碩),91,76,167,0
14150,김영호(金映豪),민병덕(閔炳德),93,110,203,0
14151,김영호(金映豪),민형배(閔馨培),74,124,198,0
14152,김영호(金映豪),민홍철(閔洪喆),85,58,143,0
14153,김영호(金映豪),박광온(朴洸瑥),78,54,132,0
14154,김영호(金映豪),박대수(朴大壽),49,4,53,1
14155,김영호(金映豪),박대출(朴大出),49,4,53,1
14156,김영호(金映豪),박덕흠(朴德欽),35,5,40,1
14157,김영호(金映豪),박범계(朴範界),74,33,107,0
14158,김영호(金映豪),박병석(朴炳錫),40,18,58,0
14159,김영호(金映豪),박상혁(朴商赫),89,84,173,0
14160,김영호(金映豪),박성민(朴聖敏),49,5,54,1
14161,김영호(金映豪),박성준(朴省俊),125,162,287,0
14162,김영호(金映豪),박성중(朴成重),49,5,54,1
14163,김영호(金映豪),박수영(朴洙瑩),49,4,53,1
14164,김영호(金映豪),박영순(朴英淳),99,77,176,0
14165,김영호(金映豪),박완주(朴完柱),44,47,91,1
14166,김영호(金映豪),박용진(朴用鎭),77,52,129,0
14167,김영호(金映豪),박재호(朴在昊),79,56,135,0
14168,김영호(金映豪),박정(朴釘),95,73,168,0
14169,김영호(金映豪),박정하(朴正河),25,4,29,1
14170,김영호(金映豪),박주민(朴柱民),77,63,140,0
14171,김영호(金映豪),박진(朴振),49,7,56,1
14172,김영호(金映豪),박찬대(朴贊大),87,61,148,0
14173,김영호(金映豪),박형수(朴亨修),49,5,54,1
14174,김영호(金映豪),박홍근(朴洪根),94,81,175,0
14175,김영호(金映豪),배준영(裵俊英),49,5,54,1
14176,김영호(金映豪),배진교(裵晋敎),15,14,29,1
14177,김영호(金映豪),배현진(裵賢鎭),49,4,53,1
14178,김영호(金映豪),백종헌(白宗憲),49,5,54,1
14179,김영호(金映豪),백혜련(白惠蓮),99,65,164,0
14180,김영호(金映豪),변재일(卞在一),85,42,127,0
14181,김영호(金映豪),서동용(徐東榕),101,96,197,0
14182,김영호(金映豪),서범수(徐範洙),51,5,56,1
14183,김영호(金映豪),서병수(徐秉洙),49,4,53,1
14184,김영호(金映豪),서삼석(徐參錫),91,62,153,0
14185,김영호(金映豪),서영교(徐瑛敎),127,136,263,0
14186,김영호(金映豪),서영석(徐暎錫),91,86,177,0
14187,김영호(金映豪),서일준(徐一俊),49,4,53,1
14188,김영호(金映豪),서정숙(徐正淑),49,4,53,1
14189,김영호(金映豪),설훈(薛勳),81,50,131,0
14190,김영호(金映豪),성일종(成一鍾),49,4,53,1
14191,김영호(金映豪),소병철(蘇秉哲),82,48,130,0
14192,김영호(金映豪),소병훈(蘇秉勳),96,84,180,0
14193,김영호(金映豪),송갑석(宋甲錫),102,93,195,0
14194,김영호(金映豪),송기헌(宋基憲),82,53,135,0
14195,김영호(金映豪),송석준(宋錫俊),50,4,54,1
14196,김영호(金映豪),송언석(宋彦錫),45,6,51,1
14197,김영호(金映豪),송옥주(宋玉珠),92,100,192,0
14198,김영호(金映豪),송재호(宋在祜),108,96,204,0
14199,김영호(金映豪),신동근(申東根),85,48,133,0
14200,김영호(金映豪),신영대(申榮大),81,57,138,0
14201,김영호(金映豪),신원식(申源湜),49,4,53,1
14202,김영호(金映豪),신정훈(辛正勳),119,172,291,0
14203,김영호(金映豪),신현영(申賢榮),77,44,121,0
14204,김영호(金映豪),심상정(沈相奵),12,21,33,1
14205,김영호(金映豪),안규백(安圭伯),102,78,180,0
14206,김영호(金映豪),안민석(安敏錫),103,107,210,0
14207,김영호(金映豪),안병길(安炳吉),50,4,54,1
14208,김영호(金映豪),안철수(安哲秀),25,4,29,1
14209,김영호(金映豪),안호영(安浩永),86,55,141,0
14210,김영호(金映豪),양경숙(梁敬淑),106,127,233,0
14211,김영호(金映豪),양금희(梁琴喜),49,4,53,1
14212,김영호(金映豪),양기대(梁基大),86,57,143,0
14213,김영호(金映豪),양이원영(梁李媛瑛),88,61,149,0
14214,김영호(金映豪),양정숙(梁貞淑),59,155,214,1
14215,김영호(金映豪),양향자(梁香子),34,37,71,1
14216,김영호(金映豪),어기구(魚基龜),79,54,133,0
14217,김영호(金映豪),엄태영(嚴泰永),49,5,54,1
14218,김영호(金映豪),오기형(吳奇炯),80,44,124,0
14219,김영호(金映豪),오영환(吳永煥),143,154,297,0
14220,김영호(金映豪),용혜인(龍慧仁),19,42,61,1
14221,김영호(金映豪),우상호(禹相虎),77,41,118,0
14222,김영호(金映豪),우원식(禹元植),81,52,133,0
14223,김영호(金映豪),위성곤(魏聖坤),87,80,167,0
14224,김영호(金映豪),유경준(兪京濬),49,4,53,1
14225,김영호(金映豪),유기홍(柳基洪),82,65,147,0
14226,김영호(金映豪),유동수(柳東秀),81,51,132,0
14227,김영호(金映豪),유상범(劉相凡),49,4,53,1
14228,김영호(金映豪),유의동(兪義東),50,5,55,1
14229,김영호(金映豪),유정주(兪訂炷),103,102,205,0
14230,김영호(金映豪),윤건영(尹建永),94,72,166,0
14231,김영호(金映豪),윤관석(尹官石),73,62,135,1
14232,김영호(金映豪),윤두현(尹斗鉉),49,5,54,1
14233,김영호(金映豪),윤미향(尹美香),59,71,130,1
14234,김영호(金映豪),윤상현(尹相現),29,5,34,1
14235,김영호(金映豪),윤영덕(尹永德),91,77,168,0
14236,김영호(金映豪),윤영석(尹永碩),50,4,54,1
14237,김영호(金映豪),윤영찬(尹永燦),84,65,149,0
14238,김영호(金映豪),윤재갑(尹才鉀),112,102,214,0
14239,김영호(金映豪),윤재옥(尹在玉),50,4,54,1
14240,김영호(金映豪),윤주경(尹柱卿),49,8,57,1
14241,김영호(金映豪),윤준병(尹準炳),89,111,200,0
14242,김영호(金映豪),윤창현(尹暢賢),49,4,53,1
14243,김영호(金映豪),윤한홍(尹漢洪),49,5,54,1
14244,김영호(金映豪),윤호중(尹昊重),77,45,122,0
14245,김영호(金映豪),윤후덕(尹厚德),79,58,137,0
14246,김영호(金映豪),이개호(李介昊),82,51,133,0
14247,김영호(金映豪),이달곤(李達坤),51,7,58,1
14248,김영호(金映豪),이동주(李東洲),94,91,185,0
14249,김영호(金映豪),이만희(李晩熙),49,4,53,1
14250,김영호(金映豪),이명수(李明洙),49,10,59,1
14251,김영호(金映豪),이병훈(李炳勳),102,93,195,0
14252,김영호(金映豪),이상민(李相珉),81,56,137,0
14253,김영호(金映豪),이상헌(李相憲),96,102,198,0
14254,김영호(金映豪),이성만(李成萬),107,137,244,1
14255,김영호(金映豪),이소영(李素永),82,47,129,0
14256,김영호(金映豪),이수진(李壽珍),108,107,215,0
14257,김영호(金映豪),이수진(李秀眞),87,75,162,0
14258,김영호(金映豪),이양수(李亮壽),50,4,54,1
14259,김영호(金映豪),이용(李鏞),49,4,53,1
14260,김영호(金映豪),이용빈(李龍彬),104,165,269,0
14261,김영호(金映豪),이용선(李庸瑄),95,87,182,0
14262,김영호(金映豪),이용우(李龍雨),92,58,150,0
14263,김영호(金映豪),이용호(李容鎬),33,17,50,1
14264,김영호(金映豪),이원욱(李元旭),82,63,145,0
14265,김영호(金映豪),이원택(李源澤),96,87,183,0
14266,김영호(金映豪),이은주(李恩周),14,17,31,1
14267,김영호(金映豪),이인선(李仁善),25,5,30,1
14268,김영호(金映豪),이인영(李仁榮),81,52,133,0
14269,김영호(金映豪),이장섭(李將燮),94,72,166,0
14270,김영호(金映豪),이재명(李在明),41,22,63,0
14271,김영호(金映豪),이재정(李在汀),93,85,178,0
14272,김영호(金映豪),이정문(李楨文),86,66,152,0
14273,김영호(金映豪),이종배(李鍾培),50,6,56,1
14274,김영호(金映豪),이종성(李鍾成),49,5,54,1
14275,김영호(金映豪),이주환(李周桓),49,4,53,1
14276,김영호(金映豪),이채익(李埰益),50,10,60,1
14277,김영호(金映豪),이철규(李喆圭),50,4,54,1
14278,김영호(金映豪),이탄희(李誕熙),94,72,166,0
14279,김영호(金映豪),이태규(李泰珪),29,5,34,1
14280,김영호(金映豪),이학영(李學永),90,70,160,0
14281,김영호(金映豪),이해식(李海植),94,64,158,0
14282,김영호(金映豪),이헌승(李憲昇),50,4,54,1
14283,김영호(金映豪),이형석(李炯錫),101,68,169,0
14284,김영호(金映豪),인재근(印在謹),102,86,188,0
14285,김영호(金映豪),임병헌(林炳憲),25,4,29,1
14286,김영호(金映豪),임오경(林五卿),96,67,163,0
14287,김영호(金映豪),임이자(林利子),49,4,53,1
14288,김영호(金映豪),임종성(林鍾聲),96,84,180,0
14289,김영호(金映豪),임호선(林昊宣),107,98,205,0
14290,김영호(金映豪),장경태(張耿態),88,83,171,0
14291,김영호(金映豪),장동혁(張東赫),25,4,29,1
14292,김영호(金映豪),장제원(張濟元),49,4,53,1
14293,김영호(金映豪),장철민(張喆敏),90,61,151,0
14294,김영호(金映豪),장혜영(張惠英),14,9,23,1
14295,김영호(金映豪),전봉민(田奉珉),35,5,40,1
14296,김영호(金映豪),전용기(田溶冀),84,89,173,0
14297,김영호(金映豪),전재수(田載秀),82,63,145,0
14298,김영호(金映豪),전주혜(全珠惠),50,4,54,1
14299,김영호(金映豪),전해철(全海澈),78,59,137,0
14300,김영호(金映豪),전혜숙(全惠淑),95,108,203,0
14301,김영호(金映豪),정경희(丁慶姬),49,4,53,1
14302,김영호(金映豪),정동만(鄭東萬),49,4,53,1
14303,김영호(金映豪),정성호(鄭成湖),86,87,173,0
14304,김영호(金映豪),정우택(鄭宇澤),25,4,29,1
14305,김영호(金映豪),정운천(鄭雲天),49,7,56,1
14306,김영호(金映豪),정일영(鄭日永),83,62,145,0
14307,김영호(金映豪),정점식(鄭点植),49,4,53,1
14308,김영호(金映豪),정진석(鄭鎭碩),49,8,57,1
14309,김영호(金映豪),정청래(鄭淸來),88,59,147,0
14310,김영호(金映豪),정춘숙(鄭春淑),89,71,160,0
14311,김영호(金映豪),정태호(鄭泰浩),85,58,143,0
14312,김영호(金映豪),정필모(鄭必模),87,62,149,0
14313,김영호(金映豪),정희용(鄭熙溶),50,5,55,1
14314,김영호(金映豪),조경태(趙慶泰),49,5,54,1
14315,김영호(金映豪),조명희(曺明姬),50,5,55,1
14316,김영호(金映豪),조수진(趙修眞),49,5,54,1
14317,김영호(金映豪),조승래(趙承來),90,63,153,0
14318,김영호(金映豪),조오섭(曺五燮),92,126,218,0
14319,김영호(金映豪),조은희(趙恩禧),25,4,29,1
14320,김영호(金映豪),조응천(趙應天),72,31,103,0
14321,김영호(金映豪),조정식(趙正湜),73,37,110,0
14322,김영호(金映豪),조정훈(趙廷訓),3,9,12,1
14323,김영호(金映豪),조해진(曺海珍),51,5,56,1
14324,김영호(金映豪),주철현(朱哲鉉),94,96,190,0
14325,김영호(金映豪),주호영(朱豪英),49,4,53,1
14326,김영호(金映豪),지성호(池成浩),49,5,54,1
14327,김영호(金映豪),진선미(陳善美),81,46,127,0
14328,김영호(金映豪),진성준(陳聲準),86,78,164,0
14329,김영호(金映豪),천준호(千俊鎬),86,51,137,0
14330,김영호(金映豪),최기상(崔基相),82,58,140,0
14331,김영호(金映豪),최승재(崔承宰),49,7,56,1
14332,김영호(金映豪),최연숙(崔姸淑),30,8,38,1
14333,김영호(金映豪),최영희(崔英姬),25,4,29,1
14334,김영호(金映豪),최인호(崔仁昊),85,53,138,0
14335,김영호(金映豪),최재형(崔在亨),25,4,29,1
14336,김영호(金映豪),최종윤(崔鍾允),104,127,231,0
14337,김영호(金映豪),최춘식(崔春植),49,4,53,1
14338,김영호(金映豪),최형두(崔炯斗),50,5,55,1
14339,김영호(金映豪),최혜영(崔惠英),97,95,192,0
14340,김영호(金映豪),추경호(秋慶鎬),49,3,52,1
14341,김영호(金映豪),태영호(太永浩),49,5,54,1
14342,김영호(金映豪),하영제(河榮帝),40,1,41,1
14343,김영호(金映豪),하태경(河泰慶),50,7,57,1
14344,김영호(金映豪),한기호(韓起鎬),49,4,53,1
14345,김영호(金映豪),한무경(韓茂景),49,4,53,1
14346,김영호(金映豪),한병도(韓秉道),112,91,203,0
14347,김영호(金映豪),한정애(韓貞愛),85,52,137,0
14348,김영호(金映豪),한준호(韓俊鎬),88,71,159,0
14349,김영호(金映豪),허숙정(許淑湞),1,1,2,0
14350,김영호(金映豪),허영(許榮),96,75,171,0
14351,김영호(金映豪),허은아(許垠娥),49,5,54,1
14352,김영호(金映豪),허종식(許琮植),93,71,164,0
14353,김영호(金映豪),홍기원(洪起元),86,64,150,0
14354,김영호(金映豪),홍문표(洪文杓),49,7,56,1
14355,김영호(金映豪),홍석준(洪碩晙),49,4,53,1
14356,김영호(金映豪),홍성국(洪性國),112,120,232,0
14357,김영호(金映豪),홍영표(洪永杓),80,42,122,0
14358,김영호(金映豪),홍익표(洪翼杓),88,67,155,0
14359,김영호(金映豪),홍정민(洪貞敏),91,86,177,0
14360,김영호(金映豪),황보승희(皇甫承希),45,3,48,1
14361,김영호(金映豪),황운하(黃雲夏),116,125,241,0
14362,김영호(金映豪),황희(黃熙),75,55,130,0
14363,김예지(金睿智),김용민(金容民),52,5,57,1
14364,김예지(金睿智),김용판(金用判),200,306,506,0
14365,김예지(金睿智),김웅(金雄),75,70,145,0
14366,김예지(金睿智),김원이(金元二),53,9,62,1
14367,김예지(金睿智),김윤덕(金潤德),53,9,62,1
14368,김예지(金睿智),김의겸(金宜謙),26,7,33,1
14369,김예지(金睿智),김정재(金汀才),118,132,250,0
14370,김예지(金睿智),김정호(金禎鎬),51,10,61,1
14371,김예지(金睿智),김종민(金鐘民),56,6,62,1
14372,김예지(金睿智),김주영(金周暎),55,10,65,1
14373,김예지(金睿智),김진표(金振杓),26,1,27,1
14374,김예지(金睿智),김철민(金哲玟),51,10,61,1
14375,김예지(金睿智),김태년(金太年),50,5,55,1
14376,김예지(金睿智),김태호(金台鎬),86,88,174,0
14377,김예지(金睿智),김학용(金學容),36,50,86,0
14378,김예지(金睿智),김한규(金翰奎),25,6,31,1
14379,김예지(金睿智),김한정(金漢正),49,4,53,1
14380,김예지(金睿智),김형동(金亨東),111,167,278,0
14381,김예지(金睿智),김홍걸(金弘傑),15,14,29,1
14382,김예지(金睿智),김회재(金會在),52,6,58,1
14383,김예지(金睿智),김희곤(金熙坤),84,139,223,0
14384,김예지(金睿智),김희국(金熙國),111,132,243,0
14385,김예지(金睿智),남인순(南仁順),55,10,65,1
14386,김예지(金睿智),노용호(魯容昊),29,44,73,0
14387,김예지(金睿智),노웅래(盧雄來),50,7,57,1
14388,김예지(金睿智),도종환(都鍾煥),51,9,60,1
14389,김예지(金睿智),류성걸(柳性杰),102,118,220,0
14390,김예지(金睿智),류호정(柳好貞),14,41,55,1
14391,김예지(金睿智),맹성규(孟聖奎),53,8,61,1
14392,김예지(金睿智),문정복(文貞福),50,10,60,1
14393,김예지(金睿智),문진석(文振碩),50,4,54,1
14394,김예지(金睿智),민병덕(閔炳德),56,11,67,1
14395,김예지(金睿智),민형배(閔馨培),35,4,39,1
14396,김예지(金睿智),민홍철(閔洪喆),50,6,56,1
14397,김예지(金睿智),박광온(朴洸瑥),49,4,53,1
14398,김예지(金睿智),박대수(朴大壽),149,327,476,0
14399,김예지(金睿智),박대출(朴大出),81,85,166,0
14400,김예지(金睿智),박덕흠(朴德欽),128,235,363,0
14401,김예지(金睿智),박범계(朴範界),49,4,53,1
14402,김예지(金睿智),박병석(朴炳錫),25,3,28,1
14403,김예지(金睿智),박상혁(朴商赫),52,5,57,1
14404,김예지(金睿智),박성민(朴聖敏),91,160,251,0
14405,김예지(金睿智),박성준(朴省俊),56,10,66,1
14406,김예지(金睿智),박성중(朴成重),93,94,187,0
14407,김예지(金睿智),박수영(朴洙瑩),77,75,152,0
14408,김예지(金睿智),박영순(朴英淳),50,4,54,1
14409,김예지(金睿智),박완주(朴完柱),26,3,29,1
14410,김예지(金睿智),박용진(朴用鎭),49,9,58,1
14411,김예지(金睿智),박재호(朴在昊),50,5,55,1
14412,김예지(金睿智),박정(朴釘),53,13,66,1
14413,김예지(金睿智),박정하(朴正河),30,33,63,0
14414,김예지(金睿智),박주민(朴柱民),50,6,56,1
14415,김예지(金睿智),박진(朴振),71,96,167,0
14416,김예지(金睿智),박찬대(朴贊大),50,7,57,1
14417,김예지(金睿智),박형수(朴亨修),76,79,155,0
14418,김예지(金睿智),박홍근(朴洪根),52,8,60,1
14419,김예지(金睿智),배준영(裵俊英),99,119,218,0
14420,김예지(金睿智),배진교(裵晋敎),10,27,37,1
14421,김예지(金睿智),배현진(裵賢鎭),87,97,184,0
14422,김예지(金睿智),백종헌(白宗憲),107,163,270,0
14423,김예지(金睿智),백혜련(白惠蓮),50,6,56,1
14424,김예지(金睿智),변재일(卞在一),50,6,56,1
14425,김예지(金睿智),서동용(徐東榕),54,9,63,1
14426,김예지(金睿智),서범수(徐範洙),90,124,214,0
14427,김예지(金睿智),서병수(徐秉洙),108,146,254,0
14428,김예지(金睿智),서삼석(徐參錫),50,7,57,1
14429,김예지(金睿智),서영교(徐瑛敎),50,9,59,1
14430,김예지(金睿智),서영석(徐暎錫),52,10,62,1
14431,김예지(金睿智),서일준(徐一俊),140,207,347,0
14432,김예지(金睿智),서정숙(徐正淑),101,172,273,0
14433,김예지(金睿智),설훈(薛勳),50,6,56,1
14434,김예지(金睿智),성일종(成一鍾),137,230,367,0
14435,김예지(金睿智),소병철(蘇秉哲),51,5,56,1
14436,김예지(金睿智),소병훈(蘇秉勳),50,7,57,1
14437,김예지(金睿智),송갑석(宋甲錫),50,8,58,1
14438,김예지(金睿智),송기헌(宋基憲),49,4,53,1
14439,김예지(金睿智),송석준(宋錫俊),90,116,206,0
14440,김예지(金睿智),송언석(宋彦錫),101,92,193,0
14441,김예지(金睿智),송옥주(宋玉珠),50,5,55,1
14442,김예지(金睿智),송재호(宋在祜),56,8,64,1
14443,김예지(金睿智),신동근(申東根),50,7,57,1
14444,김예지(金睿智),신영대(申榮大),49,5,54,1
14445,김예지(金睿智),신원식(申源湜),86,112,198,0
14446,김예지(金睿智),신정훈(辛正勳),49,9,58,1
14447,김예지(金睿智),신현영(申賢榮),49,5,54,1
14448,김예지(金睿智),심상정(沈相奵),10,21,31,1
14449,김예지(金睿智),안규백(安圭伯),54,4,58,1
14450,김예지(金睿智),안민석(安敏錫),51,4,55,1
14451,김예지(金睿智),안병길(安炳吉),95,153,248,0
14452,김예지(金睿智),안철수(安哲秀),29,29,58,0
14453,김예지(金睿智),안호영(安浩永),50,6,56,1
14454,김예지(金睿智),양경숙(梁敬淑),52,6,58,1
14455,김예지(金睿智),양금희(梁琴喜),142,184,326,0
14456,김예지(金睿智),양기대(梁基大),49,4,53,1
14457,김예지(金睿智),양이원영(梁李媛瑛),47,7,54,1
14458,김예지(金睿智),양정숙(梁貞淑),5,15,20,1
14459,김예지(金睿智),양향자(梁香子),27,22,49,1
14460,김예지(金睿智),어기구(魚基龜),50,7,57,1
14461,김예지(金睿智),엄태영(嚴泰永),112,149,261,0
14462,김예지(金睿智),오기형(吳奇炯),50,5,55,1
14463,김예지(金睿智),오영환(吳永煥),57,19,76,1
14464,김예지(金睿智),용혜인(龍慧仁),3,24,27,1
14465,김예지(金睿智),우상호(禹相虎),50,4,54,1
14466,김예지(金睿智),우원식(禹元植),51,4,55,1
14467,김예지(金睿智),위성곤(魏聖坤),51,8,59,1
14468,김예지(金睿智),유경준(兪京濬),110,133,243,0
14469,김예지(金睿智),유기홍(柳基洪),50,7,57,1
14470,김예지(金睿智),유동수(柳東秀),50,9,59,1
14471,김예지(金睿智),유상범(劉相凡),74,90,164,0
14472,김예지(金睿智),유의동(兪義東),82,90,172,0
14473,김예지(金睿智),유정주(兪訂炷),53,14,67,1
14474,김예지(金睿智),윤건영(尹建永),50,5,55,1
14475,김예지(金睿智),윤관석(尹官石),40,2,42,1
14476,김예지(金睿智),윤두현(尹斗鉉),109,178,287,0
14477,김예지(金睿智),윤미향(尹美香),20,8,28,1
14478,김예지(金睿智),윤상현(尹相現),47,83,130,0
14479,김예지(金睿智),윤영덕(尹永德),50,10,60,1
14480,김예지(金睿智),윤영석(尹永碩),81,96,177,0
14481,김예지(金睿智),윤영찬(尹永燦),49,4,53,1
14482,김예지(金睿智),윤재갑(尹才鉀),53,10,63,1
14483,김예지(金睿智),윤재옥(尹在玉),97,75,172,0
14484,김예지(金睿智),윤주경(尹柱卿),84,126,210,0
14485,김예지(金睿智),윤준병(尹準炳),50,7,57,1
14486,김예지(金睿智),윤창현(尹暢賢),150,204,354,0
14487,김예지(金睿智),윤한홍(尹漢洪),79,85,164,0
14488,김예지(金睿智),윤호중(尹昊重),50,7,57,1
14489,김예지(金睿智),윤후덕(尹厚德),50,4,54,1
14490,김예지(金睿智),이개호(李介昊),49,6,55,1
14491,김예지(金睿智),이달곤(李達坤),74,112,186,0
14492,김예지(金睿智),이동주(李東洲),49,4,53,1
14493,김예지(金睿智),이만희(李晩熙),86,97,183,0
14494,김예지(金睿智),이명수(李明洙),138,246,384,0
14495,김예지(金睿智),이병훈(李炳勳),53,13,66,1
14496,김예지(金睿智),이상민(李相珉),51,9,60,1
14497,김예지(金睿智),이상헌(李相憲),61,24,85,1
14498,김예지(金睿智),이성만(李成萬),46,5,51,1
14499,김예지(金睿智),이소영(李素永),50,6,56,1
14500,김예지(金睿智),이수진(李壽珍),55,14,69,1
14501,김예지(金睿智),이수진(李秀眞),50,6,56,1
14502,김예지(金睿智),이양수(李亮壽),84,99,183,0
14503,김예지(金睿智),이용(李鏞),95,162,257,0
14504,김예지(金睿智),이용빈(李龍彬),52,14,66,1
14505,김예지(金睿智),이용선(李庸瑄),50,8,58,1
14506,김예지(金睿智),이용우(李龍雨),49,9,58,1
14507,김예지(金睿智),이용호(李容鎬),39,43,82,0
14508,김예지(金睿智),이원욱(李元旭),54,7,61,1
14509,김예지(金睿智),이원택(李源澤),52,5,57,1
14510,김예지(金睿智),이은주(李恩周),12,24,36,1
14511,김예지(金睿智),이인선(李仁善),34,48,82,0
14512,김예지(金睿智),이인영(李仁榮),49,4,53,1
14513,김예지(金睿智),이장섭(李將燮),49,5,54,1
14514,김예지(金睿智),이재명(李在明),25,4,29,1
14515,김예지(金睿智),이재정(李在汀),50,6,56,1
14516,김예지(金睿智),이정문(李楨文),50,6,56,1
14517,김예지(金睿智),이종배(李鍾培),158,266,424,0
14518,김예지(金睿智),이종성(李鍾成),153,285,438,0
14519,김예지(金睿智),이주환(李周桓),144,173,317,0
14520,김예지(金睿智),이채익(李埰益),95,133,228,0
14521,김예지(金睿智),이철규(李喆圭),94,144,238,0
14522,김예지(金睿智),이탄희(李誕熙),51,8,59,1
14523,김예지(金睿智),이태규(李泰珪),59,82,141,0
14524,김예지(金睿智),이학영(李學永),50,8,58,1
14525,김예지(金睿智),이해식(李海植),51,5,56,1
14526,김예지(金睿智),이헌승(李憲昇),72,99,171,0
14527,김예지(金睿智),이형석(李炯錫),51,5,56,1
14528,김예지(金睿智),인재근(印在謹),52,9,61,1
14529,김예지(金睿智),임병헌(林炳憲),44,86,130,0
14530,김예지(金睿智),임오경(林五卿),49,9,58,1
14531,김예지(金睿智),임이자(林利子),104,151,255,0
14532,김예지(金睿智),임종성(林鍾聲),51,6,57,1
14533,김예지(金睿智),임호선(林昊宣),51,10,61,1
14534,김예지(金睿智),장경태(張耿態),51,5,56,1
14535,김예지(金睿智),장동혁(張東赫),31,41,72,0
14536,김예지(金睿智),장제원(張濟元),66,54,120,0
14537,김예지(金睿智),장철민(張喆敏),51,11,62,1
14538,김예지(金睿智),장혜영(張惠英),16,37,53,1
14539,김예지(金睿智),전봉민(田奉珉),65,72,137,0
14540,김예지(金睿智),전용기(田溶冀),50,5,55,1
14541,김예지(金睿智),전재수(田載秀),49,5,54,1
14542,김예지(金睿智),전주혜(全珠惠),87,145,232,0
14543,김예지(金睿智),전해철(全海澈),51,5,56,1
14544,김예지(金睿智),전혜숙(全惠淑),49,9,58,1
14545,김예지(金睿智),정경희(丁慶姬),82,106,188,0
14546,김예지(金睿智),정동만(鄭東萬),79,86,165,0
14547,김예지(金睿智),정성호(鄭成湖),58,6,64,1
14548,김예지(金睿智),정우택(鄭宇澤),47,76,123,0
14549,김예지(金睿智),정운천(鄭雲天),115,168,283,0
14550,김예지(金睿智),정일영(鄭日永),50,8,58,1
14551,김예지(金睿智),정점식(鄭点植),71,54,125,0
14552,김예지(金睿智),정진석(鄭鎭碩),104,133,237,0
14553,김예지(金睿智),정청래(鄭淸來),52,7,59,1
14554,김예지(金睿智),정춘숙(鄭春淑),50,8,58,1
14555,김예지(金睿智),정태호(鄭泰浩),50,9,59,1
14556,김예지(金睿智),정필모(鄭必模),49,5,54,1
14557,김예지(金睿智),정희용(鄭熙溶),120,155,275,0
14558,김예지(金睿智),조경태(趙慶泰),94,96,190,0
14559,김예지(金睿智),조명희(曺明姬),126,207,333,0
14560,김예지(金睿智),조수진(趙修眞),113,164,277,0
14561,김예지(金睿智),조승래(趙承來),50,6,56,1
14562,김예지(金睿智),조오섭(曺五燮),51,8,59,1
14563,김예지(金睿智),조은희(趙恩禧),35,29,64,0
14564,김예지(金睿智),조응천(趙應天),52,5,57,1
14565,김예지(金睿智),조정식(趙正湜),50,3,53,1
14566,김예지(金睿智),조정훈(趙廷訓),5,16,21,1
14567,김예지(金睿智),조해진(曺海珍),66,46,112,0
14568,김예지(金睿智),주철현(朱哲鉉),50,7,57,1
14569,김예지(金睿智),주호영(朱豪英),78,81,159,0
14570,김예지(金睿智),지성호(池成浩),127,253,380,0
14571,김예지(金睿智),진선미(陳善美),50,4,54,1
14572,김예지(金睿智),진성준(陳聲準),50,4,54,1
14573,김예지(金睿智),천준호(千俊鎬),51,5,56,1
14574,김예지(金睿智),최기상(崔基相),50,5,55,1
14575,김예지(金睿智),최승재(崔承宰),119,183,302,0
14576,김예지(金睿智),최연숙(崔姸淑),53,105,158,0
14577,김예지(金睿智),최영희(崔英姬),34,67,101,0
14578,김예지(金睿智),최인호(崔仁昊),51,6,57,1
14579,김예지(金睿智),최재형(崔在亨),29,28,57,0
14580,김예지(金睿智),최종윤(崔鍾允),51,8,59,1
14581,김예지(金睿智),최춘식(崔春植),98,150,248,0
14582,김예지(金睿智),최형두(崔炯斗),117,168,285,0
14583,김예지(金睿智),최혜영(崔惠英),61,45,106,1
14584,김예지(金睿智),추경호(秋慶鎬),171,286,457,0
14585,김예지(金睿智),태영호(太永浩),113,220,333,0
14586,김예지(金睿智),하영제(河榮帝),96,145,241,1
14587,김예지(金睿智),하태경(河泰慶),68,59,127,0
14588,김예지(金睿智),한기호(韓起鎬),73,72,145,0
14589,김예지(金睿智),한무경(韓茂景),92,132,224,0
14590,김예지(金睿智),한병도(韓秉道),50,5,55,1
14591,김예지(金睿智),한정애(韓貞愛),50,9,59,1
14592,김예지(金睿智),한준호(韓俊鎬),50,5,55,1
14593,김예지(金睿智),허숙정(許淑湞),0,0,0,1
14594,김예지(金睿智),허영(許榮),52,7,59,1
14595,김예지(金睿智),허은아(許垠娥),87,104,191,0
14596,김예지(金睿智),허종식(許琮植),53,12,65,1
14597,김예지(金睿智),홍기원(洪起元),51,4,55,1
14598,김예지(金睿智),홍문표(洪文杓),93,110,203,0
14599,김예지(金睿智),홍석준(洪碩晙),97,131,228,0
14600,김예지(金睿智),홍성국(洪性國),49,5,54,1
14601,김예지(金睿智),홍영표(洪永杓),49,6,55,1
14602,김예지(金睿智),홍익표(洪翼杓),50,6,56,1
14603,김예지(金睿智),홍정민(洪貞敏),49,7,56,1
14604,김예지(金睿智),황보승희(皇甫承希),90,154,244,1
14605,김예지(金睿智),황운하(黃雲夏),52,7,59,1
14606,김예지(金睿智),황희(黃熙),49,6,55,1
14607,김용민(金容民),김용판(金用判),52,4,56,1
14608,김용민(金容民),김웅(金雄),51,4,55,1
14609,김용민(金容民),김원이(金元二),94,91,185,0
14610,김용민(金容民),김윤덕(金潤德),83,56,139,0
14611,김용민(金容民),김의겸(金宜謙),51,129,180,0
14612,김용민(金容民),김정재(金汀才),53,5,58,1
14613,김용민(金容民),김정호(金禎鎬),103,197,300,0
14614,김용민(金容民),김종민(金鐘民),104,94,198,0
14615,김용민(金容民),김주영(金周暎),103,86,189,0
14616,김용민(金容民),김진표(金振杓),49,36,85,1
14617,김용민(金容民),김철민(金哲玟),98,117,215,0
14618,김용민(金容民),김태년(金太年),85,62,147,0
14619,김용민(金容民),김태호(金台鎬),42,4,46,1
14620,김용민(金容民),김학용(金學容),25,6,31,1
14621,김용민(金容民),김한규(金翰奎),46,56,102,0
14622,김용민(金容民),김한정(金漢正),88,58,146,0
14623,김용민(金容民),김형동(金亨東),51,8,59,1
14624,김용민(金容民),김홍걸(金弘傑),42,113,155,0
14625,김용민(金容民),김회재(金會在),96,64,160,0
14626,김용민(金容民),김희곤(金熙坤),50,4,54,1
14627,김용민(金容民),김희국(金熙國),49,4,53,1
14628,김용민(金容民),남인순(南仁順),95,89,184,0
14629,김용민(金容民),노용호(魯容昊),25,4,29,1
14630,김용민(金容民),노웅래(盧雄來),93,63,156,0
14631,김용민(金容民),도종환(都鍾煥),96,96,192,0
14632,김용민(金容民),류성걸(柳性杰),49,4,53,1
14633,김용민(金容民),류호정(柳好貞),22,32,54,1
14634,김용민(金容民),맹성규(孟聖奎),96,68,164,0
14635,김용민(金容民),문정복(文貞福),103,181,284,0
14636,김용민(金容民),문진석(文振碩),101,115,216,0
14637,김용민(金容民),민병덕(閔炳德),95,179,274,0
14638,김용민(金容民),민형배(閔馨培),93,363,456,0
14639,김용민(金容民),민홍철(閔洪喆),77,48,125,0
14640,김용민(金容民),박광온(朴洸瑥),89,75,164,0
14641,김용민(金容民),박대수(朴大壽),50,5,55,1
14642,김용민(金容民),박대출(朴大出),50,4,54,1
14643,김용민(金容民),박덕흠(朴德欽),36,5,41,1
14644,김용민(金容民),박범계(朴範界),101,48,149,0
14645,김용민(金容民),박병석(朴炳錫),40,18,58,0
14646,김용민(金容民),박상혁(朴商赫),90,188,278,0
14647,김용민(金容民),박성민(朴聖敏),49,6,55,1
14648,김용민(金容民),박성준(朴省俊),108,84,192,0
14649,김용민(金容民),박성중(朴成重),49,4,53,1
14650,김용민(金容民),박수영(朴洙瑩),49,6,55,1
14651,김용민(金容民),박영순(朴英淳),103,95,198,0
14652,김용민(金容民),박완주(朴完柱),46,42,88,1
14653,김용민(金容民),박용진(朴用鎭),83,47,130,0
14654,김용민(金容民),박재호(朴在昊),86,56,142,0
14655,김용민(金容民),박정(朴釘),95,81,176,0
14656,김용민(金容民),박정하(朴正河),25,4,29,1
14657,김용민(金容民),박주민(朴柱民),118,146,264,0
14658,김용민(金容民),박진(朴振),50,4,54,1
14659,김용민(金容民),박찬대(朴贊大),88,66,154,0
14660,김용민(金容民),박형수(朴亨修),49,4,53,1
14661,김용민(金容民),박홍근(朴洪根),101,97,198,0
14662,김용민(金容民),배준영(裵俊英),49,4,53,1
14663,김용민(金容民),배진교(裵晋敎),20,20,40,1
14664,김용민(金容民),배현진(裵賢鎭),49,4,53,1
14665,김용민(金容民),백종헌(白宗憲),50,5,55,1
14666,김용민(金容民),백혜련(白惠蓮),109,53,162,0
14667,김용민(金容民),변재일(卞在一),77,53,130,0
14668,김용민(金容民),서동용(徐東榕),110,155,265,0
14669,김용민(金容民),서범수(徐範洙),50,4,54,1
14670,김용민(金容民),서병수(徐秉洙),50,4,54,1
14671,김용민(金容民),서삼석(徐參錫),93,66,159,0
14672,김용민(金容民),서영교(徐瑛敎),96,126,222,0
14673,김용민(金容民),서영석(徐暎錫),90,95,185,0
14674,김용민(金容民),서일준(徐一俊),50,5,55,1
14675,김용민(金容民),서정숙(徐正淑),49,5,54,1
14676,김용민(金容民),설훈(薛勳),81,59,140,0
14677,김용민(金容民),성일종(成一鍾),50,5,55,1
14678,김용민(金容民),소병철(蘇秉哲),112,66,178,0
14679,김용민(金容民),소병훈(蘇秉勳),89,88,177,0
14680,김용민(金容民),송갑석(宋甲錫),94,99,193,0
14681,김용민(金容民),송기헌(宋基憲),102,45,147,0
14682,김용민(金容民),송석준(宋錫俊),50,4,54,1
14683,김용민(金容民),송언석(宋彦錫),45,4,49,1
14684,김용민(金容民),송옥주(宋玉珠),89,80,169,0
14685,김용민(金容民),송재호(宋在祜),102,110,212,0
14686,김용민(金容民),신동근(申東根),107,63,170,0
14687,김용민(金容民),신영대(申榮大),85,49,134,0
14688,김용민(金容民),신원식(申源湜),49,4,53,1
14689,김용민(金容民),신정훈(辛正勳),112,181,293,0
14690,김용민(金容民),신현영(申賢榮),80,56,136,0
14691,김용민(金容民),심상정(沈相奵),16,34,50,1
14692,김용민(金容民),안규백(安圭伯),84,82,166,0
14693,김용민(金容民),안민석(安敏錫),93,115,208,0
14694,김용민(金容民),안병길(安炳吉),50,4,54,1
14695,김용민(金容民),안철수(安哲秀),25,5,30,1
14696,김용민(金容民),안호영(安浩永),80,71,151,0
14697,김용민(金容民),양경숙(梁敬淑),95,111,206,0
14698,김용민(金容民),양금희(梁琴喜),50,4,54,1
14699,김용민(金容民),양기대(梁基大),91,70,161,0
14700,김용민(金容民),양이원영(梁李媛瑛),102,134,236,0
14701,김용민(金容民),양정숙(梁貞淑),43,172,215,1
14702,김용민(金容民),양향자(梁香子),41,36,77,1
14703,김용민(金容民),어기구(魚基龜),78,59,137,0
14704,김용민(金容民),엄태영(嚴泰永),51,4,55,1
14705,김용민(金容民),오기형(吳奇炯),84,48,132,0
14706,김용민(金容民),오영환(吳永煥),122,149,271,0
14707,김용민(金容民),용혜인(龍慧仁),15,40,55,1
14708,김용민(金容民),우상호(禹相虎),79,45,124,0
14709,김용민(金容民),우원식(禹元植),87,103,190,0
14710,김용민(金容民),위성곤(魏聖坤),89,122,211,0
14711,김용민(金容民),유경준(兪京濬),49,4,53,1
14712,김용민(金容民),유기홍(柳基洪),86,58,144,0
14713,김용민(金容民),유동수(柳東秀),85,47,132,0
14714,김용민(金容民),유상범(劉相凡),49,4,53,1
14715,김용민(金容民),유의동(兪義東),49,4,53,1
14716,김용민(金容民),유정주(兪訂炷),114,194,308,0
14717,김용민(金容民),윤건영(尹建永),87,77,164,0
14718,김용민(金容民),윤관석(尹官石),75,50,125,1
14719,김용민(金容民),윤두현(尹斗鉉),49,4,53,1
14720,김용민(金容民),윤미향(尹美香),60,111,171,1
14721,김용민(金容民),윤상현(尹相現),30,5,35,1
14722,김용민(金容民),윤영덕(尹永德),109,204,313,0
14723,김용민(金容民),윤영석(尹永碩),50,6,56,1
14724,김용민(金容民),윤영찬(尹永燦),81,50,131,0
14725,김용민(金容民),윤재갑(尹才鉀),102,85,187,0
14726,김용민(金容民),윤재옥(尹在玉),49,4,53,1
14727,김용민(金容民),윤주경(尹柱卿),49,4,53,1
14728,김용민(金容民),윤준병(尹準炳),99,152,251,0
14729,김용민(金容民),윤창현(尹暢賢),49,4,53,1
14730,김용민(金容民),윤한홍(尹漢洪),50,4,54,1
14731,김용민(金容民),윤호중(尹昊重),82,55,137,0
14732,김용민(金容民),윤후덕(尹厚德),83,86,169,0
14733,김용민(金容民),이개호(李介昊),87,69,156,0
14734,김용민(金容民),이달곤(李達坤),52,5,57,1
14735,김용민(金容民),이동주(李東洲),94,195,289,0
14736,김용민(金容民),이만희(李晩熙),49,5,54,1
14737,김용민(金容民),이명수(李明洙),50,8,58,1
14738,김용민(金容民),이병훈(李炳勳),97,102,199,0
14739,김용민(金容民),이상민(李相珉),78,36,114,0
14740,김용민(金容民),이상헌(李相憲),92,80,172,0
14741,김용민(金容民),이성만(李成萬),92,96,188,1
14742,김용민(金容民),이소영(李素永),88,62,150,0
14743,김용민(金容民),이수진(李壽珍),105,174,279,0
14744,김용민(金容民),이수진(李秀眞),108,147,255,0
14745,김용민(金容民),이양수(李亮壽),51,4,55,1
14746,김용민(金容民),이용(李鏞),49,4,53,1
14747,김용민(金容民),이용빈(李龍彬),111,140,251,0
14748,김용민(金容民),이용선(李庸瑄),103,126,229,0
14749,김용민(金容民),이용우(李龍雨),102,83,185,0
14750,김용민(金容民),이용호(李容鎬),33,8,41,1
14751,김용민(金容民),이원욱(李元旭),84,70,154,0
14752,김용민(金容民),이원택(李源澤),89,63,152,0
14753,김용민(金容民),이은주(李恩周),18,29,47,1
14754,김용민(金容民),이인선(李仁善),25,4,29,1
14755,김용민(金容民),이인영(李仁榮),76,47,123,0
14756,김용민(金容民),이장섭(李將燮),88,62,150,0
14757,김용민(金容民),이재명(李在明),41,26,67,0
14758,김용민(金容民),이재정(李在汀),93,94,187,0
14759,김용민(金容民),이정문(李楨文),90,87,177,0
14760,김용민(金容民),이종배(李鍾培),50,6,56,1
14761,김용민(金容民),이종성(李鍾成),49,4,53,1
14762,김용민(金容民),이주환(李周桓),49,5,54,1
14763,김용민(金容民),이채익(李埰益),51,5,56,1
14764,김용민(金容民),이철규(李喆圭),50,5,55,1
14765,김용민(金容民),이탄희(李誕熙),88,122,210,0
14766,김용민(金容民),이태규(李泰珪),28,4,32,1
14767,김용민(金容民),이학영(李學永),90,67,157,0
14768,김용민(金容民),이해식(李海植),89,69,158,0
14769,김용민(金容民),이헌승(李憲昇),50,4,54,1
14770,김용민(金容民),이형석(李炯錫),99,89,188,0
14771,김용민(金容民),인재근(印在謹),91,81,172,0
14772,김용민(金容民),임병헌(林炳憲),25,4,29,1
14773,김용민(金容民),임오경(林五卿),94,102,196,0
14774,김용민(金容民),임이자(林利子),49,4,53,1
14775,김용민(金容民),임종성(林鍾聲),92,93,185,0
14776,김용민(金容民),임호선(林昊宣),100,122,222,0
14777,김용민(金容民),장경태(張耿態),108,230,338,0
14778,김용민(金容民),장동혁(張東赫),25,4,29,1
14779,김용민(金容民),장제원(張濟元),49,4,53,1
14780,김용민(金容民),장철민(張喆敏),88,64,152,0
14781,김용민(金容民),장혜영(張惠英),14,20,34,1
14782,김용민(金容民),전봉민(田奉珉),35,5,40,1
14783,김용민(金容民),전용기(田溶冀),94,96,190,0
14784,김용민(金容民),전재수(田載秀),85,50,135,0
14785,김용민(金容民),전주혜(全珠惠),51,4,55,1
14786,김용민(金容民),전해철(全海澈),84,72,156,0
14787,김용민(金容民),전혜숙(全惠淑),89,70,159,0
14788,김용민(金容民),정경희(丁慶姬),49,4,53,1
14789,김용민(金容民),정동만(鄭東萬),49,4,53,1
14790,김용민(金容民),정성호(鄭成湖),89,81,170,0
14791,김용민(金容民),정우택(鄭宇澤),25,5,30,1
14792,김용민(金容民),정운천(鄭雲天),49,4,53,1
14793,김용민(金容民),정일영(鄭日永),95,80,175,0
14794,김용민(金容民),정점식(鄭点植),50,4,54,1
14795,김용민(金容民),정진석(鄭鎭碩),50,6,56,1
14796,김용민(金容民),정청래(鄭淸來),88,75,163,0
14797,김용민(金容民),정춘숙(鄭春淑),87,72,159,0
14798,김용민(金容民),정태호(鄭泰浩),90,100,190,0
14799,김용민(金容民),정필모(鄭必模),98,107,205,0
14800,김용민(金容民),정희용(鄭熙溶),50,5,55,1
14801,김용민(金容民),조경태(趙慶泰),49,4,53,1
14802,김용민(金容民),조명희(曺明姬),49,6,55,1
14803,김용민(金容民),조수진(趙修眞),49,4,53,1
14804,김용민(金容民),조승래(趙承來),89,60,149,0
14805,김용민(金容民),조오섭(曺五燮),97,186,283,0
14806,김용민(金容民),조은희(趙恩禧),25,4,29,1
14807,김용민(金容民),조응천(趙應天),75,33,108,0
14808,김용민(金容民),조정식(趙正湜),78,50,128,0
14809,김용민(金容民),조정훈(趙廷訓),3,10,13,1
14810,김용민(金容民),조해진(曺海珍),52,5,57,1
14811,김용민(金容民),주철현(朱哲鉉),95,96,191,0
14812,김용민(金容民),주호영(朱豪英),49,4,53,1
14813,김용민(金容民),지성호(池成浩),49,4,53,1
14814,김용민(金容民),진선미(陳善美),82,72,154,0
14815,김용민(金容民),진성준(陳聲準),104,88,192,0
14816,김용민(金容民),천준호(千俊鎬),95,71,166,0
14817,김용민(金容民),최기상(崔基相),107,106,213,0
14818,김용민(金容民),최승재(崔承宰),49,5,54,1
14819,김용민(金容民),최연숙(崔姸淑),34,10,44,1
14820,김용민(金容民),최영희(崔英姬),25,5,30,1
14821,김용민(金容民),최인호(崔仁昊),88,70,158,0
14822,김용민(金容民),최재형(崔在亨),25,5,30,1
14823,김용민(金容民),최종윤(崔鍾允),103,140,243,0
14824,김용민(金容民),최춘식(崔春植),49,6,55,1
14825,김용민(金容民),최형두(崔炯斗),50,4,54,1
14826,김용민(金容民),최혜영(崔惠英),109,208,317,0
14827,김용민(金容民),추경호(秋慶鎬),49,3,52,1
14828,김용민(金容民),태영호(太永浩),49,4,53,1
14829,김용민(金容民),하영제(河榮帝),42,2,44,1
14830,김용민(金容民),하태경(河泰慶),49,6,55,1
14831,김용민(金容民),한기호(韓起鎬),50,6,56,1
14832,김용민(金容民),한무경(韓茂景),49,4,53,1
14833,김용민(金容民),한병도(韓秉道),90,66,156,0
14834,김용민(金容民),한정애(韓貞愛),79,74,153,0
14835,김용민(金容民),한준호(韓俊鎬),102,143,245,0
14836,김용민(金容民),허숙정(許淑湞),1,2,3,0
14837,김용민(金容民),허영(許榮),95,80,175,0
14838,김용민(金容民),허은아(許垠娥),49,4,53,1
14839,김용민(金容民),허종식(許琮植),93,100,193,0
14840,김용민(金容民),홍기원(洪起元),97,84,181,0
14841,김용민(金容民),홍문표(洪文杓),50,5,55,1
14842,김용민(金容民),홍석준(洪碩晙),50,4,54,1
14843,김용민(金容民),홍성국(洪性國),100,107,207,0
14844,김용민(金容民),홍영표(洪永杓),81,53,134,0
14845,김용민(金容民),홍익표(洪翼杓),91,67,158,0
14846,김용민(金容民),홍정민(洪貞敏),105,129,234,0
14847,김용민(金容民),황보승희(皇甫承希),46,1,47,1
14848,김용민(金容民),황운하(黃雲夏),118,227,345,0
14849,김용민(金容民),황희(黃熙),81,46,127,0
14850,김용판(金用判),김웅(金雄),78,62,140,0
14851,김용판(金用判),김원이(金元二),52,4,56,1
14852,김용판(金用判),김윤덕(金潤德),53,5,58,1
14853,김용판(金用判),김의겸(金宜謙),26,6,32,1
14854,김용판(金用判),김정재(金汀才),152,226,378,0
14855,김용판(金用判),김정호(金禎鎬),52,4,56,1
14856,김용판(金用判),김종민(金鐘民),52,7,59,1
14857,김용판(金用判),김주영(金周暎),52,5,57,1
14858,김용판(金用判),김진표(金振杓),27,2,29,1
14859,김용판(金用判),김철민(金哲玟),52,7,59,1
14860,김용판(金用判),김태년(金太年),50,5,55,1
14861,김용판(金用判),김태호(金台鎬),98,148,246,0
14862,김용판(金用判),김학용(金學容),56,121,177,0
14863,김용판(金用判),김한규(金翰奎),25,6,31,1
14864,김용판(金用判),김한정(金漢正),50,4,54,1
14865,김용판(金用判),김형동(金亨東),129,221,350,0
14866,김용판(金用判),김홍걸(金弘傑),15,6,21,1
14867,김용판(金用判),김회재(金會在),52,6,58,1
14868,김용판(金用判),김희곤(金熙坤),109,222,331,0
14869,김용판(金用判),김희국(金熙國),99,114,213,0
14870,김용판(金用判),남인순(南仁順),50,5,55,1
14871,김용판(金用判),노용호(魯容昊),44,82,126,0
14872,김용판(金用判),노웅래(盧雄來),51,6,57,1
14873,김용판(金用判),도종환(都鍾煥),51,5,56,1
14874,김용판(金用判),류성걸(柳性杰),95,147,242,0
14875,김용판(金用判),류호정(柳好貞),4,6,10,1
14876,김용판(金用判),맹성규(孟聖奎),50,4,54,1
14877,김용판(金用判),문정복(文貞福),49,5,54,1
14878,김용판(金用判),문진석(文振碩),50,5,55,1
14879,김용판(金用判),민병덕(閔炳德),50,7,57,1
14880,김용판(金用判),민형배(閔馨培),34,5,39,1
14881,김용판(金用判),민홍철(閔洪喆),50,5,55,1
14882,김용판(金用判),박광온(朴洸瑥),52,5,57,1
14883,김용판(金用判),박대수(朴大壽),198,547,745,0
14884,김용판(金用判),박대출(朴大出),86,79,165,0
14885,김용판(金用判),박덕흠(朴德欽),144,414,558,0
14886,김용판(金用判),박범계(朴範界),50,4,54,1
14887,김용판(金用判),박병석(朴炳錫),25,3,28,1
14888,김용판(金用判),박상혁(朴商赫),51,4,55,1
14889,김용판(金用判),박성민(朴聖敏),120,338,458,0
14890,김용판(金用判),박성준(朴省俊),50,5,55,1
14891,김용판(金用判),박성중(朴成重),113,145,258,0
14892,김용판(金用判),박수영(朴洙瑩),83,92,175,0
14893,김용판(金用判),박영순(朴英淳),51,5,56,1
14894,김용판(金用判),박완주(朴完柱),25,0,25,1
14895,김용판(金用判),박용진(朴用鎭),49,4,53,1
14896,김용판(金用判),박재호(朴在昊),52,4,56,1
14897,김용판(金用判),박정(朴釘),50,5,55,1
14898,김용판(金用判),박정하(朴正河),39,55,94,0
14899,김용판(金用判),박주민(朴柱民),50,4,54,1
14900,김용판(金用判),박진(朴振),91,110,201,0
14901,김용판(金用判),박찬대(朴贊大),51,4,55,1
14902,김용판(金用判),박형수(朴亨修),83,100,183,0
14903,김용판(金用判),박홍근(朴洪根),51,4,55,1
14904,김용판(金用判),배준영(裵俊英),108,170,278,0
14905,김용판(金用判),배진교(裵晋敎),5,3,8,1
14906,김용판(金用判),배현진(裵賢鎭),91,95,186,0
14907,김용판(金用判),백종헌(白宗憲),130,328,458,0
14908,김용판(金用判),백혜련(白惠蓮),51,5,56,1
14909,김용판(金用判),변재일(卞在一),51,6,57,1
14910,김용판(金用判),서동용(徐東榕),50,4,54,1
14911,김용판(金用判),서범수(徐範洙),107,174,281,0
14912,김용판(金用判),서병수(徐秉洙),111,184,295,0
14913,김용판(金用判),서삼석(徐參錫),49,5,54,1
14914,김용판(金用判),서영교(徐瑛敎),54,4,58,1
14915,김용판(金用判),서영석(徐暎錫),50,5,55,1
14916,김용판(金用判),서일준(徐一俊),198,385,583,0
14917,김용판(金用判),서정숙(徐正淑),81,132,213,0
14918,김용판(金用判),설훈(薛勳),50,7,57,1
14919,김용판(金用判),성일종(成一鍾),138,216,354,0
14920,김용판(金用判),소병철(蘇秉哲),53,5,58,1
14921,김용판(金用判),소병훈(蘇秉勳),51,4,55,1
14922,김용판(金用判),송갑석(宋甲錫),51,5,56,1
14923,김용판(金用判),송기헌(宋基憲),51,9,60,1
14924,김용판(金用判),송석준(宋錫俊),93,111,204,0
14925,김용판(金用判),송언석(宋彦錫),117,199,316,0
14926,김용판(金用判),송옥주(宋玉珠),50,3,53,1
14927,김용판(金用判),송재호(宋在祜),51,6,57,1
14928,김용판(金用判),신동근(申東根),50,7,57,1
14929,김용판(金用判),신영대(申榮大),51,4,55,1
14930,김용판(金用判),신원식(申源湜),86,132,218,0
14931,김용판(金用判),신정훈(辛正勳),51,4,55,1
14932,김용판(金用判),신현영(申賢榮),50,4,54,1
14933,김용판(金用判),심상정(沈相奵),5,3,8,1
14934,김용판(金用判),안규백(安圭伯),52,12,64,1
14935,김용판(金用判),안민석(安敏錫),50,3,53,1
14936,김용판(金用判),안병길(安炳吉),94,186,280,0
14937,김용판(金用判),안철수(安哲秀),30,40,70,0
14938,김용판(金用判),안호영(安浩永),50,6,56,1
14939,김용판(金用判),양경숙(梁敬淑),50,4,54,1
14940,김용판(金用判),양금희(梁琴喜),161,260,421,0
14941,김용판(金用判),양기대(梁基大),51,5,56,1
14942,김용판(金用判),양이원영(梁李媛瑛),45,4,49,1
14943,김용판(金用判),양정숙(梁貞淑),4,12,16,1
14944,김용판(金用判),양향자(梁香子),21,14,35,1
14945,김용판(金用判),어기구(魚基龜),50,6,56,1
14946,김용판(金用判),엄태영(嚴泰永),101,134,235,0
14947,김용판(金用判),오기형(吳奇炯),49,4,53,1
14948,김용판(金用判),오영환(吳永煥),54,9,63,1
14949,김용판(金用判),용혜인(龍慧仁),2,7,9,1
14950,김용판(金用判),우상호(禹相虎),51,4,55,1
14951,김용판(金用判),우원식(禹元植),50,4,54,1
14952,김용판(金用判),위성곤(魏聖坤),50,6,56,1
14953,김용판(金用判),유경준(兪京濬),135,182,317,0
14954,김용판(金用判),유기홍(柳基洪),50,4,54,1
14955,김용판(金用判),유동수(柳東秀),51,9,60,1
14956,김용판(金用判),유상범(劉相凡),80,93,173,0
14957,김용판(金用判),유의동(兪義東),82,136,218,0
14958,김용판(金用判),유정주(兪訂炷),49,5,54,1
14959,김용판(金用判),윤건영(尹建永),49,3,52,1
14960,김용판(金用判),윤관석(尹官石),41,1,42,1
14961,김용판(金用判),윤두현(尹斗鉉),96,163,259,0
14962,김용판(金用判),윤미향(尹美香),20,2,22,1
14963,김용판(金用判),윤상현(尹相現),48,53,101,0
14964,김용판(金用判),윤영덕(尹永德),51,6,57,1
14965,김용판(金用判),윤영석(尹永碩),79,112,191,0
14966,김용판(金用判),윤영찬(尹永燦),51,4,55,1
14967,김용판(金用判),윤재갑(尹才鉀),52,12,64,1
14968,김용판(金用判),윤재옥(尹在玉),105,95,200,0
14969,김용판(金用判),윤주경(尹柱卿),74,92,166,0
14970,김용판(金用判),윤준병(尹準炳),52,5,57,1
14971,김용판(金用判),윤창현(尹暢賢),185,237,422,0
14972,김용판(金用判),윤한홍(尹漢洪),91,121,212,0
14973,김용판(金用判),윤호중(尹昊重),52,4,56,1
14974,김용판(金用判),윤후덕(尹厚德),50,4,54,1
14975,김용판(金用判),이개호(李介昊),51,4,55,1
14976,김용판(金用判),이달곤(李達坤),80,110,190,0
14977,김용판(金用判),이동주(李東洲),49,5,54,1
14978,김용판(金用判),이만희(李晩熙),79,88,167,0
14979,김용판(金用判),이명수(李明洙),125,265,390,0
14980,김용판(金用判),이병훈(李炳勳),53,8,61,1
14981,김용판(金用判),이상민(李相珉),50,6,56,1
14982,김용판(金用判),이상헌(李相憲),52,7,59,1
14983,김용판(金用判),이성만(李成萬),41,1,42,1
14984,김용판(金用判),이소영(李素永),51,4,55,1
14985,김용판(金用判),이수진(李壽珍),50,4,54,1
14986,김용판(金用判),이수진(李秀眞),50,5,55,1
14987,김용판(金用判),이양수(李亮壽),90,124,214,0
14988,김용판(金用判),이용(李鏞),119,161,280,0
14989,김용판(金用判),이용빈(李龍彬),53,11,64,1
14990,김용판(金用判),이용선(李庸瑄),51,4,55,1
14991,김용판(金用判),이용우(李龍雨),49,4,53,1
14992,김용판(金用判),이용호(李容鎬),29,30,59,0
14993,김용판(金用判),이원욱(李元旭),51,5,56,1
14994,김용판(金用判),이원택(李源澤),50,4,54,1
14995,김용판(金用判),이은주(李恩周),6,3,9,1
14996,김용판(金用判),이인선(李仁善),31,155,186,0
14997,김용판(金用判),이인영(李仁榮),50,4,54,1
14998,김용판(金用判),이장섭(李將燮),51,5,56,1
14999,김용판(金用判),이재명(李在明),25,4,29,1
15000,김용판(金用判),이재정(李在汀),50,4,54,1
15001,김용판(金用判),이정문(李楨文),50,4,54,1
15002,김용판(金用判),이종배(李鍾培),162,223,385,0
15003,김용판(金用判),이종성(李鍾成),165,402,567,0
15004,김용판(金用判),이주환(李周桓),210,382,592,0
15005,김용판(金用判),이채익(李埰益),112,206,318,0
15006,김용판(金用判),이철규(李喆圭),94,106,200,0
15007,김용판(金用判),이탄희(李誕熙),50,4,54,1
15008,김용판(金用判),이태규(李泰珪),58,77,135,0
15009,김용판(金用判),이학영(李學永),49,4,53,1
15010,김용판(金用判),이해식(李海植),53,4,57,1
15011,김용판(金用判),이헌승(李憲昇),80,218,298,0
15012,김용판(金用判),이형석(李炯錫),50,4,54,1
15013,김용판(金用判),인재근(印在謹),51,5,56,1
15014,김용판(金用判),임병헌(林炳憲),42,78,120,0
15015,김용판(金用判),임오경(林五卿),50,5,55,1
15016,김용판(金用判),임이자(林利子),149,227,376,0
15017,김용판(金用判),임종성(林鍾聲),52,5,57,1
15018,김용판(金用判),임호선(林昊宣),55,9,64,1
15019,김용판(金用判),장경태(張耿態),50,4,54,1
15020,김용판(金用判),장동혁(張東赫),36,78,114,0
15021,김용판(金用判),장제원(張濟元),71,46,117,0
15022,김용판(金用判),장철민(張喆敏),51,6,57,1
15023,김용판(金用判),장혜영(張惠英),6,8,14,1
15024,김용판(金用判),전봉민(田奉珉),77,172,249,0
15025,김용판(金用判),전용기(田溶冀),52,4,56,1
15026,김용판(金用判),전재수(田載秀),50,6,56,1
15027,김용판(金用判),전주혜(全珠惠),82,124,206,0
15028,김용판(金用判),전해철(全海澈),50,4,54,1
15029,김용판(金用判),전혜숙(全惠淑),50,5,55,1
15030,김용판(金用判),정경희(丁慶姬),82,98,180,0
15031,김용판(金用判),정동만(鄭東萬),101,203,304,0
15032,김용판(金用判),정성호(鄭成湖),51,7,58,1
15033,김용판(金用判),정우택(鄭宇澤),61,182,243,0
15034,김용판(金用判),정운천(鄭雲天),123,223,346,0
15035,김용판(金用判),정일영(鄭日永),49,5,54,1
15036,김용판(金用判),정점식(鄭点植),87,88,175,0
15037,김용판(金用判),정진석(鄭鎭碩),101,144,245,0
15038,김용판(金用判),정청래(鄭淸來),49,4,53,1
15039,김용판(金用判),정춘숙(鄭春淑),50,7,57,1
15040,김용판(金用判),정태호(鄭泰浩),50,4,54,1
15041,김용판(金用判),정필모(鄭必模),50,4,54,1
15042,김용판(金用判),정희용(鄭熙溶),143,281,424,0
15043,김용판(金用判),조경태(趙慶泰),107,148,255,0
15044,김용판(金用判),조명희(曺明姬),182,354,536,0
15045,김용판(金用判),조수진(趙修眞),119,170,289,0
15046,김용판(金用判),조승래(趙承來),51,9,60,1
15047,김용판(金用判),조오섭(曺五燮),50,4,54,1
15048,김용판(金用判),조은희(趙恩禧),40,66,106,0
15049,김용판(金用判),조응천(趙應天),50,4,54,1
15050,김용판(金用判),조정식(趙正湜),49,3,52,1
15051,김용판(金用判),조정훈(趙廷訓),2,11,13,1
15052,김용판(金用判),조해진(曺海珍),71,40,111,0
15053,김용판(金用判),주철현(朱哲鉉),52,5,57,1
15054,김용판(金用判),주호영(朱豪英),74,84,158,0
15055,김용판(金用判),지성호(池成浩),173,339,512,0
15056,김용판(金用判),진선미(陳善美),50,4,54,1
15057,김용판(金用判),진성준(陳聲準),50,5,55,1
15058,김용판(金用判),천준호(千俊鎬),49,3,52,1
15059,김용판(金用判),최기상(崔基相),50,4,54,1
15060,김용판(金用判),최승재(崔承宰),107,130,237,0
15061,김용판(金用判),최연숙(崔姸淑),37,52,89,0
15062,김용판(金用判),최영희(崔英姬),50,140,190,0
15063,김용판(金用判),최인호(崔仁昊),52,6,58,1
15064,김용판(金用判),최재형(崔在亨),30,30,60,0
15065,김용판(金用判),최종윤(崔鍾允),51,5,56,1
15066,김용판(金用判),최춘식(崔春植),135,286,421,0
15067,김용판(金用判),최형두(崔炯斗),120,186,306,0
15068,김용판(金用判),최혜영(崔惠英),50,5,55,1
15069,김용판(金用判),추경호(秋慶鎬),211,295,506,0
15070,김용판(金用判),태영호(太永浩),140,299,439,0
15071,김용판(金用判),하영제(河榮帝),151,398,549,1
15072,김용판(金用判),하태경(河泰慶),67,62,129,0
15073,김용판(金用判),한기호(韓起鎬),81,77,158,0
15074,김용판(金用判),한무경(韓茂景),133,221,354,0
15075,김용판(金用判),한병도(韓秉道),51,4,55,1
15076,김용판(金用判),한정애(韓貞愛),50,4,54,1
15077,김용판(金用判),한준호(韓俊鎬),50,4,54,1
15078,김용판(金用判),허숙정(許淑湞),0,0,0,1
15079,김용판(金用判),허영(許榮),51,9,60,1
15080,김용판(金用判),허은아(許垠娥),102,136,238,0
15081,김용판(金用判),허종식(許琮植),51,15,66,1
15082,김용판(金用判),홍기원(洪起元),50,5,55,1
15083,김용판(金用判),홍문표(洪文杓),99,149,248,0
15084,김용판(金用判),홍석준(洪碩晙),121,168,289,0
15085,김용판(金用判),홍성국(洪性國),51,5,56,1
15086,김용판(金用判),홍영표(洪永杓),50,4,54,1
15087,김용판(金用判),홍익표(洪翼杓),51,8,59,1
15088,김용판(金用判),홍정민(洪貞敏),51,4,55,1
15089,김용판(金用判),황보승희(皇甫承希),104,161,265,1
15090,김용판(金用判),황운하(黃雲夏),52,5,57,1
15091,김용판(金用判),황희(黃熙),49,6,55,1
15092,김웅(金雄),김원이(金元二),51,4,55,1
15093,김웅(金雄),김윤덕(金潤德),51,3,54,1
15094,김웅(金雄),김의겸(金宜謙),26,4,30,1
15095,김웅(金雄),김정재(金汀才),73,57,130,0
15096,김웅(金雄),김정호(金禎鎬),51,5,56,1
15097,김웅(金雄),김종민(金鐘民),51,6,57,1
15098,김웅(金雄),김주영(金周暎),51,6,57,1
15099,김웅(金雄),김진표(金振杓),25,0,25,1
15100,김웅(金雄),김철민(金哲玟),49,3,52,1
15101,김웅(金雄),김태년(金太年),49,4,53,1
15102,김웅(金雄),김태호(金台鎬),50,35,85,0
15103,김웅(金雄),김학용(金學容),25,18,43,0
15104,김웅(金雄),김한규(金翰奎),25,5,30,1
15105,김웅(金雄),김한정(金漢正),50,4,54,1
15106,김웅(金雄),김형동(金亨東),73,58,131,0
15107,김웅(金雄),김홍걸(金弘傑),14,6,20,1
15108,김웅(金雄),김회재(金會在),49,6,55,1
15109,김웅(金雄),김희곤(金熙坤),62,50,112,0
15110,김웅(金雄),김희국(金熙國),63,45,108,0
15111,김웅(金雄),남인순(南仁順),50,4,54,1
15112,김웅(金雄),노용호(魯容昊),25,17,42,0
15113,김웅(金雄),노웅래(盧雄來),50,5,55,1
15114,김웅(金雄),도종환(都鍾煥),49,5,54,1
15115,김웅(金雄),류성걸(柳性杰),66,41,107,0
15116,김웅(金雄),류호정(柳好貞),6,4,10,1
15117,김웅(金雄),맹성규(孟聖奎),49,5,54,1
15118,김웅(金雄),문정복(文貞福),49,4,53,1
15119,김웅(金雄),문진석(文振碩),50,5,55,1
15120,김웅(金雄),민병덕(閔炳德),49,5,54,1
15121,김웅(金雄),민형배(閔馨培),33,5,38,1
15122,김웅(金雄),민홍철(閔洪喆),50,5,55,1
15123,김웅(金雄),박광온(朴洸瑥),50,4,54,1
15124,김웅(金雄),박대수(朴大壽),73,70,143,0
15125,김웅(金雄),박대출(朴大出),61,50,111,0
15126,김웅(金雄),박덕흠(朴德欽),47,45,92,0
15127,김웅(金雄),박범계(朴範界),49,4,53,1
15128,김웅(金雄),박병석(朴炳錫),25,3,28,1
15129,김웅(金雄),박상혁(朴商赫),49,4,53,1
15130,김웅(金雄),박성민(朴聖敏),63,55,118,0
15131,김웅(金雄),박성준(朴省俊),49,6,55,1
15132,김웅(金雄),박성중(朴成重),67,50,117,0
15133,김웅(金雄),박수영(朴洙瑩),63,45,108,0
15134,김웅(金雄),박영순(朴英淳),50,3,53,1
15135,김웅(金雄),박완주(朴完柱),24,0,24,1
15136,김웅(金雄),박용진(朴用鎭),49,5,54,1
15137,김웅(金雄),박재호(朴在昊),49,5,54,1
15138,김웅(金雄),박정(朴釘),50,5,55,1
15139,김웅(金雄),박정하(朴正河),25,15,40,0
15140,김웅(金雄),박주민(朴柱民),49,4,53,1
15141,김웅(金雄),박진(朴振),68,54,122,0
15142,김웅(金雄),박찬대(朴贊大),49,5,54,1
15143,김웅(金雄),박형수(朴亨修),63,39,102,0
15144,김웅(金雄),박홍근(朴洪根),51,4,55,1
15145,김웅(金雄),배준영(裵俊英),64,45,109,0
15146,김웅(金雄),배진교(裵晋敎),4,3,7,1
15147,김웅(金雄),배현진(裵賢鎭),69,56,125,0
15148,김웅(金雄),백종헌(白宗憲),68,77,145,0
15149,김웅(金雄),백혜련(白惠蓮),49,4,53,1
15150,김웅(金雄),변재일(卞在一),51,5,56,1
15151,김웅(金雄),서동용(徐東榕),50,5,55,1
15152,김웅(金雄),서범수(徐範洙),64,46,110,0
15153,김웅(金雄),서병수(徐秉洙),62,49,111,0
15154,김웅(金雄),서삼석(徐參錫),49,4,53,1
15155,김웅(金雄),서영교(徐瑛敎),50,6,56,1
15156,김웅(金雄),서영석(徐暎錫),49,5,54,1
15157,김웅(金雄),서일준(徐一俊),73,66,139,0
15158,김웅(金雄),서정숙(徐正淑),62,64,126,0
15159,김웅(金雄),설훈(薛勳),50,4,54,1
15160,김웅(金雄),성일종(成一鍾),74,57,131,0
15161,김웅(金雄),소병철(蘇秉哲),49,4,53,1
15162,김웅(金雄),소병훈(蘇秉勳),49,5,54,1
15163,김웅(金雄),송갑석(宋甲錫),49,5,54,1
15164,김웅(金雄),송기헌(宋基憲),49,5,54,1
15165,김웅(金雄),송석준(宋錫俊),64,52,116,0
15166,김웅(金雄),송언석(宋彦錫),61,49,110,0
15167,김웅(金雄),송옥주(宋玉珠),49,3,52,1
15168,김웅(金雄),송재호(宋在祜),50,5,55,1
15169,김웅(金雄),신동근(申東根),49,3,52,1
15170,김웅(金雄),신영대(申榮大),49,4,53,1
15171,김웅(金雄),신원식(申源湜),70,73,143,0
15172,김웅(金雄),신정훈(辛正勳),50,5,55,1
15173,김웅(金雄),신현영(申賢榮),50,4,54,1
15174,김웅(金雄),심상정(沈相奵),4,4,8,1
15175,김웅(金雄),안규백(安圭伯),49,5,54,1
15176,김웅(金雄),안민석(安敏錫),49,3,52,1
15177,김웅(金雄),안병길(安炳吉),65,52,117,0
15178,김웅(金雄),안철수(安哲秀),25,14,39,0
15179,김웅(金雄),안호영(安浩永),50,5,55,1
15180,김웅(金雄),양경숙(梁敬淑),49,5,54,1
15181,김웅(金雄),양금희(梁琴喜),72,72,144,0
15182,김웅(金雄),양기대(梁基大),50,4,54,1
15183,김웅(金雄),양이원영(梁李媛瑛),46,5,51,1
15184,김웅(金雄),양정숙(梁貞淑),2,12,14,1
15185,김웅(金雄),양향자(梁香子),21,4,25,1
15186,김웅(金雄),어기구(魚基龜),49,5,54,1
15187,김웅(金雄),엄태영(嚴泰永),66,46,112,0
15188,김웅(金雄),오기형(吳奇炯),49,5,54,1
15189,김웅(金雄),오영환(吳永煥),50,6,56,1
15190,김웅(金雄),용혜인(龍慧仁),3,5,8,1
15191,김웅(金雄),우상호(禹相虎),49,4,53,1
15192,김웅(金雄),우원식(禹元植),49,4,53,1
15193,김웅(金雄),위성곤(魏聖坤),49,5,54,1
15194,김웅(金雄),유경준(兪京濬),72,74,146,0
15195,김웅(金雄),유기홍(柳基洪),49,4,53,1
15196,김웅(金雄),유동수(柳東秀),49,5,54,1
15197,김웅(金雄),유상범(劉相凡),60,42,102,0
15198,김웅(金雄),유의동(兪義東),68,48,116,0
15199,김웅(金雄),유정주(兪訂炷),49,5,54,1
15200,김웅(金雄),윤건영(尹建永),49,4,53,1
15201,김웅(金雄),윤관석(尹官石),40,0,40,1
15202,김웅(金雄),윤두현(尹斗鉉),67,64,131,0
15203,김웅(金雄),윤미향(尹美香),20,2,22,1
15204,김웅(金雄),윤상현(尹相現),32,31,63,0
15205,김웅(金雄),윤영덕(尹永德),49,4,53,1
15206,김웅(金雄),윤영석(尹永碩),62,32,94,0
15207,김웅(金雄),윤영찬(尹永燦),49,4,53,1
15208,김웅(金雄),윤재갑(尹才鉀),50,5,55,1
15209,김웅(金雄),윤재옥(尹在玉),61,36,97,0
15210,김웅(金雄),윤주경(尹柱卿),62,51,113,0
15211,김웅(金雄),윤준병(尹準炳),49,4,53,1
15212,김웅(金雄),윤창현(尹暢賢),76,58,134,0
15213,김웅(金雄),윤한홍(尹漢洪),59,39,98,0
15214,김웅(金雄),윤호중(尹昊重),50,4,54,1
15215,김웅(金雄),윤후덕(尹厚德),49,5,54,1
15216,김웅(金雄),이개호(李介昊),49,5,54,1
15217,김웅(金雄),이달곤(李達坤),59,39,98,0
15218,김웅(金雄),이동주(李東洲),49,5,54,1
15219,김웅(金雄),이만희(李晩熙),62,48,110,0
15220,김웅(金雄),이명수(李明洙),69,69,138,0
15221,김웅(金雄),이병훈(李炳勳),50,7,57,1
15222,김웅(金雄),이상민(李相珉),49,4,53,1
15223,김웅(金雄),이상헌(李相憲),50,6,56,1
15224,김웅(金雄),이성만(李成萬),40,1,41,1
15225,김웅(金雄),이소영(李素永),49,5,54,1
15226,김웅(金雄),이수진(李壽珍),50,5,55,1
15227,김웅(金雄),이수진(李秀眞),50,5,55,1
15228,김웅(金雄),이양수(李亮壽),62,54,116,0
15229,김웅(金雄),이용(李鏞),79,59,138,0
15230,김웅(金雄),이용빈(李龍彬),50,6,56,1
15231,김웅(金雄),이용선(李庸瑄),49,5,54,1
15232,김웅(金雄),이용우(李龍雨),50,5,55,1
15233,김웅(金雄),이용호(李容鎬),27,14,41,0
15234,김웅(金雄),이원욱(李元旭),49,5,54,1
15235,김웅(金雄),이원택(李源澤),49,4,53,1
15236,김웅(金雄),이은주(李恩周),4,3,7,1
15237,김웅(金雄),이인선(李仁善),25,18,43,0
15238,김웅(金雄),이인영(李仁榮),49,4,53,1
15239,김웅(金雄),이장섭(李將燮),50,4,54,1
15240,김웅(金雄),이재명(李在明),25,4,29,1
15241,김웅(金雄),이재정(李在汀),49,4,53,1
15242,김웅(金雄),이정문(李楨文),49,4,53,1
15243,김웅(金雄),이종배(李鍾培),68,57,125,0
15244,김웅(金雄),이종성(李鍾成),72,71,143,0
15245,김웅(金雄),이주환(李周桓),65,54,119,0
15246,김웅(金雄),이채익(李埰益),64,48,112,0
15247,김웅(金雄),이철규(李喆圭),62,39,101,0
15248,김웅(金雄),이탄희(李誕熙),49,5,54,1
15249,김웅(金雄),이태규(李泰珪),38,31,69,0
15250,김웅(金雄),이학영(李學永),49,5,54,1
15251,김웅(金雄),이해식(李海植),49,5,54,1
15252,김웅(金雄),이헌승(李憲昇),60,44,104,0
15253,김웅(金雄),이형석(李炯錫),50,5,55,1
15254,김웅(金雄),인재근(印在謹),49,4,53,1
15255,김웅(金雄),임병헌(林炳憲),25,15,40,0
15256,김웅(金雄),임오경(林五卿),49,5,54,1
15257,김웅(金雄),임이자(林利子),67,41,108,0
15258,김웅(金雄),임종성(林鍾聲),50,7,57,1
15259,김웅(金雄),임호선(林昊宣),49,4,53,1
15260,김웅(金雄),장경태(張耿態),49,5,54,1
15261,김웅(金雄),장동혁(張東赫),25,14,39,0
15262,김웅(金雄),장제원(張濟元),63,30,93,0
15263,김웅(金雄),장철민(張喆敏),49,4,53,1
15264,김웅(金雄),장혜영(張惠英),5,3,8,1
15265,김웅(金雄),전봉민(田奉珉),44,28,72,0
15266,김웅(金雄),전용기(田溶冀),49,5,54,1
15267,김웅(金雄),전재수(田載秀),49,4,53,1
15268,김웅(金雄),전주혜(全珠惠),70,70,140,0
15269,김웅(金雄),전해철(全海澈),49,4,53,1
15270,김웅(金雄),전혜숙(全惠淑),49,5,54,1
15271,김웅(金雄),정경희(丁慶姬),62,50,112,0
15272,김웅(金雄),정동만(鄭東萬),62,45,107,0
15273,김웅(金雄),정성호(鄭成湖),50,6,56,1
15274,김웅(金雄),정우택(鄭宇澤),26,21,47,0
15275,김웅(金雄),정운천(鄭雲天),66,39,105,0
15276,김웅(金雄),정일영(鄭日永),50,6,56,1
15277,김웅(金雄),정점식(鄭点植),60,33,93,0
15278,김웅(金雄),정진석(鄭鎭碩),66,48,114,0
15279,김웅(金雄),정청래(鄭淸來),49,4,53,1
15280,김웅(金雄),정춘숙(鄭春淑),49,4,53,1
15281,김웅(金雄),정태호(鄭泰浩),49,4,53,1
15282,김웅(金雄),정필모(鄭必模),49,5,54,1
15283,김웅(金雄),정희용(鄭熙溶),68,46,114,0
15284,김웅(金雄),조경태(趙慶泰),61,35,96,0
15285,김웅(金雄),조명희(曺明姬),63,73,136,0
15286,김웅(金雄),조수진(趙修眞),63,61,124,0
15287,김웅(金雄),조승래(趙承來),50,3,53,1
15288,김웅(金雄),조오섭(曺五燮),50,6,56,1
15289,김웅(金雄),조은희(趙恩禧),26,17,43,0
15290,김웅(金雄),조응천(趙應天),50,6,56,1
15291,김웅(金雄),조정식(趙正湜),49,3,52,1
15292,김웅(金雄),조정훈(趙廷訓),0,9,9,1
15293,김웅(金雄),조해진(曺海珍),62,32,94,0
15294,김웅(金雄),주철현(朱哲鉉),49,5,54,1
15295,김웅(金雄),주호영(朱豪英),62,39,101,0
15296,김웅(金雄),지성호(池成浩),76,63,139,0
15297,김웅(金雄),진선미(陳善美),50,5,55,1
15298,김웅(金雄),진성준(陳聲準),49,4,53,1
15299,김웅(金雄),천준호(千俊鎬),49,3,52,1
15300,김웅(金雄),최기상(崔基相),49,5,54,1
15301,김웅(金雄),최승재(崔承宰),66,60,126,0
15302,김웅(金雄),최연숙(崔姸淑),34,31,65,0
15303,김웅(金雄),최영희(崔英姬),25,18,43,0
15304,김웅(金雄),최인호(崔仁昊),49,4,53,1
15305,김웅(金雄),최재형(崔在亨),25,16,41,0
15306,김웅(金雄),최종윤(崔鍾允),49,4,53,1
15307,김웅(金雄),최춘식(崔春植),67,56,123,0
15308,김웅(金雄),최형두(崔炯斗),67,40,107,0
15309,김웅(金雄),최혜영(崔惠英),50,5,55,1
15310,김웅(金雄),추경호(秋慶鎬),78,64,142,0
15311,김웅(金雄),태영호(太永浩),78,78,156,0
15312,김웅(金雄),하영제(河榮帝),56,48,104,1
15313,김웅(金雄),하태경(河泰慶),66,48,114,0
15314,김웅(金雄),한기호(韓起鎬),60,35,95,0
15315,김웅(金雄),한무경(韓茂景),72,60,132,0
15316,김웅(金雄),한병도(韓秉道),49,4,53,1
15317,김웅(金雄),한정애(韓貞愛),50,6,56,1
15318,김웅(金雄),한준호(韓俊鎬),49,4,53,1
15319,김웅(金雄),허숙정(許淑湞),0,0,0,1
15320,김웅(金雄),허영(許榮),50,5,55,1
15321,김웅(金雄),허은아(許垠娥),78,66,144,0
15322,김웅(金雄),허종식(許琮植),49,5,54,1
15323,김웅(金雄),홍기원(洪起元),49,5,54,1
15324,김웅(金雄),홍문표(洪文杓),62,39,101,0
15325,김웅(金雄),홍석준(洪碩晙),65,43,108,0
15326,김웅(金雄),홍성국(洪性國),50,5,55,1
15327,김웅(金雄),홍영표(洪永杓),49,5,54,1
15328,김웅(金雄),홍익표(洪翼杓),49,5,54,1
15329,김웅(金雄),홍정민(洪貞敏),49,5,54,1
15330,김웅(金雄),황보승희(皇甫承希),75,72,147,1
15331,김웅(金雄),황운하(黃雲夏),50,5,55,1
15332,김웅(金雄),황희(黃熙),49,5,54,1
15333,김원이(金元二),김윤덕(金潤德),104,116,220,0
15334,김원이(金元二),김의겸(金宜謙),48,71,119,0
15335,김원이(金元二),김정재(金汀才),53,5,58,1
15336,김원이(金元二),김정호(金禎鎬),115,156,271,0
15337,김원이(金元二),김종민(金鐘民),99,72,171,0
15338,김원이(金元二),김주영(金周暎),105,117,222,0
15339,김원이(金元二),김진표(金振杓),61,47,108,1
15340,김원이(金元二),김철민(金哲玟),121,112,233,0
15341,김원이(金元二),김태년(金太年),78,47,125,0
15342,김원이(金元二),김태호(金台鎬),42,6,48,1
15343,김원이(金元二),김학용(金學容),25,5,30,1
15344,김원이(金元二),김한규(金翰奎),44,52,96,0
15345,김원이(金元二),김한정(金漢正),84,63,147,0
15346,김원이(金元二),김형동(金亨東),53,6,59,1
15347,김원이(金元二),김홍걸(金弘傑),52,115,167,0
15348,김원이(金元二),김회재(金會在),116,121,237,0
15349,김원이(金元二),김희곤(金熙坤),50,4,54,1
15350,김원이(金元二),김희국(金熙國),49,4,53,1
15351,김원이(金元二),남인순(南仁順),113,127,240,0
15352,김원이(金元二),노용호(魯容昊),25,4,29,1
15353,김원이(金元二),노웅래(盧雄來),105,100,205,0
15354,김원이(金元二),도종환(都鍾煥),114,113,227,0
15355,김원이(金元二),류성걸(柳性杰),49,4,53,1
15356,김원이(金元二),류호정(柳好貞),20,57,77,1
15357,김원이(金元二),맹성규(孟聖奎),98,62,160,0
15358,김원이(金元二),문정복(文貞福),90,59,149,0
15359,김원이(金元二),문진석(文振碩),124,134,258,0
15360,김원이(金元二),민병덕(閔炳德),101,155,256,0
15361,김원이(金元二),민형배(閔馨培),110,163,273,0
15362,김원이(金元二),민홍철(閔洪喆),89,77,166,0
15363,김원이(金元二),박광온(朴洸瑥),86,62,148,0
15364,김원이(金元二),박대수(朴大壽),50,9,59,1
15365,김원이(金元二),박대출(朴大出),50,4,54,1
15366,김원이(金元二),박덕흠(朴德欽),36,8,44,1
15367,김원이(金元二),박범계(朴範界),78,42,120,0
15368,김원이(金元二),박병석(朴炳錫),41,16,57,0
15369,김원이(金元二),박상혁(朴商赫),113,154,267,0
15370,김원이(金元二),박성민(朴聖敏),49,6,55,1
15371,김원이(金元二),박성준(朴省俊),110,98,208,0
15372,김원이(金元二),박성중(朴成重),49,4,53,1
15373,김원이(金元二),박수영(朴洙瑩),49,14,63,1
15374,김원이(金元二),박영순(朴英淳),102,90,192,0
15375,김원이(金元二),박완주(朴完柱),59,46,105,1
15376,김원이(金元二),박용진(朴用鎭),100,83,183,0
15377,김원이(金元二),박재호(朴在昊),85,74,159,0
15378,김원이(金元二),박정(朴釘),124,120,244,0
15379,김원이(金元二),박정하(朴正河),25,4,29,1
15380,김원이(金元二),박주민(朴柱民),86,62,148,0
15381,김원이(金元二),박진(朴振),50,4,54,1
15382,김원이(金元二),박찬대(朴贊大),87,58,145,0
15383,김원이(金元二),박형수(朴亨修),49,5,54,1
15384,김원이(金元二),박홍근(朴洪根),131,170,301,0
15385,김원이(金元二),배준영(裵俊英),49,4,53,1
15386,김원이(金元二),배진교(裵晋敎),21,53,74,1
15387,김원이(金元二),배현진(裵賢鎭),49,4,53,1
15388,김원이(金元二),백종헌(白宗憲),50,6,56,1
15389,김원이(金元二),백혜련(白惠蓮),94,60,154,0
15390,김원이(金元二),변재일(卞在一),87,68,155,0
15391,김원이(金元二),서동용(徐東榕),109,123,232,0
15392,김원이(金元二),서범수(徐範洙),53,5,58,1
15393,김원이(金元二),서병수(徐秉洙),50,6,56,1
15394,김원이(金元二),서삼석(徐參錫),123,124,247,0
15395,김원이(金元二),서영교(徐瑛敎),109,140,249,0
15396,김원이(金元二),서영석(徐暎錫),132,200,332,0
15397,김원이(金元二),서일준(徐一俊),50,6,56,1
15398,김원이(金元二),서정숙(徐正淑),49,7,56,1
15399,김원이(金元二),설훈(薛勳),86,71,157,0
15400,김원이(金元二),성일종(成一鍾),50,8,58,1
15401,김원이(金元二),소병철(蘇秉哲),108,89,197,0
15402,김원이(金元二),소병훈(蘇秉勳),106,119,225,0
15403,김원이(金元二),송갑석(宋甲錫),146,202,348,0
15404,김원이(金元二),송기헌(宋基憲),88,53,141,0
15405,김원이(金元二),송석준(宋錫俊),50,7,57,1
15406,김원이(金元二),송언석(宋彦錫),45,4,49,1
15407,김원이(金元二),송옥주(宋玉珠),103,103,206,0
15408,김원이(金元二),송재호(宋在祜),108,104,212,0
15409,김원이(金元二),신동근(申東根),97,83,180,0
15410,김원이(金元二),신영대(申榮大),93,73,166,0
15411,김원이(金元二),신원식(申源湜),49,4,53,1
15412,김원이(金元二),신정훈(辛正勳),148,225,373,0
15413,김원이(金元二),신현영(申賢榮),92,66,158,0
15414,김원이(金元二),심상정(沈相奵),18,45,63,1
15415,김원이(金元二),안규백(安圭伯),94,71,165,0
15416,김원이(金元二),안민석(安敏錫),98,107,205,0
15417,김원이(金元二),안병길(安炳吉),53,6,59,1
15418,김원이(金元二),안철수(安哲秀),25,6,31,1
15419,김원이(金元二),안호영(安浩永),92,142,234,0
15420,김원이(金元二),양경숙(梁敬淑),98,73,171,0
15421,김원이(金元二),양금희(梁琴喜),50,5,55,1
15422,김원이(金元二),양기대(梁基大),89,68,157,0
15423,김원이(金元二),양이원영(梁李媛瑛),103,135,238,0
15424,김원이(金元二),양정숙(梁貞淑),76,129,205,1
15425,김원이(金元二),양향자(梁香子),51,58,109,1
15426,김원이(金元二),어기구(魚基龜),97,79,176,0
15427,김원이(金元二),엄태영(嚴泰永),51,5,56,1
15428,김원이(金元二),오기형(吳奇炯),80,58,138,0
15429,김원이(金元二),오영환(吳永煥),143,216,359,0
15430,김원이(金元二),용혜인(龍慧仁),19,41,60,1
15431,김원이(金元二),우상호(禹相虎),82,48,130,0
15432,김원이(金元二),우원식(禹元植),119,143,262,0
15433,김원이(金元二),위성곤(魏聖坤),129,158,287,0
15434,김원이(金元二),유경준(兪京濬),49,5,54,1
15435,김원이(金元二),유기홍(柳基洪),79,58,137,0
15436,김원이(金元二),유동수(柳東秀),99,57,156,0
15437,김원이(金元二),유상범(劉相凡),50,4,54,1
15438,김원이(金元二),유의동(兪義東),52,5,57,1
15439,김원이(金元二),유정주(兪訂炷),111,115,226,0
15440,김원이(金元二),윤건영(尹建永),88,75,163,0
15441,김원이(金元二),윤관석(尹官石),69,43,112,1
15442,김원이(金元二),윤두현(尹斗鉉),49,4,53,1
15443,김원이(金元二),윤미향(尹美香),54,81,135,1
15444,김원이(金元二),윤상현(尹相現),30,6,36,1
15445,김원이(金元二),윤영덕(尹永德),113,162,275,0
15446,김원이(金元二),윤영석(尹永碩),50,6,56,1
15447,김원이(金元二),윤영찬(尹永燦),88,55,143,0
15448,김원이(金元二),윤재갑(尹才鉀),137,137,274,0
15449,김원이(金元二),윤재옥(尹在玉),52,5,57,1
15450,김원이(金元二),윤주경(尹柱卿),49,4,53,1
15451,김원이(金元二),윤준병(尹準炳),123,189,312,0
15452,김원이(金元二),윤창현(尹暢賢),49,6,55,1
15453,김원이(金元二),윤한홍(尹漢洪),50,4,54,1
15454,김원이(金元二),윤호중(尹昊重),82,53,135,0
15455,김원이(金元二),윤후덕(尹厚德),90,69,159,0
15456,김원이(金元二),이개호(李介昊),116,120,236,0
15457,김원이(金元二),이달곤(李達坤),51,6,57,1
15458,김원이(金元二),이동주(李東洲),101,129,230,0
15459,김원이(金元二),이만희(李晩熙),50,5,55,1
15460,김원이(金元二),이명수(李明洙),51,24,75,1
15461,김원이(金元二),이병훈(李炳勳),102,116,218,0
15462,김원이(金元二),이상민(李相珉),83,42,125,0
15463,김원이(金元二),이상헌(李相憲),110,89,199,0
15464,김원이(金元二),이성만(李成萬),93,90,183,1
15465,김원이(金元二),이소영(李素永),95,86,181,0
15466,김원이(金元二),이수진(李壽珍),122,173,295,0
15467,김원이(金元二),이수진(李秀眞),114,98,212,0
15468,김원이(金元二),이양수(李亮壽),51,6,57,1
15469,김원이(金元二),이용(李鏞),49,5,54,1
15470,김원이(金元二),이용빈(李龍彬),136,219,355,0
15471,김원이(金元二),이용선(李庸瑄),108,117,225,0
15472,김원이(金元二),이용우(李龍雨),97,87,184,0
15473,김원이(金元二),이용호(李容鎬),33,19,52,1
15474,김원이(金元二),이원욱(李元旭),99,90,189,0
15475,김원이(金元二),이원택(李源澤),107,111,218,0
15476,김원이(金元二),이은주(李恩周),26,66,92,1
15477,김원이(金元二),이인선(李仁善),25,5,30,1
15478,김원이(金元二),이인영(李仁榮),77,64,141,0
15479,김원이(金元二),이장섭(李將燮),95,95,190,0
15480,김원이(金元二),이재명(李在明),41,23,64,0
15481,김원이(金元二),이재정(李在汀),88,60,148,0
15482,김원이(金元二),이정문(李楨文),124,165,289,0
15483,김원이(金元二),이종배(李鍾培),50,6,56,1
15484,김원이(金元二),이종성(李鍾成),49,8,57,1
15485,김원이(金元二),이주환(李周桓),49,5,54,1
15486,김원이(金元二),이채익(李埰益),52,8,60,1
15487,김원이(金元二),이철규(李喆圭),52,5,57,1
15488,김원이(金元二),이탄희(李誕熙),98,91,189,0
15489,김원이(金元二),이태규(李泰珪),29,5,34,1
15490,김원이(金元二),이학영(李學永),111,115,226,0
15491,김원이(金元二),이해식(李海植),127,146,273,0
15492,김원이(金元二),이헌승(李憲昇),51,6,57,1
15493,김원이(金元二),이형석(李炯錫),116,129,245,0
15494,김원이(金元二),인재근(印在謹),138,193,331,0
15495,김원이(金元二),임병헌(林炳憲),25,4,29,1
15496,김원이(金元二),임오경(林五卿),96,106,202,0
15497,김원이(金元二),임이자(林利子),49,5,54,1
15498,김원이(金元二),임종성(林鍾聲),113,141,254,0
15499,김원이(金元二),임호선(林昊宣),146,205,351,0
15500,김원이(金元二),장경태(張耿態),108,125,233,0
15501,김원이(金元二),장동혁(張東赫),25,4,29,1
15502,김원이(金元二),장제원(張濟元),49,4,53,1
15503,김원이(金元二),장철민(張喆敏),102,99,201,0
15504,김원이(金元二),장혜영(張惠英),17,43,60,1
15505,김원이(金元二),전봉민(田奉珉),35,6,41,1
15506,김원이(金元二),전용기(田溶冀),105,112,217,0
15507,김원이(金元二),전재수(田載秀),83,60,143,0
15508,김원이(金元二),전주혜(全珠惠),51,5,56,1
15509,김원이(金元二),전해철(全海澈),81,54,135,0
15510,김원이(金元二),전혜숙(全惠淑),94,66,160,0
15511,김원이(金元二),정경희(丁慶姬),49,4,53,1
15512,김원이(金元二),정동만(鄭東萬),49,5,54,1
15513,김원이(金元二),정성호(鄭成湖),81,83,164,0
15514,김원이(金元二),정우택(鄭宇澤),25,6,31,1
15515,김원이(金元二),정운천(鄭雲天),49,7,56,1
15516,김원이(金元二),정일영(鄭日永),91,92,183,0
15517,김원이(金元二),정점식(鄭点植),50,4,54,1
15518,김원이(金元二),정진석(鄭鎭碩),52,6,58,1
15519,김원이(金元二),정청래(鄭淸來),92,74,166,0
15520,김원이(金元二),정춘숙(鄭春淑),116,141,257,0
15521,김원이(金元二),정태호(鄭泰浩),87,110,197,0
15522,김원이(金元二),정필모(鄭必模),98,88,186,0
15523,김원이(金元二),정희용(鄭熙溶),50,5,55,1
15524,김원이(金元二),조경태(趙慶泰),49,4,53,1
15525,김원이(金元二),조명희(曺明姬),49,7,56,1
15526,김원이(金元二),조수진(趙修眞),51,5,56,1
15527,김원이(金元二),조승래(趙承來),106,81,187,0
15528,김원이(金元二),조오섭(曺五燮),135,240,375,0
15529,김원이(金元二),조은희(趙恩禧),25,5,30,1
15530,김원이(金元二),조응천(趙應天),77,34,111,0
15531,김원이(金元二),조정식(趙正湜),77,39,116,0
15532,김원이(金元二),조정훈(趙廷訓),7,7,14,1
15533,김원이(金元二),조해진(曺海珍),51,7,58,1
15534,김원이(金元二),주철현(朱哲鉉),113,155,268,0
15535,김원이(金元二),주호영(朱豪英),50,4,54,1
15536,김원이(金元二),지성호(池成浩),49,4,53,1
15537,김원이(金元二),진선미(陳善美),91,96,187,0
15538,김원이(金元二),진성준(陳聲準),112,156,268,0
15539,김원이(金元二),천준호(千俊鎬),96,87,183,0
15540,김원이(金元二),최기상(崔基相),83,86,169,0
15541,김원이(金元二),최승재(崔承宰),49,5,54,1
15542,김원이(金元二),최연숙(崔姸淑),33,17,50,1
15543,김원이(金元二),최영희(崔英姬),25,6,31,1
15544,김원이(金元二),최인호(崔仁昊),92,65,157,0
15545,김원이(金元二),최재형(崔在亨),25,6,31,1
15546,김원이(金元二),최종윤(崔鍾允),133,159,292,0
15547,김원이(金元二),최춘식(崔春植),49,14,63,1
15548,김원이(金元二),최형두(崔炯斗),51,4,55,1
15549,김원이(金元二),최혜영(崔惠英),147,249,396,0
15550,김원이(金元二),추경호(秋慶鎬),49,5,54,1
15551,김원이(金元二),태영호(太永浩),49,5,54,1
15552,김원이(金元二),하영제(河榮帝),41,2,43,1
15553,김원이(金元二),하태경(河泰慶),51,6,57,1
15554,김원이(金元二),한기호(韓起鎬),51,4,55,1
15555,김원이(金元二),한무경(韓茂景),49,4,53,1
15556,김원이(金元二),한병도(韓秉道),99,92,191,0
15557,김원이(金元二),한정애(韓貞愛),85,53,138,0
15558,김원이(金元二),한준호(韓俊鎬),123,181,304,0
15559,김원이(金元二),허숙정(許淑湞),1,2,3,0
15560,김원이(金元二),허영(許榮),142,142,284,0
15561,김원이(金元二),허은아(許垠娥),49,5,54,1
15562,김원이(金元二),허종식(許琮植),114,119,233,0
15563,김원이(金元二),홍기원(洪起元),99,97,196,0
15564,김원이(金元二),홍문표(洪文杓),50,7,57,1
15565,김원이(金元二),홍석준(洪碩晙),50,4,54,1
15566,김원이(金元二),홍성국(洪性國),129,164,293,0
15567,김원이(金元二),홍영표(洪永杓),84,53,137,0
15568,김원이(金元二),홍익표(洪翼杓),106,106,212,0
15569,김원이(金元二),홍정민(洪貞敏),112,122,234,0
15570,김원이(金元二),황보승희(皇甫承希),49,3,52,1
15571,김원이(金元二),황운하(黃雲夏),132,159,291,0
15572,김원이(金元二),황희(黃熙),82,54,136,0
15573,김윤덕(金潤德),김의겸(金宜謙),47,41,88,0
15574,김윤덕(金潤德),김정재(金汀才),53,4,57,1
15575,김윤덕(金潤德),김정호(金禎鎬),180,315,495,0
15576,김윤덕(金潤德),김종민(金鐘民),93,67,160,0
15577,김윤덕(金潤德),김주영(金周暎),100,118,218,0
15578,김윤덕(金潤德),김진표(金振杓),53,39,92,1
15579,김윤덕(金潤德),김철민(金哲玟),135,174,309,0
15580,김윤덕(金潤德),김태년(金太年),76,43,119,0
15581,김윤덕(金潤德),김태호(金台鎬),41,6,47,1
15582,김윤덕(金潤德),김학용(金學容),26,3,29,1
15583,김윤덕(金潤德),김한규(金翰奎),42,38,80,0
15584,김윤덕(金潤德),김한정(金漢正),80,36,116,0
15585,김윤덕(金潤德),김형동(金亨東),51,7,58,1
15586,김윤덕(金潤德),김홍걸(金弘傑),49,124,173,0
15587,김윤덕(金潤德),김회재(金會在),99,64,163,0
15588,김윤덕(金潤德),김희곤(金熙坤),50,4,54,1
15589,김윤덕(金潤德),김희국(金熙國),49,3,52,1
15590,김윤덕(金潤德),남인순(南仁順),99,75,174,0
15591,김윤덕(金潤德),노용호(魯容昊),26,3,29,1
15592,김윤덕(金潤德),노웅래(盧雄來),103,73,176,0
15593,김윤덕(金潤德),도종환(都鍾煥),86,66,152,0
15594,김윤덕(金潤德),류성걸(柳性杰),49,3,52,1
15595,김윤덕(金潤德),류호정(柳好貞),13,23,36,1
15596,김윤덕(金潤德),맹성규(孟聖奎),93,47,140,0
15597,김윤덕(金潤德),문정복(文貞福),95,70,165,0
15598,김윤덕(金潤德),문진석(文振碩),115,166,281,0
15599,김윤덕(金潤德),민병덕(閔炳德),105,110,215,0
15600,김윤덕(金潤德),민형배(閔馨培),96,208,304,0
15601,김윤덕(金潤德),민홍철(閔洪喆),95,115,210,0
15602,김윤덕(金潤德),박광온(朴洸瑥),79,42,121,0
15603,김윤덕(金潤德),박대수(朴大壽),50,5,55,1
15604,김윤덕(金潤德),박대출(朴大出),51,3,54,1
15605,김윤덕(金潤德),박덕흠(朴德欽),36,9,45,1
15606,김윤덕(金潤德),박범계(朴範界),78,34,112,0
15607,김윤덕(金潤德),박병석(朴炳錫),41,18,59,0
15608,김윤덕(金潤德),박상혁(朴商赫),154,304,458,0
15609,김윤덕(金潤德),박성민(朴聖敏),50,3,53,1
15610,김윤덕(金潤德),박성준(朴省俊),97,90,187,0
15611,김윤덕(金潤德),박성중(朴成重),49,3,52,1
15612,김윤덕(金潤德),박수영(朴洙瑩),49,3,52,1
15613,김윤덕(金潤德),박영순(朴英淳),102,96,198,0
15614,김윤덕(金潤德),박완주(朴完柱),43,35,78,1
15615,김윤덕(金潤德),박용진(朴用鎭),81,56,137,0
15616,김윤덕(金潤德),박재호(朴在昊),115,92,207,0
15617,김윤덕(金潤德),박정(朴釘),105,101,206,0
15618,김윤덕(金潤德),박정하(朴正河),26,3,29,1
15619,김윤덕(金潤德),박주민(朴柱民),80,48,128,0
15620,김윤덕(金潤德),박진(朴振),50,3,53,1
15621,김윤덕(金潤德),박찬대(朴贊大),93,67,160,0
15622,김윤덕(金潤德),박형수(朴亨修),49,3,52,1
15623,김윤덕(金潤德),박홍근(朴洪根),97,92,189,0
15624,김윤덕(金潤德),배준영(裵俊英),49,3,52,1
15625,김윤덕(金潤德),배진교(裵晋敎),14,26,40,1
15626,김윤덕(金潤德),배현진(裵賢鎭),49,4,53,1
15627,김윤덕(金潤德),백종헌(白宗憲),51,6,57,1
15628,김윤덕(金潤德),백혜련(白惠蓮),88,65,153,0
15629,김윤덕(金潤德),변재일(卞在一),82,50,132,0
15630,김윤덕(金潤德),서동용(徐東榕),97,134,231,0
15631,김윤덕(金潤德),서범수(徐範洙),51,6,57,1
15632,김윤덕(金潤德),서병수(徐秉洙),50,3,53,1
15633,김윤덕(金潤德),서삼석(徐參錫),108,79,187,0
15634,김윤덕(金潤德),서영교(徐瑛敎),86,105,191,0
15635,김윤덕(金潤德),서영석(徐暎錫),104,108,212,0
15636,김윤덕(金潤德),서일준(徐一俊),51,7,58,1
15637,김윤덕(金潤德),서정숙(徐正淑),49,3,52,1
15638,김윤덕(金潤德),설훈(薛勳),88,64,152,0
15639,김윤덕(金潤德),성일종(成一鍾),50,8,58,1
15640,김윤덕(金潤德),소병철(蘇秉哲),81,51,132,0
15641,김윤덕(金潤德),소병훈(蘇秉勳),117,98,215,0
15642,김윤덕(金潤德),송갑석(宋甲錫),126,173,299,0
15643,김윤덕(金潤德),송기헌(宋基憲),85,46,131,0
15644,김윤덕(金潤德),송석준(宋錫俊),51,6,57,1
15645,김윤덕(金潤德),송언석(宋彦錫),45,3,48,1
15646,김윤덕(金潤德),송옥주(宋玉珠),111,102,213,0
15647,김윤덕(金潤德),송재호(宋在祜),97,107,204,0
15648,김윤덕(金潤德),신동근(申東根),114,123,237,0
15649,김윤덕(金潤德),신영대(申榮大),113,135,248,0
15650,김윤덕(金潤德),신원식(申源湜),50,3,53,1
15651,김윤덕(金潤德),신정훈(辛正勳),120,111,231,0
15652,김윤덕(金潤德),신현영(申賢榮),91,67,158,0
15653,김윤덕(金潤德),심상정(沈相奵),14,26,40,1
15654,김윤덕(金潤德),안규백(安圭伯),98,74,172,0
15655,김윤덕(金潤德),안민석(安敏錫),92,105,197,0
15656,김윤덕(金潤德),안병길(安炳吉),50,4,54,1
15657,김윤덕(金潤德),안철수(安哲秀),26,3,29,1
15658,김윤덕(金潤德),안호영(安浩永),120,190,310,0
15659,김윤덕(金潤德),양경숙(梁敬淑),93,113,206,0
15660,김윤덕(金潤德),양금희(梁琴喜),51,3,54,1
15661,김윤덕(金潤德),양기대(梁基大),82,74,156,0
15662,김윤덕(金潤德),양이원영(梁李媛瑛),93,74,167,0
15663,김윤덕(金潤德),양정숙(梁貞淑),38,123,161,1
15664,김윤덕(金潤德),양향자(梁香子),36,44,80,1
15665,김윤덕(金潤德),어기구(魚基龜),103,119,222,0
15666,김윤덕(金潤德),엄태영(嚴泰永),50,3,53,1
15667,김윤덕(金潤德),오기형(吳奇炯),77,35,112,0
15668,김윤덕(金潤德),오영환(吳永煥),115,117,232,0
15669,김윤덕(金潤德),용혜인(龍慧仁),14,31,45,1
15670,김윤덕(金潤德),우상호(禹相虎),80,30,110,0
15671,김윤덕(金潤德),우원식(禹元植),88,71,159,0
15672,김윤덕(金潤德),위성곤(魏聖坤),105,131,236,0
15673,김윤덕(金潤德),유경준(兪京濬),49,3,52,1
15674,김윤덕(金潤德),유기홍(柳基洪),83,49,132,0
15675,김윤덕(金潤德),유동수(柳東秀),96,71,167,0
15676,김윤덕(金潤德),유상범(劉相凡),51,3,54,1
15677,김윤덕(金潤德),유의동(兪義東),49,3,52,1
15678,김윤덕(金潤德),유정주(兪訂炷),101,124,225,0
15679,김윤덕(金潤德),윤건영(尹建永),83,52,135,0
15680,김윤덕(金潤德),윤관석(尹官石),78,53,131,1
15681,김윤덕(金潤德),윤두현(尹斗鉉),50,4,54,1
15682,김윤덕(金潤德),윤미향(尹美香),48,44,92,1
15683,김윤덕(金潤德),윤상현(尹相現),31,4,35,1
15684,김윤덕(金潤德),윤영덕(尹永德),85,88,173,0
15685,김윤덕(金潤德),윤영석(尹永碩),50,4,54,1
15686,김윤덕(金潤德),윤영찬(尹永燦),86,54,140,0
15687,김윤덕(金潤德),윤재갑(尹才鉀),109,101,210,0
15688,김윤덕(金潤德),윤재옥(尹在玉),49,3,52,1
15689,김윤덕(金潤德),윤주경(尹柱卿),49,5,54,1
15690,김윤덕(金潤德),윤준병(尹準炳),129,179,308,0
15691,김윤덕(金潤德),윤창현(尹暢賢),49,3,52,1
15692,김윤덕(金潤德),윤한홍(尹漢洪),50,3,53,1
15693,김윤덕(金潤德),윤호중(尹昊重),83,45,128,0
15694,김윤덕(金潤德),윤후덕(尹厚德),159,217,376,0
15695,김윤덕(金潤德),이개호(李介昊),98,83,181,0
15696,김윤덕(金潤德),이달곤(李達坤),51,5,56,1
15697,김윤덕(金潤德),이동주(李東洲),110,179,289,0
15698,김윤덕(金潤德),이만희(李晩熙),50,3,53,1
15699,김윤덕(金潤德),이명수(李明洙),54,19,73,1
15700,김윤덕(金潤德),이병훈(李炳勳),92,105,197,0
15701,김윤덕(金潤德),이상민(李相珉),78,38,116,0
15702,김윤덕(金潤德),이상헌(李相憲),94,88,182,0
15703,김윤덕(金潤德),이성만(李成萬),82,67,149,1
15704,김윤덕(金潤德),이소영(李素永),92,68,160,0
15705,김윤덕(金潤德),이수진(李壽珍),96,99,195,0
15706,김윤덕(金潤德),이수진(李秀眞),94,58,152,0
15707,김윤덕(金潤德),이양수(李亮壽),51,6,57,1
15708,김윤덕(金潤德),이용(李鏞),50,6,56,1
15709,김윤덕(金潤德),이용빈(李龍彬),133,210,343,0
15710,김윤덕(金潤德),이용선(李庸瑄),97,71,168,0
15711,김윤덕(金潤德),이용우(李龍雨),87,56,143,0
15712,김윤덕(金潤德),이용호(李容鎬),49,39,88,1
15713,김윤덕(金潤德),이원욱(李元旭),103,106,209,0
15714,김윤덕(金潤德),이원택(李源澤),95,71,166,0
15715,김윤덕(金潤德),이은주(李恩周),18,27,45,1
15716,김윤덕(金潤德),이인선(李仁善),25,3,28,1
15717,김윤덕(金潤德),이인영(李仁榮),76,35,111,0
15718,김윤덕(金潤德),이장섭(李將燮),97,75,172,0
15719,김윤덕(金潤德),이재명(李在明),40,17,57,0
15720,김윤덕(金潤德),이재정(李在汀),76,39,115,0
15721,김윤덕(金潤德),이정문(李楨文),141,193,334,0
15722,김윤덕(金潤德),이종배(李鍾培),51,4,55,1
15723,김윤덕(金潤德),이종성(李鍾成),50,5,55,1
15724,김윤덕(金潤德),이주환(李周桓),50,3,53,1
15725,김윤덕(金潤德),이채익(李埰益),53,6,59,1
15726,김윤덕(金潤德),이철규(李喆圭),54,7,61,1
15727,김윤덕(金潤德),이탄희(李誕熙),86,65,151,0
15728,김윤덕(金潤德),이태규(李泰珪),29,3,32,1
15729,김윤덕(金潤德),이학영(李學永),100,110,210,0
15730,김윤덕(金潤德),이해식(李海植),105,109,214,0
15731,김윤덕(金潤德),이헌승(李憲昇),50,3,53,1
15732,김윤덕(金潤德),이형석(李炯錫),98,81,179,0
15733,김윤덕(金潤德),인재근(印在謹),104,100,204,0
15734,김윤덕(金潤德),임병헌(林炳憲),26,4,30,1
15735,김윤덕(金潤德),임오경(林五卿),98,102,200,0
15736,김윤덕(金潤德),임이자(林利子),49,4,53,1
15737,김윤덕(金潤德),임종성(林鍾聲),153,192,345,0
15738,김윤덕(金潤德),임호선(林昊宣),109,132,241,0
15739,김윤덕(金潤德),장경태(張耿態),113,113,226,0
15740,김윤덕(金潤德),장동혁(張東赫),25,3,28,1
15741,김윤덕(金潤德),장제원(張濟元),49,3,52,1
15742,김윤덕(金潤德),장철민(張喆敏),109,139,248,0
15743,김윤덕(金潤德),장혜영(張惠英),14,15,29,1
15744,김윤덕(金潤德),전봉민(田奉珉),35,4,39,1
15745,김윤덕(金潤德),전용기(田溶冀),117,102,219,0
15746,김윤덕(金潤德),전재수(田載秀),97,103,200,0
15747,김윤덕(金潤德),전주혜(全珠惠),52,4,56,1
15748,김윤덕(金潤德),전해철(全海澈),76,37,113,0
15749,김윤덕(金潤德),전혜숙(全惠淑),86,64,150,0
15750,김윤덕(金潤德),정경희(丁慶姬),50,3,53,1
15751,김윤덕(金潤德),정동만(鄭東萬),49,4,53,1
15752,김윤덕(金潤德),정성호(鄭成湖),99,142,241,0
15753,김윤덕(金潤德),정우택(鄭宇澤),26,3,29,1
15754,김윤덕(金潤德),정운천(鄭雲天),51,7,58,1
15755,김윤덕(金潤德),정일영(鄭日永),87,74,161,0
15756,김윤덕(金潤德),정점식(鄭点植),50,3,53,1
15757,김윤덕(金潤德),정진석(鄭鎭碩),50,4,54,1
15758,김윤덕(金潤德),정청래(鄭淸來),82,37,119,0
15759,김윤덕(金潤德),정춘숙(鄭春淑),152,209,361,0
15760,김윤덕(金潤德),정태호(鄭泰浩),92,71,163,0
15761,김윤덕(金潤德),정필모(鄭必模),95,76,171,0
15762,김윤덕(金潤德),정희용(鄭熙溶),50,4,54,1
15763,김윤덕(金潤德),조경태(趙慶泰),52,4,56,1
15764,김윤덕(金潤德),조명희(曺明姬),50,4,54,1
15765,김윤덕(金潤德),조수진(趙修眞),50,5,55,1
15766,김윤덕(金潤德),조승래(趙承來),94,65,159,0
15767,김윤덕(金潤德),조오섭(曺五燮),108,154,262,0
15768,김윤덕(金潤德),조은희(趙恩禧),26,3,29,1
15769,김윤덕(金潤德),조응천(趙應天),86,51,137,0
15770,김윤덕(金潤德),조정식(趙正湜),98,97,195,0
15771,김윤덕(金潤德),조정훈(趙廷訓),3,11,14,1
15772,김윤덕(金潤德),조해진(曺海珍),51,5,56,1
15773,김윤덕(金潤德),주철현(朱哲鉉),88,69,157,0
15774,김윤덕(金潤德),주호영(朱豪英),49,4,53,1
15775,김윤덕(金潤德),지성호(池成浩),50,4,54,1
15776,김윤덕(金潤德),진선미(陳善美),86,79,165,0
15777,김윤덕(金潤德),진성준(陳聲準),118,115,233,0
15778,김윤덕(金潤德),천준호(千俊鎬),103,61,164,0
15779,김윤덕(金潤德),최기상(崔基相),87,67,154,0
15780,김윤덕(金潤德),최승재(崔承宰),51,8,59,1
15781,김윤덕(金潤德),최연숙(崔姸淑),30,9,39,1
15782,김윤덕(金潤德),최영희(崔英姬),25,3,28,1
15783,김윤덕(金潤德),최인호(崔仁昊),114,94,208,0
15784,김윤덕(金潤德),최재형(崔在亨),25,3,28,1
15785,김윤덕(金潤德),최종윤(崔鍾允),109,110,219,0
15786,김윤덕(金潤德),최춘식(崔春植),49,4,53,1
15787,김윤덕(金潤德),최형두(崔炯斗),50,3,53,1
15788,김윤덕(金潤德),최혜영(崔惠英),90,98,188,0
15789,김윤덕(金潤德),추경호(秋慶鎬),49,4,53,1
15790,김윤덕(金潤德),태영호(太永浩),50,7,57,1
15791,김윤덕(金潤德),하영제(河榮帝),42,3,45,1
15792,김윤덕(金潤德),하태경(河泰慶),50,5,55,1
15793,김윤덕(金潤德),한기호(韓起鎬),51,5,56,1
15794,김윤덕(金潤德),한무경(韓茂景),49,4,53,1
15795,김윤덕(金潤德),한병도(韓秉道),135,146,281,0
15796,김윤덕(金潤德),한정애(韓貞愛),77,59,136,0
15797,김윤덕(金潤德),한준호(韓俊鎬),99,121,220,0
15798,김윤덕(金潤德),허숙정(許淑湞),1,1,2,0
15799,김윤덕(金潤德),허영(許榮),159,199,358,0
15800,김윤덕(金潤德),허은아(許垠娥),49,3,52,1
15801,김윤덕(金潤德),허종식(許琮植),108,152,260,0
15802,김윤덕(金潤德),홍기원(洪起元),109,111,220,0
15803,김윤덕(金潤德),홍문표(洪文杓),56,9,65,1
15804,김윤덕(金潤德),홍석준(洪碩晙),50,4,54,1
15805,김윤덕(金潤德),홍성국(洪性國),105,105,210,0
15806,김윤덕(金潤德),홍영표(洪永杓),82,65,147,0
15807,김윤덕(金潤德),홍익표(洪翼杓),93,83,176,0
15808,김윤덕(金潤德),홍정민(洪貞敏),102,74,176,0
15809,김윤덕(金潤德),황보승희(皇甫承希),46,2,48,1
15810,김윤덕(金潤德),황운하(黃雲夏),104,127,231,0
15811,김윤덕(金潤德),황희(黃熙),85,70,155,0
15812,김의겸(金宜謙),김정재(金汀才),26,6,32,1
15813,김의겸(金宜謙),김정호(金禎鎬),61,136,197,0
15814,김의겸(金宜謙),김종민(金鐘民),47,84,131,0
15815,김의겸(金宜謙),김주영(金周暎),52,52,104,0
15816,김의겸(金宜謙),김진표(金振杓),5,16,21,1
15817,김의겸(金宜謙),김철민(金哲玟),63,77,140,0
15818,김의겸(金宜謙),김태년(金太年),53,52,105,0
15819,김의겸(金宜謙),김태호(金台鎬),25,7,32,1
15820,김의겸(金宜謙),김학용(金學容),25,4,29,1
15821,김의겸(金宜謙),김한규(金翰奎),44,44,88,0
15822,김의겸(金宜謙),김한정(金漢正),44,33,77,0
15823,김의겸(金宜謙),김형동(金亨東),26,4,30,1
15824,김의겸(金宜謙),김홍걸(金弘傑),18,96,114,0
15825,김의겸(金宜謙),김회재(金會在),57,43,100,0
15826,김의겸(金宜謙),김희곤(金熙坤),25,5,30,1
15827,김의겸(金宜謙),김희국(金熙國),25,4,29,1
15828,김의겸(金宜謙),남인순(南仁順),56,64,120,0
15829,김의겸(金宜謙),노용호(魯容昊),25,4,29,1
15830,김의겸(金宜謙),노웅래(盧雄來),49,45,94,0
15831,김의겸(金宜謙),도종환(都鍾煥),62,56,118,0
15832,김의겸(金宜謙),류성걸(柳性杰),25,4,29,1
15833,김의겸(金宜謙),류호정(柳好貞),13,58,71,1
15834,김의겸(金宜謙),맹성규(孟聖奎),48,36,84,0
15835,김의겸(金宜謙),문정복(文貞福),44,87,131,0
15836,김의겸(金宜謙),문진석(文振碩),46,47,93,0
15837,김의겸(金宜謙),민병덕(閔炳德),52,114,166,0
15838,김의겸(金宜謙),민형배(閔馨培),33,181,214,0
15839,김의겸(金宜謙),민홍철(閔洪喆),43,36,79,0
15840,김의겸(金宜謙),박광온(朴洸瑥),49,51,100,0
15841,김의겸(金宜謙),박대수(朴大壽),25,4,29,1
15842,김의겸(金宜謙),박대출(朴大出),25,5,30,1
15843,김의겸(金宜謙),박덕흠(朴德欽),25,8,33,1
15844,김의겸(金宜謙),박범계(朴範界),43,39,82,0
15845,김의겸(金宜謙),박병석(朴炳錫),39,16,55,0
15846,김의겸(金宜謙),박상혁(朴商赫),49,96,145,0
15847,김의겸(金宜謙),박성민(朴聖敏),25,7,32,1
15848,김의겸(金宜謙),박성준(朴省俊),52,62,114,0
15849,김의겸(金宜謙),박성중(朴成重),25,4,29,1
15850,김의겸(金宜謙),박수영(朴洙瑩),25,4,29,1
15851,김의겸(金宜謙),박영순(朴英淳),49,51,100,0
15852,김의겸(金宜謙),박완주(朴完柱),7,25,32,1
15853,김의겸(金宜謙),박용진(朴用鎭),44,49,93,0
15854,김의겸(金宜謙),박재호(朴在昊),45,36,81,0
15855,김의겸(金宜謙),박정(朴釘),46,57,103,0
15856,김의겸(金宜謙),박정하(朴正河),25,7,32,1
15857,김의겸(金宜謙),박주민(朴柱民),48,83,131,0
15858,김의겸(金宜謙),박진(朴振),25,4,29,1
15859,김의겸(金宜謙),박찬대(朴贊大),47,47,94,0
15860,김의겸(金宜謙),박형수(朴亨修),25,4,29,1
15861,김의겸(金宜謙),박홍근(朴洪根),46,52,98,0
15862,김의겸(金宜謙),배준영(裵俊英),25,7,32,1
15863,김의겸(金宜謙),배진교(裵晋敎),10,26,36,1
15864,김의겸(金宜謙),배현진(裵賢鎭),25,5,30,1
15865,김의겸(金宜謙),백종헌(白宗憲),25,7,32,1
15866,김의겸(金宜謙),백혜련(白惠蓮),49,39,88,0
15867,김의겸(金宜謙),변재일(卞在一),46,44,90,0
15868,김의겸(金宜謙),서동용(徐東榕),50,69,119,0
15869,김의겸(金宜謙),서범수(徐範洙),25,5,30,1
15870,김의겸(金宜謙),서병수(徐秉洙),25,4,29,1
15871,김의겸(金宜謙),서삼석(徐參錫),46,39,85,0
15872,김의겸(金宜謙),서영교(徐瑛敎),48,90,138,0
15873,김의겸(金宜謙),서영석(徐暎錫),47,53,100,0
15874,김의겸(金宜謙),서일준(徐一俊),25,7,32,1
15875,김의겸(金宜謙),서정숙(徐正淑),25,4,29,1
15876,김의겸(金宜謙),설훈(薛勳),43,62,105,0
15877,김의겸(金宜謙),성일종(成一鍾),25,7,32,1
15878,김의겸(金宜謙),소병철(蘇秉哲),44,41,85,0
15879,김의겸(金宜謙),소병훈(蘇秉勳),53,75,128,0
15880,김의겸(金宜謙),송갑석(宋甲錫),44,77,121,0
15881,김의겸(金宜謙),송기헌(宋基憲),45,34,79,0
15882,김의겸(金宜謙),송석준(宋錫俊),25,4,29,1
15883,김의겸(金宜謙),송언석(宋彦錫),25,4,29,1
15884,김의겸(金宜謙),송옥주(宋玉珠),48,65,113,0
15885,김의겸(金宜謙),송재호(宋在祜),53,61,114,0
15886,김의겸(金宜謙),신동근(申東根),43,37,80,0
15887,김의겸(金宜謙),신영대(申榮大),43,34,77,0
15888,김의겸(金宜謙),신원식(申源湜),25,4,29,1
15889,김의겸(金宜謙),신정훈(辛正勳),56,99,155,0
15890,김의겸(金宜謙),신현영(申賢榮),42,41,83,0
15891,김의겸(金宜謙),심상정(沈相奵),9,33,42,1
15892,김의겸(金宜謙),안규백(安圭伯),46,44,90,0
15893,김의겸(金宜謙),안민석(安敏錫),47,74,121,0
15894,김의겸(金宜謙),안병길(安炳吉),25,4,29,1
15895,김의겸(金宜謙),안철수(安哲秀),25,4,29,1
15896,김의겸(金宜謙),안호영(安浩永),44,59,103,0
15897,김의겸(金宜謙),양경숙(梁敬淑),47,59,106,0
15898,김의겸(金宜謙),양금희(梁琴喜),25,8,33,1
15899,김의겸(金宜謙),양기대(梁基大),48,60,108,0
15900,김의겸(金宜謙),양이원영(梁李媛瑛),48,74,122,0
15901,김의겸(金宜謙),양정숙(梁貞淑),13,104,117,1
15902,김의겸(金宜謙),양향자(梁香子),2,19,21,1
15903,김의겸(金宜謙),어기구(魚基龜),42,51,93,0
15904,김의겸(金宜謙),엄태영(嚴泰永),25,7,32,1
15905,김의겸(金宜謙),오기형(吳奇炯),43,29,72,0
15906,김의겸(金宜謙),오영환(吳永煥),52,74,126,0
15907,김의겸(金宜謙),용혜인(龍慧仁),12,54,66,1
15908,김의겸(金宜謙),우상호(禹相虎),41,32,73,0
15909,김의겸(金宜謙),우원식(禹元植),44,57,101,0
15910,김의겸(金宜謙),위성곤(魏聖坤),46,54,100,0
15911,김의겸(金宜謙),유경준(兪京濬),26,8,34,1
15912,김의겸(金宜謙),유기홍(柳基洪),44,43,87,0
15913,김의겸(金宜謙),유동수(柳東秀),44,33,77,0
15914,김의겸(金宜謙),유상범(劉相凡),26,5,31,1
15915,김의겸(金宜謙),유의동(兪義東),25,4,29,1
15916,김의겸(金宜謙),유정주(兪訂炷),59,121,180,0
15917,김의겸(金宜謙),윤건영(尹建永),50,78,128,0
15918,김의겸(金宜謙),윤관석(尹官石),32,26,58,1
15919,김의겸(金宜謙),윤두현(尹斗鉉),25,4,29,1
15920,김의겸(金宜謙),윤미향(尹美香),8,95,103,1
15921,김의겸(金宜謙),윤상현(尹相現),25,8,33,1
15922,김의겸(金宜謙),윤영덕(尹永德),48,130,178,0
15923,김의겸(金宜謙),윤영석(尹永碩),25,5,30,1
15924,김의겸(金宜謙),윤영찬(尹永燦),42,33,75,0
15925,김의겸(金宜謙),윤재갑(尹才鉀),48,59,107,0
15926,김의겸(金宜謙),윤재옥(尹在玉),25,5,30,1
15927,김의겸(金宜謙),윤주경(尹柱卿),25,7,32,1
15928,김의겸(金宜謙),윤준병(尹準炳),48,137,185,0
15929,김의겸(金宜謙),윤창현(尹暢賢),25,7,32,1
15930,김의겸(金宜謙),윤한홍(尹漢洪),25,4,29,1
15931,김의겸(金宜謙),윤호중(尹昊重),42,35,77,0
15932,김의겸(金宜謙),윤후덕(尹厚德),41,40,81,0
15933,김의겸(金宜謙),이개호(李介昊),43,48,91,0
15934,김의겸(金宜謙),이달곤(李達坤),26,5,31,1
15935,김의겸(金宜謙),이동주(李東洲),46,86,132,0
15936,김의겸(金宜謙),이만희(李晩熙),25,4,29,1
15937,김의겸(金宜謙),이명수(李明洙),25,13,38,1
15938,김의겸(金宜謙),이병훈(李炳勳),50,64,114,0
15939,김의겸(金宜謙),이상민(李相珉),42,29,71,0
15940,김의겸(金宜謙),이상헌(李相憲),49,44,93,0
15941,김의겸(金宜謙),이성만(李成萬),38,65,103,1
15942,김의겸(金宜謙),이소영(李素永),43,40,83,0
15943,김의겸(金宜謙),이수진(李壽珍),48,122,170,0
15944,김의겸(金宜謙),이수진(李秀眞),54,72,126,0
15945,김의겸(金宜謙),이양수(李亮壽),25,4,29,1
15946,김의겸(金宜謙),이용(李鏞),25,8,33,1
15947,김의겸(金宜謙),이용빈(李龍彬),47,77,124,0
15948,김의겸(金宜謙),이용선(李庸瑄),43,49,92,0
15949,김의겸(金宜謙),이용우(李龍雨),53,62,115,0
15950,김의겸(金宜謙),이용호(李容鎬),27,8,35,1
15951,김의겸(金宜謙),이원욱(李元旭),44,58,102,0
15952,김의겸(金宜謙),이원택(李源澤),54,54,108,0
15953,김의겸(金宜謙),이은주(李恩周),10,28,38,1
15954,김의겸(金宜謙),이인선(李仁善),25,7,32,1
15955,김의겸(金宜謙),이인영(李仁榮),46,48,94,0
15956,김의겸(金宜謙),이장섭(李將燮),46,43,89,0
15957,김의겸(金宜謙),이재명(李在明),39,23,62,0
15958,김의겸(金宜謙),이재정(李在汀),43,33,76,0
15959,김의겸(金宜謙),이정문(李楨文),52,71,123,0
15960,김의겸(金宜謙),이종배(李鍾培),25,7,32,1
15961,김의겸(金宜謙),이종성(李鍾成),25,4,29,1
15962,김의겸(金宜謙),이주환(李周桓),25,4,29,1
15963,김의겸(金宜謙),이채익(李埰益),27,6,33,1
15964,김의겸(金宜謙),이철규(李喆圭),25,4,29,1
15965,김의겸(金宜謙),이탄희(李誕熙),43,64,107,0
15966,김의겸(金宜謙),이태규(李泰珪),25,4,29,1
15967,김의겸(金宜謙),이학영(李學永),49,53,102,0
15968,김의겸(金宜謙),이해식(李海植),45,49,94,0
15969,김의겸(金宜謙),이헌승(李憲昇),25,7,32,1
15970,김의겸(金宜謙),이형석(李炯錫),48,56,104,0
15971,김의겸(金宜謙),인재근(印在謹),51,63,114,0
15972,김의겸(金宜謙),임병헌(林炳憲),25,4,29,1
15973,김의겸(金宜謙),임오경(林五卿),48,57,105,0
15974,김의겸(金宜謙),임이자(林利子),25,4,29,1
15975,김의겸(金宜謙),임종성(林鍾聲),48,64,112,0
15976,김의겸(金宜謙),임호선(林昊宣),52,87,139,0
15977,김의겸(金宜謙),장경태(張耿態),52,88,140,0
15978,김의겸(金宜謙),장동혁(張東赫),25,7,32,1
15979,김의겸(金宜謙),장제원(張濟元),25,4,29,1
15980,김의겸(金宜謙),장철민(張喆敏),47,53,100,0
15981,김의겸(金宜謙),장혜영(張惠英),9,21,30,1
15982,김의겸(金宜謙),전봉민(田奉珉),25,5,30,1
15983,김의겸(金宜謙),전용기(田溶冀),48,49,97,0
15984,김의겸(金宜謙),전재수(田載秀),45,47,92,0
15985,김의겸(金宜謙),전주혜(全珠惠),25,7,32,1
15986,김의겸(金宜謙),전해철(全海澈),41,41,82,0
15987,김의겸(金宜謙),전혜숙(全惠淑),47,47,94,0
15988,김의겸(金宜謙),정경희(丁慶姬),25,4,29,1
15989,김의겸(金宜謙),정동만(鄭東萬),25,4,29,1
15990,김의겸(金宜謙),정성호(鄭成湖),45,61,106,0
15991,김의겸(金宜謙),정우택(鄭宇澤),25,4,29,1
15992,김의겸(金宜謙),정운천(鄭雲天),25,7,32,1
15993,김의겸(金宜謙),정일영(鄭日永),47,64,111,0
15994,김의겸(金宜謙),정점식(鄭点植),25,7,32,1
15995,김의겸(金宜謙),정진석(鄭鎭碩),25,8,33,1
15996,김의겸(金宜謙),정청래(鄭淸來),44,36,80,0
15997,김의겸(金宜謙),정춘숙(鄭春淑),45,39,84,0
15998,김의겸(金宜謙),정태호(鄭泰浩),46,121,167,0
15999,김의겸(金宜謙),정필모(鄭必模),44,64,108,0
16000,김의겸(金宜謙),정희용(鄭熙溶),25,5,30,1
16001,김의겸(金宜謙),조경태(趙慶泰),25,5,30,1
16002,김의겸(金宜謙),조명희(曺明姬),25,4,29,1
16003,김의겸(金宜謙),조수진(趙修眞),25,7,32,1
16004,김의겸(金宜謙),조승래(趙承來),47,40,87,0
16005,김의겸(金宜謙),조오섭(曺五燮),49,103,152,0
16006,김의겸(金宜謙),조은희(趙恩禧),25,4,29,1
16007,김의겸(金宜謙),조응천(趙應天),45,25,70,0
16008,김의겸(金宜謙),조정식(趙正湜),43,35,78,0
16009,김의겸(金宜謙),조정훈(趙廷訓),2,15,17,1
16010,김의겸(金宜謙),조해진(曺海珍),25,6,31,1
16011,김의겸(金宜謙),주철현(朱哲鉉),53,68,121,0
16012,김의겸(金宜謙),주호영(朱豪英),25,4,29,1
16013,김의겸(金宜謙),지성호(池成浩),25,5,30,1
16014,김의겸(金宜謙),진선미(陳善美),42,37,79,0
16015,김의겸(金宜謙),진성준(陳聲準),47,59,106,0
16016,김의겸(金宜謙),천준호(千俊鎬),45,38,83,0
16017,김의겸(金宜謙),최기상(崔基相),49,65,114,0
16018,김의겸(金宜謙),최승재(崔承宰),25,9,34,1
16019,김의겸(金宜謙),최연숙(崔姸淑),27,6,33,1
16020,김의겸(金宜謙),최영희(崔英姬),25,5,30,1
16021,김의겸(金宜謙),최인호(崔仁昊),43,51,94,0
16022,김의겸(金宜謙),최재형(崔在亨),25,4,29,1
16023,김의겸(金宜謙),최종윤(崔鍾允),48,73,121,0
16024,김의겸(金宜謙),최춘식(崔春植),25,5,30,1
16025,김의겸(金宜謙),최형두(崔炯斗),25,6,31,1
16026,김의겸(金宜謙),최혜영(崔惠英),52,89,141,0
16027,김의겸(金宜謙),추경호(秋慶鎬),25,4,29,1
16028,김의겸(金宜謙),태영호(太永浩),25,7,32,1
16029,김의겸(金宜謙),하영제(河榮帝),16,1,17,1
16030,김의겸(金宜謙),하태경(河泰慶),25,8,33,1
16031,김의겸(金宜謙),한기호(韓起鎬),25,5,30,1
16032,김의겸(金宜謙),한무경(韓茂景),25,4,29,1
16033,김의겸(金宜謙),한병도(韓秉道),48,54,102,0
16034,김의겸(金宜謙),한정애(韓貞愛),44,43,87,0
16035,김의겸(金宜謙),한준호(韓俊鎬),47,73,120,0
16036,김의겸(金宜謙),허숙정(許淑湞),1,1,2,0
16037,김의겸(金宜謙),허영(許榮),49,69,118,0
16038,김의겸(金宜謙),허은아(許垠娥),25,4,29,1
16039,김의겸(金宜謙),허종식(許琮植),47,48,95,0
16040,김의겸(金宜謙),홍기원(洪起元),49,62,111,0
16041,김의겸(金宜謙),홍문표(洪文杓),25,7,32,1
16042,김의겸(金宜謙),홍석준(洪碩晙),25,4,29,1
16043,김의겸(金宜謙),홍성국(洪性國),45,70,115,0
16044,김의겸(金宜謙),홍영표(洪永杓),46,42,88,0
16045,김의겸(金宜謙),홍익표(洪翼杓),45,52,97,0
16046,김의겸(金宜謙),홍정민(洪貞敏),49,80,129,0
16047,김의겸(金宜謙),황보승희(皇甫承希),20,1,21,1
16048,김의겸(金宜謙),황운하(黃雲夏),46,108,154,0
16049,김의겸(金宜謙),황희(黃熙),42,32,74,0
16050,김정재(金汀才),김정호(金禎鎬),53,5,58,1
16051,김정재(金汀才),김종민(金鐘民),52,4,56,1
16052,김정재(金汀才),김주영(金周暎),52,5,57,1
16053,김정재(金汀才),김진표(金振杓),27,1,28,1
16054,김정재(金汀才),김철민(金哲玟),52,4,56,1
16055,김정재(金汀才),김태년(金太年),51,5,56,1
16056,김정재(金汀才),김태호(金台鎬),79,71,150,0
16057,김정재(金汀才),김학용(金學容),45,65,110,0
16058,김정재(金汀才),김한규(金翰奎),26,5,31,1
16059,김정재(金汀才),김한정(金漢正),51,5,56,1
16060,김정재(金汀才),김형동(金亨東),99,144,243,0
16061,김정재(金汀才),김홍걸(金弘傑),17,5,22,1
16062,김정재(金汀才),김회재(金會在),53,4,57,1
16063,김정재(金汀才),김희곤(金熙坤),85,99,184,0
16064,김정재(金汀才),김희국(金熙國),94,96,190,0
16065,김정재(金汀才),남인순(南仁順),51,6,57,1
16066,김정재(金汀才),노용호(魯容昊),37,39,76,0
16067,김정재(金汀才),노웅래(盧雄來),51,5,56,1
16068,김정재(金汀才),도종환(都鍾煥),52,5,57,1
16069,김정재(金汀才),류성걸(柳性杰),78,61,139,0
16070,김정재(金汀才),류호정(柳好貞),5,6,11,1
16071,김정재(金汀才),맹성규(孟聖奎),51,6,57,1
16072,김정재(金汀才),문정복(文貞福),50,4,54,1
16073,김정재(金汀才),문진석(文振碩),52,5,57,1
16074,김정재(金汀才),민병덕(閔炳德),52,6,58,1
16075,김정재(金汀才),민형배(閔馨培),35,5,40,1
16076,김정재(金汀才),민홍철(閔洪喆),51,5,56,1
16077,김정재(金汀才),박광온(朴洸瑥),51,5,56,1
16078,김정재(金汀才),박대수(朴大壽),119,160,279,0
16079,김정재(金汀才),박대출(朴大出),82,100,182,0
16080,김정재(金汀才),박덕흠(朴德欽),108,185,293,0
16081,김정재(金汀才),박범계(朴範界),51,4,55,1
16082,김정재(金汀才),박병석(朴炳錫),26,4,30,1
16083,김정재(金汀才),박상혁(朴商赫),52,5,57,1
16084,김정재(金汀才),박성민(朴聖敏),99,139,238,0
16085,김정재(金汀才),박성준(朴省俊),51,6,57,1
16086,김정재(金汀才),박성중(朴成重),80,85,165,0
16087,김정재(金汀才),박수영(朴洙瑩),70,55,125,0
16088,김정재(金汀才),박영순(朴英淳),52,5,57,1
16089,김정재(金汀才),박완주(朴完柱),26,0,26,1
16090,김정재(金汀才),박용진(朴用鎭),50,5,55,1
16091,김정재(金汀才),박재호(朴在昊),52,5,57,1
16092,김정재(金汀才),박정(朴釘),51,6,57,1
16093,김정재(金汀才),박정하(朴正河),40,52,92,0
16094,김정재(金汀才),박주민(朴柱民),51,5,56,1
16095,김정재(金汀才),박진(朴振),79,83,162,0
16096,김정재(金汀才),박찬대(朴贊大),51,5,56,1
16097,김정재(金汀才),박형수(朴亨修),71,58,129,0
16098,김정재(金汀才),박홍근(朴洪根),52,4,56,1
16099,김정재(金汀才),배준영(裵俊英),90,99,189,0
16100,김정재(金汀才),배진교(裵晋敎),6,3,9,1
16101,김정재(金汀才),배현진(裵賢鎭),78,60,138,0
16102,김정재(金汀才),백종헌(白宗憲),80,89,169,0
16103,김정재(金汀才),백혜련(白惠蓮),51,5,56,1
16104,김정재(金汀才),변재일(卞在一),51,5,56,1
16105,김정재(金汀才),서동용(徐東榕),51,5,56,1
16106,김정재(金汀才),서범수(徐範洙),84,89,173,0
16107,김정재(金汀才),서병수(徐秉洙),96,97,193,0
16108,김정재(金汀才),서삼석(徐參錫),50,5,55,1
16109,김정재(金汀才),서영교(徐瑛敎),52,5,57,1
16110,김정재(金汀才),서영석(徐暎錫),51,5,56,1
16111,김정재(金汀才),서일준(徐一俊),146,231,377,0
16112,김정재(金汀才),서정숙(徐正淑),85,84,169,0
16113,김정재(金汀才),설훈(薛勳),53,7,60,1
16114,김정재(金汀才),성일종(成一鍾),121,186,307,0
16115,김정재(金汀才),소병철(蘇秉哲),52,5,57,1
16116,김정재(金汀才),소병훈(蘇秉勳),53,5,58,1
16117,김정재(金汀才),송갑석(宋甲錫),51,5,56,1
16118,김정재(金汀才),송기헌(宋基憲),53,5,58,1
16119,김정재(金汀才),송석준(宋錫俊),93,98,191,0
16120,김정재(金汀才),송언석(宋彦錫),143,222,365,0
16121,김정재(金汀才),송옥주(宋玉珠),51,4,55,1
16122,김정재(金汀才),송재호(宋在祜),51,6,57,1
16123,김정재(金汀才),신동근(申東根),51,4,55,1
16124,김정재(金汀才),신영대(申榮大),51,7,58,1
16125,김정재(金汀才),신원식(申源湜),83,73,156,0
16126,김정재(金汀才),신정훈(辛正勳),54,5,59,1
16127,김정재(金汀才),신현영(申賢榮),50,5,55,1
16128,김정재(金汀才),심상정(沈相奵),6,3,9,1
16129,김정재(金汀才),안규백(安圭伯),53,6,59,1
16130,김정재(金汀才),안민석(安敏錫),52,4,56,1
16131,김정재(金汀才),안병길(安炳吉),89,106,195,0
16132,김정재(金汀才),안철수(安哲秀),27,18,45,0
16133,김정재(金汀才),안호영(安浩永),51,5,56,1
16134,김정재(金汀才),양경숙(梁敬淑),51,5,56,1
16135,김정재(金汀才),양금희(梁琴喜),140,174,314,0
16136,김정재(金汀才),양기대(梁基大),51,5,56,1
16137,김정재(金汀才),양이원영(梁李媛瑛),46,5,51,1
16138,김정재(金汀才),양정숙(梁貞淑),6,5,11,1
16139,김정재(金汀才),양향자(梁香子),22,4,26,1
16140,김정재(金汀才),어기구(魚基龜),52,7,59,1
16141,김정재(金汀才),엄태영(嚴泰永),91,94,185,0
16142,김정재(金汀才),오기형(吳奇炯),49,4,53,1
16143,김정재(金汀才),오영환(吳永煥),51,5,56,1
16144,김정재(金汀才),용혜인(龍慧仁),2,7,9,1
16145,김정재(金汀才),우상호(禹相虎),50,4,54,1
16146,김정재(金汀才),우원식(禹元植),50,5,55,1
16147,김정재(金汀才),위성곤(魏聖坤),51,7,58,1
16148,김정재(金汀才),유경준(兪京濬),97,130,227,0
16149,김정재(金汀才),유기홍(柳基洪),52,5,57,1
16150,김정재(金汀才),유동수(柳東秀),54,12,66,1
16151,김정재(金汀才),유상범(劉相凡),76,77,153,0
16152,김정재(金汀才),유의동(兪義東),77,60,137,0
16153,김정재(金汀才),유정주(兪訂炷),50,5,55,1
16154,김정재(金汀才),윤건영(尹建永),50,4,54,1
16155,김정재(金汀才),윤관석(尹官石),42,1,43,1
16156,김정재(金汀才),윤두현(尹斗鉉),104,123,227,0
16157,김정재(金汀才),윤미향(尹美香),20,0,20,1
16158,김정재(金汀才),윤상현(尹相現),47,46,93,0
16159,김정재(金汀才),윤영덕(尹永德),50,5,55,1
16160,김정재(金汀才),윤영석(尹永碩),76,68,144,0
16161,김정재(金汀才),윤영찬(尹永燦),50,5,55,1
16162,김정재(金汀才),윤재갑(尹才鉀),52,6,58,1
16163,김정재(金汀才),윤재옥(尹在玉),82,56,138,0
16164,김정재(金汀才),윤주경(尹柱卿),77,78,155,0
16165,김정재(金汀才),윤준병(尹準炳),51,5,56,1
16166,김정재(金汀才),윤창현(尹暢賢),122,129,251,0
16167,김정재(金汀才),윤한홍(尹漢洪),80,84,164,0
16168,김정재(金汀才),윤호중(尹昊重),52,5,57,1
16169,김정재(金汀才),윤후덕(尹厚德),51,6,57,1
16170,김정재(金汀才),이개호(李介昊),51,6,57,1
16171,김정재(金汀才),이달곤(李達坤),69,57,126,0
16172,김정재(金汀才),이동주(李東洲),50,5,55,1
16173,김정재(金汀才),이만희(李晩熙),84,72,156,0
16174,김정재(金汀才),이명수(李明洙),119,117,236,0
16175,김정재(金汀才),이병훈(李炳勳),55,6,61,1
16176,김정재(金汀才),이상민(李相珉),51,5,56,1
16177,김정재(金汀才),이상헌(李相憲),53,6,59,1
16178,김정재(金汀才),이성만(李成萬),42,1,43,1
16179,김정재(金汀才),이소영(李素永),51,5,56,1
16180,김정재(金汀才),이수진(李壽珍),52,8,60,1
16181,김정재(金汀才),이수진(李秀眞),51,5,56,1
16182,김정재(金汀才),이양수(李亮壽),111,114,225,0
16183,김정재(金汀才),이용(李鏞),106,148,254,0
16184,김정재(金汀才),이용빈(李龍彬),53,6,59,1
16185,김정재(金汀才),이용선(李庸瑄),52,5,57,1
16186,김정재(金汀才),이용우(李龍雨),50,8,58,1
16187,김정재(金汀才),이용호(李容鎬),34,31,65,0
16188,김정재(金汀才),이원욱(李元旭),53,7,60,1
16189,김정재(金汀才),이원택(李源澤),50,4,54,1
16190,김정재(金汀才),이은주(李恩周),6,3,9,1
16191,김정재(金汀才),이인선(李仁善),30,26,56,0
16192,김정재(金汀才),이인영(李仁榮),51,5,56,1
16193,김정재(金汀才),이장섭(李將燮),51,5,56,1
16194,김정재(金汀才),이재명(李在明),26,5,31,1
16195,김정재(金汀才),이재정(李在汀),51,5,56,1
16196,김정재(金汀才),이정문(李楨文),51,5,56,1
16197,김정재(金汀才),이종배(李鍾培),140,197,337,0
16198,김정재(金汀才),이종성(李鍾成),121,142,263,0
16199,김정재(金汀才),이주환(李周桓),129,198,327,0
16200,김정재(金汀才),이채익(李埰益),80,101,181,0
16201,김정재(金汀才),이철규(李喆圭),100,84,184,0
16202,김정재(金汀才),이탄희(李誕熙),51,5,56,1
16203,김정재(金汀才),이태규(李泰珪),48,76,124,0
16204,김정재(金汀才),이학영(李學永),50,5,55,1
16205,김정재(金汀才),이해식(李海植),53,5,58,1
16206,김정재(金汀才),이헌승(李憲昇),84,86,170,0
16207,김정재(金汀才),이형석(李炯錫),50,5,55,1
16208,김정재(金汀才),인재근(印在謹),51,7,58,1
16209,김정재(金汀才),임병헌(林炳憲),34,32,66,0
16210,김정재(金汀才),임오경(林五卿),51,5,56,1
16211,김정재(金汀才),임이자(林利子),137,191,328,0
16212,김정재(金汀才),임종성(林鍾聲),54,5,59,1
16213,김정재(金汀才),임호선(林昊宣),51,5,56,1
16214,김정재(金汀才),장경태(張耿態),51,5,56,1
16215,김정재(金汀才),장동혁(張東赫),32,30,62,0
16216,김정재(金汀才),장제원(張濟元),71,58,129,0
16217,김정재(金汀才),장철민(張喆敏),51,5,56,1
16218,김정재(金汀才),장혜영(張惠英),8,6,14,1
16219,김정재(金汀才),전봉민(田奉珉),57,73,130,0
16220,김정재(金汀才),전용기(田溶冀),50,4,54,1
16221,김정재(金汀才),전재수(田載秀),50,4,54,1
16222,김정재(金汀才),전주혜(全珠惠),98,131,229,0
16223,김정재(金汀才),전해철(全海澈),52,5,57,1
16224,김정재(金汀才),전혜숙(全惠淑),51,5,56,1
16225,김정재(金汀才),정경희(丁慶姬),79,70,149,0
16226,김정재(金汀才),정동만(鄭東萬),87,100,187,0
16227,김정재(金汀才),정성호(鄭成湖),52,5,57,1
16228,김정재(金汀才),정우택(鄭宇澤),36,38,74,0
16229,김정재(金汀才),정운천(鄭雲天),105,109,214,0
16230,김정재(金汀才),정일영(鄭日永),50,5,55,1
16231,김정재(金汀才),정점식(鄭点植),74,65,139,0
16232,김정재(金汀才),정진석(鄭鎭碩),106,149,255,0
16233,김정재(金汀才),정청래(鄭淸來),50,5,55,1
16234,김정재(金汀才),정춘숙(鄭春淑),51,5,56,1
16235,김정재(金汀才),정태호(鄭泰浩),51,5,56,1
16236,김정재(金汀才),정필모(鄭必模),51,5,56,1
16237,김정재(金汀才),정희용(鄭熙溶),121,170,291,0
16238,김정재(金汀才),조경태(趙慶泰),86,86,172,0
16239,김정재(金汀才),조명희(曺明姬),101,133,234,0
16240,김정재(金汀才),조수진(趙修眞),103,125,228,0
16241,김정재(金汀才),조승래(趙承來),51,7,58,1
16242,김정재(金汀才),조오섭(曺五燮),52,9,61,1
16243,김정재(金汀才),조은희(趙恩禧),35,35,70,0
16244,김정재(金汀才),조응천(趙應天),50,3,53,1
16245,김정재(金汀才),조정식(趙正湜),50,4,54,1
16246,김정재(金汀才),조정훈(趙廷訓),4,12,16,1
16247,김정재(金汀才),조해진(曺海珍),71,46,117,0
16248,김정재(金汀才),주철현(朱哲鉉),52,6,58,1
16249,김정재(金汀才),주호영(朱豪英),73,62,135,0
16250,김정재(金汀才),지성호(池成浩),114,135,249,0
16251,김정재(金汀才),진선미(陳善美),51,5,56,1
16252,김정재(金汀才),진성준(陳聲準),51,5,56,1
16253,김정재(金汀才),천준호(千俊鎬),50,4,54,1
16254,김정재(金汀才),최기상(崔基相),50,5,55,1
16255,김정재(金汀才),최승재(崔承宰),112,116,228,0
16256,김정재(金汀才),최연숙(崔姸淑),44,60,104,0
16257,김정재(金汀才),최영희(崔英姬),43,29,72,0
16258,김정재(金汀才),최인호(崔仁昊),53,5,58,1
16259,김정재(金汀才),최재형(崔在亨),29,11,40,0
16260,김정재(金汀才),최종윤(崔鍾允),51,5,56,1
16261,김정재(金汀才),최춘식(崔春植),83,92,175,0
16262,김정재(金汀才),최형두(崔炯斗),99,107,206,0
16263,김정재(金汀才),최혜영(崔惠英),51,5,56,1
16264,김정재(金汀才),추경호(秋慶鎬),154,214,368,0
16265,김정재(金汀才),태영호(太永浩),142,259,401,0
16266,김정재(金汀才),하영제(河榮帝),78,93,171,1
16267,김정재(金汀才),하태경(河泰慶),74,50,124,0
16268,김정재(金汀才),한기호(韓起鎬),75,72,147,0
16269,김정재(金汀才),한무경(韓茂景),139,214,353,0
16270,김정재(金汀才),한병도(韓秉道),51,5,56,1
16271,김정재(金汀才),한정애(韓貞愛),51,5,56,1
16272,김정재(金汀才),한준호(韓俊鎬),52,5,57,1
16273,김정재(金汀才),허숙정(許淑湞),0,0,0,1
16274,김정재(金汀才),허영(許榮),53,5,58,1
16275,김정재(金汀才),허은아(許垠娥),97,121,218,0
16276,김정재(金汀才),허종식(許琮植),51,9,60,1
16277,김정재(金汀才),홍기원(洪起元),52,5,57,1
16278,김정재(金汀才),홍문표(洪文杓),80,75,155,0
16279,김정재(金汀才),홍석준(洪碩晙),85,79,164,0
16280,김정재(金汀才),홍성국(洪性國),51,5,56,1
16281,김정재(金汀才),홍영표(洪永杓),51,5,56,1
16282,김정재(金汀才),홍익표(洪翼杓),51,5,56,1
16283,김정재(金汀才),홍정민(洪貞敏),51,5,56,1
16284,김정재(金汀才),황보승희(皇甫承希),84,121,205,1
16285,김정재(金汀才),황운하(黃雲夏),52,5,57,1
16286,김정재(金汀才),황희(黃熙),50,6,56,1
16287,김정호(金禎鎬),김종민(金鐘民),98,138,236,0
16288,김정호(金禎鎬),김주영(金周暎),150,298,448,0
16289,김정호(金禎鎬),김진표(金振杓),66,85,151,1
16290,김정호(金禎鎬),김철민(金哲玟),171,276,447,0
16291,김정호(金禎鎬),김태년(金太年),97,100,197,0
16292,김정호(金禎鎬),김태호(金台鎬),42,8,50,1
16293,김정호(金禎鎬),김학용(金學容),25,5,30,1
16294,김정호(金禎鎬),김한규(金翰奎),44,78,122,0
16295,김정호(金禎鎬),김한정(金漢正),83,76,159,0
16296,김정호(金禎鎬),김형동(金亨東),52,14,66,1
16297,김정호(金禎鎬),김홍걸(金弘傑),79,252,331,0
16298,김정호(金禎鎬),김회재(金會在),115,158,273,0
16299,김정호(金禎鎬),김희곤(金熙坤),50,9,59,1
16300,김정호(金禎鎬),김희국(金熙國),49,4,53,1
16301,김정호(金禎鎬),남인순(南仁順),103,155,258,0
16302,김정호(金禎鎬),노용호(魯容昊),25,5,30,1
16303,김정호(金禎鎬),노웅래(盧雄來),106,169,275,0
16304,김정호(金禎鎬),도종환(都鍾煥),116,156,272,0
16305,김정호(金禎鎬),류성걸(柳性杰),49,4,53,1
16306,김정호(金禎鎬),류호정(柳好貞),23,86,109,1
16307,김정호(金禎鎬),맹성규(孟聖奎),113,109,222,0
16308,김정호(金禎鎬),문정복(文貞福),99,147,246,0
16309,김정호(金禎鎬),문진석(文振碩),131,180,311,0
16310,김정호(金禎鎬),민병덕(閔炳德),108,296,404,0
16311,김정호(金禎鎬),민형배(閔馨培),155,382,537,0
16312,김정호(金禎鎬),민홍철(閔洪喆),104,189,293,0
16313,김정호(金禎鎬),박광온(朴洸瑥),99,112,211,0
16314,김정호(金禎鎬),박대수(朴大壽),50,11,61,1
16315,김정호(金禎鎬),박대출(朴大出),51,6,57,1
16316,김정호(金禎鎬),박덕흠(朴德欽),37,7,44,1
16317,김정호(金禎鎬),박범계(朴範界),76,41,117,0
16318,김정호(金禎鎬),박병석(朴炳錫),41,19,60,0
16319,김정호(金禎鎬),박상혁(朴商赫),153,448,601,0
16320,김정호(金禎鎬),박성민(朴聖敏),54,13,67,1
16321,김정호(金禎鎬),박성준(朴省俊),118,178,296,0
16322,김정호(金禎鎬),박성중(朴成重),49,4,53,1
16323,김정호(金禎鎬),박수영(朴洙瑩),51,16,67,1
16324,김정호(金禎鎬),박영순(朴英淳),112,141,253,0
16325,김정호(金禎鎬),박완주(朴完柱),54,74,128,1
16326,김정호(金禎鎬),박용진(朴用鎭),99,131,230,0
16327,김정호(金禎鎬),박재호(朴在昊),160,222,382,0
16328,김정호(金禎鎬),박정(朴釘),145,254,399,0
16329,김정호(金禎鎬),박정하(朴正河),25,4,29,1
16330,김정호(金禎鎬),박주민(朴柱民),85,121,206,0
16331,김정호(金禎鎬),박진(朴振),52,6,58,1
16332,김정호(金禎鎬),박찬대(朴贊大),115,153,268,0
16333,김정호(金禎鎬),박형수(朴亨修),49,4,53,1
16334,김정호(金禎鎬),박홍근(朴洪根),143,188,331,0
16335,김정호(金禎鎬),배준영(裵俊英),51,13,64,1
16336,김정호(金禎鎬),배진교(裵晋敎),28,71,99,1
16337,김정호(金禎鎬),배현진(裵賢鎭),50,5,55,1
16338,김정호(金禎鎬),백종헌(白宗憲),50,4,54,1
16339,김정호(金禎鎬),백혜련(白惠蓮),105,117,222,0
16340,김정호(金禎鎬),변재일(卞在一),86,80,166,0
16341,김정호(金禎鎬),서동용(徐東榕),148,279,427,0
16342,김정호(金禎鎬),서범수(徐範洙),51,6,57,1
16343,김정호(金禎鎬),서병수(徐秉洙),51,4,55,1
16344,김정호(金禎鎬),서삼석(徐參錫),153,200,353,0
16345,김정호(金禎鎬),서영교(徐瑛敎),112,231,343,0
16346,김정호(金禎鎬),서영석(徐暎錫),112,164,276,0
16347,김정호(金禎鎬),서일준(徐一俊),51,13,64,1
16348,김정호(金禎鎬),서정숙(徐正淑),49,7,56,1
16349,김정호(金禎鎬),설훈(薛勳),88,89,177,0
16350,김정호(金禎鎬),성일종(成一鍾),50,8,58,1
16351,김정호(金禎鎬),소병철(蘇秉哲),103,137,240,0
16352,김정호(金禎鎬),소병훈(蘇秉勳),120,159,279,0
16353,김정호(金禎鎬),송갑석(宋甲錫),136,234,370,0
16354,김정호(金禎鎬),송기헌(宋基憲),95,102,197,0
16355,김정호(金禎鎬),송석준(宋錫俊),51,8,59,1
16356,김정호(金禎鎬),송언석(宋彦錫),47,6,53,1
16357,김정호(金禎鎬),송옥주(宋玉珠),127,212,339,0
16358,김정호(金禎鎬),송재호(宋在祜),114,188,302,0
16359,김정호(金禎鎬),신동근(申東根),128,138,266,0
16360,김정호(金禎鎬),신영대(申榮大),110,158,268,0
16361,김정호(金禎鎬),신원식(申源湜),49,12,61,1
16362,김정호(金禎鎬),신정훈(辛正勳),218,412,630,0
16363,김정호(金禎鎬),신현영(申賢榮),115,115,230,0
16364,김정호(金禎鎬),심상정(沈相奵),19,66,85,1
16365,김정호(金禎鎬),안규백(安圭伯),118,124,242,0
16366,김정호(金禎鎬),안민석(安敏錫),112,154,266,0
16367,김정호(金禎鎬),안병길(安炳吉),50,7,57,1
16368,김정호(金禎鎬),안철수(安哲秀),25,5,30,1
16369,김정호(金禎鎬),안호영(安浩永),105,176,281,0
16370,김정호(金禎鎬),양경숙(梁敬淑),115,231,346,0
16371,김정호(金禎鎬),양금희(梁琴喜),50,6,56,1
16372,김정호(金禎鎬),양기대(梁基大),99,118,217,0
16373,김정호(金禎鎬),양이원영(梁李媛瑛),120,203,323,0
16374,김정호(金禎鎬),양정숙(梁貞淑),90,291,381,1
16375,김정호(金禎鎬),양향자(梁香子),64,109,173,1
16376,김정호(金禎鎬),어기구(魚基龜),143,266,409,0
16377,김정호(金禎鎬),엄태영(嚴泰永),50,7,57,1
16378,김정호(金禎鎬),오기형(吳奇炯),85,52,137,0
16379,김정호(金禎鎬),오영환(吳永煥),174,389,563,0
16380,김정호(金禎鎬),용혜인(龍慧仁),31,116,147,1
16381,김정호(金禎鎬),우상호(禹相虎),80,55,135,0
16382,김정호(金禎鎬),우원식(禹元植),115,166,281,0
16383,김정호(金禎鎬),위성곤(魏聖坤),151,316,467,0
16384,김정호(金禎鎬),유경준(兪京濬),49,4,53,1
16385,김정호(金禎鎬),유기홍(柳基洪),97,109,206,0
16386,김정호(金禎鎬),유동수(柳東秀),112,117,229,0
16387,김정호(金禎鎬),유상범(劉相凡),50,4,54,1
16388,김정호(金禎鎬),유의동(兪義東),49,5,54,1
16389,김정호(金禎鎬),유정주(兪訂炷),144,282,426,0
16390,김정호(金禎鎬),윤건영(尹建永),109,136,245,0
16391,김정호(金禎鎬),윤관석(尹官石),107,141,248,1
16392,김정호(金禎鎬),윤두현(尹斗鉉),49,6,55,1
16393,김정호(金禎鎬),윤미향(尹美香),65,175,240,1
16394,김정호(金禎鎬),윤상현(尹相現),32,10,42,1
16395,김정호(金禎鎬),윤영덕(尹永德),114,243,357,0
16396,김정호(金禎鎬),윤영석(尹永碩),52,9,61,1
16397,김정호(金禎鎬),윤영찬(尹永燦),94,102,196,0
16398,김정호(金禎鎬),윤재갑(尹才鉀),158,255,413,0
16399,김정호(金禎鎬),윤재옥(尹在玉),49,4,53,1
16400,김정호(金禎鎬),윤주경(尹柱卿),50,6,56,1
16401,김정호(金禎鎬),윤준병(尹準炳),166,368,534,0
16402,김정호(金禎鎬),윤창현(尹暢賢),49,7,56,1
16403,김정호(金禎鎬),윤한홍(尹漢洪),51,5,56,1
16404,김정호(金禎鎬),윤호중(尹昊重),81,83,164,0
16405,김정호(金禎鎬),윤후덕(尹厚德),191,353,544,0
16406,김정호(金禎鎬),이개호(李介昊),115,202,317,0
16407,김정호(金禎鎬),이달곤(李達坤),53,10,63,1
16408,김정호(金禎鎬),이동주(李東洲),152,385,537,0
16409,김정호(金禎鎬),이만희(李晩熙),50,4,54,1
16410,김정호(金禎鎬),이명수(李明洙),51,23,74,1
16411,김정호(金禎鎬),이병훈(李炳勳),150,281,431,0
16412,김정호(金禎鎬),이상민(李相珉),76,58,134,0
16413,김정호(金禎鎬),이상헌(李相憲),137,219,356,0
16414,김정호(金禎鎬),이성만(李成萬),117,213,330,1
16415,김정호(金禎鎬),이소영(李素永),102,123,225,0
16416,김정호(金禎鎬),이수진(李壽珍),137,278,415,0
16417,김정호(金禎鎬),이수진(李秀眞),128,164,292,0
16418,김정호(金禎鎬),이양수(李亮壽),52,6,58,1
16419,김정호(金禎鎬),이용(李鏞),49,4,53,1
16420,김정호(金禎鎬),이용빈(李龍彬),154,285,439,0
16421,김정호(金禎鎬),이용선(李庸瑄),126,197,323,0
16422,김정호(金禎鎬),이용우(李龍雨),123,144,267,0
16423,김정호(金禎鎬),이용호(李容鎬),40,43,83,1
16424,김정호(金禎鎬),이원욱(李元旭),114,198,312,0
16425,김정호(金禎鎬),이원택(李源澤),131,145,276,0
16426,김정호(金禎鎬),이은주(李恩周),23,57,80,1
16427,김정호(金禎鎬),이인선(李仁善),25,4,29,1
16428,김정호(金禎鎬),이인영(李仁榮),78,80,158,0
16429,김정호(金禎鎬),이장섭(李將燮),114,155,269,0
16430,김정호(金禎鎬),이재명(李在明),40,23,63,0
16431,김정호(金禎鎬),이재정(李在汀),85,89,174,0
16432,김정호(金禎鎬),이정문(李楨文),128,180,308,0
16433,김정호(金禎鎬),이종배(李鍾培),52,8,60,1
16434,김정호(金禎鎬),이종성(李鍾成),49,6,55,1
16435,김정호(金禎鎬),이주환(李周桓),51,7,58,1
16436,김정호(金禎鎬),이채익(李埰益),52,9,61,1
16437,김정호(金禎鎬),이철규(李喆圭),51,5,56,1
16438,김정호(金禎鎬),이탄희(李誕熙),99,128,227,0
16439,김정호(金禎鎬),이태규(李泰珪),28,6,34,1
16440,김정호(金禎鎬),이학영(李學永),122,236,358,0
16441,김정호(金禎鎬),이해식(李海植),126,173,299,0
16442,김정호(金禎鎬),이헌승(李憲昇),54,5,59,1
16443,김정호(金禎鎬),이형석(李炯錫),110,193,303,0
16444,김정호(金禎鎬),인재근(印在謹),116,182,298,0
16445,김정호(金禎鎬),임병헌(林炳憲),25,5,30,1
16446,김정호(金禎鎬),임오경(林五卿),115,163,278,0
16447,김정호(金禎鎬),임이자(林利子),49,4,53,1
16448,김정호(金禎鎬),임종성(林鍾聲),162,323,485,0
16449,김정호(金禎鎬),임호선(林昊宣),142,283,425,0
16450,김정호(金禎鎬),장경태(張耿態),118,207,325,0
16451,김정호(金禎鎬),장동혁(張東赫),25,4,29,1
16452,김정호(金禎鎬),장제원(張濟元),49,5,54,1
16453,김정호(金禎鎬),장철민(張喆敏),110,196,306,0
16454,김정호(金禎鎬),장혜영(張惠英),13,41,54,1
16455,김정호(金禎鎬),전봉민(田奉珉),35,5,40,1
16456,김정호(金禎鎬),전용기(田溶冀),128,201,329,0
16457,김정호(金禎鎬),전재수(田載秀),140,263,403,0
16458,김정호(金禎鎬),전주혜(全珠惠),51,5,56,1
16459,김정호(金禎鎬),전해철(全海澈),77,92,169,0
16460,김정호(金禎鎬),전혜숙(全惠淑),111,177,288,0
16461,김정호(金禎鎬),정경희(丁慶姬),49,4,53,1
16462,김정호(金禎鎬),정동만(鄭東萬),51,5,56,1
16463,김정호(金禎鎬),정성호(鄭成湖),128,271,399,0
16464,김정호(金禎鎬),정우택(鄭宇澤),25,5,30,1
16465,김정호(金禎鎬),정운천(鄭雲天),49,7,56,1
16466,김정호(金禎鎬),정일영(鄭日永),132,237,369,0
16467,김정호(金禎鎬),정점식(鄭点植),51,6,57,1
16468,김정호(金禎鎬),정진석(鄭鎭碩),50,7,57,1
16469,김정호(金禎鎬),정청래(鄭淸來),90,73,163,0
16470,김정호(金禎鎬),정춘숙(鄭春淑),165,286,451,0
16471,김정호(金禎鎬),정태호(鄭泰浩),107,173,280,0
16472,김정호(金禎鎬),정필모(鄭必模),110,145,255,0
16473,김정호(金禎鎬),정희용(鄭熙溶),51,8,59,1
16474,김정호(金禎鎬),조경태(趙慶泰),49,8,57,1
16475,김정호(金禎鎬),조명희(曺明姬),51,13,64,1
16476,김정호(金禎鎬),조수진(趙修眞),50,4,54,1
16477,김정호(金禎鎬),조승래(趙承來),109,118,227,0
16478,김정호(金禎鎬),조오섭(曺五燮),113,319,432,0
16479,김정호(金禎鎬),조은희(趙恩禧),25,7,32,1
16480,김정호(金禎鎬),조응천(趙應天),87,69,156,0
16481,김정호(金禎鎬),조정식(趙正湜),91,75,166,0
16482,김정호(金禎鎬),조정훈(趙廷訓),10,31,41,1
16483,김정호(金禎鎬),조해진(曺海珍),51,6,57,1
16484,김정호(金禎鎬),주철현(朱哲鉉),112,202,314,0
16485,김정호(金禎鎬),주호영(朱豪英),49,4,53,1
16486,김정호(金禎鎬),지성호(池成浩),49,4,53,1
16487,김정호(金禎鎬),진선미(陳善美),85,71,156,0
16488,김정호(金禎鎬),진성준(陳聲準),128,210,338,0
16489,김정호(金禎鎬),천준호(千俊鎬),106,121,227,0
16490,김정호(金禎鎬),최기상(崔基相),102,162,264,0
16491,김정호(金禎鎬),최승재(崔承宰),49,9,58,1
16492,김정호(金禎鎬),최연숙(崔姸淑),30,28,58,1
16493,김정호(金禎鎬),최영희(崔英姬),25,5,30,1
16494,김정호(金禎鎬),최인호(崔仁昊),168,245,413,0
16495,김정호(金禎鎬),최재형(崔在亨),25,5,30,1
16496,김정호(金禎鎬),최종윤(崔鍾允),121,229,350,0
16497,김정호(金禎鎬),최춘식(崔春植),49,14,63,1
16498,김정호(金禎鎬),최형두(崔炯斗),51,9,60,1
16499,김정호(金禎鎬),최혜영(崔惠英),105,219,324,0
16500,김정호(金禎鎬),추경호(秋慶鎬),49,4,53,1
16501,김정호(金禎鎬),태영호(太永浩),49,7,56,1
16502,김정호(金禎鎬),하영제(河榮帝),44,7,51,1
16503,김정호(金禎鎬),하태경(河泰慶),50,6,56,1
16504,김정호(金禎鎬),한기호(韓起鎬),50,4,54,1
16505,김정호(金禎鎬),한무경(韓茂景),49,6,55,1
16506,김정호(金禎鎬),한병도(韓秉道),138,225,363,0
16507,김정호(金禎鎬),한정애(韓貞愛),84,112,196,0
16508,김정호(金禎鎬),한준호(韓俊鎬),122,228,350,0
16509,김정호(金禎鎬),허숙정(許淑湞),1,2,3,0
16510,김정호(金禎鎬),허영(許榮),170,295,465,0
16511,김정호(金禎鎬),허은아(許垠娥),49,7,56,1
16512,김정호(金禎鎬),허종식(許琮植),139,327,466,0
16513,김정호(金禎鎬),홍기원(洪起元),119,195,314,0
16514,김정호(金禎鎬),홍문표(洪文杓),51,17,68,1
16515,김정호(金禎鎬),홍석준(洪碩晙),50,5,55,1
16516,김정호(金禎鎬),홍성국(洪性國),136,216,352,0
16517,김정호(金禎鎬),홍영표(洪永杓),95,90,185,0
16518,김정호(金禎鎬),홍익표(洪翼杓),101,105,206,0
16519,김정호(金禎鎬),홍정민(洪貞敏),151,207,358,0
16520,김정호(金禎鎬),황보승희(皇甫承希),46,2,48,1
16521,김정호(金禎鎬),황운하(黃雲夏),130,212,342,0
16522,김정호(金禎鎬),황희(黃熙),80,94,174,0
16523,김종민(金鐘民),김주영(金周暎),87,104,191,0
16524,김종민(金鐘民),김진표(金振杓),60,52,112,1
16525,김종민(金鐘民),김철민(金哲玟),100,86,186,0
16526,김종민(金鐘民),김태년(金太年),75,59,134,0
16527,김종민(金鐘民),김태호(金台鎬),41,9,50,1
16528,김종민(金鐘民),김학용(金學容),25,5,30,1
16529,김종민(金鐘民),김한규(金翰奎),39,76,115,0
16530,김종민(金鐘民),김한정(金漢正),77,48,125,0
16531,김종민(金鐘民),김형동(金亨東),54,10,64,1
16532,김종민(金鐘民),김홍걸(金弘傑),35,106,141,0
16533,김종민(金鐘民),김회재(金會在),88,61,149,0
16534,김종민(金鐘民),김희곤(金熙坤),50,13,63,1
16535,김종민(金鐘民),김희국(金熙國),49,4,53,1
16536,김종민(金鐘民),남인순(南仁順),88,78,166,0
16537,김종민(金鐘民),노용호(魯容昊),25,10,35,1
16538,김종민(金鐘民),노웅래(盧雄來),87,62,149,0
16539,김종민(金鐘民),도종환(都鍾煥),93,61,154,0
16540,김종민(金鐘民),류성걸(柳性杰),49,5,54,1
16541,김종민(金鐘民),류호정(柳好貞),15,36,51,1
16542,김종민(金鐘民),맹성규(孟聖奎),84,72,156,0
16543,김종민(金鐘民),문정복(文貞福),83,60,143,0
16544,김종민(金鐘民),문진석(文振碩),84,73,157,0
16545,김종민(金鐘民),민병덕(閔炳德),90,120,210,0
16546,김종민(金鐘民),민형배(閔馨培),69,121,190,0
16547,김종민(金鐘民),민홍철(閔洪喆),80,48,128,0
16548,김종민(金鐘民),박광온(朴洸瑥),86,82,168,0
16549,김종민(金鐘民),박대수(朴大壽),49,15,64,1
16550,김종민(金鐘民),박대출(朴大出),50,6,56,1
16551,김종민(金鐘民),박덕흠(朴德欽),36,9,45,1
16552,김종민(金鐘民),박범계(朴範界),99,49,148,0
16553,김종민(金鐘民),박병석(朴炳錫),41,23,64,0
16554,김종민(金鐘民),박상혁(朴商赫),84,94,178,0
16555,김종민(金鐘民),박성민(朴聖敏),49,7,56,1
16556,김종민(金鐘民),박성준(朴省俊),102,144,246,0
16557,김종민(金鐘民),박성중(朴成重),49,5,54,1
16558,김종민(金鐘民),박수영(朴洙瑩),49,6,55,1
16559,김종민(金鐘民),박영순(朴英淳),86,91,177,0
16560,김종민(金鐘民),박완주(朴完柱),49,49,98,1
16561,김종민(金鐘民),박용진(朴用鎭),78,95,173,0
16562,김종민(金鐘民),박재호(朴在昊),84,65,149,0
16563,김종민(金鐘民),박정(朴釘),94,83,177,0
16564,김종민(金鐘民),박정하(朴正河),25,6,31,1
16565,김종민(金鐘民),박주민(朴柱民),102,99,201,0
16566,김종민(金鐘民),박진(朴振),50,5,55,1
16567,김종민(金鐘民),박찬대(朴贊大),77,52,129,0
16568,김종민(金鐘民),박형수(朴亨修),49,7,56,1
16569,김종민(金鐘民),박홍근(朴洪根),89,78,167,0
16570,김종민(金鐘民),배준영(裵俊英),49,9,58,1
16571,김종민(金鐘民),배진교(裵晋敎),10,29,39,1
16572,김종민(金鐘民),배현진(裵賢鎭),49,6,55,1
16573,김종민(金鐘民),백종헌(白宗憲),50,11,61,1
16574,김종민(金鐘民),백혜련(白惠蓮),109,67,176,0
16575,김종민(金鐘民),변재일(卞在一),79,52,131,0
16576,김종민(金鐘民),서동용(徐東榕),94,77,171,0
16577,김종민(金鐘民),서범수(徐範洙),50,7,57,1
16578,김종민(金鐘民),서병수(徐秉洙),50,5,55,1
16579,김종민(金鐘民),서삼석(徐參錫),94,67,161,0
16580,김종민(金鐘民),서영교(徐瑛敎),93,122,215,0
16581,김종민(金鐘民),서영석(徐暎錫),80,87,167,0
16582,김종민(金鐘民),서일준(徐一俊),50,5,55,1
16583,김종민(金鐘民),서정숙(徐正淑),49,11,60,1
16584,김종민(金鐘民),설훈(薛勳),77,95,172,0
16585,김종민(金鐘民),성일종(成一鍾),50,8,58,1
16586,김종민(金鐘民),소병철(蘇秉哲),107,104,211,0
16587,김종민(金鐘民),소병훈(蘇秉勳),85,77,162,0
16588,김종민(金鐘民),송갑석(宋甲錫),90,105,195,0
16589,김종민(金鐘民),송기헌(宋基憲),111,57,168,0
16590,김종민(金鐘民),송석준(宋錫俊),49,7,56,1
16591,김종민(金鐘民),송언석(宋彦錫),47,5,52,1
16592,김종민(金鐘民),송옥주(宋玉珠),89,78,167,0
16593,김종민(金鐘民),송재호(宋在祜),101,115,216,0
16594,김종민(金鐘民),신동근(申東根),113,95,208,0
16595,김종민(金鐘民),신영대(申榮大),82,53,135,0
16596,김종민(金鐘民),신원식(申源湜),50,10,60,1
16597,김종민(金鐘民),신정훈(辛正勳),91,113,204,0
16598,김종민(金鐘民),신현영(申賢榮),78,56,134,0
16599,김종민(金鐘民),심상정(沈相奵),11,34,45,1
16600,김종민(金鐘民),안규백(安圭伯),86,78,164,0
16601,김종민(金鐘民),안민석(安敏錫),78,67,145,0
16602,김종민(金鐘民),안병길(安炳吉),51,6,57,1
16603,김종민(金鐘民),안철수(安哲秀),25,4,29,1
16604,김종민(金鐘民),안호영(安浩永),82,59,141,0
16605,김종민(金鐘民),양경숙(梁敬淑),83,85,168,0
16606,김종민(金鐘民),양금희(梁琴喜),50,11,61,1
16607,김종민(金鐘民),양기대(梁基大),78,96,174,0
16608,김종민(金鐘民),양이원영(梁李媛瑛),76,49,125,0
16609,김종민(金鐘民),양정숙(梁貞淑),41,137,178,1
16610,김종민(金鐘民),양향자(梁香子),38,47,85,1
16611,김종민(金鐘民),어기구(魚基龜),82,62,144,0
16612,김종민(金鐘民),엄태영(嚴泰永),50,4,54,1
16613,김종민(金鐘民),오기형(吳奇炯),77,58,135,0
16614,김종민(金鐘民),오영환(吳永煥),91,125,216,0
16615,김종민(金鐘民),용혜인(龍慧仁),8,39,47,1
16616,김종민(金鐘民),우상호(禹相虎),75,41,116,0
16617,김종민(金鐘民),우원식(禹元植),77,54,131,0
16618,김종민(金鐘民),위성곤(魏聖坤),87,90,177,0
16619,김종민(金鐘民),유경준(兪京濬),49,4,53,1
16620,김종민(金鐘民),유기홍(柳基洪),76,53,129,0
16621,김종민(金鐘民),유동수(柳東秀),86,58,144,0
16622,김종민(金鐘民),유상범(劉相凡),50,11,61,1
16623,김종민(金鐘民),유의동(兪義東),49,10,59,1
16624,김종민(金鐘民),유정주(兪訂炷),91,83,174,0
16625,김종민(金鐘民),윤건영(尹建永),75,78,153,0
16626,김종민(金鐘民),윤관석(尹官石),76,51,127,1
16627,김종민(金鐘民),윤두현(尹斗鉉),49,13,62,1
16628,김종민(金鐘民),윤미향(尹美香),44,71,115,1
16629,김종민(金鐘民),윤상현(尹相現),30,6,36,1
16630,김종민(金鐘民),윤영덕(尹永德),86,130,216,0
16631,김종민(金鐘民),윤영석(尹永碩),50,6,56,1
16632,김종민(金鐘民),윤영찬(尹永燦),80,65,145,0
16633,김종민(金鐘民),윤재갑(尹才鉀),104,95,199,0
16634,김종민(金鐘民),윤재옥(尹在玉),49,6,55,1
16635,김종민(金鐘民),윤주경(尹柱卿),49,12,61,1
16636,김종민(金鐘民),윤준병(尹準炳),92,103,195,0
16637,김종민(金鐘民),윤창현(尹暢賢),49,11,60,1
16638,김종민(金鐘民),윤한홍(尹漢洪),50,12,62,1
16639,김종민(金鐘民),윤호중(尹昊重),80,72,152,0
16640,김종민(金鐘民),윤후덕(尹厚德),81,56,137,0
16641,김종민(金鐘民),이개호(李介昊),85,62,147,0
16642,김종민(金鐘民),이달곤(李達坤),50,7,57,1
16643,김종민(金鐘民),이동주(李東洲),82,94,176,0
16644,김종민(金鐘民),이만희(李晩熙),49,4,53,1
16645,김종민(金鐘民),이명수(李明洙),51,20,71,1
16646,김종민(金鐘民),이병훈(李炳勳),91,106,197,0
16647,김종민(金鐘民),이상민(李相珉),80,56,136,0
16648,김종민(金鐘民),이상헌(李相憲),105,79,184,0
16649,김종민(金鐘民),이성만(李成萬),80,74,154,1
16650,김종민(金鐘民),이소영(李素永),79,54,133,0
16651,김종민(金鐘民),이수진(李壽珍),92,91,183,0
16652,김종민(金鐘民),이수진(李秀眞),93,90,183,0
16653,김종민(金鐘民),이양수(李亮壽),51,8,59,1
16654,김종민(金鐘民),이용(李鏞),49,6,55,1
16655,김종민(金鐘民),이용빈(李龍彬),92,119,211,0
16656,김종민(金鐘民),이용선(李庸瑄),86,68,154,0
16657,김종민(金鐘民),이용우(李龍雨),86,96,182,0
16658,김종민(金鐘民),이용호(李容鎬),29,14,43,1
16659,김종민(金鐘民),이원욱(李元旭),93,102,195,0
16660,김종민(金鐘民),이원택(李源澤),85,70,155,0
16661,김종민(金鐘民),이은주(李恩周),14,31,45,1
16662,김종민(金鐘民),이인선(李仁善),25,6,31,1
16663,김종민(金鐘民),이인영(李仁榮),77,56,133,0
16664,김종민(金鐘民),이장섭(李將燮),92,111,203,0
16665,김종민(金鐘民),이재명(李在明),38,17,55,0
16666,김종민(金鐘民),이재정(李在汀),78,44,122,0
16667,김종민(金鐘民),이정문(李楨文),82,89,171,0
16668,김종민(金鐘民),이종배(李鍾培),49,8,57,1
16669,김종민(金鐘民),이종성(李鍾成),49,12,61,1
16670,김종민(金鐘民),이주환(李周桓),49,5,54,1
16671,김종민(金鐘民),이채익(李埰益),50,8,58,1
16672,김종민(金鐘民),이철규(李喆圭),52,11,63,1
16673,김종민(金鐘民),이탄희(李誕熙),84,69,153,0
16674,김종민(金鐘民),이태규(李泰珪),28,7,35,1
16675,김종민(金鐘民),이학영(李學永),86,105,191,0
16676,김종민(金鐘民),이해식(李海植),89,82,171,0
16677,김종민(金鐘民),이헌승(李憲昇),50,6,56,1
16678,김종민(金鐘民),이형석(李炯錫),82,90,172,0
16679,김종민(金鐘民),인재근(印在謹),79,79,158,0
16680,김종민(金鐘民),임병헌(林炳憲),25,6,31,1
16681,김종민(金鐘民),임오경(林五卿),84,71,155,0
16682,김종민(金鐘民),임이자(林利子),49,5,54,1
16683,김종민(金鐘民),임종성(林鍾聲),96,84,180,0
16684,김종민(金鐘民),임호선(林昊宣),101,150,251,0
16685,김종민(金鐘民),장경태(張耿態),94,92,186,0
16686,김종민(金鐘民),장동혁(張東赫),25,5,30,1
16687,김종민(金鐘民),장제원(張濟元),49,5,54,1
16688,김종민(金鐘民),장철민(張喆敏),88,98,186,0
16689,김종민(金鐘民),장혜영(張惠英),10,33,43,1
16690,김종민(金鐘民),전봉민(田奉珉),34,5,39,1
16691,김종민(金鐘民),전용기(田溶冀),91,111,202,0
16692,김종민(金鐘民),전재수(田載秀),88,66,154,0
16693,김종민(金鐘民),전주혜(全珠惠),50,6,56,1
16694,김종민(金鐘民),전해철(全海澈),85,70,155,0
16695,김종민(金鐘民),전혜숙(全惠淑),84,69,153,0
16696,김종민(金鐘民),정경희(丁慶姬),49,10,59,1
16697,김종민(金鐘民),정동만(鄭東萬),49,5,54,1
16698,김종민(金鐘民),정성호(鄭成湖),83,75,158,0
16699,김종민(金鐘民),정우택(鄭宇澤),25,5,30,1
16700,김종민(金鐘民),정운천(鄭雲天),49,6,55,1
16701,김종민(金鐘民),정일영(鄭日永),77,74,151,0
16702,김종민(金鐘民),정점식(鄭点植),50,5,55,1
16703,김종민(金鐘民),정진석(鄭鎭碩),50,8,58,1
16704,김종민(金鐘民),정청래(鄭淸來),84,57,141,0
16705,김종민(金鐘民),정춘숙(鄭春淑),88,66,154,0
16706,김종민(金鐘民),정태호(鄭泰浩),85,108,193,0
16707,김종민(金鐘民),정필모(鄭必模),84,72,156,0
16708,김종민(金鐘民),정희용(鄭熙溶),49,5,54,1
16709,김종민(金鐘民),조경태(趙慶泰),49,4,53,1
16710,김종민(金鐘民),조명희(曺明姬),49,12,61,1
16711,김종민(金鐘民),조수진(趙修眞),49,10,59,1
16712,김종민(金鐘民),조승래(趙承來),94,77,171,0
16713,김종민(金鐘民),조오섭(曺五燮),85,119,204,0
16714,김종민(金鐘民),조은희(趙恩禧),25,5,30,1
16715,김종민(金鐘民),조응천(趙應天),72,59,131,0
16716,김종민(金鐘民),조정식(趙正湜),72,50,122,0
16717,김종민(金鐘民),조정훈(趙廷訓),2,18,20,1
16718,김종민(金鐘民),조해진(曺海珍),50,6,56,1
16719,김종민(金鐘民),주철현(朱哲鉉),88,71,159,0
16720,김종민(金鐘民),주호영(朱豪英),50,5,55,1
16721,김종민(金鐘民),지성호(池成浩),49,4,53,1
16722,김종민(金鐘民),진선미(陳善美),79,49,128,0
16723,김종민(金鐘民),진성준(陳聲準),83,77,160,0
16724,김종민(金鐘民),천준호(千俊鎬),78,45,123,0
16725,김종민(金鐘民),최기상(崔基相),96,84,180,0
16726,김종민(金鐘民),최승재(崔承宰),49,12,61,1
16727,김종민(金鐘民),최연숙(崔姸淑),29,16,45,1
16728,김종민(金鐘民),최영희(崔英姬),25,6,31,1
16729,김종민(金鐘民),최인호(崔仁昊),81,86,167,0
16730,김종민(金鐘民),최재형(崔在亨),25,5,30,1
16731,김종민(金鐘民),최종윤(崔鍾允),90,111,201,0
16732,김종민(金鐘民),최춘식(崔春植),49,15,64,1
16733,김종민(金鐘民),최형두(崔炯斗),50,8,58,1
16734,김종민(金鐘民),최혜영(崔惠英),77,95,172,0
16735,김종민(金鐘民),추경호(秋慶鎬),49,6,55,1
16736,김종민(金鐘民),태영호(太永浩),49,5,54,1
16737,김종민(金鐘民),하영제(河榮帝),41,4,45,1
16738,김종민(金鐘民),하태경(河泰慶),50,4,54,1
16739,김종민(金鐘民),한기호(韓起鎬),50,6,56,1
16740,김종민(金鐘民),한무경(韓茂景),49,7,56,1
16741,김종민(金鐘民),한병도(韓秉道),85,100,185,0
16742,김종민(金鐘民),한정애(韓貞愛),75,64,139,0
16743,김종민(金鐘民),한준호(韓俊鎬),84,97,181,0
16744,김종민(金鐘民),허숙정(許淑湞),1,1,2,0
16745,김종민(金鐘民),허영(許榮),98,103,201,0
16746,김종민(金鐘民),허은아(許垠娥),49,6,55,1
16747,김종민(金鐘民),허종식(許琮植),81,60,141,0
16748,김종민(金鐘民),홍기원(洪起元),82,83,165,0
16749,김종민(金鐘民),홍문표(洪文杓),50,10,60,1
16750,김종민(金鐘民),홍석준(洪碩晙),50,4,54,1
16751,김종민(金鐘民),홍성국(洪性國),97,133,230,0
16752,김종민(金鐘民),홍영표(洪永杓),78,64,142,0
16753,김종민(金鐘民),홍익표(洪翼杓),85,73,158,0
16754,김종민(金鐘民),홍정민(洪貞敏),90,100,190,0
16755,김종민(金鐘民),황보승희(皇甫承希),45,10,55,1
16756,김종민(金鐘民),황운하(黃雲夏),92,117,209,0
16757,김종민(金鐘民),황희(黃熙),77,53,130,0
16758,김주영(金周暎),김진표(金振杓),68,75,143,1
16759,김주영(金周暎),김철민(金哲玟),109,129,238,0
16760,김주영(金周暎),김태년(金太年),80,67,147,0
16761,김주영(金周暎),김태호(金台鎬),42,6,48,1
16762,김주영(金周暎),김학용(金學容),25,4,29,1
16763,김주영(金周暎),김한규(金翰奎),45,41,86,0
16764,김주영(金周暎),김한정(金漢正),84,56,140,0
16765,김주영(金周暎),김형동(金亨東),50,9,59,1
16766,김주영(金周暎),김홍걸(金弘傑),54,140,194,0
16767,김주영(金周暎),김회재(金會在),107,92,199,0
16768,김주영(金周暎),김희곤(金熙坤),50,4,54,1
16769,김주영(金周暎),김희국(金熙國),49,4,53,1
16770,김주영(金周暎),남인순(南仁順),101,77,178,0
16771,김주영(金周暎),노용호(魯容昊),25,4,29,1
16772,김주영(金周暎),노웅래(盧雄來),119,165,284,0
16773,김주영(金周暎),도종환(都鍾煥),87,82,169,0
16774,김주영(金周暎),류성걸(柳性杰),51,4,55,1
16775,김주영(金周暎),류호정(柳好貞),24,65,89,1
16776,김주영(金周暎),맹성규(孟聖奎),95,84,179,0
16777,김주영(金周暎),문정복(文貞福),96,96,192,0
16778,김주영(金周暎),문진석(文振碩),124,102,226,0
16779,김주영(金周暎),민병덕(閔炳德),119,165,284,0
16780,김주영(金周暎),민형배(閔馨培),101,162,263,0
16781,김주영(金周暎),민홍철(閔洪喆),88,65,153,0
16782,김주영(金周暎),박광온(朴洸瑥),87,100,187,0
16783,김주영(金周暎),박대수(朴大壽),52,13,65,1
16784,김주영(金周暎),박대출(朴大出),50,5,55,1
16785,김주영(金周暎),박덕흠(朴德欽),37,8,45,1
16786,김주영(金周暎),박범계(朴範界),77,42,119,0
16787,김주영(金周暎),박병석(朴炳錫),41,17,58,0
16788,김주영(金周暎),박상혁(朴商赫),115,237,352,0
16789,김주영(金周暎),박성민(朴聖敏),49,4,53,1
16790,김주영(金周暎),박성준(朴省俊),115,122,237,0
16791,김주영(金周暎),박성중(朴成重),50,5,55,1
16792,김주영(金周暎),박수영(朴洙瑩),50,6,56,1
16793,김주영(金周暎),박영순(朴英淳),108,128,236,0
16794,김주영(金周暎),박완주(朴完柱),52,44,96,1
16795,김주영(金周暎),박용진(朴用鎭),78,42,120,0
16796,김주영(金周暎),박재호(朴在昊),101,81,182,0
16797,김주영(金周暎),박정(朴釘),115,147,262,0
16798,김주영(金周暎),박정하(朴正河),27,4,31,1
16799,김주영(金周暎),박주민(朴柱民),84,59,143,0
16800,김주영(金周暎),박진(朴振),51,6,57,1
16801,김주영(金周暎),박찬대(朴贊大),97,77,174,0
16802,김주영(金周暎),박형수(朴亨修),51,4,55,1
16803,김주영(金周暎),박홍근(朴洪根),128,165,293,0
16804,김주영(金周暎),배준영(裵俊英),51,11,62,1
16805,김주영(金周暎),배진교(裵晋敎),19,64,83,1
16806,김주영(金周暎),배현진(裵賢鎭),50,6,56,1
16807,김주영(金周暎),백종헌(白宗憲),52,5,57,1
16808,김주영(金周暎),백혜련(白惠蓮),96,62,158,0
16809,김주영(金周暎),변재일(卞在一),87,84,171,0
16810,김주영(金周暎),서동용(徐東榕),99,110,209,0
16811,김주영(金周暎),서범수(徐範洙),52,6,58,1
16812,김주영(金周暎),서병수(徐秉洙),53,5,58,1
16813,김주영(金周暎),서삼석(徐參錫),108,121,229,0
16814,김주영(金周暎),서영교(徐瑛敎),111,165,276,0
16815,김주영(金周暎),서영석(徐暎錫),126,159,285,0
16816,김주영(金周暎),서일준(徐一俊),52,10,62,1
16817,김주영(金周暎),서정숙(徐正淑),51,6,57,1
16818,김주영(金周暎),설훈(薛勳),85,97,182,0
16819,김주영(金周暎),성일종(成一鍾),53,7,60,1
16820,김주영(金周暎),소병철(蘇秉哲),94,107,201,0
16821,김주영(金周暎),소병훈(蘇秉勳),94,89,183,0
16822,김주영(金周暎),송갑석(宋甲錫),113,147,260,0
16823,김주영(金周暎),송기헌(宋基憲),91,58,149,0
16824,김주영(金周暎),송석준(宋錫俊),55,6,61,1
16825,김주영(金周暎),송언석(宋彦錫),45,4,49,1
16826,김주영(金周暎),송옥주(宋玉珠),108,159,267,0
16827,김주영(金周暎),송재호(宋在祜),106,120,226,0
16828,김주영(金周暎),신동근(申東根),96,128,224,0
16829,김주영(金周暎),신영대(申榮大),92,85,177,0
16830,김주영(金周暎),신원식(申源湜),52,6,58,1
16831,김주영(金周暎),신정훈(辛正勳),142,196,338,0
16832,김주영(金周暎),신현영(申賢榮),86,89,175,0
16833,김주영(金周暎),심상정(沈相奵),23,72,95,1
16834,김주영(金周暎),안규백(安圭伯),107,102,209,0
16835,김주영(金周暎),안민석(安敏錫),88,56,144,0
16836,김주영(金周暎),안병길(安炳吉),50,5,55,1
16837,김주영(金周暎),안철수(安哲秀),26,5,31,1
16838,김주영(金周暎),안호영(安浩永),93,140,233,0
16839,김주영(金周暎),양경숙(梁敬淑),114,125,239,0
16840,김주영(金周暎),양금희(梁琴喜),54,8,62,1
16841,김주영(金周暎),양기대(梁基大),110,151,261,0
16842,김주영(金周暎),양이원영(梁李媛瑛),101,96,197,0
16843,김주영(金周暎),양정숙(梁貞淑),55,167,222,1
16844,김주영(金周暎),양향자(梁香子),61,68,129,1
16845,김주영(金周暎),어기구(魚基龜),103,140,243,0
16846,김주영(金周暎),엄태영(嚴泰永),51,7,58,1
16847,김주영(金周暎),오기형(吳奇炯),88,53,141,0
16848,김주영(金周暎),오영환(吳永煥),156,262,418,0
16849,김주영(金周暎),용혜인(龍慧仁),23,57,80,1
16850,김주영(金周暎),우상호(禹相虎),77,37,114,0
16851,김주영(金周暎),우원식(禹元植),104,112,216,0
16852,김주영(金周暎),위성곤(魏聖坤),113,150,263,0
16853,김주영(金周暎),유경준(兪京濬),50,5,55,1
16854,김주영(金周暎),유기홍(柳基洪),81,56,137,0
16855,김주영(金周暎),유동수(柳東秀),93,81,174,0
16856,김주영(金周暎),유상범(劉相凡),49,4,53,1
16857,김주영(金周暎),유의동(兪義東),49,4,53,1
16858,김주영(金周暎),유정주(兪訂炷),117,143,260,0
16859,김주영(金周暎),윤건영(尹建永),113,111,224,0
16860,김주영(金周暎),윤관석(尹官石),80,66,146,1
16861,김주영(金周暎),윤두현(尹斗鉉),49,5,54,1
16862,김주영(金周暎),윤미향(尹美香),52,135,187,1
16863,김주영(金周暎),윤상현(尹相現),31,12,43,1
16864,김주영(金周暎),윤영덕(尹永德),113,162,275,0
16865,김주영(金周暎),윤영석(尹永碩),51,10,61,1
16866,김주영(金周暎),윤영찬(尹永燦),90,80,170,0
16867,김주영(金周暎),윤재갑(尹才鉀),121,169,290,0
16868,김주영(金周暎),윤재옥(尹在玉),49,4,53,1
16869,김주영(金周暎),윤주경(尹柱卿),51,5,56,1
16870,김주영(金周暎),윤준병(尹準炳),146,212,358,0
16871,김주영(金周暎),윤창현(尹暢賢),49,5,54,1
16872,김주영(金周暎),윤한홍(尹漢洪),50,4,54,1
16873,김주영(金周暎),윤호중(尹昊重),80,61,141,0
16874,김주영(金周暎),윤후덕(尹厚德),109,159,268,0
16875,김주영(金周暎),이개호(李介昊),105,165,270,0
16876,김주영(金周暎),이달곤(李達坤),52,7,59,1
16877,김주영(金周暎),이동주(李東洲),99,163,262,0
16878,김주영(金周暎),이만희(李晩熙),49,4,53,1
16879,김주영(金周暎),이명수(李明洙),59,16,75,1
16880,김주영(金周暎),이병훈(李炳勳),120,214,334,0
16881,김주영(金周暎),이상민(李相珉),74,39,113,0
16882,김주영(金周暎),이상헌(李相憲),93,118,211,0
16883,김주영(金周暎),이성만(李成萬),97,111,208,1
16884,김주영(金周暎),이소영(李素永),92,67,159,0
16885,김주영(金周暎),이수진(李壽珍),139,210,349,0
16886,김주영(金周暎),이수진(李秀眞),115,160,275,0
16887,김주영(金周暎),이양수(李亮壽),51,7,58,1
16888,김주영(金周暎),이용(李鏞),49,4,53,1
16889,김주영(金周暎),이용빈(李龍彬),148,207,355,0
16890,김주영(金周暎),이용선(李庸瑄),100,105,205,0
16891,김주영(金周暎),이용우(李龍雨),162,187,349,0
16892,김주영(金周暎),이용호(李容鎬),37,14,51,1
16893,김주영(金周暎),이원욱(李元旭),112,143,255,0
16894,김주영(金周暎),이원택(李源澤),98,89,187,0
16895,김주영(金周暎),이은주(李恩周),18,57,75,1
16896,김주영(金周暎),이인선(李仁善),27,5,32,1
16897,김주영(金周暎),이인영(李仁榮),73,47,120,0
16898,김주영(金周暎),이장섭(李將燮),104,100,204,0
16899,김주영(金周暎),이재명(李在明),41,21,62,0
16900,김주영(金周暎),이재정(李在汀),84,49,133,0
16901,김주영(金周暎),이정문(李楨文),92,110,202,0
16902,김주영(金周暎),이종배(李鍾培),52,7,59,1
16903,김주영(金周暎),이종성(李鍾成),50,7,57,1
16904,김주영(金周暎),이주환(李周桓),49,5,54,1
16905,김주영(金周暎),이채익(李埰益),51,11,62,1
16906,김주영(金周暎),이철규(李喆圭),52,5,57,1
16907,김주영(金周暎),이탄희(李誕熙),100,85,185,0
16908,김주영(金周暎),이태규(李泰珪),30,6,36,1
16909,김주영(金周暎),이학영(李學永),105,145,250,0
16910,김주영(金周暎),이해식(李海植),110,112,222,0
16911,김주영(金周暎),이헌승(李憲昇),52,5,57,1
16912,김주영(金周暎),이형석(李炯錫),107,125,232,0
16913,김주영(金周暎),인재근(印在謹),92,84,176,0
16914,김주영(金周暎),임병헌(林炳憲),28,4,32,1
16915,김주영(金周暎),임오경(林五卿),107,137,244,0
16916,김주영(金周暎),임이자(林利子),49,4,53,1
16917,김주영(金周暎),임종성(林鍾聲),108,150,258,0
16918,김주영(金周暎),임호선(林昊宣),131,192,323,0
16919,김주영(金周暎),장경태(張耿態),110,163,273,0
16920,김주영(金周暎),장동혁(張東赫),25,4,29,1
16921,김주영(金周暎),장제원(張濟元),49,4,53,1
16922,김주영(金周暎),장철민(張喆敏),100,161,261,0
16923,김주영(金周暎),장혜영(張惠英),18,47,65,1
16924,김주영(金周暎),전봉민(田奉珉),35,5,40,1
16925,김주영(金周暎),전용기(田溶冀),102,127,229,0
16926,김주영(金周暎),전재수(田載秀),82,76,158,0
16927,김주영(金周暎),전주혜(全珠惠),54,6,60,1
16928,김주영(金周暎),전해철(全海澈),76,66,142,0
16929,김주영(金周暎),전혜숙(全惠淑),93,98,191,0
16930,김주영(金周暎),정경희(丁慶姬),50,4,54,1
16931,김주영(金周暎),정동만(鄭東萬),49,4,53,1
16932,김주영(金周暎),정성호(鄭成湖),101,133,234,0
16933,김주영(金周暎),정우택(鄭宇澤),27,5,32,1
16934,김주영(金周暎),정운천(鄭雲天),52,6,58,1
16935,김주영(金周暎),정일영(鄭日永),154,272,426,0
16936,김주영(金周暎),정점식(鄭点植),50,5,55,1
16937,김주영(金周暎),정진석(鄭鎭碩),50,6,56,1
16938,김주영(金周暎),정청래(鄭淸來),91,79,170,0
16939,김주영(金周暎),정춘숙(鄭春淑),91,100,191,0
16940,김주영(金周暎),정태호(鄭泰浩),90,138,228,0
16941,김주영(金周暎),정필모(鄭必模),102,101,203,0
16942,김주영(金周暎),정희용(鄭熙溶),51,6,57,1
16943,김주영(金周暎),조경태(趙慶泰),49,5,54,1
16944,김주영(金周暎),조명희(曺明姬),51,7,58,1
16945,김주영(金周暎),조수진(趙修眞),49,4,53,1
16946,김주영(金周暎),조승래(趙承來),98,88,186,0
16947,김주영(金周暎),조오섭(曺五燮),106,170,276,0
16948,김주영(金周暎),조은희(趙恩禧),27,6,33,1
16949,김주영(金周暎),조응천(趙應天),79,48,127,0
16950,김주영(金周暎),조정식(趙正湜),92,103,195,0
16951,김주영(金周暎),조정훈(趙廷訓),2,23,25,1
16952,김주영(金周暎),조해진(曺海珍),52,5,57,1
16953,김주영(金周暎),주철현(朱哲鉉),110,135,245,0
16954,김주영(金周暎),주호영(朱豪英),51,4,55,1
16955,김주영(金周暎),지성호(池成浩),50,5,55,1
16956,김주영(金周暎),진선미(陳善美),84,90,174,0
16957,김주영(金周暎),진성준(陳聲準),135,135,270,0
16958,김주영(金周暎),천준호(千俊鎬),102,89,191,0
16959,김주영(金周暎),최기상(崔基相),97,78,175,0
16960,김주영(金周暎),최승재(崔承宰),52,10,62,1
16961,김주영(金周暎),최연숙(崔姸淑),34,17,51,1
16962,김주영(金周暎),최영희(崔英姬),25,6,31,1
16963,김주영(金周暎),최인호(崔仁昊),107,117,224,0
16964,김주영(金周暎),최재형(崔在亨),25,5,30,1
16965,김주영(金周暎),최종윤(崔鍾允),102,147,249,0
16966,김주영(金周暎),최춘식(崔春植),49,8,57,1
16967,김주영(金周暎),최형두(崔炯斗),52,10,62,1
16968,김주영(金周暎),최혜영(崔惠英),97,133,230,0
16969,김주영(金周暎),추경호(秋慶鎬),49,3,52,1
16970,김주영(金周暎),태영호(太永浩),50,6,56,1
16971,김주영(金周暎),하영제(河榮帝),44,3,47,1
16972,김주영(金周暎),하태경(河泰慶),51,4,55,1
16973,김주영(金周暎),한기호(韓起鎬),51,5,56,1
16974,김주영(金周暎),한무경(韓茂景),50,6,56,1
16975,김주영(金周暎),한병도(韓秉道),102,157,259,0
16976,김주영(金周暎),한정애(韓貞愛),83,85,168,0
16977,김주영(金周暎),한준호(韓俊鎬),109,148,257,0
16978,김주영(金周暎),허숙정(許淑湞),1,2,3,0
16979,김주영(金周暎),허영(許榮),117,158,275,0
16980,김주영(金周暎),허은아(許垠娥),49,5,54,1
16981,김주영(金周暎),허종식(許琮植),113,149,262,0
16982,김주영(金周暎),홍기원(洪起元),124,166,290,0
16983,김주영(金周暎),홍문표(洪文杓),51,6,57,1
16984,김주영(金周暎),홍석준(洪碩晙),50,4,54,1
16985,김주영(金周暎),홍성국(洪性國),117,229,346,0
16986,김주영(金周暎),홍영표(洪永杓),91,94,185,0
16987,김주영(金周暎),홍익표(洪翼杓),94,100,194,0
16988,김주영(金周暎),홍정민(洪貞敏),138,187,325,0
16989,김주영(金周暎),황보승희(皇甫承希),49,5,54,1
16990,김주영(金周暎),황운하(黃雲夏),129,155,284,0
16991,김주영(金周暎),황희(黃熙),81,61,142,0
16992,김진표(金振杓),김철민(金哲玟),64,42,106,1
16993,김진표(金振杓),김태년(金太年),40,18,58,1
16994,김진표(金振杓),김태호(金台鎬),16,0,16,1
16995,김진표(金振杓),김학용(金學容),0,0,0,1
16996,김진표(金振杓),김한규(金翰奎),2,2,4,1
16997,김진표(金振杓),김한정(金漢正),41,28,69,1
16998,김진표(金振杓),김형동(金亨東),28,2,30,1
16999,김진표(金振杓),김홍걸(金弘傑),36,54,90,1
17000,김진표(金振杓),김회재(金會在),56,49,105,1
17001,김진표(金振杓),김희곤(金熙坤),25,0,25,1
17002,김진표(金振杓),김희국(金熙國),24,0,24,1
17003,김진표(金振杓),남인순(南仁順),51,49,100,1
17004,김진표(金振杓),노용호(魯容昊),0,0,0,1
17005,김진표(金振杓),노웅래(盧雄來),58,63,121,1
17006,김진표(金振杓),도종환(都鍾煥),58,45,103,1
17007,김진표(金振杓),류성걸(柳性杰),25,0,25,1
17008,김진표(金振杓),류호정(柳好貞),13,20,33,1
17009,김진표(金振杓),맹성규(孟聖奎),53,39,92,1
17010,김진표(金振杓),문정복(文貞福),52,31,83,1
17011,김진표(金振杓),문진석(文振碩),58,55,113,1
17012,김진표(金振杓),민병덕(閔炳德),54,74,128,1
17013,김진표(金振杓),민형배(閔馨培),58,77,135,1
17014,김진표(金振杓),민홍철(閔洪喆),61,42,103,1
17015,김진표(金振杓),박광온(朴洸瑥),62,69,131,1
17016,김진표(金振杓),박대수(朴大壽),25,2,27,1
17017,김진표(金振杓),박대출(朴大出),25,0,25,1
17018,김진표(金振杓),박덕흠(朴德欽),11,3,14,1
17019,김진표(金振杓),박범계(朴範界),40,19,59,1
17020,김진표(金振杓),박병석(朴炳錫),2,1,3,1
17021,김진표(金振杓),박상혁(朴商赫),53,64,117,1
17022,김진표(金振杓),박성민(朴聖敏),24,2,26,1
17023,김진표(金振杓),박성준(朴省俊),76,86,162,1
17024,김진표(金振杓),박성중(朴成重),24,2,26,1
17025,김진표(金振杓),박수영(朴洙瑩),24,0,24,1
17026,김진표(金振杓),박영순(朴英淳),64,59,123,1
17027,김진표(金振杓),박완주(朴完柱),54,33,87,0
17028,김진표(金振杓),박용진(朴用鎭),38,22,60,1
17029,김진표(金振杓),박재호(朴在昊),57,31,88,1
17030,김진표(金振杓),박정(朴釘),62,55,117,1
17031,김진표(金振杓),박정하(朴正河),0,0,0,1
17032,김진표(金振杓),박주민(朴柱民),42,32,74,1
17033,김진표(金振杓),박진(朴振),25,0,25,1
17034,김진표(金振杓),박찬대(朴贊大),50,40,90,1
17035,김진표(金振杓),박형수(朴亨修),24,1,25,1
17036,김진표(金振杓),박홍근(朴洪根),71,78,149,1
17037,김진표(金振杓),배준영(裵俊英),24,0,24,1
17038,김진표(金振杓),배진교(裵晋敎),11,11,22,1
17039,김진표(金振杓),배현진(裵賢鎭),24,0,24,1
17040,김진표(金振杓),백종헌(白宗憲),26,0,26,1
17041,김진표(金振杓),백혜련(白惠蓮),66,36,102,1
17042,김진표(金振杓),변재일(卞在一),52,31,83,1
17043,김진표(金振杓),서동용(徐東榕),53,31,84,1
17044,김진표(金振杓),서범수(徐範洙),25,2,27,1
17045,김진표(金振杓),서병수(徐秉洙),25,3,28,1
17046,김진표(金振杓),서삼석(徐參錫),57,47,104,1
17047,김진표(金振杓),서영교(徐瑛敎),61,58,119,1
17048,김진표(金振杓),서영석(徐暎錫),56,52,108,1
17049,김진표(金振杓),서일준(徐一俊),26,2,28,1
17050,김진표(金振杓),서정숙(徐正淑),24,1,25,1
17051,김진표(金振杓),설훈(薛勳),55,48,103,1
17052,김진표(金振杓),성일종(成一鍾),25,2,27,1
17053,김진표(金振杓),소병철(蘇秉哲),62,46,108,1
17054,김진표(金振杓),소병훈(蘇秉勳),50,40,90,1
17055,김진표(金振杓),송갑석(宋甲錫),65,76,141,1
17056,김진표(金振杓),송기헌(宋基憲),47,39,86,1
17057,김진표(金振杓),송석준(宋錫俊),25,0,25,1
17058,김진표(金振杓),송언석(宋彦錫),21,1,22,1
17059,김진표(金振杓),송옥주(宋玉珠),60,46,106,1
17060,김진표(金振杓),송재호(宋在祜),64,68,132,1
17061,김진표(金振杓),신동근(申東根),55,37,92,1
17062,김진표(金振杓),신영대(申榮大),44,38,82,1
17063,김진표(金振杓),신원식(申源湜),24,3,27,1
17064,김진표(金振杓),신정훈(辛正勳),72,85,157,1
17065,김진표(金振杓),신현영(申賢榮),53,40,93,1
17066,김진표(金振杓),심상정(沈相奵),10,9,19,1
17067,김진표(金振杓),안규백(安圭伯),79,73,152,1
17068,김진표(金振杓),안민석(安敏錫),55,35,90,1
17069,김진표(金振杓),안병길(安炳吉),26,1,27,1
17070,김진표(金振杓),안철수(安哲秀),0,0,0,1
17071,김진표(金振杓),안호영(安浩永),52,42,94,1
17072,김진표(金振杓),양경숙(梁敬淑),59,55,114,1
17073,김진표(金振杓),양금희(梁琴喜),25,1,26,1
17074,김진표(金振杓),양기대(梁基大),60,55,115,1
17075,김진표(金振杓),양이원영(梁李媛瑛),54,41,95,1
17076,김진표(金振杓),양정숙(梁貞淑),45,84,129,0
17077,김진표(金振杓),양향자(梁香子),45,37,82,1
17078,김진표(金振杓),어기구(魚基龜),51,27,78,1
17079,김진표(金振杓),엄태영(嚴泰永),25,0,25,1
17080,김진표(金振杓),오기형(吳奇炯),46,30,76,1
17081,김진표(金振杓),오영환(吳永煥),88,113,201,1
17082,김진표(金振杓),용혜인(龍慧仁),8,20,28,1
17083,김진표(金振杓),우상호(禹相虎),44,19,63,1
17084,김진표(金振杓),우원식(禹元植),54,35,89,1
17085,김진표(金振杓),위성곤(魏聖坤),57,44,101,1
17086,김진표(金振杓),유경준(兪京濬),25,0,25,1
17087,김진표(金振杓),유기홍(柳基洪),42,22,64,1
17088,김진표(金振杓),유동수(柳東秀),60,41,101,1
17089,김진표(金振杓),유상범(劉相凡),25,1,26,1
17090,김진표(金振杓),유의동(兪義東),24,2,26,1
17091,김진표(金振杓),유정주(兪訂炷),70,67,137,1
17092,김진표(金振杓),윤건영(尹建永),50,51,101,1
17093,김진표(金振杓),윤관석(尹官石),57,44,101,0
17094,김진표(金振杓),윤두현(尹斗鉉),24,1,25,1
17095,김진표(金振杓),윤미향(尹美香),44,27,71,0
17096,김진표(金振杓),윤상현(尹相現),5,1,6,1
17097,김진표(金振杓),윤영덕(尹永德),57,63,120,1
17098,김진표(金振杓),윤영석(尹永碩),26,1,27,1
17099,김진표(金振杓),윤영찬(尹永燦),50,45,95,1
17100,김진표(金振杓),윤재갑(尹才鉀),61,73,134,1
17101,김진표(金振杓),윤재옥(尹在玉),25,0,25,1
17102,김진표(金振杓),윤주경(尹柱卿),24,1,25,1
17103,김진표(金振杓),윤준병(尹準炳),69,100,169,1
17104,김진표(金振杓),윤창현(尹暢賢),25,1,26,1
17105,김진표(金振杓),윤한홍(尹漢洪),26,0,26,1
17106,김진표(金振杓),윤호중(尹昊重),43,28,71,1
17107,김진표(金振杓),윤후덕(尹厚德),55,43,98,1
17108,김진표(金振杓),이개호(李介昊),58,50,108,1
17109,김진표(金振杓),이달곤(李達坤),28,1,29,1
17110,김진표(金振杓),이동주(李東洲),44,45,89,1
17111,김진표(金振杓),이만희(李晩熙),24,1,25,1
17112,김진표(金振杓),이명수(李明洙),27,4,31,1
17113,김진표(金振杓),이병훈(李炳勳),63,82,145,1
17114,김진표(金振杓),이상민(李相珉),46,24,70,1
17115,김진표(金振杓),이상헌(李相憲),61,67,128,1
17116,김진표(金振杓),이성만(李成萬),56,52,108,0
17117,김진표(金振杓),이소영(李素永),43,30,73,1
17118,김진표(金振杓),이수진(李壽珍),72,83,155,1
17119,김진표(金振杓),이수진(李秀眞),59,74,133,1
17120,김진표(金振杓),이양수(李亮壽),27,2,29,1
17121,김진표(金振杓),이용(李鏞),24,1,25,1
17122,김진표(金振杓),이용빈(李龍彬),73,74,147,1
17123,김진표(金振杓),이용선(李庸瑄),57,51,108,1
17124,김진표(金振杓),이용우(李龍雨),65,74,139,1
17125,김진표(金振杓),이용호(李容鎬),13,13,26,1
17126,김진표(金振杓),이원욱(李元旭),61,59,120,1
17127,김진표(金振杓),이원택(李源澤),45,36,81,1
17128,김진표(金振杓),이은주(李恩周),11,5,16,1
17129,김진표(金振杓),이인선(李仁善),0,0,0,1
17130,김진표(金振杓),이인영(李仁榮),45,23,68,1
17131,김진표(金振杓),이장섭(李將燮),60,54,114,1
17132,김진표(金振杓),이재명(李在明),2,1,3,1
17133,김진표(金振杓),이재정(李在汀),45,28,73,1
17134,김진표(金振杓),이정문(李楨文),53,30,83,1
17135,김진표(金振杓),이종배(李鍾培),25,1,26,1
17136,김진표(金振杓),이종성(李鍾成),24,1,25,1
17137,김진표(金振杓),이주환(李周桓),24,0,24,1
17138,김진표(金振杓),이채익(李埰益),26,3,29,1
17139,김진표(金振杓),이철규(李喆圭),28,1,29,1
17140,김진표(金振杓),이탄희(李誕熙),58,53,111,1
17141,김진표(金振杓),이태규(李泰珪),4,1,5,1
17142,김진표(金振杓),이학영(李學永),58,47,105,1
17143,김진표(金振杓),이해식(李海植),60,43,103,1
17144,김진표(金振杓),이헌승(李憲昇),26,3,29,1
17145,김진표(金振杓),이형석(李炯錫),58,47,105,1
17146,김진표(金振杓),인재근(印在謹),67,54,121,1
17147,김진표(金振杓),임병헌(林炳憲),0,0,0,1
17148,김진표(金振杓),임오경(林五卿),66,56,122,1
17149,김진표(金振杓),임이자(林利子),24,1,25,1
17150,김진표(金振杓),임종성(林鍾聲),66,56,122,1
17151,김진표(金振杓),임호선(林昊宣),83,110,193,1
17152,김진표(金振杓),장경태(張耿態),61,51,112,1
17153,김진표(金振杓),장동혁(張東赫),0,0,0,1
17154,김진표(金振杓),장제원(張濟元),24,0,24,1
17155,김진표(金振杓),장철민(張喆敏),64,55,119,1
17156,김진표(金振杓),장혜영(張惠英),8,5,13,1
17157,김진표(金振杓),전봉민(田奉珉),10,1,11,1
17158,김진표(金振杓),전용기(田溶冀),80,84,164,1
17159,김진표(金振杓),전재수(田載秀),48,36,84,1
17160,김진표(金振杓),전주혜(全珠惠),27,1,28,1
17161,김진표(金振杓),전해철(全海澈),44,28,72,1
17162,김진표(金振杓),전혜숙(全惠淑),53,77,130,1
17163,김진표(金振杓),정경희(丁慶姬),25,0,25,1
17164,김진표(金振杓),정동만(鄭東萬),24,0,24,1
17165,김진표(金振杓),정성호(鄭成湖),45,31,76,1
17166,김진표(金振杓),정우택(鄭宇澤),0,0,0,1
17167,김진표(金振杓),정운천(鄭雲天),24,3,27,1
17168,김진표(金振杓),정일영(鄭日永),60,76,136,1
17169,김진표(金振杓),정점식(鄭点植),25,0,25,1
17170,김진표(金振杓),정진석(鄭鎭碩),26,2,28,1
17171,김진표(金振杓),정청래(鄭淸來),54,42,96,1
17172,김진표(金振杓),정춘숙(鄭春淑),56,32,88,1
17173,김진표(金振杓),정태호(鄭泰浩),50,54,104,1
17174,김진표(金振杓),정필모(鄭必模),56,75,131,1
17175,김진표(金振杓),정희용(鄭熙溶),26,1,27,1
17176,김진표(金振杓),조경태(趙慶泰),24,1,25,1
17177,김진표(金振杓),조명희(曺明姬),25,3,28,1
17178,김진표(金振杓),조수진(趙修眞),25,1,26,1
17179,김진표(金振杓),조승래(趙承來),67,45,112,1
17180,김진표(金振杓),조오섭(曺五燮),57,34,91,1
17181,김진표(金振杓),조은희(趙恩禧),0,0,0,1
17182,김진표(金振杓),조응천(趙應天),40,21,61,1
17183,김진표(金振杓),조정식(趙正湜),42,21,63,1
17184,김진표(金振杓),조정훈(趙廷訓),4,3,7,1
17185,김진표(金振杓),조해진(曺海珍),26,1,27,1
17186,김진표(金振杓),주철현(朱哲鉉),48,54,102,1
17187,김진표(金振杓),주호영(朱豪英),25,0,25,1
17188,김진표(金振杓),지성호(池成浩),24,0,24,1
17189,김진표(金振杓),진선미(陳善美),50,30,80,1
17190,김진표(金振杓),진성준(陳聲準),58,50,108,1
17191,김진표(金振杓),천준호(千俊鎬),58,47,105,1
17192,김진표(金振杓),최기상(崔基相),51,45,96,1
17193,김진표(金振杓),최승재(崔承宰),24,0,24,1
17194,김진표(金振杓),최연숙(崔姸淑),5,4,9,1
17195,김진표(金振杓),최영희(崔英姬),0,0,0,1
17196,김진표(金振杓),최인호(崔仁昊),52,38,90,1
17197,김진표(金振杓),최재형(崔在亨),0,0,0,1
17198,김진표(金振杓),최종윤(崔鍾允),79,74,153,1
17199,김진표(金振杓),최춘식(崔春植),24,2,26,1
17200,김진표(金振杓),최형두(崔炯斗),28,7,35,1
17201,김진표(金振杓),최혜영(崔惠英),56,48,104,1
17202,김진표(金振杓),추경호(秋慶鎬),26,2,28,1
17203,김진표(金振杓),태영호(太永浩),24,1,25,1
17204,김진표(金振杓),하영제(河榮帝),25,1,26,0
17205,김진표(金振杓),하태경(河泰慶),24,1,25,1
17206,김진표(金振杓),한기호(韓起鎬),26,3,29,1
17207,김진표(金振杓),한무경(韓茂景),24,0,24,1
17208,김진표(金振杓),한병도(韓秉道),77,77,154,1
17209,김진표(金振杓),한정애(韓貞愛),44,30,74,1
17210,김진표(金振杓),한준호(韓俊鎬),65,66,131,1
17211,김진표(金振杓),허숙정(許淑湞),0,0,0,1
17212,김진표(金振杓),허영(許榮),68,69,137,1
17213,김진표(金振杓),허은아(許垠娥),25,0,25,1
17214,김진표(金振杓),허종식(許琮植),77,58,135,1
17215,김진표(金振杓),홍기원(洪起元),71,69,140,1
17216,김진표(金振杓),홍문표(洪文杓),25,5,30,1
17217,김진표(金振杓),홍석준(洪碩晙),25,1,26,1
17218,김진표(金振杓),홍성국(洪性國),72,79,151,1
17219,김진표(金振杓),홍영표(洪永杓),75,47,122,1
17220,김진표(金振杓),홍익표(洪翼杓),54,34,88,1
17221,김진표(金振杓),홍정민(洪貞敏),67,74,141,1
17222,김진표(金振杓),황보승희(皇甫承希),27,1,28,0
17223,김진표(金振杓),황운하(黃雲夏),67,63,130,1
17224,김진표(金振杓),황희(黃熙),45,23,68,1
17225,김철민(金哲玟),김태년(金太年),92,92,184,0
17226,김철민(金哲玟),김태호(金台鎬),42,4,46,1
17227,김철민(金哲玟),김학용(金學容),25,4,29,1
17228,김철민(金哲玟),김한규(金翰奎),41,32,73,0
17229,김철민(金哲玟),김한정(金漢正),82,45,127,0
17230,김철민(金哲玟),김형동(金亨東),51,4,55,1
17231,김철민(金哲玟),김홍걸(金弘傑),63,180,243,0
17232,김철민(金哲玟),김회재(金會在),111,69,180,0
17233,김철민(金哲玟),김희곤(金熙坤),50,3,53,1
17234,김철민(金哲玟),김희국(金熙國),49,3,52,1
17235,김철민(金哲玟),남인순(南仁順),102,93,195,0
17236,김철민(金哲玟),노용호(魯容昊),26,3,29,1
17237,김철민(金哲玟),노웅래(盧雄來),101,89,190,0
17238,김철민(金哲玟),도종환(都鍾煥),155,216,371,0
17239,김철민(金哲玟),류성걸(柳性杰),50,3,53,1
17240,김철민(金哲玟),류호정(柳好貞),20,36,56,1
17241,김철민(金哲玟),맹성규(孟聖奎),103,81,184,0
17242,김철민(金哲玟),문정복(文貞福),98,99,197,0
17243,김철민(金哲玟),문진석(文振碩),122,174,296,0
17244,김철민(金哲玟),민병덕(閔炳德),107,219,326,0
17245,김철민(金哲玟),민형배(閔馨培),211,460,671,0
17246,김철민(金哲玟),민홍철(閔洪喆),107,78,185,0
17247,김철민(金哲玟),박광온(朴洸瑥),113,153,266,0
17248,김철민(金哲玟),박대수(朴大壽),51,7,58,1
17249,김철민(金哲玟),박대출(朴大出),52,5,57,1
17250,김철민(金哲玟),박덕흠(朴德欽),39,13,52,1
17251,김철민(金哲玟),박범계(朴範界),79,35,114,0
17252,김철민(金哲玟),박병석(朴炳錫),41,18,59,0
17253,김철민(金哲玟),박상혁(朴商赫),127,234,361,0
17254,김철민(金哲玟),박성민(朴聖敏),50,6,56,1
17255,김철민(金哲玟),박성준(朴省俊),111,113,224,0
17256,김철민(金哲玟),박성중(朴成重),49,6,55,1
17257,김철민(金哲玟),박수영(朴洙瑩),49,3,52,1
17258,김철민(金哲玟),박영순(朴英淳),101,95,196,0
17259,김철민(金哲玟),박완주(朴完柱),66,53,119,1
17260,김철민(金哲玟),박용진(朴用鎭),94,111,205,0
17261,김철민(金哲玟),박재호(朴在昊),103,79,182,0
17262,김철민(金哲玟),박정(朴釘),169,262,431,0
17263,김철민(金哲玟),박정하(朴正河),26,3,29,1
17264,김철민(金哲玟),박주민(朴柱民),87,63,150,0
17265,김철민(金哲玟),박진(朴振),50,5,55,1
17266,김철민(金哲玟),박찬대(朴贊大),122,146,268,0
17267,김철민(金哲玟),박형수(朴亨修),49,3,52,1
17268,김철민(金哲玟),박홍근(朴洪根),119,107,226,0
17269,김철민(金哲玟),배준영(裵俊英),49,7,56,1
17270,김철민(金哲玟),배진교(裵晋敎),22,32,54,1
17271,김철민(金哲玟),배현진(裵賢鎭),50,3,53,1
17272,김철민(金哲玟),백종헌(白宗憲),51,3,54,1
17273,김철민(金哲玟),백혜련(白惠蓮),117,114,231,0
17274,김철민(金哲玟),변재일(卞在一),110,123,233,0
17275,김철민(金哲玟),서동용(徐東榕),154,272,426,0
17276,김철민(金哲玟),서범수(徐範洙),50,4,54,1
17277,김철민(金哲玟),서병수(徐秉洙),51,4,55,1
17278,김철민(金哲玟),서삼석(徐參錫),137,161,298,0
17279,김철민(金哲玟),서영교(徐瑛敎),140,199,339,0
17280,김철민(金哲玟),서영석(徐暎錫),122,148,270,0
17281,김철민(金哲玟),서일준(徐一俊),52,3,55,1
17282,김철민(金哲玟),서정숙(徐正淑),51,4,55,1
17283,김철민(金哲玟),설훈(薛勳),89,96,185,0
17284,김철민(金哲玟),성일종(成一鍾),50,10,60,1
17285,김철민(金哲玟),소병철(蘇秉哲),96,75,171,0
17286,김철민(金哲玟),소병훈(蘇秉勳),110,138,248,0
17287,김철민(金哲玟),송갑석(宋甲錫),132,246,378,0
17288,김철민(金哲玟),송기헌(宋基憲),93,59,152,0
17289,김철민(金哲玟),송석준(宋錫俊),52,7,59,1
17290,김철민(金哲玟),송언석(宋彦錫),45,3,48,1
17291,김철민(金哲玟),송옥주(宋玉珠),127,173,300,0
17292,김철민(金哲玟),송재호(宋在祜),111,140,251,0
17293,김철민(金哲玟),신동근(申東根),145,135,280,0
17294,김철민(金哲玟),신영대(申榮大),101,77,178,0
17295,김철민(金哲玟),신원식(申源湜),52,3,55,1
17296,김철민(金哲玟),신정훈(辛正勳),143,205,348,0
17297,김철민(金哲玟),신현영(申賢榮),88,50,138,0
17298,김철민(金哲玟),심상정(沈相奵),18,33,51,1
17299,김철민(金哲玟),안규백(安圭伯),116,140,256,0
17300,김철민(金哲玟),안민석(安敏錫),150,271,421,0
17301,김철민(金哲玟),안병길(安炳吉),50,4,54,1
17302,김철민(金哲玟),안철수(安哲秀),26,3,29,1
17303,김철민(金哲玟),안호영(安浩永),101,101,202,0
17304,김철민(金哲玟),양경숙(梁敬淑),96,183,279,0
17305,김철민(金哲玟),양금희(梁琴喜),51,4,55,1
17306,김철민(金哲玟),양기대(梁基大),99,124,223,0
17307,김철민(金哲玟),양이원영(梁李媛瑛),105,79,184,0
17308,김철민(金哲玟),양정숙(梁貞淑),80,261,341,1
17309,김철민(金哲玟),양향자(梁香子),57,72,129,1
17310,김철민(金哲玟),어기구(魚基龜),101,100,201,0
17311,김철민(金哲玟),엄태영(嚴泰永),52,3,55,1
17312,김철민(金哲玟),오기형(吳奇炯),81,54,135,0
17313,김철민(金哲玟),오영환(吳永煥),173,288,461,0
17314,김철민(金哲玟),용혜인(龍慧仁),19,31,50,1
17315,김철민(金哲玟),우상호(禹相虎),81,40,121,0
17316,김철민(金哲玟),우원식(禹元植),95,80,175,0
17317,김철민(金哲玟),위성곤(魏聖坤),102,142,244,0
17318,김철민(金哲玟),유경준(兪京濬),49,3,52,1
17319,김철민(金哲玟),유기홍(柳基洪),116,128,244,0
17320,김철민(金哲玟),유동수(柳東秀),110,125,235,0
17321,김철민(金哲玟),유상범(劉相凡),52,3,55,1
17322,김철민(金哲玟),유의동(兪義東),49,3,52,1
17323,김철민(金哲玟),유정주(兪訂炷),148,142,290,0
17324,김철민(金哲玟),윤건영(尹建永),78,62,140,0
17325,김철민(金哲玟),윤관석(尹官石),93,73,166,1
17326,김철민(金哲玟),윤두현(尹斗鉉),51,4,55,1
17327,김철민(金哲玟),윤미향(尹美香),53,65,118,1
17328,김철민(金哲玟),윤상현(尹相現),31,6,37,1
17329,김철민(金哲玟),윤영덕(尹永德),116,135,251,0
17330,김철민(金哲玟),윤영석(尹永碩),50,8,58,1
17331,김철민(金哲玟),윤영찬(尹永燦),97,119,216,0
17332,김철민(金哲玟),윤재갑(尹才鉀),122,123,245,0
17333,김철민(金哲玟),윤재옥(尹在玉),49,3,52,1
17334,김철민(金哲玟),윤주경(尹柱卿),50,4,54,1
17335,김철민(金哲玟),윤준병(尹準炳),138,240,378,0
17336,김철민(金哲玟),윤창현(尹暢賢),51,4,55,1
17337,김철민(金哲玟),윤한홍(尹漢洪),50,4,54,1
17338,김철민(金哲玟),윤호중(尹昊重),85,51,136,0
17339,김철민(金哲玟),윤후덕(尹厚德),132,205,337,0
17340,김철민(金哲玟),이개호(李介昊),100,122,222,0
17341,김철민(金哲玟),이달곤(李達坤),52,6,58,1
17342,김철민(金哲玟),이동주(李東洲),95,163,258,0
17343,김철민(金哲玟),이만희(李晩熙),51,4,55,1
17344,김철민(金哲玟),이명수(李明洙),51,10,61,1
17345,김철민(金哲玟),이병훈(李炳勳),146,216,362,0
17346,김철민(金哲玟),이상민(李相珉),76,39,115,0
17347,김철민(金哲玟),이상헌(李相憲),124,115,239,0
17348,김철민(金哲玟),이성만(李成萬),91,114,205,1
17349,김철민(金哲玟),이소영(李素永),97,67,164,0
17350,김철민(金哲玟),이수진(李壽珍),118,144,262,0
17351,김철민(金哲玟),이수진(李秀眞),120,111,231,0
17352,김철민(金哲玟),이양수(李亮壽),53,5,58,1
17353,김철민(金哲玟),이용(李鏞),50,3,53,1
17354,김철민(金哲玟),이용빈(李龍彬),146,272,418,0
17355,김철민(金哲玟),이용선(李庸瑄),120,105,225,0
17356,김철민(金哲玟),이용우(李龍雨),112,81,193,0
17357,김철민(金哲玟),이용호(李容鎬),46,28,74,1
17358,김철민(金哲玟),이원욱(李元旭),149,210,359,0
17359,김철민(金哲玟),이원택(李源澤),109,88,197,0
17360,김철민(金哲玟),이은주(李恩周),26,28,54,1
17361,김철민(金哲玟),이인선(李仁善),25,3,28,1
17362,김철민(金哲玟),이인영(李仁榮),77,44,121,0
17363,김철민(金哲玟),이장섭(李將燮),110,127,237,0
17364,김철민(金哲玟),이재명(李在明),39,21,60,0
17365,김철민(金哲玟),이재정(李在汀),88,54,142,0
17366,김철민(金哲玟),이정문(李楨文),185,329,514,0
17367,김철민(金哲玟),이종배(李鍾培),51,5,56,1
17368,김철민(金哲玟),이종성(李鍾成),51,6,57,1
17369,김철민(金哲玟),이주환(李周桓),51,5,56,1
17370,김철민(金哲玟),이채익(李埰益),52,10,62,1
17371,김철민(金哲玟),이철규(李喆圭),55,6,61,1
17372,김철민(金哲玟),이탄희(李誕熙),113,99,212,0
17373,김철민(金哲玟),이태규(李泰珪),29,6,35,1
17374,김철민(金哲玟),이학영(李學永),106,79,185,0
17375,김철민(金哲玟),이해식(李海植),121,122,243,0
17376,김철민(金哲玟),이헌승(李憲昇),50,5,55,1
17377,김철민(金哲玟),이형석(李炯錫),114,120,234,0
17378,김철민(金哲玟),인재근(印在謹),115,132,247,0
17379,김철민(金哲玟),임병헌(林炳憲),25,3,28,1
17380,김철민(金哲玟),임오경(林五卿),112,115,227,0
17381,김철민(金哲玟),임이자(林利子),49,3,52,1
17382,김철민(金哲玟),임종성(林鍾聲),146,223,369,0
17383,김철민(金哲玟),임호선(林昊宣),141,227,368,0
17384,김철민(金哲玟),장경태(張耿態),121,133,254,0
17385,김철민(金哲玟),장동혁(張東赫),25,3,28,1
17386,김철민(金哲玟),장제원(張濟元),49,3,52,1
17387,김철민(金哲玟),장철민(張喆敏),107,109,216,0
17388,김철민(金哲玟),장혜영(張惠英),26,27,53,1
17389,김철민(金哲玟),전봉민(田奉珉),35,4,39,1
17390,김철민(金哲玟),전용기(田溶冀),120,137,257,0
17391,김철민(金哲玟),전재수(田載秀),105,77,182,0
17392,김철민(金哲玟),전주혜(全珠惠),52,4,56,1
17393,김철민(金哲玟),전해철(全海澈),80,76,156,0
17394,김철민(金哲玟),전혜숙(全惠淑),113,123,236,0
17395,김철민(金哲玟),정경희(丁慶姬),52,5,57,1
17396,김철민(金哲玟),정동만(鄭東萬),49,3,52,1
17397,김철민(金哲玟),정성호(鄭成湖),87,95,182,0
17398,김철민(金哲玟),정우택(鄭宇澤),27,3,30,1
17399,김철민(金哲玟),정운천(鄭雲天),50,7,57,1
17400,김철민(金哲玟),정일영(鄭日永),84,76,160,0
17401,김철민(金哲玟),정점식(鄭点植),51,4,55,1
17402,김철민(金哲玟),정진석(鄭鎭碩),50,5,55,1
17403,김철민(金哲玟),정청래(鄭淸來),102,62,164,0
17404,김철민(金哲玟),정춘숙(鄭春淑),124,186,310,0
17405,김철민(金哲玟),정태호(鄭泰浩),91,91,182,0
17406,김철민(金哲玟),정필모(鄭必模),102,85,187,0
17407,김철민(金哲玟),정희용(鄭熙溶),50,4,54,1
17408,김철민(金哲玟),조경태(趙慶泰),50,6,56,1
17409,김철민(金哲玟),조명희(曺明姬),51,7,58,1
17410,김철민(金哲玟),조수진(趙修眞),50,3,53,1
17411,김철민(金哲玟),조승래(趙承來),124,117,241,0
17412,김철민(金哲玟),조오섭(曺五燮),115,178,293,0
17413,김철민(金哲玟),조은희(趙恩禧),26,3,29,1
17414,김철민(金哲玟),조응천(趙應天),87,44,131,0
17415,김철민(金哲玟),조정식(趙正湜),79,42,121,0
17416,김철민(金哲玟),조정훈(趙廷訓),5,9,14,1
17417,김철민(金哲玟),조해진(曺海珍),51,5,56,1
17418,김철민(金哲玟),주철현(朱哲鉉),121,141,262,0
17419,김철민(金哲玟),주호영(朱豪英),49,3,52,1
17420,김철민(金哲玟),지성호(池成浩),50,4,54,1
17421,김철민(金哲玟),진선미(陳善美),91,62,153,0
17422,김철민(金哲玟),진성준(陳聲準),101,67,168,0
17423,김철민(金哲玟),천준호(千俊鎬),97,72,169,0
17424,김철민(金哲玟),최기상(崔基相),88,73,161,0
17425,김철민(金哲玟),최승재(崔承宰),51,4,55,1
17426,김철민(金哲玟),최연숙(崔姸淑),32,10,42,1
17427,김철민(金哲玟),최영희(崔英姬),25,4,29,1
17428,김철민(金哲玟),최인호(崔仁昊),107,93,200,0
17429,김철민(金哲玟),최재형(崔在亨),25,3,28,1
17430,김철민(金哲玟),최종윤(崔鍾允),121,182,303,0
17431,김철민(金哲玟),최춘식(崔春植),49,10,59,1
17432,김철민(金哲玟),최형두(崔炯斗),50,5,55,1
17433,김철민(金哲玟),최혜영(崔惠英),110,95,205,0
17434,김철민(金哲玟),추경호(秋慶鎬),50,5,55,1
17435,김철민(金哲玟),태영호(太永浩),50,3,53,1
17436,김철민(金哲玟),하영제(河榮帝),42,3,45,1
17437,김철민(金哲玟),하태경(河泰慶),50,3,53,1
17438,김철민(金哲玟),한기호(韓起鎬),52,7,59,1
17439,김철민(金哲玟),한무경(韓茂景),49,4,53,1
17440,김철민(金哲玟),한병도(韓秉道),138,166,304,0
17441,김철민(金哲玟),한정애(韓貞愛),81,67,148,0
17442,김철민(金哲玟),한준호(韓俊鎬),110,126,236,0
17443,김철민(金哲玟),허숙정(許淑湞),1,1,2,0
17444,김철민(金哲玟),허영(許榮),126,146,272,0
17445,김철민(金哲玟),허은아(許垠娥),49,4,53,1
17446,김철민(金哲玟),허종식(許琮植),88,89,177,0
17447,김철민(金哲玟),홍기원(洪起元),105,153,258,0
17448,김철민(金哲玟),홍문표(洪文杓),50,7,57,1
17449,김철민(金哲玟),홍석준(洪碩晙),50,3,53,1
17450,김철민(金哲玟),홍성국(洪性國),119,162,281,0
17451,김철민(金哲玟),홍영표(洪永杓),84,63,147,0
17452,김철민(金哲玟),홍익표(洪翼杓),102,126,228,0
17453,김철민(金哲玟),홍정민(洪貞敏),117,129,246,0
17454,김철민(金哲玟),황보승희(皇甫承希),48,4,52,1
17455,김철민(金哲玟),황운하(黃雲夏),127,144,271,0
17456,김철민(金哲玟),황희(黃熙),93,61,154,0
17457,김태년(金太年),김태호(金台鎬),41,5,46,1
17458,김태년(金太年),김학용(金學容),26,6,32,1
17459,김태년(金太年),김한규(金翰奎),41,52,93,0
17460,김태년(金太年),김한정(金漢正),75,35,110,0
17461,김태년(金太年),김형동(金亨東),50,4,54,1
17462,김태년(金太年),김홍걸(金弘傑),33,66,99,0
17463,김태년(金太年),김회재(金會在),86,48,134,0
17464,김태년(金太年),김희곤(金熙坤),49,5,54,1
17465,김태년(金太年),김희국(金熙國),50,4,54,1
17466,김태년(金太年),남인순(南仁順),77,54,131,0
17467,김태년(金太年),노용호(魯容昊),25,4,29,1
17468,김태년(金太年),노웅래(盧雄來),79,45,124,0
17469,김태년(金太年),도종환(都鍾煥),86,62,148,0
17470,김태년(金太年),류성걸(柳性杰),50,4,54,1
17471,김태년(金太年),류호정(柳好貞),12,11,23,1
17472,김태년(金太年),맹성규(孟聖奎),75,51,126,0
17473,김태년(金太年),문정복(文貞福),81,52,133,0
17474,김태년(金太年),문진석(文振碩),78,59,137,0
17475,김태년(金太年),민병덕(閔炳德),79,79,158,0
17476,김태년(金太年),민형배(閔馨培),60,71,131,0
17477,김태년(金太年),민홍철(閔洪喆),73,52,125,0
17478,김태년(金太年),박광온(朴洸瑥),83,47,130,0
17479,김태년(金太年),박대수(朴大壽),50,5,55,1
17480,김태년(金太年),박대출(朴大出),49,4,53,1
17481,김태년(金太年),박덕흠(朴德欽),36,5,41,1
17482,김태년(金太年),박범계(朴範界),73,31,104,0
17483,김태년(金太年),박병석(朴炳錫),40,18,58,0
17484,김태년(金太年),박상혁(朴商赫),76,71,147,0
17485,김태년(金太年),박성민(朴聖敏),50,6,56,1
17486,김태년(金太年),박성준(朴省俊),78,45,123,0
17487,김태년(金太年),박성중(朴成重),49,4,53,1
17488,김태년(金太年),박수영(朴洙瑩),49,6,55,1
17489,김태년(金太年),박영순(朴英淳),75,43,118,0
17490,김태년(金太年),박완주(朴完柱),39,27,66,1
17491,김태년(金太年),박용진(朴用鎭),73,36,109,0
17492,김태년(金太年),박재호(朴在昊),79,45,124,0
17493,김태년(金太年),박정(朴釘),75,50,125,0
17494,김태년(金太年),박정하(朴正河),26,5,31,1
17495,김태년(金太年),박주민(朴柱民),76,40,116,0
17496,김태년(金太年),박진(朴振),49,4,53,1
17497,김태년(金太年),박찬대(朴贊大),74,43,117,0
17498,김태년(金太年),박형수(朴亨修),50,4,54,1
17499,김태년(金太年),박홍근(朴洪根),77,54,131,0
17500,김태년(金太年),배준영(裵俊英),49,5,54,1
17501,김태년(金太年),배진교(裵晋敎),11,10,21,1
17502,김태년(金太年),배현진(裵賢鎭),50,5,55,1
17503,김태년(金太年),백종헌(白宗憲),49,4,53,1
17504,김태년(金太年),백혜련(白惠蓮),76,41,117,0
17505,김태년(金太年),변재일(卞在一),73,41,114,0
17506,김태년(金太年),서동용(徐東榕),83,86,169,0
17507,김태년(金太年),서범수(徐範洙),49,6,55,1
17508,김태년(金太年),서병수(徐秉洙),49,4,53,1
17509,김태년(金太年),서삼석(徐參錫),79,42,121,0
17510,김태년(金太年),서영교(徐瑛敎),79,84,163,0
17511,김태년(金太年),서영석(徐暎錫),79,79,158,0
17512,김태년(金太年),서일준(徐一俊),49,4,53,1
17513,김태년(金太年),서정숙(徐正淑),50,9,59,1
17514,김태년(金太年),설훈(薛勳),77,51,128,0
17515,김태년(金太年),성일종(成一鍾),49,5,54,1
17516,김태년(金太年),소병철(蘇秉哲),77,42,119,0
17517,김태년(金太年),소병훈(蘇秉勳),81,61,142,0
17518,김태년(金太年),송갑석(宋甲錫),78,68,146,0
17519,김태년(金太年),송기헌(宋基憲),78,46,124,0
17520,김태년(金太年),송석준(宋錫俊),50,5,55,1
17521,김태년(金太年),송언석(宋彦錫),46,4,50,1
17522,김태년(金太年),송옥주(宋玉珠),80,42,122,0
17523,김태년(金太年),송재호(宋在祜),80,52,132,0
17524,김태년(金太年),신동근(申東根),77,61,138,0
17525,김태년(金太年),신영대(申榮大),77,42,119,0
17526,김태년(金太年),신원식(申源湜),50,4,54,1
17527,김태년(金太年),신정훈(辛正勳),84,97,181,0
17528,김태년(金太年),신현영(申賢榮),73,40,113,0
17529,김태년(金太年),심상정(沈相奵),10,10,20,1
17530,김태년(金太年),안규백(安圭伯),77,48,125,0
17531,김태년(金太年),안민석(安敏錫),77,51,128,0
17532,김태년(金太年),안병길(安炳吉),49,4,53,1
17533,김태년(金太年),안철수(安哲秀),26,4,30,1
17534,김태년(金太年),안호영(安浩永),73,42,115,0
17535,김태년(金太年),양경숙(梁敬淑),77,62,139,0
17536,김태년(金太年),양금희(梁琴喜),50,5,55,1
17537,김태년(金太年),양기대(梁基大),80,68,148,0
17538,김태년(金太年),양이원영(梁李媛瑛),70,50,120,0
17539,김태년(金太年),양정숙(梁貞淑),8,40,48,1
17540,김태년(金太年),양향자(梁香子),28,22,50,1
17541,김태년(金太年),어기구(魚基龜),75,52,127,0
17542,김태년(金太年),엄태영(嚴泰永),50,4,54,1
17543,김태년(金太年),오기형(吳奇炯),73,37,110,0
17544,김태년(金太年),오영환(吳永煥),78,66,144,0
17545,김태년(金太年),용혜인(龍慧仁),9,10,19,1
17546,김태년(金太年),우상호(禹相虎),76,36,112,0
17547,김태년(金太年),우원식(禹元植),76,46,122,0
17548,김태년(金太年),위성곤(魏聖坤),75,67,142,0
17549,김태년(金太年),유경준(兪京濬),50,4,54,1
17550,김태년(金太年),유기홍(柳基洪),81,52,133,0
17551,김태년(金太年),유동수(柳東秀),75,41,116,0
17552,김태년(金太年),유상범(劉相凡),50,4,54,1
17553,김태년(金太年),유의동(兪義東),50,4,54,1
17554,김태년(金太年),유정주(兪訂炷),75,53,128,0
17555,김태년(金太年),윤건영(尹建永),74,47,121,0
17556,김태년(金太年),윤관석(尹官石),67,32,99,1
17557,김태년(金太年),윤두현(尹斗鉉),50,6,56,1
17558,김태년(金太年),윤미향(尹美香),28,22,50,1
17559,김태년(金太年),윤상현(尹相現),30,4,34,1
17560,김태년(金太年),윤영덕(尹永德),77,56,133,0
17561,김태년(金太年),윤영석(尹永碩),49,4,53,1
17562,김태년(金太年),윤영찬(尹永燦),76,58,134,0
17563,김태년(金太年),윤재갑(尹才鉀),79,44,123,0
17564,김태년(金太年),윤재옥(尹在玉),50,5,55,1
17565,김태년(金太年),윤주경(尹柱卿),50,5,55,1
17566,김태년(金太年),윤준병(尹準炳),77,94,171,0
17567,김태년(金太年),윤창현(尹暢賢),50,6,56,1
17568,김태년(金太年),윤한홍(尹漢洪),49,5,54,1
17569,김태년(金太年),윤호중(尹昊重),75,41,116,0
17570,김태년(金太年),윤후덕(尹厚德),74,65,139,0
17571,김태년(金太年),이개호(李介昊),77,61,138,0
17572,김태년(金太年),이달곤(李達坤),51,8,59,1
17573,김태년(金太年),이동주(李東洲),76,72,148,0
17574,김태년(金太年),이만희(李晩熙),50,4,54,1
17575,김태년(金太年),이명수(李明洙),49,10,59,1
17576,김태년(金太年),이병훈(李炳勳),83,72,155,0
17577,김태년(金太年),이상민(李相珉),73,31,104,0
17578,김태년(金太年),이상헌(李相憲),76,60,136,0
17579,김태년(金太年),이성만(李成萬),70,71,141,1
17580,김태년(金太年),이소영(李素永),74,52,126,0
17581,김태년(金太年),이수진(李壽珍),75,51,126,0
17582,김태년(金太年),이수진(李秀眞),78,52,130,0
17583,김태년(金太年),이양수(李亮壽),50,4,54,1
17584,김태년(金太年),이용(李鏞),50,4,54,1
17585,김태년(金太年),이용빈(李龍彬),78,90,168,0
17586,김태년(金太年),이용선(李庸瑄),76,55,131,0
17587,김태년(金太年),이용우(李龍雨),82,44,126,0
17588,김태년(金太年),이용호(李容鎬),27,5,32,1
17589,김태년(金太年),이원욱(李元旭),75,80,155,0
17590,김태년(金太年),이원택(李源澤),82,43,125,0
17591,김태년(金太年),이은주(李恩周),11,7,18,1
17592,김태년(金太年),이인선(李仁善),26,5,31,1
17593,김태년(金太年),이인영(李仁榮),75,42,117,0
17594,김태년(金太年),이장섭(李將燮),75,50,125,0
17595,김태년(金太年),이재명(李在明),39,20,59,0
17596,김태년(金太年),이재정(李在汀),75,40,115,0
17597,김태년(金太年),이정문(李楨文),76,48,124,0
17598,김태년(金太年),이종배(李鍾培),50,6,56,1
17599,김태년(金太年),이종성(李鍾成),50,4,54,1
17600,김태년(金太年),이주환(李周桓),49,4,53,1
17601,김태년(金太年),이채익(李埰益),50,5,55,1
17602,김태년(金太年),이철규(李喆圭),50,5,55,1
17603,김태년(金太年),이탄희(李誕熙),79,46,125,0
17604,김태년(金太年),이태규(李泰珪),28,5,33,1
17605,김태년(金太年),이학영(李學永),79,59,138,0
17606,김태년(金太年),이해식(李海植),75,38,113,0
17607,김태년(金太年),이헌승(李憲昇),49,5,54,1
17608,김태년(金太年),이형석(李炯錫),77,49,126,0
17609,김태년(金太年),인재근(印在謹),77,64,141,0
17610,김태년(金太年),임병헌(林炳憲),26,5,31,1
17611,김태년(金太年),임오경(林五卿),74,46,120,0
17612,김태년(金太年),임이자(林利子),50,5,55,1
17613,김태년(金太年),임종성(林鍾聲),77,56,133,0
17614,김태년(金太年),임호선(林昊宣),78,78,156,0
17615,김태년(金太年),장경태(張耿態),76,54,130,0
17616,김태년(金太年),장동혁(張東赫),26,4,30,1
17617,김태년(金太年),장제원(張濟元),49,4,53,1
17618,김태년(金太年),장철민(張喆敏),76,62,138,0
17619,김태년(金太年),장혜영(張惠英),10,6,16,1
17620,김태년(金太年),전봉민(田奉珉),35,6,41,1
17621,김태년(金太年),전용기(田溶冀),74,48,122,0
17622,김태년(金太年),전재수(田載秀),79,43,122,0
17623,김태년(金太年),전주혜(全珠惠),51,5,56,1
17624,김태년(金太年),전해철(全海澈),72,45,117,0
17625,김태년(金太年),전혜숙(全惠淑),77,55,132,0
17626,김태년(金太年),정경희(丁慶姬),49,5,54,1
17627,김태년(金太年),정동만(鄭東萬),49,5,54,1
17628,김태년(金太年),정성호(鄭成湖),76,51,127,0
17629,김태년(金太年),정우택(鄭宇澤),25,5,30,1
17630,김태년(金太年),정운천(鄭雲天),50,5,55,1
17631,김태년(金太年),정일영(鄭日永),76,53,129,0
17632,김태년(金太年),정점식(鄭点植),49,4,53,1
17633,김태년(金太年),정진석(鄭鎭碩),49,4,53,1
17634,김태년(金太年),정청래(鄭淸來),74,30,104,0
17635,김태년(金太年),정춘숙(鄭春淑),76,63,139,0
17636,김태년(金太年),정태호(鄭泰浩),77,95,172,0
17637,김태년(金太年),정필모(鄭必模),78,44,122,0
17638,김태년(金太年),정희용(鄭熙溶),51,6,57,1
17639,김태년(金太年),조경태(趙慶泰),49,5,54,1
17640,김태년(金太年),조명희(曺明姬),50,6,56,1
17641,김태년(金太年),조수진(趙修眞),49,4,53,1
17642,김태년(金太年),조승래(趙承來),82,74,156,0
17643,김태년(金太年),조오섭(曺五燮),77,97,174,0
17644,김태년(金太年),조은희(趙恩禧),26,4,30,1
17645,김태년(金太年),조응천(趙應天),70,37,107,0
17646,김태년(金太年),조정식(趙正湜),73,43,116,0
17647,김태년(金太年),조정훈(趙廷訓),0,1,1,1
17648,김태년(金太年),조해진(曺海珍),51,5,56,1
17649,김태년(金太年),주철현(朱哲鉉),76,54,130,0
17650,김태년(金太年),주호영(朱豪英),50,4,54,1
17651,김태년(金太年),지성호(池成浩),50,4,54,1
17652,김태년(金太年),진선미(陳善美),75,47,122,0
17653,김태년(金太年),진성준(陳聲準),76,40,116,0
17654,김태년(金太年),천준호(千俊鎬),74,37,111,0
17655,김태년(金太年),최기상(崔基相),77,49,126,0
17656,김태년(金太年),최승재(崔承宰),50,5,55,1
17657,김태년(金太年),최연숙(崔姸淑),31,7,38,1
17658,김태년(金太年),최영희(崔英姬),26,5,31,1
17659,김태년(金太年),최인호(崔仁昊),81,63,144,0
17660,김태년(金太年),최재형(崔在亨),26,5,31,1
17661,김태년(金太年),최종윤(崔鍾允),77,76,153,0
17662,김태년(金太年),최춘식(崔春植),50,6,56,1
17663,김태년(金太年),최형두(崔炯斗),50,5,55,1
17664,김태년(金太年),최혜영(崔惠英),76,62,138,0
17665,김태년(金太年),추경호(秋慶鎬),49,3,52,1
17666,김태년(金太年),태영호(太永浩),50,5,55,1
17667,김태년(金太年),하영제(河榮帝),41,1,42,1
17668,김태년(金太年),하태경(河泰慶),49,5,54,1
17669,김태년(金太年),한기호(韓起鎬),50,7,57,1
17670,김태년(金太年),한무경(韓茂景),50,5,55,1
17671,김태년(金太年),한병도(韓秉道),80,71,151,0
17672,김태년(金太年),한정애(韓貞愛),72,43,115,0
17673,김태년(金太年),한준호(韓俊鎬),78,90,168,0
17674,김태년(金太年),허숙정(許淑湞),1,1,2,0
17675,김태년(金太年),허영(許榮),77,77,154,0
17676,김태년(金太年),허은아(許垠娥),50,4,54,1
17677,김태년(金太年),허종식(許琮植),74,54,128,0
17678,김태년(金太年),홍기원(洪起元),80,60,140,0
17679,김태년(金太年),홍문표(洪文杓),49,4,53,1
17680,김태년(金太年),홍석준(洪碩晙),50,4,54,1
17681,김태년(金太年),홍성국(洪性國),84,101,185,0
17682,김태년(金太年),홍영표(洪永杓),76,53,129,0
17683,김태년(金太年),홍익표(洪翼杓),74,51,125,0
17684,김태년(金太年),홍정민(洪貞敏),77,68,145,0
17685,김태년(金太年),황보승희(皇甫承希),45,2,47,1
17686,김태년(金太年),황운하(黃雲夏),73,46,119,0
17687,김태년(金太年),황희(黃熙),72,37,109,0
17688,김태호(金台鎬),김학용(金學容),32,44,76,0
17689,김태호(金台鎬),김한규(金翰奎),25,6,31,1
17690,김태호(金台鎬),김한정(金漢正),41,4,45,1
17691,김태호(金台鎬),김형동(金亨東),76,105,181,0
17692,김태호(金台鎬),김홍걸(金弘傑),7,10,17,1
17693,김태호(金台鎬),김회재(金會在),44,4,48,1
17694,김태호(金台鎬),김희곤(金熙坤),63,79,142,0
17695,김태호(金台鎬),김희국(金熙國),58,44,102,0
17696,김태호(金台鎬),남인순(南仁順),41,7,48,1
17697,김태호(金台鎬),노용호(魯容昊),26,18,44,0
17698,김태호(金台鎬),노웅래(盧雄來),41,4,45,1
17699,김태호(金台鎬),도종환(都鍾煥),41,8,49,1
17700,김태호(金台鎬),류성걸(柳性杰),62,57,119,0
17701,김태호(金台鎬),류호정(柳好貞),5,7,12,1
17702,김태호(金台鎬),맹성규(孟聖奎),41,4,45,1
17703,김태호(金台鎬),문정복(文貞福),41,8,49,1
17704,김태호(金台鎬),문진석(文振碩),42,7,49,1
17705,김태호(金台鎬),민병덕(閔炳德),42,9,51,1
17706,김태호(金台鎬),민형배(閔馨培),26,10,36,1
17707,김태호(金台鎬),민홍철(閔洪喆),43,8,51,1
17708,김태호(金台鎬),박광온(朴洸瑥),41,5,46,1
17709,김태호(金台鎬),박대수(朴大壽),85,138,223,0
17710,김태호(金台鎬),박대출(朴大出),56,63,119,0
17711,김태호(金台鎬),박덕흠(朴德欽),54,89,143,0
17712,김태호(金台鎬),박범계(朴範界),41,4,45,1
17713,김태호(金台鎬),박병석(朴炳錫),25,3,28,1
17714,김태호(金台鎬),박상혁(朴商赫),41,5,46,1
17715,김태호(金台鎬),박성민(朴聖敏),64,83,147,0
17716,김태호(金台鎬),박성준(朴省俊),41,7,48,1
17717,김태호(金台鎬),박성중(朴成重),61,60,121,0
17718,김태호(金台鎬),박수영(朴洙瑩),53,47,100,0
17719,김태호(金台鎬),박영순(朴英淳),42,6,48,1
17720,김태호(金台鎬),박완주(朴完柱),17,1,18,1
17721,김태호(金台鎬),박용진(朴用鎭),41,6,47,1
17722,김태호(金台鎬),박재호(朴在昊),44,10,54,1
17723,김태호(金台鎬),박정(朴釘),42,8,50,1
17724,김태호(金台鎬),박정하(朴正河),28,20,48,0
17725,김태호(金台鎬),박주민(朴柱民),42,5,47,1
17726,김태호(金台鎬),박진(朴振),59,46,105,0
17727,김태호(金台鎬),박찬대(朴贊大),41,5,46,1
17728,김태호(金台鎬),박형수(朴亨修),54,51,105,0
17729,김태호(金台鎬),박홍근(朴洪根),44,9,53,1
17730,김태호(金台鎬),배준영(裵俊英),62,53,115,0
17731,김태호(金台鎬),배진교(裵晋敎),6,4,10,1
17732,김태호(金台鎬),배현진(裵賢鎭),59,44,103,0
17733,김태호(金台鎬),백종헌(白宗憲),67,93,160,0
17734,김태호(金台鎬),백혜련(白惠蓮),42,7,49,1
17735,김태호(金台鎬),변재일(卞在一),41,4,45,1
17736,김태호(金台鎬),서동용(徐東榕),43,7,50,1
17737,김태호(金台鎬),서범수(徐範洙),64,63,127,0
17738,김태호(金台鎬),서병수(徐秉洙),73,93,166,0
17739,김태호(金台鎬),서삼석(徐參錫),47,6,53,1
17740,김태호(金台鎬),서영교(徐瑛敎),44,6,50,1
17741,김태호(金台鎬),서영석(徐暎錫),44,8,52,1
17742,김태호(金台鎬),서일준(徐一俊),86,118,204,0
17743,김태호(金台鎬),서정숙(徐正淑),59,48,107,0
17744,김태호(金台鎬),설훈(薛勳),43,8,51,1
17745,김태호(金台鎬),성일종(成一鍾),75,97,172,0
17746,김태호(金台鎬),소병철(蘇秉哲),43,6,49,1
17747,김태호(金台鎬),소병훈(蘇秉勳),41,6,47,1
17748,김태호(金台鎬),송갑석(宋甲錫),42,7,49,1
17749,김태호(金台鎬),송기헌(宋基憲),42,5,47,1
17750,김태호(金台鎬),송석준(宋錫俊),56,46,102,0
17751,김태호(金台鎬),송언석(宋彦錫),57,52,109,0
17752,김태호(金台鎬),송옥주(宋玉珠),42,5,47,1
17753,김태호(金台鎬),송재호(宋在祜),41,6,47,1
17754,김태호(金台鎬),신동근(申東根),43,8,51,1
17755,김태호(金台鎬),신영대(申榮大),41,6,47,1
17756,김태호(金台鎬),신원식(申源湜),55,53,108,0
17757,김태호(金台鎬),신정훈(辛正勳),43,4,47,1
17758,김태호(金台鎬),신현영(申賢榮),40,4,44,1
17759,김태호(金台鎬),심상정(沈相奵),7,3,10,1
17760,김태호(金台鎬),안규백(安圭伯),42,9,51,1
17761,김태호(金台鎬),안민석(安敏錫),42,5,47,1
17762,김태호(金台鎬),안병길(安炳吉),68,92,160,0
17763,김태호(金台鎬),안철수(安哲秀),26,32,58,0
17764,김태호(金台鎬),안호영(安浩永),46,9,55,1
17765,김태호(金台鎬),양경숙(梁敬淑),44,5,49,1
17766,김태호(金台鎬),양금희(梁琴喜),60,75,135,0
17767,김태호(金台鎬),양기대(梁基大),43,4,47,1
17768,김태호(金台鎬),양이원영(梁李媛瑛),37,5,42,1
17769,김태호(金台鎬),양정숙(梁貞淑),5,3,8,1
17770,김태호(金台鎬),양향자(梁香子),17,8,25,1
17771,김태호(金台鎬),어기구(魚基龜),42,11,53,1
17772,김태호(金台鎬),엄태영(嚴泰永),62,82,144,0
17773,김태호(金台鎬),오기형(吳奇炯),40,4,44,1
17774,김태호(金台鎬),오영환(吳永煥),42,9,51,1
17775,김태호(金台鎬),용혜인(龍慧仁),2,1,3,1
17776,김태호(金台鎬),우상호(禹相虎),42,4,46,1
17777,김태호(金台鎬),우원식(禹元植),41,5,46,1
17778,김태호(金台鎬),위성곤(魏聖坤),42,8,50,1
17779,김태호(金台鎬),유경준(兪京濬),63,61,124,0
17780,김태호(金台鎬),유기홍(柳基洪),41,5,46,1
17781,김태호(金台鎬),유동수(柳東秀),41,6,47,1
17782,김태호(金台鎬),유상범(劉相凡),52,39,91,0
17783,김태호(金台鎬),유의동(兪義東),55,49,104,0
17784,김태호(金台鎬),유정주(兪訂炷),41,5,46,1
17785,김태호(金台鎬),윤건영(尹建永),40,4,44,1
17786,김태호(金台鎬),윤관석(尹官石),33,0,33,1
17787,김태호(金台鎬),윤두현(尹斗鉉),69,69,138,0
17788,김태호(金台鎬),윤미향(尹美香),12,0,12,1
17789,김태호(金台鎬),윤상현(尹相現),38,44,82,0
17790,김태호(金台鎬),윤영덕(尹永德),42,6,48,1
17791,김태호(金台鎬),윤영석(尹永碩),66,69,135,0
17792,김태호(金台鎬),윤영찬(尹永燦),42,5,47,1
17793,김태호(金台鎬),윤재갑(尹才鉀),48,13,61,1
17794,김태호(金台鎬),윤재옥(尹在玉),51,46,97,0
17795,김태호(金台鎬),윤주경(尹柱卿),54,54,108,0
17796,김태호(金台鎬),윤준병(尹準炳),45,7,52,1
17797,김태호(金台鎬),윤창현(尹暢賢),65,91,156,0
17798,김태호(金台鎬),윤한홍(尹漢洪),56,49,105,0
17799,김태호(金台鎬),윤호중(尹昊重),41,7,48,1
17800,김태호(金台鎬),윤후덕(尹厚德),41,8,49,1
17801,김태호(金台鎬),이개호(李介昊),47,5,52,1
17802,김태호(金台鎬),이달곤(李達坤),64,71,135,0
17803,김태호(金台鎬),이동주(李東洲),41,4,45,1
17804,김태호(金台鎬),이만희(李晩熙),59,41,100,0
17805,김태호(金台鎬),이명수(李明洙),73,101,174,0
17806,김태호(金台鎬),이병훈(李炳勳),44,8,52,1
17807,김태호(金台鎬),이상민(李相珉),41,4,45,1
17808,김태호(金台鎬),이상헌(李相憲),42,8,50,1
17809,김태호(金台鎬),이성만(李成萬),33,1,34,1
17810,김태호(金台鎬),이소영(李素永),43,4,47,1
17811,김태호(金台鎬),이수진(李壽珍),43,5,48,1
17812,김태호(金台鎬),이수진(李秀眞),42,6,48,1
17813,김태호(金台鎬),이양수(李亮壽),68,60,128,0
17814,김태호(金台鎬),이용(李鏞),72,75,147,0
17815,김태호(金台鎬),이용빈(李龍彬),43,9,52,1
17816,김태호(金台鎬),이용선(李庸瑄),42,5,47,1
17817,김태호(金台鎬),이용우(李龍雨),41,5,46,1
17818,김태호(金台鎬),이용호(李容鎬),31,19,50,0
17819,김태호(金台鎬),이원욱(李元旭),41,7,48,1
17820,김태호(金台鎬),이원택(李源澤),43,6,49,1
17821,김태호(金台鎬),이은주(李恩周),7,5,12,1
17822,김태호(金台鎬),이인선(李仁善),26,19,45,0
17823,김태호(金台鎬),이인영(李仁榮),41,4,45,1
17824,김태호(金台鎬),이장섭(李將燮),41,7,48,1
17825,김태호(金台鎬),이재명(李在明),25,4,29,1
17826,김태호(金台鎬),이재정(李在汀),41,7,48,1
17827,김태호(金台鎬),이정문(李楨文),41,8,49,1
17828,김태호(金台鎬),이종배(李鍾培),79,85,164,0
17829,김태호(金台鎬),이종성(李鍾成),85,128,213,0
17830,김태호(金台鎬),이주환(李周桓),65,86,151,0
17831,김태호(金台鎬),이채익(李埰益),63,74,137,0
17832,김태호(金台鎬),이철규(李喆圭),56,50,106,0
17833,김태호(金台鎬),이탄희(李誕熙),42,4,46,1
17834,김태호(金台鎬),이태규(李泰珪),38,38,76,0
17835,김태호(金台鎬),이학영(李學永),41,6,47,1
17836,김태호(金台鎬),이해식(李海植),41,4,45,1
17837,김태호(金台鎬),이헌승(李憲昇),59,72,131,0
17838,김태호(金台鎬),이형석(李炯錫),41,7,48,1
17839,김태호(金台鎬),인재근(印在謹),41,7,48,1
17840,김태호(金台鎬),임병헌(林炳憲),30,33,63,0
17841,김태호(金台鎬),임오경(林五卿),42,4,46,1
17842,김태호(金台鎬),임이자(林利子),72,68,140,0
17843,김태호(金台鎬),임종성(林鍾聲),42,7,49,1
17844,김태호(金台鎬),임호선(林昊宣),42,6,48,1
17845,김태호(金台鎬),장경태(張耿態),43,5,48,1
17846,김태호(金台鎬),장동혁(張東赫),27,18,45,0
17847,김태호(金台鎬),장제원(張濟元),47,39,86,0
17848,김태호(金台鎬),장철민(張喆敏),42,4,46,1
17849,김태호(金台鎬),장혜영(張惠英),8,4,12,1
17850,김태호(金台鎬),전봉민(田奉珉),35,55,90,0
17851,김태호(金台鎬),전용기(田溶冀),43,7,50,1
17852,김태호(金台鎬),전재수(田載秀),42,6,48,1
17853,김태호(金台鎬),전주혜(全珠惠),58,53,111,0
17854,김태호(金台鎬),전해철(全海澈),43,4,47,1
17855,김태호(金台鎬),전혜숙(全惠淑),42,7,49,1
17856,김태호(金台鎬),정경희(丁慶姬),56,50,106,0
17857,김태호(金台鎬),정동만(鄭東萬),56,49,105,0
17858,김태호(金台鎬),정성호(鄭成湖),44,9,53,1
17859,김태호(金台鎬),정우택(鄭宇澤),32,34,66,0
17860,김태호(金台鎬),정운천(鄭雲天),76,101,177,0
17861,김태호(金台鎬),정일영(鄭日永),41,6,47,1
17862,김태호(金台鎬),정점식(鄭点植),69,72,141,0
17863,김태호(金台鎬),정진석(鄭鎭碩),68,62,130,0
17864,김태호(金台鎬),정청래(鄭淸來),42,4,46,1
17865,김태호(金台鎬),정춘숙(鄭春淑),42,7,49,1
17866,김태호(金台鎬),정태호(鄭泰浩),42,6,48,1
17867,김태호(金台鎬),정필모(鄭必模),42,5,47,1
17868,김태호(金台鎬),정희용(鄭熙溶),66,55,121,0
17869,김태호(金台鎬),조경태(趙慶泰),63,66,129,0
17870,김태호(金台鎬),조명희(曺明姬),67,103,170,0
17871,김태호(金台鎬),조수진(趙修眞),90,93,183,0
17872,김태호(金台鎬),조승래(趙承來),41,7,48,1
17873,김태호(金台鎬),조오섭(曺五燮),43,9,52,1
17874,김태호(金台鎬),조은희(趙恩禧),28,28,56,0
17875,김태호(金台鎬),조응천(趙應天),41,4,45,1
17876,김태호(金台鎬),조정식(趙正湜),40,5,45,1
17877,김태호(金台鎬),조정훈(趙廷訓),1,5,6,1
17878,김태호(金台鎬),조해진(曺海珍),57,51,108,0
17879,김태호(金台鎬),주철현(朱哲鉉),49,7,56,1
17880,김태호(金台鎬),주호영(朱豪英),53,37,90,0
17881,김태호(金台鎬),지성호(池成浩),76,101,177,0
17882,김태호(金台鎬),진선미(陳善美),42,5,47,1
17883,김태호(金台鎬),진성준(陳聲準),42,5,47,1
17884,김태호(金台鎬),천준호(千俊鎬),41,3,44,1
17885,김태호(金台鎬),최기상(崔基相),40,4,44,1
17886,김태호(金台鎬),최승재(崔承宰),52,52,104,0
17887,김태호(金台鎬),최연숙(崔姸淑),39,35,74,0
17888,김태호(金台鎬),최영희(崔英姬),29,46,75,0
17889,김태호(金台鎬),최인호(崔仁昊),41,6,47,1
17890,김태호(金台鎬),최재형(崔在亨),26,15,41,0
17891,김태호(金台鎬),최종윤(崔鍾允),41,5,46,1
17892,김태호(金台鎬),최춘식(崔春植),69,89,158,0
17893,김태호(金台鎬),최형두(崔炯斗),82,83,165,0
17894,김태호(金台鎬),최혜영(崔惠英),41,9,50,1
17895,김태호(金台鎬),추경호(秋慶鎬),74,74,148,0
17896,김태호(金台鎬),태영호(太永浩),70,99,169,0
17897,김태호(金台鎬),하영제(河榮帝),63,65,128,1
17898,김태호(金台鎬),하태경(河泰慶),56,54,110,0
17899,김태호(金台鎬),한기호(韓起鎬),53,48,101,0
17900,김태호(金台鎬),한무경(韓茂景),69,69,138,0
17901,김태호(金台鎬),한병도(韓秉道),43,10,53,1
17902,김태호(金台鎬),한정애(韓貞愛),41,5,46,1
17903,김태호(金台鎬),한준호(韓俊鎬),43,6,49,1
17904,김태호(金台鎬),허숙정(許淑湞),0,0,0,1
17905,김태호(金台鎬),허영(許榮),43,8,51,1
17906,김태호(金台鎬),허은아(許垠娥),61,52,113,0
17907,김태호(金台鎬),허종식(許琮植),42,7,49,1
17908,김태호(金台鎬),홍기원(洪起元),42,4,46,1
17909,김태호(金台鎬),홍문표(洪文杓),64,68,132,0
17910,김태호(金台鎬),홍석준(洪碩晙),60,78,138,0
17911,김태호(金台鎬),홍성국(洪性國),42,4,46,1
17912,김태호(金台鎬),홍영표(洪永杓),41,4,45,1
17913,김태호(金台鎬),홍익표(洪翼杓),42,4,46,1
17914,김태호(金台鎬),홍정민(洪貞敏),42,6,48,1
17915,김태호(金台鎬),황보승희(皇甫承希),55,65,120,1
17916,김태호(金台鎬),황운하(黃雲夏),42,6,48,1
17917,김태호(金台鎬),황희(黃熙),41,9,50,1
17918,김학용(金學容),김한규(金翰奎),25,4,29,1
17919,김학용(金學容),김한정(金漢正),25,4,29,1
17920,김학용(金學容),김형동(金亨東),31,32,63,0
17921,김학용(金學容),김홍걸(金弘傑),5,5,10,1
17922,김학용(金學容),김회재(金會在),26,3,29,1
17923,김학용(金學容),김희곤(金熙坤),29,55,84,0
17924,김학용(金學容),김희국(金熙國),31,26,57,0
17925,김학용(金學容),남인순(南仁順),25,4,29,1
17926,김학용(金學容),노용호(魯容昊),40,35,75,0
17927,김학용(金學容),노웅래(盧雄來),26,3,29,1
17928,김학용(金學容),도종환(都鍾煥),26,5,31,1
17929,김학용(金學容),류성걸(柳性杰),32,72,104,0
17930,김학용(金學容),류호정(柳好貞),0,0,0,1
17931,김학용(金學容),맹성규(孟聖奎),25,5,30,1
17932,김학용(金學容),문정복(文貞福),25,5,30,1
17933,김학용(金學容),문진석(文振碩),25,4,29,1
17934,김학용(金學容),민병덕(閔炳德),25,5,30,1
17935,김학용(金學容),민형배(閔馨培),9,4,13,1
17936,김학용(金學容),민홍철(閔洪喆),26,4,30,1
17937,김학용(金學容),박광온(朴洸瑥),25,5,30,1
17938,김학용(金學容),박대수(朴大壽),52,117,169,0
17939,김학용(金學容),박대출(朴大出),31,23,54,0
17940,김학용(金學容),박덕흠(朴德欽),46,84,130,0
17941,김학용(金學容),박범계(朴範界),25,4,29,1
17942,김학용(金學容),박병석(朴炳錫),25,3,28,1
17943,김학용(金學容),박상혁(朴商赫),25,5,30,1
17944,김학용(金學容),박성민(朴聖敏),48,89,137,0
17945,김학용(金學容),박성준(朴省俊),25,5,30,1
17946,김학용(金學容),박성중(朴成重),30,25,55,0
17947,김학용(金學容),박수영(朴洙瑩),27,15,42,0
17948,김학용(金學容),박영순(朴英淳),25,3,28,1
17949,김학용(金學容),박완주(朴完柱),0,0,0,1
17950,김학용(金學容),박용진(朴用鎭),25,5,30,1
17951,김학용(金學容),박재호(朴在昊),25,5,30,1
17952,김학용(金學容),박정(朴釘),25,7,32,1
17953,김학용(金學容),박정하(朴正河),51,60,111,0
17954,김학용(金學容),박주민(朴柱民),25,4,29,1
17955,김학용(金學容),박진(朴振),30,23,53,0
17956,김학용(金學容),박찬대(朴贊大),25,4,29,1
17957,김학용(金學容),박형수(朴亨修),27,17,44,0
17958,김학용(金學容),박홍근(朴洪根),25,6,31,1
17959,김학용(金學容),배준영(裵俊英),33,45,78,0
17960,김학용(金學容),배진교(裵晋敎),1,0,1,1
17961,김학용(金學容),배현진(裵賢鎭),31,17,48,0
17962,김학용(金學容),백종헌(白宗憲),38,97,135,0
17963,김학용(金學容),백혜련(白惠蓮),25,4,29,1
17964,김학용(金學容),변재일(卞在一),25,5,30,1
17965,김학용(金學容),서동용(徐東榕),25,4,29,1
17966,김학용(金學容),서범수(徐範洙),36,32,68,0
17967,김학용(金學容),서병수(徐秉洙),30,57,87,0
17968,김학용(金學容),서삼석(徐參錫),27,4,31,1
17969,김학용(金學容),서영교(徐瑛敎),25,6,31,1
17970,김학용(金學容),서영석(徐暎錫),25,7,32,1
17971,김학용(金學容),서일준(徐一俊),55,72,127,0
17972,김학용(金學容),서정숙(徐正淑),30,21,51,0
17973,김학용(金學容),설훈(薛勳),25,5,30,1
17974,김학용(金學容),성일종(成一鍾),38,56,94,0
17975,김학용(金學容),소병철(蘇秉哲),26,4,30,1
17976,김학용(金學容),소병훈(蘇秉勳),26,4,30,1
17977,김학용(金學容),송갑석(宋甲錫),25,5,30,1
17978,김학용(金學容),송기헌(宋基憲),25,8,33,1
17979,김학용(金學容),송석준(宋錫俊),31,43,74,0
17980,김학용(金學容),송언석(宋彦錫),31,24,55,0
17981,김학용(金學容),송옥주(宋玉珠),25,4,29,1
17982,김학용(金學容),송재호(宋在祜),25,4,29,1
17983,김학용(金學容),신동근(申東根),25,5,30,1
17984,김학용(金學容),신영대(申榮大),25,4,29,1
17985,김학용(金學容),신원식(申源湜),31,19,50,0
17986,김학용(金學容),신정훈(辛正勳),25,4,29,1
17987,김학용(金學容),신현영(申賢榮),25,4,29,1
17988,김학용(金學容),심상정(沈相奵),0,0,0,1
17989,김학용(金學容),안규백(安圭伯),30,5,35,1
17990,김학용(金學容),안민석(安敏錫),25,4,29,1
17991,김학용(金學容),안병길(安炳吉),42,109,151,0
17992,김학용(金學容),안철수(安哲秀),27,28,55,0
17993,김학용(金學容),안호영(安浩永),26,6,32,1
17994,김학용(金學容),양경숙(梁敬淑),25,4,29,1
17995,김학용(金學容),양금희(梁琴喜),41,41,82,0
17996,김학용(金學容),양기대(梁基大),25,6,31,1
17997,김학용(金學容),양이원영(梁李媛瑛),25,4,29,1
17998,김학용(金學容),양정숙(梁貞淑),1,9,10,1
17999,김학용(金學容),양향자(梁香子),0,5,5,1
18000,김학용(金學容),어기구(魚基龜),26,5,31,1
18001,김학용(金學容),엄태영(嚴泰永),32,52,84,0
18002,김학용(金學容),오기형(吳奇炯),25,4,29,1
18003,김학용(金學容),오영환(吳永煥),25,5,30,1
18004,김학용(金學容),용혜인(龍慧仁),0,0,0,1
18005,김학용(金學容),우상호(禹相虎),25,4,29,1
18006,김학용(金學容),우원식(禹元植),25,4,29,1
18007,김학용(金學容),위성곤(魏聖坤),25,4,29,1
18008,김학용(金學容),유경준(兪京濬),54,72,126,0
18009,김학용(金學容),유기홍(柳基洪),25,4,29,1
18010,김학용(金學容),유동수(柳東秀),26,4,30,1
18011,김학용(金學容),유상범(劉相凡),30,29,59,0
18012,김학용(金學容),유의동(兪義東),41,23,64,0
18013,김학용(金學容),유정주(兪訂炷),25,4,29,1
18014,김학용(金學容),윤건영(尹建永),25,3,28,1
18015,김학용(金學容),윤관석(尹官石),16,0,16,1
18016,김학용(金學容),윤두현(尹斗鉉),30,39,69,0
18017,김학용(金學容),윤미향(尹美香),0,1,1,1
18018,김학용(金學容),윤상현(尹相現),29,26,55,0
18019,김학용(金學容),윤영덕(尹永德),25,5,30,1
18020,김학용(金學容),윤영석(尹永碩),26,19,45,0
18021,김학용(金學容),윤영찬(尹永燦),25,4,29,1
18022,김학용(金學容),윤재갑(尹才鉀),26,4,30,1
18023,김학용(金學容),윤재옥(尹在玉),28,14,42,0
18024,김학용(金學容),윤주경(尹柱卿),40,21,61,0
18025,김학용(金學容),윤준병(尹準炳),26,5,31,1
18026,김학용(金學容),윤창현(尹暢賢),31,32,63,0
18027,김학용(金學容),윤한홍(尹漢洪),36,26,62,0
18028,김학용(金學容),윤호중(尹昊重),25,5,30,1
18029,김학용(金學容),윤후덕(尹厚德),26,6,32,1
18030,김학용(金學容),이개호(李介昊),26,4,30,1
18031,김학용(金學容),이달곤(李達坤),31,25,56,0
18032,김학용(金學容),이동주(李東洲),25,4,29,1
18033,김학용(金學容),이만희(李晩熙),29,11,40,0
18034,김학용(金學容),이명수(李明洙),41,67,108,0
18035,김학용(金學容),이병훈(李炳勳),26,6,32,1
18036,김학용(金學容),이상민(李相珉),26,4,30,1
18037,김학용(金學容),이상헌(李相憲),25,5,30,1
18038,김학용(金學容),이성만(李成萬),16,3,19,1
18039,김학용(金學容),이소영(李素永),25,4,29,1
18040,김학용(金學容),이수진(李壽珍),25,5,30,1
18041,김학용(金學容),이수진(李秀眞),25,4,29,1
18042,김학용(金學容),이양수(李亮壽),32,16,48,0
18043,김학용(金學容),이용(李鏞),33,50,83,0
18044,김학용(金學容),이용빈(李龍彬),25,5,30,1
18045,김학용(金學容),이용선(李庸瑄),25,4,29,1
18046,김학용(金學容),이용우(李龍雨),25,5,30,1
18047,김학용(金學容),이용호(李容鎬),31,20,51,0
18048,김학용(金學容),이원욱(李元旭),25,6,31,1
18049,김학용(金學容),이원택(李源澤),26,5,31,1
18050,김학용(金學容),이은주(李恩周),0,0,0,1
18051,김학용(金學容),이인선(李仁善),41,35,76,0
18052,김학용(金學容),이인영(李仁榮),25,4,29,1
18053,김학용(金學容),이장섭(李將燮),25,5,30,1
18054,김학용(金學容),이재명(李在明),25,4,29,1
18055,김학용(金學容),이재정(李在汀),25,4,29,1
18056,김학용(金學容),이정문(李楨文),25,4,29,1
18057,김학용(金學容),이종배(李鍾培),39,77,116,0
18058,김학용(金學容),이종성(李鍾成),42,59,101,0
18059,김학용(金學容),이주환(李周桓),59,144,203,0
18060,김학용(金學容),이채익(李埰益),39,45,84,0
18061,김학용(金學容),이철규(李喆圭),41,20,61,0
18062,김학용(金學容),이탄희(李誕熙),25,4,29,1
18063,김학용(金學容),이태규(李泰珪),29,20,49,0
18064,김학용(金學容),이학영(李學永),25,5,30,1
18065,김학용(金學容),이해식(李海植),25,4,29,1
18066,김학용(金學容),이헌승(李憲昇),33,104,137,0
18067,김학용(金學容),이형석(李炯錫),25,6,31,1
18068,김학용(金學容),인재근(印在謹),25,6,31,1
18069,김학용(金學容),임병헌(林炳憲),36,27,63,0
18070,김학용(金學容),임오경(林五卿),25,4,29,1
18071,김학용(金學容),임이자(林利子),32,35,67,0
18072,김학용(金學容),임종성(林鍾聲),26,7,33,1
18073,김학용(金學容),임호선(林昊宣),25,5,30,1
18074,김학용(金學容),장경태(張耿態),25,4,29,1
18075,김학용(金學容),장동혁(張東赫),38,51,89,0
18076,김학용(金學容),장제원(張濟元),25,12,37,0
18077,김학용(金學容),장철민(張喆敏),25,6,31,1
18078,김학용(金學容),장혜영(張惠英),0,0,0,1
18079,김학용(金學容),전봉민(田奉珉),37,113,150,0
18080,김학용(金學容),전용기(田溶冀),25,4,29,1
18081,김학용(金學容),전재수(田載秀),25,4,29,1
18082,김학용(金學容),전주혜(全珠惠),30,17,47,0
18083,김학용(金學容),전해철(全海澈),25,4,29,1
18084,김학용(金學容),전혜숙(全惠淑),25,5,30,1
18085,김학용(金學容),정경희(丁慶姬),30,17,47,0
18086,김학용(金學容),정동만(鄭東萬),38,81,119,0
18087,김학용(金學容),정성호(鄭成湖),26,6,32,1
18088,김학용(金學容),정우택(鄭宇澤),36,74,110,0
18089,김학용(金學容),정운천(鄭雲天),53,71,124,0
18090,김학용(金學容),정일영(鄭日永),25,4,29,1
18091,김학용(金學容),정점식(鄭点植),30,22,52,0
18092,김학용(金學容),정진석(鄭鎭碩),28,11,39,0
18093,김학용(金學容),정청래(鄭淸來),25,4,29,1
18094,김학용(金學容),정춘숙(鄭春淑),25,4,29,1
18095,김학용(金學容),정태호(鄭泰浩),25,5,30,1
18096,김학용(金學容),정필모(鄭必模),25,4,29,1
18097,김학용(金學容),정희용(鄭熙溶),34,37,71,0
18098,김학용(金學容),조경태(趙慶泰),31,32,63,0
18099,김학용(金學容),조명희(曺明姬),38,55,93,0
18100,김학용(金學容),조수진(趙修眞),34,22,56,0
18101,김학용(金學容),조승래(趙承來),25,3,28,1
18102,김학용(金學容),조오섭(曺五燮),26,5,31,1
18103,김학용(金學容),조은희(趙恩禧),30,44,74,0
18104,김학용(金學容),조응천(趙應天),25,3,28,1
18105,김학용(金學容),조정식(趙正湜),25,3,28,1
18106,김학용(金學容),조정훈(趙廷訓),1,5,6,1
18107,김학용(金學容),조해진(曺海珍),27,14,41,0
18108,김학용(金學容),주철현(朱哲鉉),27,5,32,1
18109,김학용(金學容),주호영(朱豪英),31,43,74,0
18110,김학용(金學容),지성호(池成浩),39,60,99,0
18111,김학용(金學容),진선미(陳善美),25,4,29,1
18112,김학용(金學容),진성준(陳聲準),25,4,29,1
18113,김학용(金學容),천준호(千俊鎬),25,3,28,1
18114,김학용(金學容),최기상(崔基相),25,4,29,1
18115,김학용(金學容),최승재(崔承宰),28,26,54,0
18116,김학용(金學容),최연숙(崔姸淑),29,22,51,0
18117,김학용(金學容),최영희(崔英姬),37,81,118,0
18118,김학용(金學容),최인호(崔仁昊),25,4,29,1
18119,김학용(金學容),최재형(崔在亨),28,21,49,0
18120,김학용(金學容),최종윤(崔鍾允),25,5,30,1
18121,김학용(金學容),최춘식(崔春植),41,68,109,0
18122,김학용(金學容),최형두(崔炯斗),30,18,48,0
18123,김학용(金學容),최혜영(崔惠英),25,4,29,1
18124,김학용(金學容),추경호(秋慶鎬),25,10,35,0
18125,김학용(金學容),태영호(太永浩),50,68,118,0
18126,김학용(金學容),하영제(河榮帝),32,79,111,1
18127,김학용(金學容),하태경(河泰慶),27,21,48,0
18128,김학용(金學容),한기호(韓起鎬),37,21,58,0
18129,김학용(金學容),한무경(韓茂景),37,44,81,0
18130,김학용(金學容),한병도(韓秉道),26,5,31,1
18131,김학용(金學容),한정애(韓貞愛),25,7,32,1
18132,김학용(金學容),한준호(韓俊鎬),25,4,29,1
18133,김학용(金學容),허숙정(許淑湞),0,0,0,1
18134,김학용(金學容),허영(許榮),25,5,30,1
18135,김학용(金學容),허은아(許垠娥),26,24,50,0
18136,김학용(金學容),허종식(許琮植),26,5,31,1
18137,김학용(金學容),홍기원(洪起元),25,6,31,1
18138,김학용(金學容),홍문표(洪文杓),28,46,74,0
18139,김학용(金學容),홍석준(洪碩晙),29,31,60,0
18140,김학용(金學容),홍성국(洪性國),25,6,31,1
18141,김학용(金學容),홍영표(洪永杓),26,7,33,1
18142,김학용(金學容),홍익표(洪翼杓),25,4,29,1
18143,김학용(金學容),홍정민(洪貞敏),25,6,31,1
18144,김학용(金學容),황보승희(皇甫承希),26,43,69,1
18145,김학용(金學容),황운하(黃雲夏),25,4,29,1
18146,김학용(金學容),황희(黃熙),25,4,29,1
18147,김한규(金翰奎),김한정(金漢正),45,28,73,0
18148,김한규(金翰奎),김형동(金亨東),25,6,31,1
18149,김한규(金翰奎),김홍걸(金弘傑),16,61,77,0
18150,김한규(金翰奎),김회재(金會在),45,30,75,0
18151,김한규(金翰奎),김희곤(金熙坤),25,6,31,1
18152,김한규(金翰奎),김희국(金熙國),25,4,29,1
18153,김한규(金翰奎),남인순(南仁順),42,35,77,0
18154,김한규(金翰奎),노용호(魯容昊),25,5,30,1
18155,김한규(金翰奎),노웅래(盧雄來),44,32,76,0
18156,김한규(金翰奎),도종환(都鍾煥),44,34,78,0
18157,김한규(金翰奎),류성걸(柳性杰),25,5,30,1
18158,김한규(金翰奎),류호정(柳好貞),7,18,25,1
18159,김한규(金翰奎),맹성규(孟聖奎),42,23,65,0
18160,김한규(金翰奎),문정복(文貞福),42,40,82,0
18161,김한규(金翰奎),문진석(文振碩),47,46,93,0
18162,김한규(金翰奎),민병덕(閔炳德),46,124,170,0
18163,김한규(金翰奎),민형배(閔馨培),19,47,66,0
18164,김한규(金翰奎),민홍철(閔洪喆),40,29,69,0
18165,김한규(金翰奎),박광온(朴洸瑥),42,31,73,0
18166,김한규(金翰奎),박대수(朴大壽),25,8,33,1
18167,김한규(金翰奎),박대출(朴大出),25,5,30,1
18168,김한규(金翰奎),박덕흠(朴德欽),26,7,33,1
18169,김한규(金翰奎),박범계(朴範界),40,22,62,0
18170,김한규(金翰奎),박병석(朴炳錫),40,16,56,0
18171,김한규(金翰奎),박상혁(朴商赫),44,66,110,0
18172,김한규(金翰奎),박성민(朴聖敏),26,5,31,1
18173,김한규(金翰奎),박성준(朴省俊),44,41,85,0
18174,김한규(金翰奎),박성중(朴成重),25,5,30,1
18175,김한규(金翰奎),박수영(朴洙瑩),26,5,31,1
18176,김한규(金翰奎),박영순(朴英淳),43,36,79,0
18177,김한규(金翰奎),박완주(朴完柱),6,6,12,1
18178,김한규(金翰奎),박용진(朴用鎭),45,71,116,0
18179,김한규(金翰奎),박재호(朴在昊),42,73,115,0
18180,김한규(金翰奎),박정(朴釘),41,29,70,0
18181,김한규(金翰奎),박정하(朴正河),25,6,31,1
18182,김한규(金翰奎),박주민(朴柱民),42,38,80,0
18183,김한규(金翰奎),박진(朴振),25,6,31,1
18184,김한규(金翰奎),박찬대(朴贊大),42,27,69,0
18185,김한규(金翰奎),박형수(朴亨修),25,5,30,1
18186,김한규(金翰奎),박홍근(朴洪根),39,41,80,0
18187,김한규(金翰奎),배준영(裵俊英),25,6,31,1
18188,김한규(金翰奎),배진교(裵晋敎),7,16,23,1
18189,김한규(金翰奎),배현진(裵賢鎭),25,6,31,1
18190,김한규(金翰奎),백종헌(白宗憲),25,7,32,1
18191,김한규(金翰奎),백혜련(白惠蓮),40,40,80,0
18192,김한규(金翰奎),변재일(卞在一),39,23,62,0
18193,김한규(金翰奎),서동용(徐東榕),44,46,90,0
18194,김한규(金翰奎),서범수(徐範洙),25,6,31,1
18195,김한규(金翰奎),서병수(徐秉洙),25,5,30,1
18196,김한규(金翰奎),서삼석(徐參錫),43,32,75,0
18197,김한규(金翰奎),서영교(徐瑛敎),44,57,101,0
18198,김한규(金翰奎),서영석(徐暎錫),43,70,113,0
18199,김한규(金翰奎),서일준(徐一俊),25,5,30,1
18200,김한규(金翰奎),서정숙(徐正淑),25,8,33,1
18201,김한규(金翰奎),설훈(薛勳),41,29,70,0
18202,김한규(金翰奎),성일종(成一鍾),25,5,30,1
18203,김한규(金翰奎),소병철(蘇秉哲),42,45,87,0
18204,김한규(金翰奎),소병훈(蘇秉勳),43,34,77,0
18205,김한규(金翰奎),송갑석(宋甲錫),42,67,109,0
18206,김한규(金翰奎),송기헌(宋基憲),40,27,67,0
18207,김한규(金翰奎),송석준(宋錫俊),25,7,32,1
18208,김한규(金翰奎),송언석(宋彦錫),25,5,30,1
18209,김한규(金翰奎),송옥주(宋玉珠),40,33,73,0
18210,김한규(金翰奎),송재호(宋在祜),56,117,173,0
18211,김한규(金翰奎),신동근(申東根),40,33,73,0
18212,김한규(金翰奎),신영대(申榮大),41,25,66,0
18213,김한규(金翰奎),신원식(申源湜),25,6,31,1
18214,김한규(金翰奎),신정훈(辛正勳),49,84,133,0
18215,김한규(金翰奎),신현영(申賢榮),46,55,101,0
18216,김한규(金翰奎),심상정(沈相奵),5,18,23,1
18217,김한규(金翰奎),안규백(安圭伯),42,23,65,0
18218,김한규(金翰奎),안민석(安敏錫),41,28,69,0
18219,김한규(金翰奎),안병길(安炳吉),25,6,31,1
18220,김한규(金翰奎),안철수(安哲秀),25,5,30,1
18221,김한규(金翰奎),안호영(安浩永),41,38,79,0
18222,김한규(金翰奎),양경숙(梁敬淑),43,67,110,0
18223,김한규(金翰奎),양금희(梁琴喜),25,6,31,1
18224,김한규(金翰奎),양기대(梁基大),41,43,84,0
18225,김한규(金翰奎),양이원영(梁李媛瑛),42,41,83,0
18226,김한규(金翰奎),양정숙(梁貞淑),11,53,64,1
18227,김한규(金翰奎),양향자(梁香子),2,10,12,1
18228,김한규(金翰奎),어기구(魚基龜),41,27,68,0
18229,김한규(金翰奎),엄태영(嚴泰永),25,4,29,1
18230,김한규(金翰奎),오기형(吳奇炯),42,33,75,0
18231,김한규(金翰奎),오영환(吳永煥),42,66,108,0
18232,김한규(金翰奎),용혜인(龍慧仁),7,20,27,1
18233,김한규(金翰奎),우상호(禹相虎),39,19,58,0
18234,김한규(金翰奎),우원식(禹元植),44,42,86,0
18235,김한규(金翰奎),위성곤(魏聖坤),51,92,143,0
18236,김한규(金翰奎),유경준(兪京濬),25,5,30,1
18237,김한규(金翰奎),유기홍(柳基洪),40,30,70,0
18238,김한규(金翰奎),유동수(柳東秀),40,26,66,0
18239,김한규(金翰奎),유상범(劉相凡),25,6,31,1
18240,김한규(金翰奎),유의동(兪義東),25,5,30,1
18241,김한규(金翰奎),유정주(兪訂炷),49,85,134,0
18242,김한규(金翰奎),윤건영(尹建永),46,43,89,0
18243,김한규(金翰奎),윤관석(尹官石),27,13,40,1
18244,김한규(金翰奎),윤두현(尹斗鉉),25,6,31,1
18245,김한규(金翰奎),윤미향(尹美香),5,19,24,1
18246,김한규(金翰奎),윤상현(尹相現),25,5,30,1
18247,김한규(金翰奎),윤영덕(尹永德),52,84,136,0
18248,김한규(金翰奎),윤영석(尹永碩),25,6,31,1
18249,김한규(金翰奎),윤영찬(尹永燦),39,25,64,0
18250,김한규(金翰奎),윤재갑(尹才鉀),45,49,94,0
18251,김한규(金翰奎),윤재옥(尹在玉),25,6,31,1
18252,김한규(金翰奎),윤주경(尹柱卿),25,7,32,1
18253,김한규(金翰奎),윤준병(尹準炳),41,66,107,0
18254,김한규(金翰奎),윤창현(尹暢賢),25,7,32,1
18255,김한규(金翰奎),윤한홍(尹漢洪),25,7,32,1
18256,김한규(金翰奎),윤호중(尹昊重),42,37,79,0
18257,김한규(金翰奎),윤후덕(尹厚德),41,34,75,0
18258,김한규(金翰奎),이개호(李介昊),44,46,90,0
18259,김한규(金翰奎),이달곤(李達坤),27,7,34,1
18260,김한규(金翰奎),이동주(李東洲),45,69,114,0
18261,김한규(金翰奎),이만희(李晩熙),25,4,29,1
18262,김한규(金翰奎),이명수(李明洙),26,10,36,1
18263,김한규(金翰奎),이병훈(李炳勳),44,69,113,0
18264,김한규(金翰奎),이상민(李相珉),39,18,57,0
18265,김한규(金翰奎),이상헌(李相憲),41,32,73,0
18266,김한규(金翰奎),이성만(李成萬),32,33,65,1
18267,김한규(金翰奎),이소영(李素永),41,61,102,0
18268,김한규(金翰奎),이수진(李壽珍),45,59,104,0
18269,김한규(金翰奎),이수진(李秀眞),49,41,90,0
18270,김한규(金翰奎),이양수(李亮壽),26,5,31,1
18271,김한규(金翰奎),이용(李鏞),25,9,34,1
18272,김한규(金翰奎),이용빈(李龍彬),44,88,132,0
18273,김한규(金翰奎),이용선(李庸瑄),42,51,93,0
18274,김한규(金翰奎),이용우(李龍雨),46,79,125,0
18275,김한규(金翰奎),이용호(李容鎬),26,5,31,1
18276,김한규(金翰奎),이원욱(李元旭),40,42,82,0
18277,김한규(金翰奎),이원택(李源澤),50,41,91,0
18278,김한규(金翰奎),이은주(李恩周),6,8,14,1
18279,김한규(金翰奎),이인선(李仁善),25,7,32,1
18280,김한규(金翰奎),이인영(李仁榮),44,21,65,0
18281,김한규(金翰奎),이장섭(李將燮),42,40,82,0
18282,김한규(金翰奎),이재명(李在明),41,22,63,0
18283,김한규(金翰奎),이재정(李在汀),42,23,65,0
18284,김한규(金翰奎),이정문(李楨文),42,35,77,0
18285,김한규(金翰奎),이종배(李鍾培),26,8,34,1
18286,김한규(金翰奎),이종성(李鍾成),25,5,30,1
18287,김한규(金翰奎),이주환(李周桓),25,5,30,1
18288,김한규(金翰奎),이채익(李埰益),26,6,32,1
18289,김한규(金翰奎),이철규(李喆圭),25,6,31,1
18290,김한규(金翰奎),이탄희(李誕熙),43,37,80,0
18291,김한규(金翰奎),이태규(李泰珪),25,7,32,1
18292,김한규(金翰奎),이학영(李學永),43,46,89,0
18293,김한규(金翰奎),이해식(李海植),46,34,80,0
18294,김한규(金翰奎),이헌승(李憲昇),25,5,30,1
18295,김한규(金翰奎),이형석(李炯錫),47,51,98,0
18296,김한규(金翰奎),인재근(印在謹),45,36,81,0
18297,김한규(金翰奎),임병헌(林炳憲),25,7,32,1
18298,김한규(金翰奎),임오경(林五卿),41,28,69,0
18299,김한규(金翰奎),임이자(林利子),25,5,30,1
18300,김한규(金翰奎),임종성(林鍾聲),42,56,98,0
18301,김한규(金翰奎),임호선(林昊宣),48,93,141,0
18302,김한규(金翰奎),장경태(張耿態),44,49,93,0
18303,김한규(金翰奎),장동혁(張東赫),25,5,30,1
18304,김한규(金翰奎),장제원(張濟元),25,4,29,1
18305,김한규(金翰奎),장철민(張喆敏),39,60,99,0
18306,김한규(金翰奎),장혜영(張惠英),5,12,17,1
18307,김한규(金翰奎),전봉민(田奉珉),26,6,32,1
18308,김한규(金翰奎),전용기(田溶冀),39,56,95,0
18309,김한규(金翰奎),전재수(田載秀),41,34,75,0
18310,김한규(金翰奎),전주혜(全珠惠),26,6,32,1
18311,김한규(金翰奎),전해철(全海澈),40,28,68,0
18312,김한규(金翰奎),전혜숙(全惠淑),40,23,63,0
18313,김한규(金翰奎),정경희(丁慶姬),25,6,31,1
18314,김한규(金翰奎),정동만(鄭東萬),25,5,30,1
18315,김한규(金翰奎),정성호(鄭成湖),39,43,82,0
18316,김한규(金翰奎),정우택(鄭宇澤),25,7,32,1
18317,김한규(金翰奎),정운천(鄭雲天),25,5,30,1
18318,김한규(金翰奎),정일영(鄭日永),43,52,95,0
18319,김한규(金翰奎),정점식(鄭点植),25,5,30,1
18320,김한규(金翰奎),정진석(鄭鎭碩),25,4,29,1
18321,김한규(金翰奎),정청래(鄭淸來),40,19,59,0
18322,김한규(金翰奎),정춘숙(鄭春淑),40,42,82,0
18323,김한규(金翰奎),정태호(鄭泰浩),42,55,97,0
18324,김한규(金翰奎),정필모(鄭必模),43,49,92,0
18325,김한규(金翰奎),정희용(鄭熙溶),26,8,34,1
18326,김한규(金翰奎),조경태(趙慶泰),25,4,29,1
18327,김한규(金翰奎),조명희(曺明姬),25,5,30,1
18328,김한규(金翰奎),조수진(趙修眞),25,5,30,1
18329,김한규(金翰奎),조승래(趙承來),42,29,71,0
18330,김한규(金翰奎),조오섭(曺五燮),46,103,149,0
18331,김한규(金翰奎),조은희(趙恩禧),26,6,32,1
18332,김한규(金翰奎),조응천(趙應天),38,23,61,0
18333,김한규(金翰奎),조정식(趙正湜),41,23,64,0
18334,김한규(金翰奎),조정훈(趙廷訓),0,6,6,1
18335,김한규(金翰奎),조해진(曺海珍),27,6,33,1
18336,김한규(金翰奎),주철현(朱哲鉉),47,51,98,0
18337,김한규(金翰奎),주호영(朱豪英),25,4,29,1
18338,김한규(金翰奎),지성호(池成浩),25,5,30,1
18339,김한규(金翰奎),진선미(陳善美),40,29,69,0
18340,김한규(金翰奎),진성준(陳聲準),41,36,77,0
18341,김한규(金翰奎),천준호(千俊鎬),43,29,72,0
18342,김한규(金翰奎),최기상(崔基相),44,48,92,0
18343,김한규(金翰奎),최승재(崔承宰),25,6,31,1
18344,김한규(金翰奎),최연숙(崔姸淑),27,7,34,1
18345,김한규(金翰奎),최영희(崔英姬),25,8,33,1
18346,김한규(金翰奎),최인호(崔仁昊),42,46,88,0
18347,김한규(金翰奎),최재형(崔在亨),25,6,31,1
18348,김한규(金翰奎),최종윤(崔鍾允),45,56,101,0
18349,김한규(金翰奎),최춘식(崔春植),26,7,33,1
18350,김한규(金翰奎),최형두(崔炯斗),25,7,32,1
18351,김한규(金翰奎),최혜영(崔惠英),42,59,101,0
18352,김한규(金翰奎),추경호(秋慶鎬),25,3,28,1
18353,김한규(金翰奎),태영호(太永浩),25,4,29,1
18354,김한규(金翰奎),하영제(河榮帝),16,2,18,1
18355,김한규(金翰奎),하태경(河泰慶),25,5,30,1
18356,김한규(金翰奎),한기호(韓起鎬),25,5,30,1
18357,김한규(金翰奎),한무경(韓茂景),25,7,32,1
18358,김한규(金翰奎),한병도(韓秉道),41,38,79,0
18359,김한규(金翰奎),한정애(韓貞愛),41,25,66,0
18360,김한규(金翰奎),한준호(韓俊鎬),43,57,100,0
18361,김한규(金翰奎),허숙정(許淑湞),1,2,3,0
18362,김한규(金翰奎),허영(許榮),49,70,119,0
18363,김한규(金翰奎),허은아(許垠娥),25,5,30,1
18364,김한규(金翰奎),허종식(許琮植),43,41,84,0
18365,김한규(金翰奎),홍기원(洪起元),42,48,90,0
18366,김한규(金翰奎),홍문표(洪文杓),25,6,31,1
18367,김한규(金翰奎),홍석준(洪碩晙),25,4,29,1
18368,김한규(金翰奎),홍성국(洪性國),45,94,139,0
18369,김한규(金翰奎),홍영표(洪永杓),40,24,64,0
18370,김한규(金翰奎),홍익표(洪翼杓),41,32,73,0
18371,김한규(金翰奎),홍정민(洪貞敏),50,78,128,0
18372,김한규(金翰奎),황보승희(皇甫承希),20,5,25,1
18373,김한규(金翰奎),황운하(黃雲夏),48,83,131,0
18374,김한규(金翰奎),황희(黃熙),41,28,69,0
18375,김한정(金漢正),김형동(金亨東),51,6,57,1
18376,김한정(金漢正),김홍걸(金弘傑),29,48,77,0
18377,김한정(金漢正),김회재(金會在),86,52,138,0
18378,김한정(金漢正),김희곤(金熙坤),50,4,54,1
18379,김한정(金漢正),김희국(金熙國),49,4,53,1
18380,김한정(金漢正),남인순(南仁順),95,67,162,0
18381,김한정(金漢正),노용호(魯容昊),26,4,30,1
18382,김한정(金漢正),노웅래(盧雄來),89,53,142,0
18383,김한정(金漢正),도종환(都鍾煥),83,50,133,0
18384,김한정(金漢正),류성걸(柳性杰),49,4,53,1
18385,김한정(金漢正),류호정(柳好貞),14,22,36,1
18386,김한정(金漢正),맹성규(孟聖奎),82,49,131,0
18387,김한정(金漢正),문정복(文貞福),79,46,125,0
18388,김한정(金漢正),문진석(文振碩),87,50,137,0
18389,김한정(金漢正),민병덕(閔炳德),81,65,146,0
18390,김한정(金漢正),민형배(閔馨培),55,59,114,0
18391,김한정(金漢正),민홍철(閔洪喆),76,41,117,0
18392,김한정(金漢正),박광온(朴洸瑥),80,50,130,0
18393,김한정(金漢正),박대수(朴大壽),50,6,56,1
18394,김한정(金漢正),박대출(朴大出),51,4,55,1
18395,김한정(金漢正),박덕흠(朴德欽),35,5,40,1
18396,김한정(金漢正),박범계(朴範界),73,32,105,0
18397,김한정(金漢正),박병석(朴炳錫),40,16,56,0
18398,김한정(金漢正),박상혁(朴商赫),84,63,147,0
18399,김한정(金漢正),박성민(朴聖敏),50,4,54,1
18400,김한정(金漢正),박성준(朴省俊),80,51,131,0
18401,김한정(金漢正),박성중(朴成重),50,4,54,1
18402,김한정(金漢正),박수영(朴洙瑩),50,4,54,1
18403,김한정(金漢正),박영순(朴英淳),85,52,137,0
18404,김한정(金漢正),박완주(朴完柱),41,32,73,1
18405,김한정(金漢正),박용진(朴用鎭),75,38,113,0
18406,김한정(金漢正),박재호(朴在昊),78,44,122,0
18407,김한정(金漢正),박정(朴釘),83,61,144,0
18408,김한정(金漢正),박정하(朴正河),26,4,30,1
18409,김한정(金漢正),박주민(朴柱民),79,47,126,0
18410,김한정(金漢正),박진(朴振),49,3,52,1
18411,김한정(金漢正),박찬대(朴贊大),80,45,125,0
18412,김한정(金漢正),박형수(朴亨修),49,4,53,1
18413,김한정(金漢正),박홍근(朴洪根),83,72,155,0
18414,김한정(金漢正),배준영(裵俊英),49,4,53,1
18415,김한정(金漢正),배진교(裵晋敎),10,14,24,1
18416,김한정(金漢正),배현진(裵賢鎭),50,4,54,1
18417,김한정(金漢正),백종헌(白宗憲),50,4,54,1
18418,김한정(金漢正),백혜련(白惠蓮),80,44,124,0
18419,김한정(金漢正),변재일(卞在一),74,39,113,0
18420,김한정(金漢正),서동용(徐東榕),83,59,142,0
18421,김한정(金漢正),서범수(徐範洙),51,4,55,1
18422,김한정(金漢正),서병수(徐秉洙),50,5,55,1
18423,김한정(金漢正),서삼석(徐參錫),84,54,138,0
18424,김한정(金漢正),서영교(徐瑛敎),88,60,148,0
18425,김한정(金漢正),서영석(徐暎錫),87,69,156,0
18426,김한정(金漢正),서일준(徐一俊),50,5,55,1
18427,김한정(金漢正),서정숙(徐正淑),49,4,53,1
18428,김한정(金漢正),설훈(薛勳),78,55,133,0
18429,김한정(金漢正),성일종(成一鍾),50,5,55,1
18430,김한정(金漢正),소병철(蘇秉哲),84,50,134,0
18431,김한정(金漢正),소병훈(蘇秉勳),81,70,151,0
18432,김한정(金漢正),송갑석(宋甲錫),87,62,149,0
18433,김한정(金漢正),송기헌(宋基憲),77,37,114,0
18434,김한정(金漢正),송석준(宋錫俊),49,7,56,1
18435,김한정(金漢正),송언석(宋彦錫),45,4,49,1
18436,김한정(金漢正),송옥주(宋玉珠),77,56,133,0
18437,김한정(金漢正),송재호(宋在祜),87,75,162,0
18438,김한정(金漢正),신동근(申東根),76,44,120,0
18439,김한정(金漢正),신영대(申榮大),83,49,132,0
18440,김한정(金漢正),신원식(申源湜),51,4,55,1
18441,김한정(金漢正),신정훈(辛正勳),86,68,154,0
18442,김한정(金漢正),신현영(申賢榮),81,43,124,0
18443,김한정(金漢正),심상정(沈相奵),11,18,29,1
18444,김한정(金漢正),안규백(安圭伯),79,50,129,0
18445,김한정(金漢正),안민석(安敏錫),78,49,127,0
18446,김한정(金漢正),안병길(安炳吉),49,4,53,1
18447,김한정(金漢正),안철수(安哲秀),26,4,30,1
18448,김한정(金漢正),안호영(安浩永),80,55,135,0
18449,김한정(金漢正),양경숙(梁敬淑),82,51,133,0
18450,김한정(金漢正),양금희(梁琴喜),50,4,54,1
18451,김한정(金漢正),양기대(梁基大),76,43,119,0
18452,김한정(金漢正),양이원영(梁李媛瑛),78,66,144,0
18453,김한정(金漢正),양정숙(梁貞淑),22,50,72,1
18454,김한정(金漢正),양향자(梁香子),35,19,54,1
18455,김한정(金漢正),어기구(魚基龜),77,37,114,0
18456,김한정(金漢正),엄태영(嚴泰永),49,4,53,1
18457,김한정(金漢正),오기형(吳奇炯),76,39,115,0
18458,김한정(金漢正),오영환(吳永煥),89,81,170,0
18459,김한정(金漢正),용혜인(龍慧仁),11,22,33,1
18460,김한정(金漢正),우상호(禹相虎),75,37,112,0
18461,김한정(金漢正),우원식(禹元植),81,60,141,0
18462,김한정(金漢正),위성곤(魏聖坤),84,53,137,0
18463,김한정(金漢正),유경준(兪京濬),49,4,53,1
18464,김한정(金漢正),유기홍(柳基洪),75,45,120,0
18465,김한정(金漢正),유동수(柳東秀),79,47,126,0
18466,김한정(金漢正),유상범(劉相凡),50,4,54,1
18467,김한정(金漢正),유의동(兪義東),50,4,54,1
18468,김한정(金漢正),유정주(兪訂炷),86,61,147,0
18469,김한정(金漢正),윤건영(尹建永),78,51,129,0
18470,김한정(金漢正),윤관석(尹官石),67,50,117,1
18471,김한정(金漢正),윤두현(尹斗鉉),50,4,54,1
18472,김한정(金漢正),윤미향(尹美香),36,35,71,1
18473,김한정(金漢正),윤상현(尹相現),31,4,35,1
18474,김한정(金漢正),윤영덕(尹永德),87,59,146,0
18475,김한정(金漢正),윤영석(尹永碩),50,5,55,1
18476,김한정(金漢正),윤영찬(尹永燦),79,46,125,0
18477,김한정(金漢正),윤재갑(尹才鉀),86,56,142,0
18478,김한정(金漢正),윤재옥(尹在玉),50,4,54,1
18479,김한정(金漢正),윤주경(尹柱卿),49,4,53,1
18480,김한정(金漢正),윤준병(尹準炳),81,77,158,0
18481,김한정(金漢正),윤창현(尹暢賢),49,4,53,1
18482,김한정(金漢正),윤한홍(尹漢洪),50,4,54,1
18483,김한정(金漢正),윤호중(尹昊重),77,44,121,0
18484,김한정(金漢正),윤후덕(尹厚德),77,46,123,0
18485,김한정(金漢正),이개호(李介昊),79,40,119,0
18486,김한정(金漢正),이달곤(李達坤),52,5,57,1
18487,김한정(金漢正),이동주(李東洲),80,65,145,0
18488,김한정(金漢正),이만희(李晩熙),51,4,55,1
18489,김한정(金漢正),이명수(李明洙),53,5,58,1
18490,김한정(金漢正),이병훈(李炳勳),84,63,147,0
18491,김한정(金漢正),이상민(李相珉),73,36,109,0
18492,김한정(金漢正),이상헌(李相憲),81,48,129,0
18493,김한정(金漢正),이성만(李成萬),76,67,143,1
18494,김한정(金漢正),이소영(李素永),80,47,127,0
18495,김한정(金漢正),이수진(李壽珍),87,62,149,0
18496,김한정(金漢正),이수진(李秀眞),86,63,149,0
18497,김한정(金漢正),이양수(李亮壽),51,4,55,1
18498,김한정(金漢正),이용(李鏞),50,4,54,1
18499,김한정(金漢正),이용빈(李龍彬),88,80,168,0
18500,김한정(金漢正),이용선(李庸瑄),84,58,142,0
18501,김한정(金漢正),이용우(李龍雨),89,59,148,0
18502,김한정(金漢正),이용호(李容鎬),29,7,36,1
18503,김한정(金漢正),이원욱(李元旭),78,52,130,0
18504,김한정(金漢正),이원택(李源澤),79,48,127,0
18505,김한정(金漢正),이은주(李恩周),12,13,25,1
18506,김한정(金漢正),이인선(李仁善),25,4,29,1
18507,김한정(金漢正),이인영(李仁榮),78,41,119,0
18508,김한정(金漢正),이장섭(李將燮),81,56,137,0
18509,김한정(金漢正),이재명(李在明),40,21,61,0
18510,김한정(金漢正),이재정(李在汀),75,47,122,0
18511,김한정(金漢正),이정문(李楨文),77,54,131,0
18512,김한정(金漢正),이종배(李鍾培),51,5,56,1
18513,김한정(金漢正),이종성(李鍾成),50,4,54,1
18514,김한정(金漢正),이주환(李周桓),50,4,54,1
18515,김한정(金漢正),이채익(李埰益),50,5,55,1
18516,김한정(金漢正),이철규(李喆圭),51,4,55,1
18517,김한정(金漢正),이탄희(李誕熙),77,49,126,0
18518,김한정(金漢正),이태규(李泰珪),29,4,33,1
18519,김한정(金漢正),이학영(李學永),80,62,142,0
18520,김한정(金漢正),이해식(李海植),82,59,141,0
18521,김한정(金漢正),이헌승(李憲昇),49,5,54,1
18522,김한정(金漢正),이형석(李炯錫),86,54,140,0
18523,김한정(金漢正),인재근(印在謹),82,64,146,0
18524,김한정(金漢正),임병헌(林炳憲),25,4,29,1
18525,김한정(金漢正),임오경(林五卿),78,47,125,0
18526,김한정(金漢正),임이자(林利子),49,4,53,1
18527,김한정(金漢正),임종성(林鍾聲),84,70,154,0
18528,김한정(金漢正),임호선(林昊宣),83,61,144,0
18529,김한정(金漢正),장경태(張耿態),81,63,144,0
18530,김한정(金漢正),장동혁(張東赫),25,4,29,1
18531,김한정(金漢正),장제원(張濟元),49,4,53,1
18532,김한정(金漢正),장철민(張喆敏),77,46,123,0
18533,김한정(金漢正),장혜영(張惠英),9,7,16,1
18534,김한정(金漢正),전봉민(田奉珉),35,5,40,1
18535,김한정(金漢正),전용기(田溶冀),78,48,126,0
18536,김한정(金漢正),전재수(田載秀),74,39,113,0
18537,김한정(金漢正),전주혜(全珠惠),51,4,55,1
18538,김한정(金漢正),전해철(全海澈),75,46,121,0
18539,김한정(金漢正),전혜숙(全惠淑),85,62,147,0
18540,김한정(金漢正),정경희(丁慶姬),50,4,54,1
18541,김한정(金漢正),정동만(鄭東萬),49,4,53,1
18542,김한정(金漢正),정성호(鄭成湖),81,43,124,0
18543,김한정(金漢正),정우택(鄭宇澤),26,4,30,1
18544,김한정(金漢正),정운천(鄭雲天),50,4,54,1
18545,김한정(金漢正),정일영(鄭日永),86,67,153,0
18546,김한정(金漢正),정점식(鄭点植),50,4,54,1
18547,김한정(金漢正),정진석(鄭鎭碩),49,5,54,1
18548,김한정(金漢正),정청래(鄭淸來),79,44,123,0
18549,김한정(金漢正),정춘숙(鄭春淑),78,52,130,0
18550,김한정(金漢正),정태호(鄭泰浩),79,48,127,0
18551,김한정(金漢正),정필모(鄭必模),80,69,149,0
18552,김한정(金漢正),정희용(鄭熙溶),50,5,55,1
18553,김한정(金漢正),조경태(趙慶泰),50,4,54,1
18554,김한정(金漢正),조명희(曺明姬),50,6,56,1
18555,김한정(金漢正),조수진(趙修眞),50,4,54,1
18556,김한정(金漢正),조승래(趙承來),80,36,116,0
18557,김한정(金漢正),조오섭(曺五燮),82,60,142,0
18558,김한정(金漢正),조은희(趙恩禧),26,4,30,1
18559,김한정(金漢正),조응천(趙應天),74,33,107,0
18560,김한정(金漢正),조정식(趙正湜),72,35,107,0
18561,김한정(金漢正),조정훈(趙廷訓),2,2,4,1
18562,김한정(金漢正),조해진(曺海珍),51,5,56,1
18563,김한정(金漢正),주철현(朱哲鉉),83,47,130,0
18564,김한정(金漢正),주호영(朱豪英),49,4,53,1
18565,김한정(金漢正),지성호(池成浩),50,4,54,1
18566,김한정(金漢正),진선미(陳善美),75,37,112,0
18567,김한정(金漢正),진성준(陳聲準),77,56,133,0
18568,김한정(金漢正),천준호(千俊鎬),79,49,128,0
18569,김한정(金漢正),최기상(崔基相),79,41,120,0
18570,김한정(金漢正),최승재(崔承宰),50,4,54,1
18571,김한정(金漢正),최연숙(崔姸淑),31,10,41,1
18572,김한정(金漢正),최영희(崔英姬),25,4,29,1
18573,김한정(金漢正),최인호(崔仁昊),78,38,116,0
18574,김한정(金漢正),최재형(崔在亨),25,4,29,1
18575,김한정(金漢正),최종윤(崔鍾允),89,65,154,0
18576,김한정(金漢正),최춘식(崔春植),49,6,55,1
18577,김한정(金漢正),최형두(崔炯斗),50,4,54,1
18578,김한정(金漢正),최혜영(崔惠英),85,56,141,0
18579,김한정(金漢正),추경호(秋慶鎬),49,3,52,1
18580,김한정(金漢正),태영호(太永浩),49,5,54,1
18581,김한정(金漢正),하영제(河榮帝),42,1,43,1
18582,김한정(金漢正),하태경(河泰慶),50,4,54,1
18583,김한정(金漢正),한기호(韓起鎬),50,4,54,1
18584,김한정(金漢正),한무경(韓茂景),50,4,54,1
18585,김한정(金漢正),한병도(韓秉道),81,50,131,0
18586,김한정(金漢正),한정애(韓貞愛),77,40,117,0
18587,김한정(金漢正),한준호(韓俊鎬),81,61,142,0
18588,김한정(金漢正),허숙정(許淑湞),1,1,2,0
18589,김한정(金漢正),허영(許榮),82,53,135,0
18590,김한정(金漢正),허은아(許垠娥),49,4,53,1
18591,김한정(金漢正),허종식(許琮植),84,60,144,0
18592,김한정(金漢正),홍기원(洪起元),83,63,146,0
18593,김한정(金漢正),홍문표(洪文杓),50,4,54,1
18594,김한정(金漢正),홍석준(洪碩晙),49,4,53,1
18595,김한정(金漢正),홍성국(洪性國),87,84,171,0
18596,김한정(金漢正),홍영표(洪永杓),76,43,119,0
18597,김한정(金漢正),홍익표(洪翼杓),76,45,121,0
18598,김한정(金漢正),홍정민(洪貞敏),90,71,161,0
18599,김한정(金漢正),황보승희(皇甫承希),46,1,47,1
18600,김한정(金漢正),황운하(黃雲夏),88,57,145,0
18601,김한정(金漢正),황희(黃熙),74,37,111,0
18602,김형동(金亨東),김홍걸(金弘傑),16,6,22,1
18603,김형동(金亨東),김회재(金會在),53,5,58,1
18604,김형동(金亨東),김희곤(金熙坤),80,152,232,0
18605,김형동(金亨東),김희국(金熙國),101,85,186,0
18606,김형동(金亨東),남인순(南仁順),54,13,67,1
18607,김형동(金亨東),노용호(魯容昊),27,34,61,0
18608,김형동(金亨東),노웅래(盧雄來),50,7,57,1
18609,김형동(金亨東),도종환(都鍾煥),52,7,59,1
18610,김형동(金亨東),류성걸(柳性杰),81,92,173,0
18611,김형동(金亨東),류호정(柳好貞),9,8,17,1
18612,김형동(金亨東),맹성규(孟聖奎),51,11,62,1
18613,김형동(金亨東),문정복(文貞福),50,9,59,1
18614,김형동(金亨東),문진석(文振碩),54,6,60,1
18615,김형동(金亨東),민병덕(閔炳德),53,12,65,1
18616,김형동(金亨東),민형배(閔馨培),37,7,44,1
18617,김형동(金亨東),민홍철(閔洪喆),51,7,58,1
18618,김형동(金亨東),박광온(朴洸瑥),50,8,58,1
18619,김형동(金亨東),박대수(朴大壽),152,289,441,0
18620,김형동(金亨東),박대출(朴大出),77,76,153,0
18621,김형동(金亨東),박덕흠(朴德欽),79,165,244,0
18622,김형동(金亨東),박범계(朴範界),51,4,55,1
18623,김형동(金亨東),박병석(朴炳錫),26,3,29,1
18624,김형동(金亨東),박상혁(朴商赫),50,13,63,1
18625,김형동(金亨東),박성민(朴聖敏),88,131,219,0
18626,김형동(金亨東),박성준(朴省俊),54,11,65,1
18627,김형동(金亨東),박성중(朴成重),74,77,151,0
18628,김형동(金亨東),박수영(朴洙瑩),69,61,130,0
18629,김형동(金亨東),박영순(朴英淳),54,19,73,1
18630,김형동(金亨東),박완주(朴完柱),27,1,28,1
18631,김형동(金亨東),박용진(朴用鎭),49,8,57,1
18632,김형동(金亨東),박재호(朴在昊),53,9,62,1
18633,김형동(金亨東),박정(朴釘),53,8,61,1
18634,김형동(金亨東),박정하(朴正河),27,33,60,0
18635,김형동(金亨東),박주민(朴柱民),51,5,56,1
18636,김형동(金亨東),박진(朴振),71,68,139,0
18637,김형동(金亨東),박찬대(朴贊大),52,6,58,1
18638,김형동(金亨東),박형수(朴亨修),79,110,189,0
18639,김형동(金亨東),박홍근(朴洪根),52,6,58,1
18640,김형동(金亨東),배준영(裵俊英),82,74,156,0
18641,김형동(金亨東),배진교(裵晋敎),9,8,17,1
18642,김형동(金亨東),배현진(裵賢鎭),88,79,167,0
18643,김형동(金亨東),백종헌(白宗憲),87,146,233,0
18644,김형동(金亨東),백혜련(白惠蓮),52,6,58,1
18645,김형동(金亨東),변재일(卞在一),52,8,60,1
18646,김형동(金亨東),서동용(徐東榕),52,9,61,1
18647,김형동(金亨東),서범수(徐範洙),82,98,180,0
18648,김형동(金亨東),서병수(徐秉洙),99,159,258,0
18649,김형동(金亨東),서삼석(徐參錫),53,9,62,1
18650,김형동(金亨東),서영교(徐瑛敎),53,6,59,1
18651,김형동(金亨東),서영석(徐暎錫),52,10,62,1
18652,김형동(金亨東),서일준(徐一俊),130,232,362,0
18653,김형동(金亨東),서정숙(徐正淑),83,77,160,0
18654,김형동(金亨東),설훈(薛勳),53,6,59,1
18655,김형동(金亨東),성일종(成一鍾),105,176,281,0
18656,김형동(金亨東),소병철(蘇秉哲),53,5,58,1
18657,김형동(金亨東),소병훈(蘇秉勳),51,6,57,1
18658,김형동(金亨東),송갑석(宋甲錫),51,6,57,1
18659,김형동(金亨東),송기헌(宋基憲),54,10,64,1
18660,김형동(金亨東),송석준(宋錫俊),70,61,131,0
18661,김형동(金亨東),송언석(宋彦錫),106,116,222,0
18662,김형동(金亨東),송옥주(宋玉珠),50,5,55,1
18663,김형동(金亨東),송재호(宋在祜),53,7,60,1
18664,김형동(金亨東),신동근(申東根),51,3,54,1
18665,김형동(金亨東),신영대(申榮大),50,5,55,1
18666,김형동(金亨東),신원식(申源湜),86,88,174,0
18667,김형동(金亨東),신정훈(辛正勳),56,6,62,1
18668,김형동(金亨東),신현영(申賢榮),51,5,56,1
18669,김형동(金亨東),심상정(沈相奵),7,10,17,1
18670,김형동(金亨東),안규백(安圭伯),54,16,70,1
18671,김형동(金亨東),안민석(安敏錫),52,6,58,1
18672,김형동(金亨東),안병길(安炳吉),85,109,194,0
18673,김형동(金亨東),안철수(安哲秀),27,20,47,0
18674,김형동(金亨東),안호영(安浩永),51,11,62,1
18675,김형동(金亨東),양경숙(梁敬淑),51,7,58,1
18676,김형동(金亨東),양금희(梁琴喜),106,150,256,0
18677,김형동(金亨東),양기대(梁基大),53,5,58,1
18678,김형동(金亨東),양이원영(梁李媛瑛),47,9,56,1
18679,김형동(金亨東),양정숙(梁貞淑),11,17,28,1
18680,김형동(金亨東),양향자(梁香子),24,7,31,1
18681,김형동(金亨東),어기구(魚基龜),53,9,62,1
18682,김형동(金亨東),엄태영(嚴泰永),76,79,155,0
18683,김형동(金亨東),오기형(吳奇炯),50,4,54,1
18684,김형동(金亨東),오영환(吳永煥),52,14,66,1
18685,김형동(金亨東),용혜인(龍慧仁),2,8,10,1
18686,김형동(金亨東),우상호(禹相虎),51,4,55,1
18687,김형동(金亨東),우원식(禹元植),51,5,56,1
18688,김형동(金亨東),위성곤(魏聖坤),52,14,66,1
18689,김형동(金亨東),유경준(兪京濬),77,113,190,0
18690,김형동(金亨東),유기홍(柳基洪),50,4,54,1
18691,김형동(金亨東),유동수(柳東秀),53,9,62,1
18692,김형동(金亨東),유상범(劉相凡),73,82,155,0
18693,김형동(金亨東),유의동(兪義東),76,83,159,0
18694,김형동(金亨東),유정주(兪訂炷),52,4,56,1
18695,김형동(金亨東),윤건영(尹建永),50,5,55,1
18696,김형동(金亨東),윤관석(尹官石),42,4,46,1
18697,김형동(金亨東),윤두현(尹斗鉉),102,125,227,0
18698,김형동(金亨東),윤미향(尹美香),23,12,35,1
18699,김형동(金亨東),윤상현(尹相現),48,56,104,0
18700,김형동(金亨東),윤영덕(尹永德),52,8,60,1
18701,김형동(金亨東),윤영석(尹永碩),82,94,176,0
18702,김형동(金亨東),윤영찬(尹永燦),51,5,56,1
18703,김형동(金亨東),윤재갑(尹才鉀),58,15,73,1
18704,김형동(金亨東),윤재옥(尹在玉),75,70,145,0
18705,김형동(金亨東),윤주경(尹柱卿),73,79,152,0
18706,김형동(金亨東),윤준병(尹準炳),51,9,60,1
18707,김형동(金亨東),윤창현(尹暢賢),115,128,243,0
18708,김형동(金亨東),윤한홍(尹漢洪),78,91,169,0
18709,김형동(金亨東),윤호중(尹昊重),52,6,58,1
18710,김형동(金亨東),윤후덕(尹厚德),51,10,61,1
18711,김형동(金亨東),이개호(李介昊),52,9,61,1
18712,김형동(金亨東),이달곤(李達坤),65,63,128,0
18713,김형동(金亨東),이동주(李東洲),50,5,55,1
18714,김형동(金亨東),이만희(李晩熙),83,67,150,0
18715,김형동(金亨東),이명수(李明洙),125,186,311,0
18716,김형동(金亨東),이병훈(李炳勳),54,6,60,1
18717,김형동(金亨東),이상민(李相珉),50,6,56,1
18718,김형동(金亨東),이상헌(李相憲),55,7,62,1
18719,김형동(金亨東),이성만(李成萬),45,4,49,1
18720,김형동(金亨東),이소영(李素永),52,9,61,1
18721,김형동(金亨東),이수진(李壽珍),55,8,63,1
18722,김형동(金亨東),이수진(李秀眞),54,8,62,1
18723,김형동(金亨東),이양수(李亮壽),78,71,149,0
18724,김형동(金亨東),이용(李鏞),87,136,223,0
18725,김형동(金亨東),이용빈(李龍彬),54,8,62,1
18726,김형동(金亨東),이용선(李庸瑄),53,7,60,1
18727,김형동(金亨東),이용우(李龍雨),51,10,61,1
18728,김형동(金亨東),이용호(李容鎬),34,17,51,0
18729,김형동(金亨東),이원욱(李元旭),55,10,65,1
18730,김형동(金亨東),이원택(李源澤),51,7,58,1
18731,김형동(金亨東),이은주(李恩周),9,10,19,1
18732,김형동(金亨東),이인선(李仁善),30,48,78,0
18733,김형동(金亨東),이인영(李仁榮),50,4,54,1
18734,김형동(金亨東),이장섭(李將燮),51,6,57,1
18735,김형동(金亨東),이재명(李在明),25,4,29,1
18736,김형동(金亨東),이재정(李在汀),50,5,55,1
18737,김형동(金亨東),이정문(李楨文),52,5,57,1
18738,김형동(金亨東),이종배(李鍾培),102,129,231,0
18739,김형동(金亨東),이종성(李鍾成),143,267,410,0
18740,김형동(金亨東),이주환(李周桓),98,139,237,0
18741,김형동(金亨東),이채익(李埰益),78,112,190,0
18742,김형동(金亨東),이철규(李喆圭),91,85,176,0
18743,김형동(金亨東),이탄희(李誕熙),51,7,58,1
18744,김형동(金亨東),이태규(李泰珪),49,66,115,0
18745,김형동(金亨東),이학영(李學永),51,5,56,1
18746,김형동(金亨東),이해식(李海植),52,13,65,1
18747,김형동(金亨東),이헌승(李憲昇),73,85,158,0
18748,김형동(金亨東),이형석(李炯錫),50,6,56,1
18749,김형동(金亨東),인재근(印在謹),49,9,58,1
18750,김형동(金亨東),임병헌(林炳憲),34,59,93,0
18751,김형동(金亨東),임오경(林五卿),51,6,57,1
18752,김형동(金亨東),임이자(林利子),149,229,378,0
18753,김형동(金亨東),임종성(林鍾聲),51,5,56,1
18754,김형동(金亨東),임호선(林昊宣),53,9,62,1
18755,김형동(金亨東),장경태(張耿態),53,8,61,1
18756,김형동(金亨東),장동혁(張東赫),29,21,50,0
18757,김형동(金亨東),장제원(張濟元),71,53,124,0
18758,김형동(金亨東),장철민(張喆敏),52,7,59,1
18759,김형동(金亨東),장혜영(張惠英),8,9,17,1
18760,김형동(金亨東),전봉민(田奉珉),55,76,131,0
18761,김형동(金亨東),전용기(田溶冀),52,5,57,1
18762,김형동(金亨東),전재수(田載秀),51,6,57,1
18763,김형동(金亨東),전주혜(全珠惠),80,89,169,0
18764,김형동(金亨東),전해철(全海澈),53,5,58,1
18765,김형동(金亨東),전혜숙(全惠淑),52,10,62,1
18766,김형동(金亨東),정경희(丁慶姬),77,63,140,0
18767,김형동(金亨東),정동만(鄭東萬),68,73,141,0
18768,김형동(金亨東),정성호(鄭成湖),54,5,59,1
18769,김형동(金亨東),정우택(鄭宇澤),33,42,75,0
18770,김형동(金亨東),정운천(鄭雲天),111,148,259,0
18771,김형동(金亨東),정일영(鄭日永),51,4,55,1
18772,김형동(金亨東),정점식(鄭点植),80,76,156,0
18773,김형동(金亨東),정진석(鄭鎭碩),101,118,219,0
18774,김형동(金亨東),정청래(鄭淸來),51,5,56,1
18775,김형동(金亨東),정춘숙(鄭春淑),52,5,57,1
18776,김형동(金亨東),정태호(鄭泰浩),52,5,57,1
18777,김형동(金亨東),정필모(鄭必模),51,5,56,1
18778,김형동(金亨東),정희용(鄭熙溶),113,157,270,0
18779,김형동(金亨東),조경태(趙慶泰),83,92,175,0
18780,김형동(金亨東),조명희(曺明姬),100,160,260,0
18781,김형동(金亨東),조수진(趙修眞),87,140,227,0
18782,김형동(金亨東),조승래(趙承來),54,8,62,1
18783,김형동(金亨東),조오섭(曺五燮),51,8,59,1
18784,김형동(金亨東),조은희(趙恩禧),29,28,57,0
18785,김형동(金亨東),조응천(趙應天),50,4,54,1
18786,김형동(金亨東),조정식(趙正湜),49,4,53,1
18787,김형동(金亨東),조정훈(趙廷訓),1,14,15,1
18788,김형동(金亨東),조해진(曺海珍),64,50,114,0
18789,김형동(金亨東),주철현(朱哲鉉),53,8,61,1
18790,김형동(金亨東),주호영(朱豪英),78,68,146,0
18791,김형동(金亨東),지성호(池成浩),111,189,300,0
18792,김형동(金亨東),진선미(陳善美),50,7,57,1
18793,김형동(金亨東),진성준(陳聲準),51,5,56,1
18794,김형동(金亨東),천준호(千俊鎬),50,4,54,1
18795,김형동(金亨東),최기상(崔基相),49,5,54,1
18796,김형동(金亨東),최승재(崔承宰),84,112,196,0
18797,김형동(金亨東),최연숙(崔姸淑),46,52,98,0
18798,김형동(金亨東),최영희(崔英姬),34,40,74,0
18799,김형동(金亨東),최인호(崔仁昊),53,9,62,1
18800,김형동(金亨東),최재형(崔在亨),27,14,41,0
18801,김형동(金亨東),최종윤(崔鍾允),51,5,56,1
18802,김형동(金亨東),최춘식(崔春植),91,130,221,0
18803,김형동(金亨東),최형두(崔炯斗),97,111,208,0
18804,김형동(金亨東),최혜영(崔惠英),54,6,60,1
18805,김형동(金亨東),추경호(秋慶鎬),123,173,296,0
18806,김형동(金亨東),태영호(太永浩),89,149,238,0
18807,김형동(金亨東),하영제(河榮帝),94,150,244,1
18808,김형동(金亨東),하태경(河泰慶),65,49,114,0
18809,김형동(金亨東),한기호(韓起鎬),73,82,155,0
18810,김형동(金亨東),한무경(韓茂景),105,146,251,0
18811,김형동(金亨東),한병도(韓秉道),50,9,59,1
18812,김형동(金亨東),한정애(韓貞愛),50,5,55,1
18813,김형동(金亨東),한준호(韓俊鎬),51,9,60,1
18814,김형동(金亨東),허숙정(許淑湞),0,0,0,1
18815,김형동(金亨東),허영(許榮),52,12,64,1
18816,김형동(金亨東),허은아(許垠娥),82,89,171,0
18817,김형동(金亨東),허종식(許琮植),53,8,61,1
18818,김형동(金亨東),홍기원(洪起元),52,6,58,1
18819,김형동(金亨東),홍문표(洪文杓),88,105,193,0
18820,김형동(金亨東),홍석준(洪碩晙),85,87,172,0
18821,김형동(金亨東),홍성국(洪性國),53,17,70,1
18822,김형동(金亨東),홍영표(洪永杓),52,7,59,1
18823,김형동(金亨東),홍익표(洪翼杓),51,8,59,1
18824,김형동(金亨東),홍정민(洪貞敏),54,6,60,1
18825,김형동(金亨東),황보승희(皇甫承希),81,104,185,1
18826,김형동(金亨東),황운하(黃雲夏),54,11,65,1
18827,김형동(金亨東),황희(黃熙),50,6,56,1
18828,김홍걸(金弘傑),김회재(金會在),48,89,137,0
18829,김홍걸(金弘傑),김희곤(金熙坤),16,5,21,1
18830,김홍걸(金弘傑),김희국(金熙國),14,4,18,1
18831,김홍걸(金弘傑),남인순(南仁順),54,137,191,0
18832,김홍걸(金弘傑),노용호(魯容昊),5,5,10,1
18833,김홍걸(金弘傑),노웅래(盧雄來),56,136,192,0
18834,김홍걸(金弘傑),도종환(都鍾煥),45,90,135,0
18835,김홍걸(金弘傑),류성걸(柳性杰),15,4,19,1
18836,김홍걸(金弘傑),류호정(柳好貞),25,93,118,1
18837,김홍걸(金弘傑),맹성규(孟聖奎),44,62,106,0
18838,김홍걸(金弘傑),문정복(文貞福),51,104,155,0
18839,김홍걸(金弘傑),문진석(文振碩),82,162,244,0
18840,김홍걸(金弘傑),민병덕(閔炳德),56,212,268,0
18841,김홍걸(金弘傑),민형배(閔馨培),106,311,417,0
18842,김홍걸(金弘傑),민홍철(閔洪喆),45,71,116,0
18843,김홍걸(金弘傑),박광온(朴洸瑥),33,68,101,0
18844,김홍걸(金弘傑),박대수(朴大壽),16,10,26,1
18845,김홍걸(金弘傑),박대출(朴大出),15,5,20,1
18846,김홍걸(金弘傑),박덕흠(朴德欽),16,8,24,1
18847,김홍걸(金弘傑),박범계(朴範界),28,27,55,0
18848,김홍걸(金弘傑),박병석(朴炳錫),12,21,33,0
18849,김홍걸(金弘傑),박상혁(朴商赫),52,158,210,0
18850,김홍걸(金弘傑),박성민(朴聖敏),14,6,20,1
18851,김홍걸(金弘傑),박성준(朴省俊),68,149,217,0
18852,김홍걸(金弘傑),박성중(朴成重),14,6,20,1
18853,김홍걸(金弘傑),박수영(朴洙瑩),14,8,22,1
18854,김홍걸(金弘傑),박영순(朴英淳),70,123,193,0
18855,김홍걸(金弘傑),박완주(朴完柱),34,54,88,1
18856,김홍걸(金弘傑),박용진(朴用鎭),29,79,108,0
18857,김홍걸(金弘傑),박재호(朴在昊),45,85,130,0
18858,김홍걸(金弘傑),박정(朴釘),74,170,244,0
18859,김홍걸(金弘傑),박정하(朴正河),10,7,17,1
18860,김홍걸(金弘傑),박주민(朴柱民),38,77,115,0
18861,김홍걸(金弘傑),박진(朴振),15,6,21,1
18862,김홍걸(金弘傑),박찬대(朴贊大),42,79,121,0
18863,김홍걸(金弘傑),박형수(朴亨修),15,5,20,1
18864,김홍걸(金弘傑),박홍근(朴洪根),69,139,208,0
18865,김홍걸(金弘傑),배준영(裵俊英),21,11,32,1
18866,김홍걸(金弘傑),배진교(裵晋敎),24,74,98,1
18867,김홍걸(金弘傑),배현진(裵賢鎭),14,6,20,1
18868,김홍걸(金弘傑),백종헌(白宗憲),15,6,21,1
18869,김홍걸(金弘傑),백혜련(白惠蓮),46,85,131,0
18870,김홍걸(金弘傑),변재일(卞在一),40,62,102,0
18871,김홍걸(金弘傑),서동용(徐東榕),53,134,187,0
18872,김홍걸(金弘傑),서범수(徐範洙),15,6,21,1
18873,김홍걸(金弘傑),서병수(徐秉洙),15,6,21,1
18874,김홍걸(金弘傑),서삼석(徐參錫),50,84,134,0
18875,김홍걸(金弘傑),서영교(徐瑛敎),84,203,287,0
18876,김홍걸(金弘傑),서영석(徐暎錫),61,152,213,0
18877,김홍걸(金弘傑),서일준(徐一俊),20,7,27,1
18878,김홍걸(金弘傑),서정숙(徐正淑),18,9,27,1
18879,김홍걸(金弘傑),설훈(薛勳),42,108,150,0
18880,김홍걸(金弘傑),성일종(成一鍾),15,7,22,1
18881,김홍걸(金弘傑),소병철(蘇秉哲),39,86,125,0
18882,김홍걸(金弘傑),소병훈(蘇秉勳),49,99,148,0
18883,김홍걸(金弘傑),송갑석(宋甲錫),61,159,220,0
18884,김홍걸(金弘傑),송기헌(宋基憲),38,65,103,0
18885,김홍걸(金弘傑),송석준(宋錫俊),14,6,20,1
18886,김홍걸(金弘傑),송언석(宋彦錫),15,5,20,1
18887,김홍걸(金弘傑),송옥주(宋玉珠),56,149,205,0
18888,김홍걸(金弘傑),송재호(宋在祜),48,141,189,0
18889,김홍걸(金弘傑),신동근(申東根),54,83,137,0
18890,김홍걸(金弘傑),신영대(申榮大),36,90,126,0
18891,김홍걸(金弘傑),신원식(申源湜),14,5,19,1
18892,김홍걸(金弘傑),신정훈(辛正勳),107,244,351,0
18893,김홍걸(金弘傑),신현영(申賢榮),35,41,76,0
18894,김홍걸(金弘傑),심상정(沈相奵),25,73,98,1
18895,김홍걸(金弘傑),안규백(安圭伯),51,93,144,0
18896,김홍걸(金弘傑),안민석(安敏錫),61,146,207,0
18897,김홍걸(金弘傑),안병길(安炳吉),15,5,20,1
18898,김홍걸(金弘傑),안철수(安哲秀),5,4,9,1
18899,김홍걸(金弘傑),안호영(安浩永),59,152,211,0
18900,김홍걸(金弘傑),양경숙(梁敬淑),60,173,233,0
18901,김홍걸(金弘傑),양금희(梁琴喜),15,7,22,1
18902,김홍걸(金弘傑),양기대(梁基大),56,133,189,0
18903,김홍걸(金弘傑),양이원영(梁李媛瑛),49,90,139,0
18904,김홍걸(金弘傑),양정숙(梁貞淑),103,340,443,1
18905,김홍걸(金弘傑),양향자(梁香子),52,84,136,1
18906,김홍걸(金弘傑),어기구(魚基龜),40,70,110,0
18907,김홍걸(金弘傑),엄태영(嚴泰永),16,5,21,1
18908,김홍걸(金弘傑),오기형(吳奇炯),28,34,62,0
18909,김홍걸(金弘傑),오영환(吳永煥),103,267,370,0
18910,김홍걸(金弘傑),용혜인(龍慧仁),22,74,96,1
18911,김홍걸(金弘傑),우상호(禹相虎),29,58,87,0
18912,김홍걸(金弘傑),우원식(禹元植),37,72,109,0
18913,김홍걸(金弘傑),위성곤(魏聖坤),52,137,189,0
18914,김홍걸(金弘傑),유경준(兪京濬),15,4,19,1
18915,김홍걸(金弘傑),유기홍(柳基洪),30,89,119,0
18916,김홍걸(金弘傑),유동수(柳東秀),42,72,114,0
18917,김홍걸(金弘傑),유상범(劉相凡),19,6,25,1
18918,김홍걸(金弘傑),유의동(兪義東),15,6,21,1
18919,김홍걸(金弘傑),유정주(兪訂炷),73,191,264,0
18920,김홍걸(金弘傑),윤건영(尹建永),41,95,136,0
18921,김홍걸(金弘傑),윤관석(尹官石),42,72,114,1
18922,김홍걸(金弘傑),윤두현(尹斗鉉),15,8,23,1
18923,김홍걸(金弘傑),윤미향(尹美香),60,179,239,1
18924,김홍걸(金弘傑),윤상현(尹相現),6,7,13,1
18925,김홍걸(金弘傑),윤영덕(尹永德),55,157,212,0
18926,김홍걸(金弘傑),윤영석(尹永碩),15,5,20,1
18927,김홍걸(金弘傑),윤영찬(尹永燦),40,82,122,0
18928,김홍걸(金弘傑),윤재갑(尹才鉀),81,173,254,0
18929,김홍걸(金弘傑),윤재옥(尹在玉),14,5,19,1
18930,김홍걸(金弘傑),윤주경(尹柱卿),14,8,22,1
18931,김홍걸(金弘傑),윤준병(尹準炳),82,273,355,0
18932,김홍걸(金弘傑),윤창현(尹暢賢),15,7,22,1
18933,김홍걸(金弘傑),윤한홍(尹漢洪),15,6,21,1
18934,김홍걸(金弘傑),윤호중(尹昊重),29,81,110,0
18935,김홍걸(金弘傑),윤후덕(尹厚德),54,113,167,0
18936,김홍걸(金弘傑),이개호(李介昊),42,99,141,0
18937,김홍걸(金弘傑),이달곤(李達坤),18,12,30,1
18938,김홍걸(金弘傑),이동주(李東洲),58,181,239,0
18939,김홍걸(金弘傑),이만희(李晩熙),14,4,18,1
18940,김홍걸(金弘傑),이명수(李明洙),21,24,45,1
18941,김홍걸(金弘傑),이병훈(李炳勳),79,184,263,0
18942,김홍걸(金弘傑),이상민(李相珉),29,48,77,0
18943,김홍걸(金弘傑),이상헌(李相憲),65,166,231,0
18944,김홍걸(金弘傑),이성만(李成萬),67,169,236,1
18945,김홍걸(金弘傑),이소영(李素永),42,47,89,0
18946,김홍걸(金弘傑),이수진(李壽珍),67,204,271,0
18947,김홍걸(金弘傑),이수진(李秀眞),68,111,179,0
18948,김홍걸(金弘傑),이양수(李亮壽),16,7,23,1
18949,김홍걸(金弘傑),이용(李鏞),14,5,19,1
18950,김홍걸(金弘傑),이용빈(李龍彬),98,292,390,0
18951,김홍걸(金弘傑),이용선(李庸瑄),57,149,206,0
18952,김홍걸(金弘傑),이용우(李龍雨),49,92,141,0
18953,김홍걸(金弘傑),이용호(李容鎬),29,48,77,1
18954,김홍걸(金弘傑),이원욱(李元旭),45,137,182,0
18955,김홍걸(金弘傑),이원택(李源澤),44,71,115,0
18956,김홍걸(金弘傑),이은주(李恩周),29,77,106,1
18957,김홍걸(金弘傑),이인선(李仁善),5,6,11,1
18958,김홍걸(金弘傑),이인영(李仁榮),28,57,85,0
18959,김홍걸(金弘傑),이장섭(李將燮),57,96,153,0
18960,김홍걸(金弘傑),이재명(李在明),12,24,36,0
18961,김홍걸(金弘傑),이재정(李在汀),43,69,112,0
18962,김홍걸(金弘傑),이정문(李楨文),63,175,238,0
18963,김홍걸(金弘傑),이종배(李鍾培),15,7,22,1
18964,김홍걸(金弘傑),이종성(李鍾成),14,8,22,1
18965,김홍걸(金弘傑),이주환(李周桓),14,6,20,1
18966,김홍걸(金弘傑),이채익(李埰益),17,9,26,1
18967,김홍걸(金弘傑),이철규(李喆圭),15,5,20,1
18968,김홍걸(金弘傑),이탄희(李誕熙),50,88,138,0
18969,김홍걸(金弘傑),이태규(李泰珪),9,10,19,1
18970,김홍걸(金弘傑),이학영(李學永),70,152,222,0
18971,김홍걸(金弘傑),이해식(李海植),56,86,142,0
18972,김홍걸(金弘傑),이헌승(李憲昇),16,5,21,1
18973,김홍걸(金弘傑),이형석(李炯錫),54,126,180,0
18974,김홍걸(金弘傑),인재근(印在謹),51,129,180,0
18975,김홍걸(金弘傑),임병헌(林炳憲),5,5,10,1
18976,김홍걸(金弘傑),임오경(林五卿),76,127,203,0
18977,김홍걸(金弘傑),임이자(林利子),14,5,19,1
18978,김홍걸(金弘傑),임종성(林鍾聲),65,126,191,0
18979,김홍걸(金弘傑),임호선(林昊宣),79,180,259,0
18980,김홍걸(金弘傑),장경태(張耿態),62,165,227,0
18981,김홍걸(金弘傑),장동혁(張東赫),6,5,11,1
18982,김홍걸(金弘傑),장제원(張濟元),14,4,18,1
18983,김홍걸(金弘傑),장철민(張喆敏),79,113,192,0
18984,김홍걸(金弘傑),장혜영(張惠英),20,68,88,1
18985,김홍걸(金弘傑),전봉민(田奉珉),15,5,20,1
18986,김홍걸(金弘傑),전용기(田溶冀),67,133,200,0
18987,김홍걸(金弘傑),전재수(田載秀),39,80,119,0
18988,김홍걸(金弘傑),전주혜(全珠惠),16,9,25,1
18989,김홍걸(金弘傑),전해철(全海澈),31,62,93,0
18990,김홍걸(金弘傑),전혜숙(全惠淑),54,110,164,0
18991,김홍걸(金弘傑),정경희(丁慶姬),14,4,18,1
18992,김홍걸(金弘傑),정동만(鄭東萬),14,4,18,1
18993,김홍걸(金弘傑),정성호(鄭成湖),37,107,144,0
18994,김홍걸(金弘傑),정우택(鄭宇澤),5,4,9,1
18995,김홍걸(金弘傑),정운천(鄭雲天),14,7,21,1
18996,김홍걸(金弘傑),정일영(鄭日永),43,107,150,0
18997,김홍걸(金弘傑),정점식(鄭点植),15,4,19,1
18998,김홍걸(金弘傑),정진석(鄭鎭碩),15,7,22,1
18999,김홍걸(金弘傑),정청래(鄭淸來),49,46,95,0
19000,김홍걸(金弘傑),정춘숙(鄭春淑),54,106,160,0
19001,김홍걸(金弘傑),정태호(鄭泰浩),47,131,178,0
19002,김홍걸(金弘傑),정필모(鄭必模),52,111,163,0
19003,김홍걸(金弘傑),정희용(鄭熙溶),15,6,21,1
19004,김홍걸(金弘傑),조경태(趙慶泰),14,7,21,1
19005,김홍걸(金弘傑),조명희(曺明姬),14,9,23,1
19006,김홍걸(金弘傑),조수진(趙修眞),14,5,19,1
19007,김홍걸(金弘傑),조승래(趙承來),73,129,202,0
19008,김홍걸(金弘傑),조오섭(曺五燮),58,215,273,0
19009,김홍걸(金弘傑),조은희(趙恩禧),13,10,23,1
19010,김홍걸(金弘傑),조응천(趙應天),29,39,68,0
19011,김홍걸(金弘傑),조정식(趙正湜),35,66,101,0
19012,김홍걸(金弘傑),조정훈(趙廷訓),7,28,35,1
19013,김홍걸(金弘傑),조해진(曺海珍),16,7,23,1
19014,김홍걸(金弘傑),주철현(朱哲鉉),60,133,193,0
19015,김홍걸(金弘傑),주호영(朱豪英),15,4,19,1
19016,김홍걸(金弘傑),지성호(池成浩),19,6,25,1
19017,김홍걸(金弘傑),진선미(陳善美),34,66,100,0
19018,김홍걸(金弘傑),진성준(陳聲準),50,94,144,0
19019,김홍걸(金弘傑),천준호(千俊鎬),32,49,81,0
19020,김홍걸(金弘傑),최기상(崔基相),33,71,104,0
19021,김홍걸(金弘傑),최승재(崔承宰),15,10,25,1
19022,김홍걸(金弘傑),최연숙(崔姸淑),12,19,31,1
19023,김홍걸(金弘傑),최영희(崔英姬),6,9,15,1
19024,김홍걸(金弘傑),최인호(崔仁昊),48,101,149,0
19025,김홍걸(金弘傑),최재형(崔在亨),5,4,9,1
19026,김홍걸(金弘傑),최종윤(崔鍾允),65,181,246,0
19027,김홍걸(金弘傑),최춘식(崔春植),14,10,24,1
19028,김홍걸(金弘傑),최형두(崔炯斗),15,7,22,1
19029,김홍걸(金弘傑),최혜영(崔惠英),74,161,235,0
19030,김홍걸(金弘傑),추경호(秋慶鎬),14,3,17,1
19031,김홍걸(金弘傑),태영호(太永浩),14,6,20,1
19032,김홍걸(金弘傑),하영제(河榮帝),10,5,15,1
19033,김홍걸(金弘傑),하태경(河泰慶),15,6,21,1
19034,김홍걸(金弘傑),한기호(韓起鎬),16,6,22,1
19035,김홍걸(金弘傑),한무경(韓茂景),16,7,23,1
19036,김홍걸(金弘傑),한병도(韓秉道),75,139,214,0
19037,김홍걸(金弘傑),한정애(韓貞愛),35,93,128,0
19038,김홍걸(金弘傑),한준호(韓俊鎬),63,213,276,0
19039,김홍걸(金弘傑),허숙정(許淑湞),1,3,4,0
19040,김홍걸(金弘傑),허영(許榮),65,111,176,0
19041,김홍걸(金弘傑),허은아(許垠娥),14,7,21,1
19042,김홍걸(金弘傑),허종식(許琮植),59,116,175,0
19043,김홍걸(金弘傑),홍기원(洪起元),47,110,157,0
19044,김홍걸(金弘傑),홍문표(洪文杓),16,15,31,1
19045,김홍걸(金弘傑),홍석준(洪碩晙),15,5,20,1
19046,김홍걸(金弘傑),홍성국(洪性國),83,151,234,0
19047,김홍걸(金弘傑),홍영표(洪永杓),32,86,118,0
19048,김홍걸(金弘傑),홍익표(洪翼杓),42,59,101,0
19049,김홍걸(金弘傑),홍정민(洪貞敏),82,156,238,0
19050,김홍걸(金弘傑),황보승희(皇甫承希),12,4,16,1
19051,김홍걸(金弘傑),황운하(黃雲夏),74,146,220,0
19052,김홍걸(金弘傑),황희(黃熙),31,54,85,0
19053,김회재(金會在),김희곤(金熙坤),51,5,56,1
19054,김회재(金會在),김희국(金熙國),50,4,54,1
19055,김회재(金會在),남인순(南仁順),123,97,220,0
19056,김회재(金會在),노용호(魯容昊),26,3,29,1
19057,김회재(金會在),노웅래(盧雄來),111,81,192,0
19058,김회재(金會在),도종환(都鍾煥),107,64,171,0
19059,김회재(金會在),류성걸(柳性杰),50,3,53,1
19060,김회재(金會在),류호정(柳好貞),18,33,51,1
19061,김회재(金會在),맹성규(孟聖奎),107,97,204,0
19062,김회재(金會在),문정복(文貞福),104,59,163,0
19063,김회재(金會在),문진석(文振碩),124,89,213,0
19064,김회재(金會在),민병덕(閔炳德),89,78,167,0
19065,김회재(金會在),민형배(閔馨培),79,99,178,0
19066,김회재(金會在),민홍철(閔洪喆),94,83,177,0
19067,김회재(金會在),박광온(朴洸瑥),96,63,159,0
19068,김회재(金會在),박대수(朴大壽),51,5,56,1
19069,김회재(金會在),박대출(朴大出),51,4,55,1
19070,김회재(金會在),박덕흠(朴德欽),38,5,43,1
19071,김회재(金會在),박범계(朴範界),79,37,116,0
19072,김회재(金會在),박병석(朴炳錫),41,18,59,0
19073,김회재(金會在),박상혁(朴商赫),110,107,217,0
19074,김회재(金會在),박성민(朴聖敏),52,5,57,1
19075,김회재(金會在),박성준(朴省俊),132,146,278,0
19076,김회재(金會在),박성중(朴成重),49,3,52,1
19077,김회재(金會在),박수영(朴洙瑩),51,5,56,1
19078,김회재(金會在),박영순(朴英淳),135,109,244,0
19079,김회재(金會在),박완주(朴完柱),61,58,119,1
19080,김회재(金會在),박용진(朴用鎭),91,54,145,0
19081,김회재(金會在),박재호(朴在昊),93,57,150,0
19082,김회재(金會在),박정(朴釘),114,96,210,0
19083,김회재(金會在),박정하(朴正河),27,3,30,1
19084,김회재(金會在),박주민(朴柱民),86,55,141,0
19085,김회재(金會在),박진(朴振),51,6,57,1
19086,김회재(金會在),박찬대(朴贊大),94,59,153,0
19087,김회재(金會在),박형수(朴亨修),51,3,54,1
19088,김회재(金會在),박홍근(朴洪根),114,104,218,0
19089,김회재(金會在),배준영(裵俊英),50,5,55,1
19090,김회재(金會在),배진교(裵晋敎),19,24,43,1
19091,김회재(金會在),배현진(裵賢鎭),51,4,55,1
19092,김회재(金會在),백종헌(白宗憲),52,4,56,1
19093,김회재(金會在),백혜련(白惠蓮),98,73,171,0
19094,김회재(金會在),변재일(卞在一),87,39,126,0
19095,김회재(金會在),서동용(徐東榕),114,121,235,0
19096,김회재(金會在),서범수(徐範洙),55,6,61,1
19097,김회재(金會在),서병수(徐秉洙),51,3,54,1
19098,김회재(金會在),서삼석(徐參錫),100,86,186,0
19099,김회재(金會在),서영교(徐瑛敎),109,117,226,0
19100,김회재(金會在),서영석(徐暎錫),104,91,195,0
19101,김회재(金會在),서일준(徐一俊),52,5,57,1
19102,김회재(金會在),서정숙(徐正淑),51,6,57,1
19103,김회재(金會在),설훈(薛勳),86,59,145,0
19104,김회재(金會在),성일종(成一鍾),52,8,60,1
19105,김회재(金會在),소병철(蘇秉哲),97,88,185,0
19106,김회재(金會在),소병훈(蘇秉勳),117,113,230,0
19107,김회재(金會在),송갑석(宋甲錫),112,112,224,0
19108,김회재(金會在),송기헌(宋基憲),85,59,144,0
19109,김회재(金會在),송석준(宋錫俊),52,7,59,1
19110,김회재(金會在),송언석(宋彦錫),47,7,54,1
19111,김회재(金會在),송옥주(宋玉珠),95,89,184,0
19112,김회재(金會在),송재호(宋在祜),118,118,236,0
19113,김회재(金會在),신동근(申東根),92,63,155,0
19114,김회재(金會在),신영대(申榮大),88,63,151,0
19115,김회재(金會在),신원식(申源湜),52,3,55,1
19116,김회재(金會在),신정훈(辛正勳),132,182,314,0
19117,김회재(金會在),신현영(申賢榮),90,61,151,0
19118,김회재(金會在),심상정(沈相奵),17,18,35,1
19119,김회재(金會在),안규백(安圭伯),105,89,194,0
19120,김회재(金會在),안민석(安敏錫),90,54,144,0
19121,김회재(金會在),안병길(安炳吉),54,4,58,1
19122,김회재(金會在),안철수(安哲秀),27,4,31,1
19123,김회재(金會在),안호영(安浩永),79,65,144,0
19124,김회재(金會在),양경숙(梁敬淑),101,120,221,0
19125,김회재(金會在),양금희(梁琴喜),52,7,59,1
19126,김회재(金會在),양기대(梁基大),94,64,158,0
19127,김회재(金會在),양이원영(梁李媛瑛),95,70,165,0
19128,김회재(金會在),양정숙(梁貞淑),88,148,236,1
19129,김회재(金會在),양향자(梁香子),52,70,122,1
19130,김회재(金會在),어기구(魚基龜),85,59,144,0
19131,김회재(金會在),엄태영(嚴泰永),53,9,62,1
19132,김회재(金會在),오기형(吳奇炯),86,50,136,0
19133,김회재(金會在),오영환(吳永煥),135,141,276,0
19134,김회재(金會在),용혜인(龍慧仁),22,29,51,1
19135,김회재(金會在),우상호(禹相虎),82,38,120,0
19136,김회재(金會在),우원식(禹元植),99,71,170,0
19137,김회재(金會在),위성곤(魏聖坤),100,100,200,0
19138,김회재(金會在),유경준(兪京濬),51,6,57,1
19139,김회재(金會在),유기홍(柳基洪),82,41,123,0
19140,김회재(金會在),유동수(柳東秀),97,66,163,0
19141,김회재(金會在),유상범(劉相凡),53,5,58,1
19142,김회재(金會在),유의동(兪義東),53,4,57,1
19143,김회재(金會在),유정주(兪訂炷),111,82,193,0
19144,김회재(金會在),윤건영(尹建永),99,84,183,0
19145,김회재(金會在),윤관석(尹官石),83,67,150,1
19146,김회재(金會在),윤두현(尹斗鉉),52,3,55,1
19147,김회재(金會在),윤미향(尹美香),56,56,112,1
19148,김회재(金會在),윤상현(尹相現),32,9,41,1
19149,김회재(金會在),윤영덕(尹永德),110,92,202,0
19150,김회재(金會在),윤영석(尹永碩),50,6,56,1
19151,김회재(金會在),윤영찬(尹永燦),86,48,134,0
19152,김회재(金會在),윤재갑(尹才鉀),137,141,278,0
19153,김회재(金會在),윤재옥(尹在玉),54,4,58,1
19154,김회재(金會在),윤주경(尹柱卿),50,5,55,1
19155,김회재(金會在),윤준병(尹準炳),112,117,229,0
19156,김회재(金會在),윤창현(尹暢賢),50,5,55,1
19157,김회재(金會在),윤한홍(尹漢洪),50,4,54,1
19158,김회재(金會在),윤호중(尹昊重),81,51,132,0
19159,김회재(金會在),윤후덕(尹厚德),87,77,164,0
19160,김회재(金會在),이개호(李介昊),100,103,203,0
19161,김회재(金會在),이달곤(李達坤),53,5,58,1
19162,김회재(金會在),이동주(李東洲),99,86,185,0
19163,김회재(金會在),이만희(李晩熙),53,3,56,1
19164,김회재(金會在),이명수(李明洙),53,10,63,1
19165,김회재(金會在),이병훈(李炳勳),118,134,252,0
19166,김회재(金會在),이상민(李相珉),87,48,135,0
19167,김회재(金會在),이상헌(李相憲),102,106,208,0
19168,김회재(金會在),이성만(李成萬),115,126,241,1
19169,김회재(金會在),이소영(李素永),85,51,136,0
19170,김회재(金會在),이수진(李壽珍),121,131,252,0
19171,김회재(金會在),이수진(李秀眞),108,77,185,0
19172,김회재(金會在),이양수(李亮壽),55,5,60,1
19173,김회재(金會在),이용(李鏞),53,4,57,1
19174,김회재(金會在),이용빈(李龍彬),124,151,275,0
19175,김회재(金會在),이용선(李庸瑄),105,75,180,0
19176,김회재(金會在),이용우(李龍雨),112,82,194,0
19177,김회재(金會在),이용호(李容鎬),36,21,57,1
19178,김회재(金會在),이원욱(李元旭),89,74,163,0
19179,김회재(金會在),이원택(李源澤),111,99,210,0
19180,김회재(金會在),이은주(李恩周),25,20,45,1
19181,김회재(金會在),이인선(李仁善),26,3,29,1
19182,김회재(金會在),이인영(李仁榮),81,46,127,0
19183,김회재(金會在),이장섭(李將燮),91,66,157,0
19184,김회재(金會在),이재명(李在明),40,20,60,0
19185,김회재(金會在),이재정(李在汀),84,54,138,0
19186,김회재(金會在),이정문(李楨文),108,85,193,0
19187,김회재(金會在),이종배(李鍾培),51,6,57,1
19188,김회재(金會在),이종성(李鍾成),52,3,55,1
19189,김회재(金會在),이주환(李周桓),51,5,56,1
19190,김회재(金會在),이채익(李埰益),51,5,56,1
19191,김회재(金會在),이철규(李喆圭),55,7,62,1
19192,김회재(金會在),이탄희(李誕熙),98,69,167,0
19193,김회재(金會在),이태규(李泰珪),30,4,34,1
19194,김회재(金會在),이학영(李學永),97,72,169,0
19195,김회재(金會在),이해식(李海植),101,76,177,0
19196,김회재(金會在),이헌승(李憲昇),51,3,54,1
19197,김회재(金會在),이형석(李炯錫),111,102,213,0
19198,김회재(金會在),인재근(印在謹),123,107,230,0
19199,김회재(金會在),임병헌(林炳憲),26,3,29,1
19200,김회재(金會在),임오경(林五卿),85,58,143,0
19201,김회재(金會在),임이자(林利子),50,4,54,1
19202,김회재(金會在),임종성(林鍾聲),104,105,209,0
19203,김회재(金會在),임호선(林昊宣),115,109,224,0
19204,김회재(金會在),장경태(張耿態),116,88,204,0
19205,김회재(金會在),장동혁(張東赫),26,3,29,1
19206,김회재(金會在),장제원(張濟元),50,3,53,1
19207,김회재(金會在),장철민(張喆敏),104,88,192,0
19208,김회재(金會在),장혜영(張惠英),15,15,30,1
19209,김회재(金會在),전봉민(田奉珉),36,4,40,1
19210,김회재(金會在),전용기(田溶冀),88,62,150,0
19211,김회재(金會在),전재수(田載秀),96,74,170,0
19212,김회재(金會在),전주혜(全珠惠),54,5,59,1
19213,김회재(金會在),전해철(全海澈),84,57,141,0
19214,김회재(金會在),전혜숙(全惠淑),127,150,277,0
19215,김회재(金會在),정경희(丁慶姬),51,3,54,1
19216,김회재(金會在),정동만(鄭東萬),50,3,53,1
19217,김회재(金會在),정성호(鄭成湖),81,84,165,0
19218,김회재(金會在),정우택(鄭宇澤),26,4,30,1
19219,김회재(金會在),정운천(鄭雲天),51,4,55,1
19220,김회재(金會在),정일영(鄭日永),112,117,229,0
19221,김회재(金會在),정점식(鄭点植),51,3,54,1
19222,김회재(金會在),정진석(鄭鎭碩),53,6,59,1
19223,김회재(金會在),정청래(鄭淸來),96,64,160,0
19224,김회재(金會在),정춘숙(鄭春淑),98,77,175,0
19225,김회재(金會在),정태호(鄭泰浩),92,69,161,0
19226,김회재(金會在),정필모(鄭必模),95,72,167,0
19227,김회재(金會在),정희용(鄭熙溶),51,6,57,1
19228,김회재(金會在),조경태(趙慶泰),51,3,54,1
19229,김회재(金會在),조명희(曺明姬),52,6,58,1
19230,김회재(金會在),조수진(趙修眞),52,5,57,1
19231,김회재(金會在),조승래(趙承來),106,67,173,0
19232,김회재(金會在),조오섭(曺五燮),139,179,318,0
19233,김회재(金會在),조은희(趙恩禧),27,3,30,1
19234,김회재(金會在),조응천(趙應天),98,49,147,0
19235,김회재(金會在),조정식(趙正湜),81,40,121,0
19236,김회재(金會在),조정훈(趙廷訓),6,11,17,1
19237,김회재(金會在),조해진(曺海珍),53,4,57,1
19238,김회재(金會在),주철현(朱哲鉉),114,129,243,0
19239,김회재(金會在),주호영(朱豪英),51,3,54,1
19240,김회재(金會在),지성호(池成浩),51,4,55,1
19241,김회재(金會在),진선미(陳善美),98,41,139,0
19242,김회재(金會在),진성준(陳聲準),106,82,188,0
19243,김회재(金會在),천준호(千俊鎬),100,67,167,0
19244,김회재(金會在),최기상(崔基相),93,61,154,0
19245,김회재(金會在),최승재(崔承宰),53,6,59,1
19246,김회재(金會在),최연숙(崔姸淑),32,7,39,1
19247,김회재(金會在),최영희(崔英姬),26,4,30,1
19248,김회재(金會在),최인호(崔仁昊),90,76,166,0
19249,김회재(金會在),최재형(崔在亨),26,4,30,1
19250,김회재(金會在),최종윤(崔鍾允),118,127,245,0
19251,김회재(金會在),최춘식(崔春植),51,4,55,1
19252,김회재(金會在),최형두(崔炯斗),52,7,59,1
19253,김회재(金會在),최혜영(崔惠英),102,88,190,0
19254,김회재(金會在),추경호(秋慶鎬),49,3,52,1
19255,김회재(金會在),태영호(太永浩),50,4,54,1
19256,김회재(金會在),하영제(河榮帝),45,6,51,1
19257,김회재(金會在),하태경(河泰慶),52,3,55,1
19258,김회재(金會在),한기호(韓起鎬),52,3,55,1
19259,김회재(金會在),한무경(韓茂景),53,6,59,1
19260,김회재(金會在),한병도(韓秉道),99,60,159,0
19261,김회재(金會在),한정애(韓貞愛),88,54,142,0
19262,김회재(金會在),한준호(韓俊鎬),110,112,222,0
19263,김회재(金會在),허숙정(許淑湞),1,1,2,0
19264,김회재(金會在),허영(許榮),133,118,251,0
19265,김회재(金會在),허은아(許垠娥),51,4,55,1
19266,김회재(金會在),허종식(許琮植),114,93,207,0
19267,김회재(金會在),홍기원(洪起元),111,86,197,0
19268,김회재(金會在),홍문표(洪文杓),51,5,56,1
19269,김회재(金會在),홍석준(洪碩晙),51,3,54,1
19270,김회재(金會在),홍성국(洪性國),121,148,269,0
19271,김회재(金會在),홍영표(洪永杓),82,48,130,0
19272,김회재(金會在),홍익표(洪翼杓),92,68,160,0
19273,김회재(金會在),홍정민(洪貞敏),113,83,196,0
19274,김회재(金會在),황보승희(皇甫承希),51,3,54,1
19275,김회재(金會在),황운하(黃雲夏),136,136,272,0
19276,김회재(金會在),황희(黃熙),81,41,122,0
19277,김희곤(金熙坤),김희국(金熙國),73,57,130,0
19278,김희곤(金熙坤),남인순(南仁順),49,6,55,1
19279,김희곤(金熙坤),노용호(魯容昊),38,86,124,0
19280,김희곤(金熙坤),노웅래(盧雄來),51,3,54,1
19281,김희곤(金熙坤),도종환(都鍾煥),51,7,58,1
19282,김희곤(金熙坤),류성걸(柳性杰),78,109,187,0
19283,김희곤(金熙坤),류호정(柳好貞),4,8,12,1
19284,김희곤(金熙坤),맹성규(孟聖奎),50,5,55,1
19285,김희곤(金熙坤),문정복(文貞福),49,4,53,1
19286,김희곤(金熙坤),문진석(文振碩),51,5,56,1
19287,김희곤(金熙坤),민병덕(閔炳德),50,8,58,1
19288,김희곤(金熙坤),민형배(閔馨培),34,6,40,1
19289,김희곤(金熙坤),민홍철(閔洪喆),51,5,56,1
19290,김희곤(金熙坤),박광온(朴洸瑥),50,4,54,1
19291,김희곤(金熙坤),박대수(朴大壽),111,379,490,0
19292,김희곤(金熙坤),박대출(朴大出),66,65,131,0
19293,김희곤(金熙坤),박덕흠(朴德欽),73,165,238,0
19294,김희곤(金熙坤),박범계(朴範界),50,4,54,1
19295,김희곤(金熙坤),박병석(朴炳錫),25,3,28,1
19296,김희곤(金熙坤),박상혁(朴商赫),50,4,54,1
19297,김희곤(金熙坤),박성민(朴聖敏),83,191,274,0
19298,김희곤(金熙坤),박성준(朴省俊),50,6,56,1
19299,김희곤(金熙坤),박성중(朴成重),72,73,145,0
19300,김희곤(金熙坤),박수영(朴洙瑩),81,103,184,0
19301,김희곤(金熙坤),박영순(朴英淳),51,4,55,1
19302,김희곤(金熙坤),박완주(朴完柱),25,0,25,1
19303,김희곤(金熙坤),박용진(朴用鎭),49,12,61,1
19304,김희곤(金熙坤),박재호(朴在昊),52,9,61,1
19305,김희곤(金熙坤),박정(朴釘),52,8,60,1
19306,김희곤(金熙坤),박정하(朴正河),31,57,88,0
19307,김희곤(金熙坤),박주민(朴柱民),50,5,55,1
19308,김희곤(金熙坤),박진(朴振),65,67,132,0
19309,김희곤(金熙坤),박찬대(朴贊大),50,4,54,1
19310,김희곤(金熙坤),박형수(朴亨修),61,71,132,0
19311,김희곤(金熙坤),박홍근(朴洪根),50,4,54,1
19312,김희곤(金熙坤),배준영(裵俊英),75,103,178,0
19313,김희곤(金熙坤),배진교(裵晋敎),5,3,8,1
19314,김희곤(金熙坤),배현진(裵賢鎭),68,53,121,0
19315,김희곤(金熙坤),백종헌(白宗憲),91,187,278,0
19316,김희곤(金熙坤),백혜련(白惠蓮),50,5,55,1
19317,김희곤(金熙坤),변재일(卞在一),50,4,54,1
19318,김희곤(金熙坤),서동용(徐東榕),51,5,56,1
19319,김희곤(金熙坤),서범수(徐範洙),93,163,256,0
19320,김희곤(金熙坤),서병수(徐秉洙),82,140,222,0
19321,김희곤(金熙坤),서삼석(徐參錫),50,6,56,1
19322,김희곤(金熙坤),서영교(徐瑛敎),51,6,57,1
19323,김희곤(金熙坤),서영석(徐暎錫),49,4,53,1
19324,김희곤(金熙坤),서일준(徐一俊),75,139,214,0
19325,김희곤(金熙坤),서정숙(徐正淑),66,72,138,0
19326,김희곤(金熙坤),설훈(薛勳),50,4,54,1
19327,김희곤(金熙坤),성일종(成一鍾),86,140,226,0
19328,김희곤(金熙坤),소병철(蘇秉哲),51,5,56,1
19329,김희곤(金熙坤),소병훈(蘇秉勳),51,6,57,1
19330,김희곤(金熙坤),송갑석(宋甲錫),50,5,55,1
19331,김희곤(金熙坤),송기헌(宋基憲),51,4,55,1
19332,김희곤(金熙坤),송석준(宋錫俊),70,96,166,0
19333,김희곤(金熙坤),송언석(宋彦錫),70,91,161,0
19334,김희곤(金熙坤),송옥주(宋玉珠),51,3,54,1
19335,김희곤(金熙坤),송재호(宋在祜),50,6,56,1
19336,김희곤(金熙坤),신동근(申東根),50,9,59,1
19337,김희곤(金熙坤),신영대(申榮大),51,5,56,1
19338,김희곤(金熙坤),신원식(申源湜),69,87,156,0
19339,김희곤(金熙坤),신정훈(辛正勳),51,13,64,1
19340,김희곤(金熙坤),신현영(申賢榮),49,4,53,1
19341,김희곤(金熙坤),심상정(沈相奵),7,3,10,1
19342,김희곤(金熙坤),안규백(安圭伯),51,6,57,1
19343,김희곤(金熙坤),안민석(安敏錫),51,6,57,1
19344,김희곤(金熙坤),안병길(安炳吉),105,223,328,0
19345,김희곤(金熙坤),안철수(安哲秀),25,30,55,0
19346,김희곤(金熙坤),안호영(安浩永),50,4,54,1
19347,김희곤(金熙坤),양경숙(梁敬淑),50,5,55,1
19348,김희곤(金熙坤),양금희(梁琴喜),100,160,260,0
19349,김희곤(金熙坤),양기대(梁基大),51,4,55,1
19350,김희곤(金熙坤),양이원영(梁李媛瑛),45,4,49,1
19351,김희곤(金熙坤),양정숙(梁貞淑),4,8,12,1
19352,김희곤(金熙坤),양향자(梁香子),21,19,40,1
19353,김희곤(金熙坤),어기구(魚基龜),51,4,55,1
19354,김희곤(金熙坤),엄태영(嚴泰永),87,153,240,0
19355,김희곤(金熙坤),오기형(吳奇炯),49,9,58,1
19356,김희곤(金熙坤),오영환(吳永煥),49,6,55,1
19357,김희곤(金熙坤),용혜인(龍慧仁),1,3,4,1
19358,김희곤(金熙坤),우상호(禹相虎),50,4,54,1
19359,김희곤(金熙坤),우원식(禹元植),49,4,53,1
19360,김희곤(金熙坤),위성곤(魏聖坤),51,6,57,1
19361,김희곤(金熙坤),유경준(兪京濬),72,121,193,0
19362,김희곤(金熙坤),유기홍(柳基洪),50,5,55,1
19363,김희곤(金熙坤),유동수(柳東秀),50,5,55,1
19364,김희곤(金熙坤),유상범(劉相凡),68,71,139,0
19365,김희곤(金熙坤),유의동(兪義東),78,75,153,0
19366,김희곤(金熙坤),유정주(兪訂炷),50,4,54,1
19367,김희곤(金熙坤),윤건영(尹建永),49,5,54,1
19368,김희곤(金熙坤),윤관석(尹官石),41,0,41,1
19369,김희곤(金熙坤),윤두현(尹斗鉉),73,105,178,0
19370,김희곤(金熙坤),윤미향(尹美香),20,0,20,1
19371,김희곤(金熙坤),윤상현(尹相現),36,65,101,0
19372,김희곤(金熙坤),윤영덕(尹永德),49,6,55,1
19373,김희곤(金熙坤),윤영석(尹永碩),80,83,163,0
19374,김희곤(金熙坤),윤영찬(尹永燦),50,4,54,1
19375,김희곤(金熙坤),윤재갑(尹才鉀),56,10,66,1
19376,김희곤(金熙坤),윤재옥(尹在玉),95,110,205,0
19377,김희곤(金熙坤),윤주경(尹柱卿),70,97,167,0
19378,김희곤(金熙坤),윤준병(尹準炳),50,5,55,1
19379,김희곤(金熙坤),윤창현(尹暢賢),84,174,258,0
19380,김희곤(金熙坤),윤한홍(尹漢洪),69,115,184,0
19381,김희곤(金熙坤),윤호중(尹昊重),50,4,54,1
19382,김희곤(金熙坤),윤후덕(尹厚德),51,5,56,1
19383,김희곤(金熙坤),이개호(李介昊),50,6,56,1
19384,김희곤(金熙坤),이달곤(李達坤),63,71,134,0
19385,김희곤(金熙坤),이동주(李東洲),49,4,53,1
19386,김희곤(金熙坤),이만희(李晩熙),70,67,137,0
19387,김희곤(金熙坤),이명수(李明洙),101,184,285,0
19388,김희곤(金熙坤),이병훈(李炳勳),52,7,59,1
19389,김희곤(金熙坤),이상민(李相珉),50,4,54,1
19390,김희곤(金熙坤),이상헌(李相憲),51,11,62,1
19391,김희곤(金熙坤),이성만(李成萬),42,0,42,1
19392,김희곤(金熙坤),이소영(李素永),51,4,55,1
19393,김희곤(金熙坤),이수진(李壽珍),50,4,54,1
19394,김희곤(金熙坤),이수진(李秀眞),50,5,55,1
19395,김희곤(金熙坤),이양수(李亮壽),85,67,152,0
19396,김희곤(金熙坤),이용(李鏞),73,191,264,0
19397,김희곤(金熙坤),이용빈(李龍彬),51,6,57,1
19398,김희곤(金熙坤),이용선(李庸瑄),50,4,54,1
19399,김희곤(金熙坤),이용우(李龍雨),51,13,64,1
19400,김희곤(金熙坤),이용호(李容鎬),28,41,69,0
19401,김희곤(金熙坤),이원욱(李元旭),50,4,54,1
19402,김희곤(金熙坤),이원택(李源澤),51,4,55,1
19403,김희곤(金熙坤),이은주(李恩周),6,3,9,1
19404,김희곤(金熙坤),이인선(李仁善),32,118,150,0
19405,김희곤(金熙坤),이인영(李仁榮),50,4,54,1
19406,김희곤(金熙坤),이장섭(李將燮),50,5,55,1
19407,김희곤(金熙坤),이재명(李在明),25,4,29,1
19408,김희곤(金熙坤),이재정(李在汀),50,4,54,1
19409,김희곤(金熙坤),이정문(李楨文),50,5,55,1
19410,김희곤(金熙坤),이종배(李鍾培),97,159,256,0
19411,김희곤(金熙坤),이종성(李鍾成),91,225,316,0
19412,김희곤(金熙坤),이주환(李周桓),97,243,340,0
19413,김희곤(金熙坤),이채익(李埰益),76,126,202,0
19414,김희곤(金熙坤),이철규(李喆圭),67,79,146,0
19415,김희곤(金熙坤),이탄희(李誕熙),50,4,54,1
19416,김희곤(金熙坤),이태규(李泰珪),36,51,87,0
19417,김희곤(金熙坤),이학영(李學永),49,5,54,1
19418,김희곤(金熙坤),이해식(李海植),50,4,54,1
19419,김희곤(金熙坤),이헌승(李憲昇),84,215,299,0
19420,김희곤(金熙坤),이형석(李炯錫),49,5,54,1
19421,김희곤(金熙坤),인재근(印在謹),50,5,55,1
19422,김희곤(金熙坤),임병헌(林炳憲),29,81,110,0
19423,김희곤(金熙坤),임오경(林五卿),50,4,54,1
19424,김희곤(金熙坤),임이자(林利子),78,131,209,0
19425,김희곤(金熙坤),임종성(林鍾聲),51,7,58,1
19426,김희곤(金熙坤),임호선(林昊宣),50,5,55,1
19427,김희곤(金熙坤),장경태(張耿態),51,4,55,1
19428,김희곤(金熙坤),장동혁(張東赫),28,62,90,0
19429,김희곤(金熙坤),장제원(張濟元),65,51,116,0
19430,김희곤(金熙坤),장철민(張喆敏),50,4,54,1
19431,김희곤(金熙坤),장혜영(張惠英),7,5,12,1
19432,김희곤(金熙坤),전봉민(田奉珉),81,228,309,0
19433,김희곤(金熙坤),전용기(田溶冀),50,5,55,1
19434,김희곤(金熙坤),전재수(田載秀),51,8,59,1
19435,김희곤(金熙坤),전주혜(全珠惠),68,68,136,0
19436,김희곤(金熙坤),전해철(全海澈),50,4,54,1
19437,김희곤(金熙坤),전혜숙(全惠淑),51,5,56,1
19438,김희곤(金熙坤),정경희(丁慶姬),69,73,142,0
19439,김희곤(金熙坤),정동만(鄭東萬),89,147,236,0
19440,김희곤(金熙坤),정성호(鄭成湖),52,6,58,1
19441,김희곤(金熙坤),정우택(鄭宇澤),35,125,160,0
19442,김희곤(金熙坤),정운천(鄭雲天),69,108,177,0
19443,김희곤(金熙坤),정일영(鄭日永),49,4,53,1
19444,김희곤(金熙坤),정점식(鄭点植),66,42,108,0
19445,김희곤(金熙坤),정진석(鄭鎭碩),74,65,139,0
19446,김희곤(金熙坤),정청래(鄭淸來),49,4,53,1
19447,김희곤(金熙坤),정춘숙(鄭春淑),51,11,62,1
19448,김희곤(金熙坤),정태호(鄭泰浩),50,5,55,1
19449,김희곤(金熙坤),정필모(鄭必模),50,5,55,1
19450,김희곤(金熙坤),정희용(鄭熙溶),103,217,320,0
19451,김희곤(金熙坤),조경태(趙慶泰),86,130,216,0
19452,김희곤(金熙坤),조명희(曺明姬),74,130,204,0
19453,김희곤(金熙坤),조수진(趙修眞),66,102,168,0
19454,김희곤(金熙坤),조승래(趙承來),50,3,53,1
19455,김희곤(金熙坤),조오섭(曺五燮),50,9,59,1
19456,김희곤(金熙坤),조은희(趙恩禧),33,62,95,0
19457,김희곤(金熙坤),조응천(趙應天),51,3,54,1
19458,김희곤(金熙坤),조정식(趙正湜),49,3,52,1
19459,김희곤(金熙坤),조정훈(趙廷訓),0,19,19,1
19460,김희곤(金熙坤),조해진(曺海珍),62,47,109,0
19461,김희곤(金熙坤),주철현(朱哲鉉),50,6,56,1
19462,김희곤(金熙坤),주호영(朱豪英),67,90,157,0
19463,김희곤(金熙坤),지성호(池成浩),95,222,317,0
19464,김희곤(金熙坤),진선미(陳善美),50,4,54,1
19465,김희곤(金熙坤),진성준(陳聲準),50,5,55,1
19466,김희곤(金熙坤),천준호(千俊鎬),49,3,52,1
19467,김희곤(金熙坤),최기상(崔基相),49,5,54,1
19468,김희곤(金熙坤),최승재(崔承宰),73,102,175,0
19469,김희곤(金熙坤),최연숙(崔姸淑),32,54,86,0
19470,김희곤(金熙坤),최영희(崔英姬),42,112,154,0
19471,김희곤(金熙坤),최인호(崔仁昊),53,9,62,1
19472,김희곤(金熙坤),최재형(崔在亨),26,18,44,0
19473,김희곤(金熙坤),최종윤(崔鍾允),51,5,56,1
19474,김희곤(金熙坤),최춘식(崔春植),106,223,329,0
19475,김희곤(金熙坤),최형두(崔炯斗),85,102,187,0
19476,김희곤(金熙坤),최혜영(崔惠英),51,11,62,1
19477,김희곤(金熙坤),추경호(秋慶鎬),75,84,159,0
19478,김희곤(金熙坤),태영호(太永浩),86,229,315,0
19479,김희곤(金熙坤),하영제(河榮帝),66,114,180,1
19480,김희곤(金熙坤),하태경(河泰慶),72,63,135,0
19481,김희곤(金熙坤),한기호(韓起鎬),72,63,135,0
19482,김희곤(金熙坤),한무경(韓茂景),75,131,206,0
19483,김희곤(金熙坤),한병도(韓秉道),49,4,53,1
19484,김희곤(金熙坤),한정애(韓貞愛),50,4,54,1
19485,김희곤(金熙坤),한준호(韓俊鎬),51,4,55,1
19486,김희곤(金熙坤),허숙정(許淑湞),0,0,0,1
19487,김희곤(金熙坤),허영(許榮),51,4,55,1
19488,김희곤(金熙坤),허은아(許垠娥),69,69,138,0
19489,김희곤(金熙坤),허종식(許琮植),50,5,55,1
19490,김희곤(金熙坤),홍기원(洪起元),50,4,54,1
19491,김희곤(金熙坤),홍문표(洪文杓),77,99,176,0
19492,김희곤(金熙坤),홍석준(洪碩晙),75,78,153,0
19493,김희곤(金熙坤),홍성국(洪性國),50,4,54,1
19494,김희곤(金熙坤),홍영표(洪永杓),50,4,54,1
19495,김희곤(金熙坤),홍익표(洪翼杓),50,4,54,1
19496,김희곤(金熙坤),홍정민(洪貞敏),53,10,63,1
19497,김희곤(金熙坤),황보승희(皇甫承希),87,167,254,1
19498,김희곤(金熙坤),황운하(黃雲夏),50,7,57,1
19499,김희곤(金熙坤),황희(黃熙),49,12,61,1
19500,김희국(金熙國),남인순(南仁順),49,4,53,1
19501,김희국(金熙國),노용호(魯容昊),26,14,40,0
19502,김희국(金熙國),노웅래(盧雄來),50,4,54,1
19503,김희국(金熙國),도종환(都鍾煥),50,4,54,1
19504,김희국(金熙國),류성걸(柳性杰),76,72,148,0
19505,김희국(金熙國),류호정(柳好貞),4,3,7,1
19506,김희국(金熙國),맹성규(孟聖奎),49,4,53,1
19507,김희국(金熙國),문정복(文貞福),49,4,53,1
19508,김희국(金熙國),문진석(文振碩),49,5,54,1
19509,김희국(金熙國),민병덕(閔炳德),49,5,54,1
19510,김희국(金熙國),민형배(閔馨培),33,4,37,1
19511,김희국(金熙國),민홍철(閔洪喆),49,4,53,1
19512,김희국(金熙國),박광온(朴洸瑥),49,4,53,1
19513,김희국(金熙國),박대수(朴大壽),74,69,143,0
19514,김희국(金熙國),박대출(朴大出),69,42,111,0
19515,김희국(金熙國),박덕흠(朴德欽),77,89,166,0
19516,김희국(金熙國),박범계(朴範界),49,4,53,1
19517,김희국(金熙國),박병석(朴炳錫),25,3,28,1
19518,김희국(金熙國),박상혁(朴商赫),49,5,54,1
19519,김희국(金熙國),박성민(朴聖敏),66,52,118,0
19520,김희국(金熙國),박성준(朴省俊),49,5,54,1
19521,김희국(金熙國),박성중(朴成重),84,96,180,0
19522,김희국(金熙國),박수영(朴洙瑩),62,36,98,0
19523,김희국(金熙國),박영순(朴英淳),50,4,54,1
19524,김희국(金熙國),박완주(朴完柱),24,0,24,1
19525,김희국(金熙國),박용진(朴用鎭),49,4,53,1
19526,김희국(金熙國),박재호(朴在昊),50,4,54,1
19527,김희국(金熙國),박정(朴釘),49,4,53,1
19528,김희국(金熙國),박정하(朴正河),30,29,59,0
19529,김희국(金熙國),박주민(朴柱民),49,4,53,1
19530,김희국(金熙國),박진(朴振),65,49,114,0
19531,김희국(金熙國),박찬대(朴贊大),49,4,53,1
19532,김희국(金熙國),박형수(朴亨修),72,60,132,0
19533,김희국(金熙國),박홍근(朴洪根),49,4,53,1
19534,김희국(金熙國),배준영(裵俊英),62,48,110,0
19535,김희국(金熙國),배진교(裵晋敎),4,2,6,1
19536,김희국(金熙國),배현진(裵賢鎭),69,45,114,0
19537,김희국(金熙國),백종헌(白宗憲),70,67,137,0
19538,김희국(金熙國),백혜련(白惠蓮),49,4,53,1
19539,김희국(金熙國),변재일(卞在一),50,4,54,1
19540,김희국(金熙國),서동용(徐東榕),49,4,53,1
19541,김희국(金熙國),서범수(徐範洙),69,49,118,0
19542,김희국(金熙國),서병수(徐秉洙),77,60,137,0
19543,김희국(金熙國),서삼석(徐參錫),50,4,54,1
19544,김희국(金熙國),서영교(徐瑛敎),49,5,54,1
19545,김희국(金熙國),서영석(徐暎錫),49,5,54,1
19546,김희국(金熙國),서일준(徐一俊),86,88,174,0
19547,김희국(金熙國),서정숙(徐正淑),69,53,122,0
19548,김희국(金熙國),설훈(薛勳),50,4,54,1
19549,김희국(金熙國),성일종(成一鍾),95,83,178,0
19550,김희국(金熙國),소병철(蘇秉哲),50,4,54,1
19551,김희국(金熙國),소병훈(蘇秉勳),49,4,53,1
19552,김희국(金熙國),송갑석(宋甲錫),49,5,54,1
19553,김희국(金熙國),송기헌(宋基憲),49,4,53,1
19554,김희국(金熙國),송석준(宋錫俊),68,49,117,0
19555,김희국(金熙國),송언석(宋彦錫),82,62,144,0
19556,김희국(金熙國),송옥주(宋玉珠),49,3,52,1
19557,김희국(金熙國),송재호(宋在祜),49,4,53,1
19558,김희국(金熙國),신동근(申東根),49,3,52,1
19559,김희국(金熙國),신영대(申榮大),49,6,55,1
19560,김희국(金熙國),신원식(申源湜),72,65,137,0
19561,김희국(金熙國),신정훈(辛正勳),49,4,53,1
19562,김희국(金熙國),신현영(申賢榮),49,4,53,1
19563,김희국(金熙國),심상정(沈相奵),4,2,6,1
19564,김희국(金熙國),안규백(安圭伯),54,5,59,1
19565,김희국(金熙國),안민석(安敏錫),49,3,52,1
19566,김희국(金熙國),안병길(安炳吉),65,53,118,0
19567,김희국(金熙國),안철수(安哲秀),27,9,36,0
19568,김희국(金熙國),안호영(安浩永),49,4,53,1
19569,김희국(金熙國),양경숙(梁敬淑),49,4,53,1
19570,김희국(金熙國),양금희(梁琴喜),84,75,159,0
19571,김희국(金熙國),양기대(梁基大),49,4,53,1
19572,김희국(金熙國),양이원영(梁李媛瑛),45,4,49,1
19573,김희국(金熙國),양정숙(梁貞淑),1,1,2,1
19574,김희국(金熙國),양향자(梁香子),20,1,21,1
19575,김희국(金熙國),어기구(魚基龜),50,4,54,1
19576,김희국(金熙國),엄태영(嚴泰永),71,71,142,0
19577,김희국(金熙國),오기형(吳奇炯),49,4,53,1
19578,김희국(金熙國),오영환(吳永煥),50,4,54,1
19579,김희국(金熙國),용혜인(龍慧仁),1,1,2,1
19580,김희국(金熙國),우상호(禹相虎),49,4,53,1
19581,김희국(金熙國),우원식(禹元植),49,4,53,1
19582,김희국(金熙國),위성곤(魏聖坤),49,5,54,1
19583,김희국(金熙國),유경준(兪京濬),78,90,168,0
19584,김희국(金熙國),유기홍(柳基洪),49,4,53,1
19585,김희국(金熙國),유동수(柳東秀),51,4,55,1
19586,김희국(金熙國),유상범(劉相凡),64,45,109,0
19587,김희국(金熙國),유의동(兪義東),65,54,119,0
19588,김희국(金熙國),유정주(兪訂炷),49,4,53,1
19589,김희국(金熙國),윤건영(尹建永),49,3,52,1
19590,김희국(金熙國),윤관석(尹官石),40,1,41,1
19591,김희국(金熙國),윤두현(尹斗鉉),88,69,157,0
19592,김희국(金熙國),윤미향(尹美香),20,1,21,1
19593,김희국(金熙國),윤상현(尹相現),42,35,77,0
19594,김희국(金熙國),윤영덕(尹永德),49,4,53,1
19595,김희국(金熙國),윤영석(尹永碩),87,71,158,0
19596,김희국(金熙國),윤영찬(尹永燦),49,4,53,1
19597,김희국(金熙國),윤재갑(尹才鉀),50,7,57,1
19598,김희국(金熙國),윤재옥(尹在玉),74,54,128,0
19599,김희국(金熙國),윤주경(尹柱卿),76,55,131,0
19600,김희국(金熙國),윤준병(尹準炳),49,4,53,1
19601,김희국(金熙國),윤창현(尹暢賢),85,71,156,0
19602,김희국(金熙國),윤한홍(尹漢洪),75,59,134,0
19603,김희국(金熙國),윤호중(尹昊重),49,4,53,1
19604,김희국(金熙國),윤후덕(尹厚德),49,4,53,1
19605,김희국(金熙國),이개호(李介昊),49,5,54,1
19606,김희국(金熙國),이달곤(李達坤),58,43,101,0
19607,김희국(金熙國),이동주(李東洲),49,4,53,1
19608,김희국(金熙國),이만희(李晩熙),72,41,113,0
19609,김희국(金熙國),이명수(李明洙),107,104,211,0
19610,김희국(金熙國),이병훈(李炳勳),51,5,56,1
19611,김희국(金熙國),이상민(李相珉),50,4,54,1
19612,김희국(金熙國),이상헌(李相憲),50,5,55,1
19613,김희국(金熙國),이성만(李成萬),41,1,42,1
19614,김희국(金熙國),이소영(李素永),49,4,53,1
19615,김희국(金熙國),이수진(李壽珍),50,5,55,1
19616,김희국(金熙國),이수진(李秀眞),49,4,53,1
19617,김희국(金熙國),이양수(李亮壽),70,43,113,0
19618,김희국(金熙國),이용(李鏞),71,72,143,0
19619,김희국(金熙國),이용빈(李龍彬),50,6,56,1
19620,김희국(金熙國),이용선(李庸瑄),49,4,53,1
19621,김희국(金熙國),이용우(李龍雨),49,4,53,1
19622,김희국(金熙國),이용호(李容鎬),28,12,40,0
19623,김희국(金熙國),이원욱(李元旭),50,4,54,1
19624,김희국(金熙國),이원택(李源澤),49,4,53,1
19625,김희국(金熙國),이은주(李恩周),5,3,8,1
19626,김희국(金熙國),이인선(李仁善),26,14,40,0
19627,김희국(金熙國),이인영(李仁榮),49,4,53,1
19628,김희국(金熙國),이장섭(李將燮),49,4,53,1
19629,김희국(金熙國),이재명(李在明),25,4,29,1
19630,김희국(金熙國),이재정(李在汀),49,4,53,1
19631,김희국(金熙國),이정문(李楨文),49,4,53,1
19632,김희국(金熙國),이종배(李鍾培),92,70,162,0
19633,김희국(金熙國),이종성(李鍾成),96,87,183,0
19634,김희국(金熙國),이주환(李周桓),77,67,144,0
19635,김희국(金熙國),이채익(李埰益),68,60,128,0
19636,김희국(金熙國),이철규(李喆圭),69,54,123,0
19637,김희국(金熙國),이탄희(李誕熙),49,4,53,1
19638,김희국(金熙國),이태규(李泰珪),37,27,64,0
19639,김희국(金熙國),이학영(李學永),49,4,53,1
19640,김희국(金熙國),이해식(李海植),49,4,53,1
19641,김희국(金熙國),이헌승(李憲昇),61,40,101,0
19642,김희국(金熙國),이형석(李炯錫),49,4,53,1
19643,김희국(金熙國),인재근(印在謹),49,5,54,1
19644,김희국(金熙國),임병헌(林炳憲),27,34,61,0
19645,김희국(金熙國),임오경(林五卿),49,4,53,1
19646,김희국(金熙國),임이자(林利子),90,66,156,0
19647,김희국(金熙國),임종성(林鍾聲),50,4,54,1
19648,김희국(金熙國),임호선(林昊宣),49,4,53,1
19649,김희국(金熙國),장경태(張耿態),49,4,53,1
19650,김희국(金熙國),장동혁(張東赫),26,14,40,0
19651,김희국(金熙國),장제원(張濟元),65,37,102,0
19652,김희국(金熙國),장철민(張喆敏),49,4,53,1
19653,김희국(金熙國),장혜영(張惠英),5,5,10,1
19654,김희국(金熙國),전봉민(田奉珉),47,37,84,0
19655,김희국(金熙國),전용기(田溶冀),49,4,53,1
19656,김희국(金熙國),전재수(田載秀),49,4,53,1
19657,김희국(金熙國),전주혜(全珠惠),63,54,117,0
19658,김희국(金熙國),전해철(全海澈),50,4,54,1
19659,김희국(金熙國),전혜숙(全惠淑),49,4,53,1
19660,김희국(金熙國),정경희(丁慶姬),62,46,108,0
19661,김희국(金熙國),정동만(鄭東萬),68,43,111,0
19662,김희국(金熙國),정성호(鄭成湖),50,4,54,1
19663,김희국(金熙國),정우택(鄭宇澤),29,27,56,0
19664,김희국(金熙國),정운천(鄭雲天),73,52,125,0
19665,김희국(金熙國),정일영(鄭日永),49,4,53,1
19666,김희국(金熙國),정점식(鄭点植),66,43,109,0
19667,김희국(金熙國),정진석(鄭鎭碩),81,88,169,0
19668,김희국(金熙國),정청래(鄭淸來),49,4,53,1
19669,김희국(金熙國),정춘숙(鄭春淑),49,4,53,1
19670,김희국(金熙國),정태호(鄭泰浩),49,4,53,1
19671,김희국(金熙國),정필모(鄭必模),49,4,53,1
19672,김희국(金熙國),정희용(鄭熙溶),91,68,159,0
19673,김희국(金熙國),조경태(趙慶泰),73,47,120,0
19674,김희국(金熙國),조명희(曺明姬),75,67,142,0
19675,김희국(金熙國),조수진(趙修眞),85,84,169,0
19676,김희국(金熙國),조승래(趙承來),49,4,53,1
19677,김희국(金熙國),조오섭(曺五燮),50,4,54,1
19678,김희국(金熙國),조은희(趙恩禧),26,14,40,0
19679,김희국(金熙國),조응천(趙應天),50,4,54,1
19680,김희국(金熙國),조정식(趙正湜),49,3,52,1
19681,김희국(金熙國),조정훈(趙廷訓),0,0,0,1
19682,김희국(金熙國),조해진(曺海珍),63,31,94,0
19683,김희국(金熙國),주철현(朱哲鉉),52,7,59,1
19684,김희국(金熙國),주호영(朱豪英),64,39,103,0
19685,김희국(金熙國),지성호(池成浩),78,85,163,0
19686,김희국(金熙國),진선미(陳善美),49,4,53,1
19687,김희국(金熙國),진성준(陳聲準),49,4,53,1
19688,김희국(金熙國),천준호(千俊鎬),49,3,52,1
19689,김희국(金熙國),최기상(崔基相),49,4,53,1
19690,김희국(金熙國),최승재(崔承宰),83,78,161,0
19691,김희국(金熙國),최연숙(崔姸淑),36,29,65,0
19692,김희국(金熙國),최영희(崔英姬),28,27,55,0
19693,김희국(金熙國),최인호(崔仁昊),50,4,54,1
19694,김희국(金熙國),최재형(崔在亨),27,12,39,0
19695,김희국(金熙國),최종윤(崔鍾允),49,4,53,1
19696,김희국(金熙國),최춘식(崔春植),74,50,124,0
19697,김희국(金熙國),최형두(崔炯斗),96,84,180,0
19698,김희국(金熙國),최혜영(崔惠英),50,5,55,1
19699,김희국(金熙國),추경호(秋慶鎬),120,127,247,0
19700,김희국(金熙國),태영호(太永浩),81,84,165,0
19701,김희국(金熙國),하영제(河榮帝),69,52,121,1
19702,김희국(金熙國),하태경(河泰慶),62,34,96,0
19703,김희국(金熙國),한기호(韓起鎬),70,45,115,0
19704,김희국(金熙國),한무경(韓茂景),84,76,160,0
19705,김희국(金熙國),한병도(韓秉道),49,4,53,1
19706,김희국(金熙國),한정애(韓貞愛),49,4,53,1
19707,김희국(金熙國),한준호(韓俊鎬),49,4,53,1
19708,김희국(金熙國),허숙정(許淑湞),0,0,0,1
19709,김희국(金熙國),허영(許榮),49,4,53,1
19710,김희국(金熙國),허은아(許垠娥),71,61,132,0
19711,김희국(金熙國),허종식(許琮植),50,5,55,1
19712,김희국(金熙國),홍기원(洪起元),50,7,57,1
19713,김희국(金熙國),홍문표(洪文杓),80,56,136,0
19714,김희국(金熙國),홍석준(洪碩晙),73,57,130,0
19715,김희국(金熙國),홍성국(洪性國),50,4,54,1
19716,김희국(金熙國),홍영표(洪永杓),50,4,54,1
19717,김희국(金熙國),홍익표(洪翼杓),49,4,53,1
19718,김희국(金熙國),홍정민(洪貞敏),49,4,53,1
19719,김희국(金熙國),황보승희(皇甫承希),58,59,117,1
19720,김희국(金熙國),황운하(黃雲夏),49,5,54,1
19721,김희국(金熙國),황희(黃熙),49,4,53,1
19722,남인순(南仁順),노용호(魯容昊),26,4,30,1
19723,남인순(南仁順),노웅래(盧雄來),109,80,189,0
19724,남인순(南仁順),도종환(都鍾煥),95,84,179,0
19725,남인순(南仁順),류성걸(柳性杰),49,6,55,1
19726,남인순(南仁順),류호정(柳好貞),39,92,131,1
19727,남인순(南仁順),맹성규(孟聖奎),135,103,238,0
19728,남인순(南仁順),문정복(文貞福),108,85,193,0
19729,남인순(南仁順),문진석(文振碩),114,78,192,0
19730,남인순(南仁順),민병덕(閔炳德),97,124,221,0
19731,남인순(南仁順),민형배(閔馨培),79,97,176,0
19732,남인순(南仁順),민홍철(閔洪喆),94,73,167,0
19733,남인순(南仁順),박광온(朴洸瑥),91,67,158,0
19734,남인순(南仁順),박대수(朴大壽),50,11,61,1
19735,남인순(南仁順),박대출(朴大出),50,4,54,1
19736,남인순(南仁順),박덕흠(朴德欽),37,5,42,1
19737,남인순(南仁順),박범계(朴範界),81,38,119,0
19738,남인순(南仁順),박병석(朴炳錫),41,18,59,0
19739,남인순(南仁順),박상혁(朴商赫),106,88,194,0
19740,남인순(南仁順),박성민(朴聖敏),50,5,55,1
19741,남인순(南仁順),박성준(朴省俊),176,215,391,0
19742,남인순(南仁順),박성중(朴成重),49,4,53,1
19743,남인순(南仁順),박수영(朴洙瑩),49,5,54,1
19744,남인순(南仁順),박영순(朴英淳),129,108,237,0
19745,남인순(南仁順),박완주(朴完柱),63,66,129,1
19746,남인순(南仁順),박용진(朴用鎭),84,58,142,0
19747,남인순(南仁順),박재호(朴在昊),90,62,152,0
19748,남인순(南仁順),박정(朴釘),119,113,232,0
19749,남인순(南仁順),박정하(朴正河),26,5,31,1
19750,남인순(南仁順),박주민(朴柱民),88,93,181,0
19751,남인순(南仁順),박진(朴振),49,5,54,1
19752,남인순(南仁順),박찬대(朴贊大),93,74,167,0
19753,남인순(南仁順),박형수(朴亨修),49,5,54,1
19754,남인순(南仁順),박홍근(朴洪根),148,165,313,0
19755,남인순(南仁順),배준영(裵俊英),49,6,55,1
19756,남인순(南仁順),배진교(裵晋敎),27,56,83,1
19757,남인순(南仁順),배현진(裵賢鎭),49,5,54,1
19758,남인순(南仁順),백종헌(白宗憲),50,7,57,1
19759,남인순(南仁順),백혜련(白惠蓮),112,94,206,0
19760,남인순(南仁順),변재일(卞在一),95,58,153,0
19761,남인순(南仁順),서동용(徐東榕),108,99,207,0
19762,남인순(南仁順),서범수(徐範洙),54,7,61,1
19763,남인순(南仁順),서병수(徐秉洙),49,6,55,1
19764,남인순(南仁順),서삼석(徐參錫),88,71,159,0
19765,남인순(南仁順),서영교(徐瑛敎),118,124,242,0
19766,남인순(南仁順),서영석(徐暎錫),129,149,278,0
19767,남인순(南仁順),서일준(徐一俊),50,8,58,1
19768,남인순(南仁順),서정숙(徐正淑),51,9,60,1
19769,남인순(南仁順),설훈(薛勳),84,56,140,0
19770,남인순(南仁順),성일종(成一鍾),50,7,57,1
19771,남인순(南仁順),소병철(蘇秉哲),84,67,151,0
19772,남인순(南仁順),소병훈(蘇秉勳),106,111,217,0
19773,남인순(南仁順),송갑석(宋甲錫),108,110,218,0
19774,남인순(南仁順),송기헌(宋基憲),84,64,148,0
19775,남인순(南仁順),송석준(宋錫俊),51,7,58,1
19776,남인순(南仁順),송언석(宋彦錫),46,4,50,1
19777,남인순(南仁順),송옥주(宋玉珠),123,116,239,0
19778,남인순(南仁順),송재호(宋在祜),130,151,281,0
19779,남인순(南仁順),신동근(申東根),92,67,159,0
19780,남인순(南仁順),신영대(申榮大),89,48,137,0
19781,남인순(南仁順),신원식(申源湜),50,4,54,1
19782,남인순(南仁順),신정훈(辛正勳),127,138,265,0
19783,남인순(南仁順),신현영(申賢榮),87,67,154,0
19784,남인순(南仁順),심상정(沈相奵),27,54,81,1
19785,남인순(南仁順),안규백(安圭伯),112,76,188,0
19786,남인순(南仁順),안민석(安敏錫),95,77,172,0
19787,남인순(南仁順),안병길(安炳吉),52,5,57,1
19788,남인순(南仁順),안철수(安哲秀),26,4,30,1
19789,남인순(南仁順),안호영(安浩永),92,87,179,0
19790,남인순(南仁順),양경숙(梁敬淑),115,135,250,0
19791,남인순(南仁順),양금희(梁琴喜),50,9,59,1
19792,남인순(南仁順),양기대(梁基大),89,69,158,0
19793,남인순(南仁順),양이원영(梁李媛瑛),132,153,285,0
19794,남인순(南仁順),양정숙(梁貞淑),123,238,361,1
19795,남인순(南仁順),양향자(梁香子),51,59,110,1
19796,남인순(南仁順),어기구(魚基龜),85,53,138,0
19797,남인순(南仁順),엄태영(嚴泰永),51,6,57,1
19798,남인순(南仁順),오기형(吳奇炯),79,48,127,0
19799,남인순(南仁順),오영환(吳永煥),160,215,375,0
19800,남인순(南仁順),용혜인(龍慧仁),36,100,136,1
19801,남인순(南仁順),우상호(禹相虎),82,40,122,0
19802,남인순(南仁順),우원식(禹元植),113,102,215,0
19803,남인순(南仁順),위성곤(魏聖坤),92,87,179,0
19804,남인순(南仁順),유경준(兪京濬),49,5,54,1
19805,남인순(南仁順),유기홍(柳基洪),83,58,141,0
19806,남인순(南仁順),유동수(柳東秀),95,53,148,0
19807,남인순(南仁順),유상범(劉相凡),50,4,54,1
19808,남인순(南仁順),유의동(兪義東),53,6,59,1
19809,남인순(南仁順),유정주(兪訂炷),111,117,228,0
19810,남인순(南仁順),윤건영(尹建永),92,87,179,0
19811,남인순(南仁順),윤관석(尹官石),105,99,204,1
19812,남인순(南仁順),윤두현(尹斗鉉),50,6,56,1
19813,남인순(南仁順),윤미향(尹美香),104,183,287,1
19814,남인순(南仁順),윤상현(尹相現),32,9,41,1
19815,남인순(南仁順),윤영덕(尹永德),103,99,202,0
19816,남인순(南仁順),윤영석(尹永碩),49,5,54,1
19817,남인순(南仁順),윤영찬(尹永燦),93,64,157,0
19818,남인순(南仁順),윤재갑(尹才鉀),139,132,271,0
19819,남인순(南仁順),윤재옥(尹在玉),53,6,59,1
19820,남인순(南仁順),윤주경(尹柱卿),49,9,58,1
19821,남인순(南仁順),윤준병(尹準炳),114,164,278,0
19822,남인순(南仁順),윤창현(尹暢賢),49,9,58,1
19823,남인순(南仁順),윤한홍(尹漢洪),49,6,55,1
19824,남인순(南仁順),윤호중(尹昊重),78,56,134,0
19825,남인순(南仁順),윤후덕(尹厚德),92,59,151,0
19826,남인순(南仁順),이개호(李介昊),90,64,154,0
19827,남인순(南仁順),이달곤(李達坤),51,7,58,1
19828,남인순(南仁順),이동주(李東洲),97,93,190,0
19829,남인순(南仁順),이만희(李晩熙),51,4,55,1
19830,남인순(南仁順),이명수(李明洙),52,17,69,1
19831,남인순(南仁順),이병훈(李炳勳),113,112,225,0
19832,남인순(南仁順),이상민(李相珉),80,46,126,0
19833,남인순(南仁順),이상헌(李相憲),114,99,213,0
19834,남인순(南仁順),이성만(李成萬),143,176,319,1
19835,남인순(南仁順),이소영(李素永),92,52,144,0
19836,남인순(南仁順),이수진(李壽珍),169,228,397,0
19837,남인순(南仁順),이수진(李秀眞),111,131,242,0
19838,남인순(南仁順),이양수(李亮壽),50,5,55,1
19839,남인순(南仁順),이용(李鏞),50,4,54,1
19840,남인순(南仁順),이용빈(李龍彬),141,164,305,0
19841,남인순(南仁順),이용선(李庸瑄),100,96,196,0
19842,남인순(南仁順),이용우(李龍雨),100,84,184,0
19843,남인순(南仁順),이용호(李容鎬),35,25,60,1
19844,남인순(南仁順),이원욱(李元旭),99,80,179,0
19845,남인순(南仁順),이원택(李源澤),117,102,219,0
19846,남인순(南仁順),이은주(李恩周),37,79,116,1
19847,남인순(南仁順),이인선(李仁善),25,5,30,1
19848,남인순(南仁順),이인영(李仁榮),83,53,136,0
19849,남인순(南仁順),이장섭(李將燮),101,82,183,0
19850,남인순(南仁順),이재명(李在明),40,21,61,0
19851,남인순(南仁順),이재정(李在汀),87,66,153,0
19852,남인순(南仁順),이정문(李楨文),96,80,176,0
19853,남인순(南仁順),이종배(李鍾培),51,6,57,1
19854,남인순(南仁順),이종성(李鍾成),51,5,56,1
19855,남인순(南仁順),이주환(李周桓),50,4,54,1
19856,남인순(南仁順),이채익(李埰益),52,9,61,1
19857,남인순(南仁順),이철규(李喆圭),50,5,55,1
19858,남인순(南仁順),이탄희(李誕熙),118,116,234,0
19859,남인순(南仁順),이태규(李泰珪),31,8,39,1
19860,남인순(南仁順),이학영(李學永),117,130,247,0
19861,남인순(南仁順),이해식(李海植),107,79,186,0
19862,남인순(南仁順),이헌승(李憲昇),52,7,59,1
19863,남인순(南仁順),이형석(李炯錫),110,84,194,0
19864,남인순(南仁順),인재근(印在謹),129,184,313,0
19865,남인순(南仁順),임병헌(林炳憲),25,5,30,1
19866,남인순(南仁順),임오경(林五卿),85,79,164,0
19867,남인순(南仁順),임이자(林利子),49,5,54,1
19868,남인순(南仁順),임종성(林鍾聲),122,99,221,0
19869,남인순(南仁順),임호선(林昊宣),117,121,238,0
19870,남인순(南仁順),장경태(張耿態),105,96,201,0
19871,남인순(南仁順),장동혁(張東赫),25,4,29,1
19872,남인순(南仁順),장제원(張濟元),49,4,53,1
19873,남인순(南仁順),장철민(張喆敏),102,85,187,0
19874,남인순(南仁順),장혜영(張惠英),34,61,95,1
19875,남인순(南仁順),전봉민(田奉珉),35,7,42,1
19876,남인순(南仁順),전용기(田溶冀),92,80,172,0
19877,남인순(南仁順),전재수(田載秀),91,80,171,0
19878,남인순(南仁順),전주혜(全珠惠),51,9,60,1
19879,남인순(南仁順),전해철(全海澈),83,54,137,0
19880,남인순(南仁順),전혜숙(全惠淑),138,116,254,0
19881,남인순(南仁順),정경희(丁慶姬),50,5,55,1
19882,남인순(南仁順),정동만(鄭東萬),49,5,54,1
19883,남인순(南仁順),정성호(鄭成湖),91,109,200,0
19884,남인순(南仁順),정우택(鄭宇澤),26,5,31,1
19885,남인순(南仁順),정운천(鄭雲天),51,6,57,1
19886,남인순(南仁順),정일영(鄭日永),97,91,188,0
19887,남인순(南仁順),정점식(鄭点植),49,4,53,1
19888,남인순(南仁順),정진석(鄭鎭碩),51,5,56,1
19889,남인순(南仁順),정청래(鄭淸來),110,103,213,0
19890,남인순(南仁順),정춘숙(鄭春淑),139,148,287,0
19891,남인순(南仁順),정태호(鄭泰浩),88,99,187,0
19892,남인순(南仁順),정필모(鄭必模),102,94,196,0
19893,남인순(南仁順),정희용(鄭熙溶),51,6,57,1
19894,남인순(南仁順),조경태(趙慶泰),52,5,57,1
19895,남인순(南仁順),조명희(曺明姬),50,10,60,1
19896,남인순(南仁順),조수진(趙修眞),52,4,56,1
19897,남인순(南仁順),조승래(趙承來),104,63,167,0
19898,남인순(南仁順),조오섭(曺五燮),129,163,292,0
19899,남인순(南仁順),조은희(趙恩禧),26,5,31,1
19900,남인순(南仁順),조응천(趙應天),77,32,109,0
19901,남인순(南仁順),조정식(趙正湜),74,41,115,0
19902,남인순(南仁順),조정훈(趙廷訓),8,18,26,1
19903,남인순(南仁順),조해진(曺海珍),50,5,55,1
19904,남인순(南仁順),주철현(朱哲鉉),112,107,219,0
19905,남인순(南仁順),주호영(朱豪英),49,4,53,1
19906,남인순(南仁順),지성호(池成浩),51,7,58,1
19907,남인순(南仁順),진선미(陳善美),98,97,195,0
19908,남인순(南仁順),진성준(陳聲準),100,111,211,0
19909,남인순(南仁順),천준호(千俊鎬),95,69,164,0
19910,남인순(南仁順),최기상(崔基相),91,71,162,0
19911,남인순(南仁順),최승재(崔承宰),50,6,56,1
19912,남인순(南仁順),최연숙(崔姸淑),39,24,63,1
19913,남인순(南仁順),최영희(崔英姬),25,4,29,1
19914,남인순(南仁順),최인호(崔仁昊),84,67,151,0
19915,남인순(南仁順),최재형(崔在亨),25,5,30,1
19916,남인순(南仁順),최종윤(崔鍾允),150,191,341,0
19917,남인순(南仁順),최춘식(崔春植),49,5,54,1
19918,남인순(南仁順),최형두(崔炯斗),50,10,60,1
19919,남인순(南仁順),최혜영(崔惠英),161,217,378,0
19920,남인순(南仁順),추경호(秋慶鎬),49,4,53,1
19921,남인순(南仁順),태영호(太永浩),49,7,56,1
19922,남인순(南仁順),하영제(河榮帝),42,2,44,1
19923,남인순(南仁順),하태경(河泰慶),51,5,56,1
19924,남인순(南仁順),한기호(韓起鎬),50,5,55,1
19925,남인순(南仁順),한무경(韓茂景),49,9,58,1
19926,남인순(南仁順),한병도(韓秉道),101,81,182,0
19927,남인순(南仁順),한정애(韓貞愛),91,78,169,0
19928,남인순(南仁順),한준호(韓俊鎬),100,101,201,0
19929,남인순(南仁順),허숙정(許淑湞),1,1,2,0
19930,남인순(南仁順),허영(許榮),117,102,219,0
19931,남인순(南仁順),허은아(許垠娥),49,4,53,1
19932,남인순(南仁順),허종식(許琮植),145,137,282,0
19933,남인순(南仁順),홍기원(洪起元),92,67,159,0
19934,남인순(南仁順),홍문표(洪文杓),49,12,61,1
19935,남인순(南仁順),홍석준(洪碩晙),51,4,55,1
19936,남인순(南仁順),홍성국(洪性國),157,184,341,0
19937,남인순(南仁順),홍영표(洪永杓),92,71,163,0
19938,남인순(南仁順),홍익표(洪翼杓),97,79,176,0
19939,남인순(南仁順),홍정민(洪貞敏),111,87,198,0
19940,남인순(南仁順),황보승희(皇甫承希),50,4,54,1
19941,남인순(南仁順),황운하(黃雲夏),146,131,277,0
19942,남인순(南仁順),황희(黃熙),86,37,123,0
19943,노용호(魯容昊),노웅래(盧雄來),26,3,29,1
19944,노용호(魯容昊),도종환(都鍾煥),25,5,30,1
19945,노용호(魯容昊),류성걸(柳性杰),30,22,52,0
19946,노용호(魯容昊),류호정(柳好貞),2,0,2,1
19947,노용호(魯容昊),맹성규(孟聖奎),25,4,29,1
19948,노용호(魯容昊),문정복(文貞福),25,4,29,1
19949,노용호(魯容昊),문진석(文振碩),25,4,29,1
19950,노용호(魯容昊),민병덕(閔炳德),25,4,29,1
19951,노용호(魯容昊),민형배(閔馨培),9,4,13,1
19952,노용호(魯容昊),민홍철(閔洪喆),25,4,29,1
19953,노용호(魯容昊),박광온(朴洸瑥),26,4,30,1
19954,노용호(魯容昊),박대수(朴大壽),42,97,139,0
19955,노용호(魯容昊),박대출(朴大出),35,25,60,0
19956,노용호(魯容昊),박덕흠(朴德欽),39,76,115,0
19957,노용호(魯容昊),박범계(朴範界),25,4,29,1
19958,노용호(魯容昊),박병석(朴炳錫),25,3,28,1
19959,노용호(魯容昊),박상혁(朴商赫),26,4,30,1
19960,노용호(魯容昊),박성민(朴聖敏),41,62,103,0
19961,노용호(魯容昊),박성준(朴省俊),25,4,29,1
19962,노용호(魯容昊),박성중(朴成重),26,21,47,0
19963,노용호(魯容昊),박수영(朴洙瑩),28,20,48,0
19964,노용호(魯容昊),박영순(朴英淳),25,3,28,1
19965,노용호(魯容昊),박완주(朴完柱),0,0,0,1
19966,노용호(魯容昊),박용진(朴用鎭),25,10,35,1
19967,노용호(魯容昊),박재호(朴在昊),25,5,30,1
19968,노용호(魯容昊),박정(朴釘),25,4,29,1
19969,노용호(魯容昊),박정하(朴正河),40,40,80,0
19970,노용호(魯容昊),박주민(朴柱民),25,4,29,1
19971,노용호(魯容昊),박진(朴振),29,26,55,0
19972,노용호(魯容昊),박찬대(朴贊大),25,4,29,1
19973,노용호(魯容昊),박형수(朴亨修),28,22,50,0
19974,노용호(魯容昊),박홍근(朴洪根),25,4,29,1
19975,노용호(魯容昊),배준영(裵俊英),31,39,70,0
19976,노용호(魯容昊),배진교(裵晋敎),0,0,0,1
19977,노용호(魯容昊),배현진(裵賢鎭),33,15,48,0
19978,노용호(魯容昊),백종헌(白宗憲),32,72,104,0
19979,노용호(魯容昊),백혜련(白惠蓮),26,4,30,1
19980,노용호(魯容昊),변재일(卞在一),25,4,29,1
19981,노용호(魯容昊),서동용(徐東榕),25,4,29,1
19982,노용호(魯容昊),서범수(徐範洙),28,28,56,0
19983,노용호(魯容昊),서병수(徐秉洙),30,27,57,0
19984,노용호(魯容昊),서삼석(徐參錫),25,4,29,1
19985,노용호(魯容昊),서영교(徐瑛敎),27,4,31,1
19986,노용호(魯容昊),서영석(徐暎錫),25,4,29,1
19987,노용호(魯容昊),서일준(徐一俊),44,59,103,0
19988,노용호(魯容昊),서정숙(徐正淑),27,33,60,0
19989,노용호(魯容昊),설훈(薛勳),25,4,29,1
19990,노용호(魯容昊),성일종(成一鍾),38,51,89,0
19991,노용호(魯容昊),소병철(蘇秉哲),26,4,30,1
19992,노용호(魯容昊),소병훈(蘇秉勳),26,4,30,1
19993,노용호(魯容昊),송갑석(宋甲錫),26,5,31,1
19994,노용호(魯容昊),송기헌(宋基憲),27,4,31,1
19995,노용호(魯容昊),송석준(宋錫俊),33,36,69,0
19996,노용호(魯容昊),송언석(宋彦錫),33,17,50,0
19997,노용호(魯容昊),송옥주(宋玉珠),25,4,29,1
19998,노용호(魯容昊),송재호(宋在祜),26,4,30,1
19999,노용호(魯容昊),신동근(申東根),25,3,28,1
20000,노용호(魯容昊),신영대(申榮大),25,4,29,1
20001,노용호(魯容昊),신원식(申源湜),34,54,88,0
20002,노용호(魯容昊),신정훈(辛正勳),26,4,30,1
20003,노용호(魯容昊),신현영(申賢榮),26,4,30,1
20004,노용호(魯容昊),심상정(沈相奵),0,0,0,1
20005,노용호(魯容昊),안규백(安圭伯),27,7,34,1
20006,노용호(魯容昊),안민석(安敏錫),25,4,29,1
20007,노용호(魯容昊),안병길(安炳吉),34,34,68,0
20008,노용호(魯容昊),안철수(安哲秀),29,22,51,0
20009,노용호(魯容昊),안호영(安浩永),25,4,29,1
20010,노용호(魯容昊),양경숙(梁敬淑),25,4,29,1
20011,노용호(魯容昊),양금희(梁琴喜),47,67,114,0
20012,노용호(魯容昊),양기대(梁基大),25,4,29,1
20013,노용호(魯容昊),양이원영(梁李媛瑛),25,4,29,1
20014,노용호(魯容昊),양정숙(梁貞淑),1,6,7,1
20015,노용호(魯容昊),양향자(梁香子),0,8,8,1
20016,노용호(魯容昊),어기구(魚基龜),25,4,29,1
20017,노용호(魯容昊),엄태영(嚴泰永),38,58,96,0
20018,노용호(魯容昊),오기형(吳奇炯),25,9,34,1
20019,노용호(魯容昊),오영환(吳永煥),26,4,30,1
20020,노용호(魯容昊),용혜인(龍慧仁),0,0,0,1
20021,노용호(魯容昊),우상호(禹相虎),26,4,30,1
20022,노용호(魯容昊),우원식(禹元植),26,4,30,1
20023,노용호(魯容昊),위성곤(魏聖坤),25,4,29,1
20024,노용호(魯容昊),유경준(兪京濬),42,80,122,0
20025,노용호(魯容昊),유기홍(柳基洪),25,4,29,1
20026,노용호(魯容昊),유동수(柳東秀),25,4,29,1
20027,노용호(魯容昊),유상범(劉相凡),31,38,69,0
20028,노용호(魯容昊),유의동(兪義東),29,34,63,0
20029,노용호(魯容昊),유정주(兪訂炷),25,4,29,1
20030,노용호(魯容昊),윤건영(尹建永),25,3,28,1
20031,노용호(魯容昊),윤관석(尹官石),16,0,16,1
20032,노용호(魯容昊),윤두현(尹斗鉉),31,49,80,0
20033,노용호(魯容昊),윤미향(尹美香),0,0,0,1
20034,노용호(魯容昊),윤상현(尹相現),29,28,57,0
20035,노용호(魯容昊),윤영덕(尹永德),25,4,29,1
20036,노용호(魯容昊),윤영석(尹永碩),27,15,42,0
20037,노용호(魯容昊),윤영찬(尹永燦),25,4,29,1
20038,노용호(魯容昊),윤재갑(尹才鉀),25,4,29,1
20039,노용호(魯容昊),윤재옥(尹在玉),32,28,60,0
20040,노용호(魯容昊),윤주경(尹柱卿),31,40,71,0
20041,노용호(魯容昊),윤준병(尹準炳),25,4,29,1
20042,노용호(魯容昊),윤창현(尹暢賢),32,36,68,0
20043,노용호(魯容昊),윤한홍(尹漢洪),26,47,73,0
20044,노용호(魯容昊),윤호중(尹昊重),26,4,30,1
20045,노용호(魯容昊),윤후덕(尹厚德),25,4,29,1
20046,노용호(魯容昊),이개호(李介昊),26,4,30,1
20047,노용호(魯容昊),이달곤(李達坤),26,26,52,0
20048,노용호(魯容昊),이동주(李東洲),25,4,29,1
20049,노용호(魯容昊),이만희(李晩熙),34,20,54,0
20050,노용호(魯容昊),이명수(李明洙),36,82,118,0
20051,노용호(魯容昊),이병훈(李炳勳),25,4,29,1
20052,노용호(魯容昊),이상민(李相珉),25,5,30,1
20053,노용호(魯容昊),이상헌(李相憲),25,4,29,1
20054,노용호(魯容昊),이성만(李成萬),16,0,16,1
20055,노용호(魯容昊),이소영(李素永),26,4,30,1
20056,노용호(魯容昊),이수진(李壽珍),25,4,29,1
20057,노용호(魯容昊),이수진(李秀眞),25,4,29,1
20058,노용호(魯容昊),이양수(李亮壽),41,28,69,0
20059,노용호(魯容昊),이용(李鏞),34,51,85,0
20060,노용호(魯容昊),이용빈(李龍彬),26,4,30,1
20061,노용호(魯容昊),이용선(李庸瑄),25,4,29,1
20062,노용호(魯容昊),이용우(李龍雨),25,10,35,1
20063,노용호(魯容昊),이용호(李容鎬),28,17,45,0
20064,노용호(魯容昊),이원욱(李元旭),26,4,30,1
20065,노용호(魯容昊),이원택(李源澤),25,4,29,1
20066,노용호(魯容昊),이은주(李恩周),1,0,1,1
20067,노용호(魯容昊),이인선(李仁善),35,60,95,0
20068,노용호(魯容昊),이인영(李仁榮),25,4,29,1
20069,노용호(魯容昊),이장섭(李將燮),25,4,29,1
20070,노용호(魯容昊),이재명(李在明),25,4,29,1
20071,노용호(魯容昊),이재정(李在汀),25,4,29,1
20072,노용호(魯容昊),이정문(李楨文),25,4,29,1
20073,노용호(魯容昊),이종배(李鍾培),30,38,68,0
20074,노용호(魯容昊),이종성(李鍾成),35,54,89,0
20075,노용호(魯容昊),이주환(李周桓),35,41,76,0
20076,노용호(魯容昊),이채익(李埰益),33,49,82,0
20077,노용호(魯容昊),이철규(李喆圭),38,30,68,0
20078,노용호(魯容昊),이탄희(李誕熙),25,4,29,1
20079,노용호(魯容昊),이태규(李泰珪),35,36,71,0
20080,노용호(魯容昊),이학영(李學永),25,4,29,1
20081,노용호(魯容昊),이해식(李海植),25,4,29,1
20082,노용호(魯容昊),이헌승(李憲昇),28,43,71,0
20083,노용호(魯容昊),이형석(李炯錫),26,4,30,1
20084,노용호(魯容昊),인재근(印在謹),26,4,30,1
20085,노용호(魯容昊),임병헌(林炳憲),30,36,66,0
20086,노용호(魯容昊),임오경(林五卿),25,4,29,1
20087,노용호(魯容昊),임이자(林利子),30,31,61,0
20088,노용호(魯容昊),임종성(林鍾聲),26,4,30,1
20089,노용호(魯容昊),임호선(林昊宣),26,4,30,1
20090,노용호(魯容昊),장경태(張耿態),25,4,29,1
20091,노용호(魯容昊),장동혁(張東赫),28,50,78,0
20092,노용호(魯容昊),장제원(張濟元),25,11,36,0
20093,노용호(魯容昊),장철민(張喆敏),26,4,30,1
20094,노용호(魯容昊),장혜영(張惠英),0,0,0,1
20095,노용호(魯容昊),전봉민(田奉珉),30,37,67,0
20096,노용호(魯容昊),전용기(田溶冀),25,4,29,1
20097,노용호(魯容昊),전재수(田載秀),25,4,29,1
20098,노용호(魯容昊),전주혜(全珠惠),33,36,69,0
20099,노용호(魯容昊),전해철(全海澈),25,4,29,1
20100,노용호(魯容昊),전혜숙(全惠淑),25,4,29,1
20101,노용호(魯容昊),정경희(丁慶姬),39,31,70,0
20102,노용호(魯容昊),정동만(鄭東萬),28,24,52,0
20103,노용호(魯容昊),정성호(鄭成湖),26,4,30,1
20104,노용호(魯容昊),정우택(鄭宇澤),35,57,92,0
20105,노용호(魯容昊),정운천(鄭雲天),38,34,72,0
20106,노용호(魯容昊),정일영(鄭日永),25,4,29,1
20107,노용호(魯容昊),정점식(鄭点植),25,21,46,0
20108,노용호(魯容昊),정진석(鄭鎭碩),26,15,41,0
20109,노용호(魯容昊),정청래(鄭淸來),25,4,29,1
20110,노용호(魯容昊),정춘숙(鄭春淑),25,4,29,1
20111,노용호(魯容昊),정태호(鄭泰浩),25,4,29,1
20112,노용호(魯容昊),정필모(鄭必模),25,4,29,1
20113,노용호(魯容昊),정희용(鄭熙溶),34,67,101,0
20114,노용호(魯容昊),조경태(趙慶泰),32,22,54,0
20115,노용호(魯容昊),조명희(曺明姬),43,57,100,0
20116,노용호(魯容昊),조수진(趙修眞),31,56,87,0
20117,노용호(魯容昊),조승래(趙承來),25,4,29,1
20118,노용호(魯容昊),조오섭(曺五燮),25,4,29,1
20119,노용호(魯容昊),조은희(趙恩禧),34,44,78,0
20120,노용호(魯容昊),조응천(趙應天),25,3,28,1
20121,노용호(魯容昊),조정식(趙正湜),25,3,28,1
20122,노용호(魯容昊),조정훈(趙廷訓),0,12,12,1
20123,노용호(魯容昊),조해진(曺海珍),29,16,45,0
20124,노용호(魯容昊),주철현(朱哲鉉),26,4,30,1
20125,노용호(魯容昊),주호영(朱豪英),27,19,46,0
20126,노용호(魯容昊),지성호(池成浩),46,86,132,0
20127,노용호(魯容昊),진선미(陳善美),25,4,29,1
20128,노용호(魯容昊),진성준(陳聲準),25,4,29,1
20129,노용호(魯容昊),천준호(千俊鎬),25,3,28,1
20130,노용호(魯容昊),최기상(崔基相),26,4,30,1
20131,노용호(魯容昊),최승재(崔承宰),31,48,79,0
20132,노용호(魯容昊),최연숙(崔姸淑),28,30,58,0
20133,노용호(魯容昊),최영희(崔英姬),35,47,82,0
20134,노용호(魯容昊),최인호(崔仁昊),26,4,30,1
20135,노용호(魯容昊),최재형(崔在亨),27,19,46,0
20136,노용호(魯容昊),최종윤(崔鍾允),26,4,30,1
20137,노용호(魯容昊),최춘식(崔春植),37,57,94,0
20138,노용호(魯容昊),최형두(崔炯斗),28,22,50,0
20139,노용호(魯容昊),최혜영(崔惠英),25,4,29,1
20140,노용호(魯容昊),추경호(秋慶鎬),25,8,33,0
20141,노용호(魯容昊),태영호(太永浩),36,52,88,0
20142,노용호(魯容昊),하영제(河榮帝),27,37,64,1
20143,노용호(魯容昊),하태경(河泰慶),28,23,51,0
20144,노용호(魯容昊),한기호(韓起鎬),36,41,77,0
20145,노용호(魯容昊),한무경(韓茂景),45,74,119,0
20146,노용호(魯容昊),한병도(韓秉道),26,4,30,1
20147,노용호(魯容昊),한정애(韓貞愛),25,4,29,1
20148,노용호(魯容昊),한준호(韓俊鎬),25,4,29,1
20149,노용호(魯容昊),허숙정(許淑湞),0,0,0,1
20150,노용호(魯容昊),허영(許榮),26,4,30,1
20151,노용호(魯容昊),허은아(許垠娥),26,16,42,0
20152,노용호(魯容昊),허종식(許琮植),25,4,29,1
20153,노용호(魯容昊),홍기원(洪起元),25,4,29,1
20154,노용호(魯容昊),홍문표(洪文杓),32,29,61,0
20155,노용호(魯容昊),홍석준(洪碩晙),29,30,59,0
20156,노용호(魯容昊),홍성국(洪性國),25,4,29,1
20157,노용호(魯容昊),홍영표(洪永杓),25,4,29,1
20158,노용호(魯容昊),홍익표(洪翼杓),26,4,30,1
20159,노용호(魯容昊),홍정민(洪貞敏),26,4,30,1
20160,노용호(魯容昊),황보승희(皇甫承希),31,36,67,1
20161,노용호(魯容昊),황운하(黃雲夏),25,4,29,1
20162,노용호(魯容昊),황희(黃熙),25,10,35,1
20163,노웅래(盧雄來),도종환(都鍾煥),99,69,168,0
20164,노웅래(盧雄來),류성걸(柳性杰),49,4,53,1
20165,노웅래(盧雄來),류호정(柳好貞),19,34,53,1
20166,노웅래(盧雄來),맹성규(孟聖奎),94,60,154,0
20167,노웅래(盧雄來),문정복(文貞福),93,57,150,0
20168,노웅래(盧雄來),문진석(文振碩),112,92,204,0
20169,노웅래(盧雄來),민병덕(閔炳德),107,109,216,0
20170,노웅래(盧雄來),민형배(閔馨培),102,139,241,0
20171,노웅래(盧雄來),민홍철(閔洪喆),88,58,146,0
20172,노웅래(盧雄來),박광온(朴洸瑥),91,69,160,0
20173,노웅래(盧雄來),박대수(朴大壽),51,7,58,1
20174,노웅래(盧雄來),박대출(朴大出),51,4,55,1
20175,노웅래(盧雄來),박덕흠(朴德欽),38,5,43,1
20176,노웅래(盧雄來),박범계(朴範界),82,36,118,0
20177,노웅래(盧雄來),박병석(朴炳錫),40,16,56,0
20178,노웅래(盧雄來),박상혁(朴商赫),111,111,222,0
20179,노웅래(盧雄來),박성민(朴聖敏),50,5,55,1
20180,노웅래(盧雄來),박성준(朴省俊),106,101,207,0
20181,노웅래(盧雄來),박성중(朴成重),51,7,58,1
20182,노웅래(盧雄來),박수영(朴洙瑩),51,7,58,1
20183,노웅래(盧雄來),박영순(朴英淳),101,81,182,0
20184,노웅래(盧雄來),박완주(朴完柱),49,46,95,1
20185,노웅래(盧雄來),박용진(朴用鎭),79,53,132,0
20186,노웅래(盧雄來),박재호(朴在昊),94,82,176,0
20187,노웅래(盧雄來),박정(朴釘),110,129,239,0
20188,노웅래(盧雄來),박정하(朴正河),26,3,29,1
20189,노웅래(盧雄來),박주민(朴柱民),85,53,138,0
20190,노웅래(盧雄來),박진(朴振),51,7,58,1
20191,노웅래(盧雄來),박찬대(朴贊大),91,61,152,0
20192,노웅래(盧雄來),박형수(朴亨修),49,4,53,1
20193,노웅래(盧雄來),박홍근(朴洪根),109,99,208,0
20194,노웅래(盧雄來),배준영(裵俊英),50,4,54,1
20195,노웅래(盧雄來),배진교(裵晋敎),19,25,44,1
20196,노웅래(盧雄來),배현진(裵賢鎭),51,5,56,1
20197,노웅래(盧雄來),백종헌(白宗憲),52,5,57,1
20198,노웅래(盧雄來),백혜련(白惠蓮),92,67,159,0
20199,노웅래(盧雄來),변재일(卞在一),88,53,141,0
20200,노웅래(盧雄來),서동용(徐東榕),104,86,190,0
20201,노웅래(盧雄來),서범수(徐範洙),54,6,60,1
20202,노웅래(盧雄來),서병수(徐秉洙),50,4,54,1
20203,노웅래(盧雄來),서삼석(徐參錫),100,92,192,0
20204,노웅래(盧雄來),서영교(徐瑛敎),113,118,231,0
20205,노웅래(盧雄來),서영석(徐暎錫),106,124,230,0
20206,노웅래(盧雄來),서일준(徐一俊),51,3,54,1
20207,노웅래(盧雄來),서정숙(徐正淑),49,6,55,1
20208,노웅래(盧雄來),설훈(薛勳),86,74,160,0
20209,노웅래(盧雄來),성일종(成一鍾),51,8,59,1
20210,노웅래(盧雄來),소병철(蘇秉哲),92,63,155,0
20211,노웅래(盧雄來),소병훈(蘇秉勳),106,90,196,0
20212,노웅래(盧雄來),송갑석(宋甲錫),104,88,192,0
20213,노웅래(盧雄來),송기헌(宋基憲),81,49,130,0
20214,노웅래(盧雄來),송석준(宋錫俊),52,6,58,1
20215,노웅래(盧雄來),송언석(宋彦錫),45,5,50,1
20216,노웅래(盧雄來),송옥주(宋玉珠),145,129,274,0
20217,노웅래(盧雄來),송재호(宋在祜),106,108,214,0
20218,노웅래(盧雄來),신동근(申東根),94,81,175,0
20219,노웅래(盧雄來),신영대(申榮大),90,69,159,0
20220,노웅래(盧雄來),신원식(申源湜),51,5,56,1
20221,노웅래(盧雄來),신정훈(辛正勳),117,161,278,0
20222,노웅래(盧雄來),신현영(申賢榮),85,53,138,0
20223,노웅래(盧雄來),심상정(沈相奵),18,37,55,1
20224,노웅래(盧雄來),안규백(安圭伯),110,91,201,0
20225,노웅래(盧雄來),안민석(安敏錫),92,68,160,0
20226,노웅래(盧雄來),안병길(安炳吉),53,4,57,1
20227,노웅래(盧雄來),안철수(安哲秀),26,3,29,1
20228,노웅래(盧雄來),안호영(安浩永),120,90,210,0
20229,노웅래(盧雄來),양경숙(梁敬淑),102,92,194,0
20230,노웅래(盧雄來),양금희(梁琴喜),52,6,58,1
20231,노웅래(盧雄來),양기대(梁基大),101,124,225,0
20232,노웅래(盧雄來),양이원영(梁李媛瑛),119,93,212,0
20233,노웅래(盧雄來),양정숙(梁貞淑),62,126,188,1
20234,노웅래(盧雄來),양향자(梁香子),44,37,81,1
20235,노웅래(盧雄來),어기구(魚基龜),97,81,178,0
20236,노웅래(盧雄來),엄태영(嚴泰永),52,4,56,1
20237,노웅래(盧雄來),오기형(吳奇炯),82,47,129,0
20238,노웅래(盧雄來),오영환(吳永煥),135,215,350,0
20239,노웅래(盧雄來),용혜인(龍慧仁),19,49,68,1
20240,노웅래(盧雄來),우상호(禹相虎),84,39,123,0
20241,노웅래(盧雄來),우원식(禹元植),103,89,192,0
20242,노웅래(盧雄來),위성곤(魏聖坤),109,86,195,0
20243,노웅래(盧雄來),유경준(兪京濬),50,5,55,1
20244,노웅래(盧雄來),유기홍(柳基洪),87,72,159,0
20245,노웅래(盧雄來),유동수(柳東秀),90,64,154,0
20246,노웅래(盧雄來),유상범(劉相凡),51,4,55,1
20247,노웅래(盧雄來),유의동(兪義東),52,4,56,1
20248,노웅래(盧雄來),유정주(兪訂炷),128,119,247,0
20249,노웅래(盧雄來),윤건영(尹建永),98,84,182,0
20250,노웅래(盧雄來),윤관석(尹官石),80,63,143,1
20251,노웅래(盧雄來),윤두현(尹斗鉉),50,3,53,1
20252,노웅래(盧雄來),윤미향(尹美香),87,106,193,1
20253,노웅래(盧雄來),윤상현(尹相現),33,6,39,1
20254,노웅래(盧雄來),윤영덕(尹永德),98,120,218,0
20255,노웅래(盧雄來),윤영석(尹永碩),51,11,62,1
20256,노웅래(盧雄來),윤영찬(尹永燦),85,57,142,0
20257,노웅래(盧雄來),윤재갑(尹才鉀),126,111,237,0
20258,노웅래(盧雄來),윤재옥(尹在玉),52,4,56,1
20259,노웅래(盧雄來),윤주경(尹柱卿),49,4,53,1
20260,노웅래(盧雄來),윤준병(尹準炳),149,179,328,0
20261,노웅래(盧雄來),윤창현(尹暢賢),49,5,54,1
20262,노웅래(盧雄來),윤한홍(尹漢洪),51,3,54,1
20263,노웅래(盧雄來),윤호중(尹昊重),79,57,136,0
20264,노웅래(盧雄來),윤후덕(尹厚德),86,77,163,0
20265,노웅래(盧雄來),이개호(李介昊),98,85,183,0
20266,노웅래(盧雄來),이달곤(李達坤),52,6,58,1
20267,노웅래(盧雄來),이동주(李東洲),95,103,198,0
20268,노웅래(盧雄來),이만희(李晩熙),51,4,55,1
20269,노웅래(盧雄來),이명수(李明洙),51,11,62,1
20270,노웅래(盧雄來),이병훈(李炳勳),128,198,326,0
20271,노웅래(盧雄來),이상민(李相珉),78,35,113,0
20272,노웅래(盧雄來),이상헌(李相憲),95,76,171,0
20273,노웅래(盧雄來),이성만(李成萬),85,93,178,1
20274,노웅래(盧雄來),이소영(李素永),92,48,140,0
20275,노웅래(盧雄來),이수진(李壽珍),162,174,336,0
20276,노웅래(盧雄來),이수진(李秀眞),106,122,228,0
20277,노웅래(盧雄來),이양수(李亮壽),53,4,57,1
20278,노웅래(盧雄來),이용(李鏞),50,4,54,1
20279,노웅래(盧雄來),이용빈(李龍彬),124,151,275,0
20280,노웅래(盧雄來),이용선(李庸瑄),97,85,182,0
20281,노웅래(盧雄來),이용우(李龍雨),110,123,233,0
20282,노웅래(盧雄來),이용호(李容鎬),35,16,51,1
20283,노웅래(盧雄來),이원욱(李元旭),95,97,192,0
20284,노웅래(盧雄來),이원택(李源澤),92,65,157,0
20285,노웅래(盧雄來),이은주(李恩周),18,25,43,1
20286,노웅래(盧雄來),이인선(李仁善),25,3,28,1
20287,노웅래(盧雄來),이인영(李仁榮),76,51,127,0
20288,노웅래(盧雄來),이장섭(李將燮),102,106,208,0
20289,노웅래(盧雄來),이재명(李在明),40,23,63,0
20290,노웅래(盧雄來),이재정(李在汀),84,44,128,0
20291,노웅래(盧雄來),이정문(李楨文),91,82,173,0
20292,노웅래(盧雄來),이종배(李鍾培),52,5,57,1
20293,노웅래(盧雄來),이종성(李鍾成),50,5,55,1
20294,노웅래(盧雄來),이주환(李周桓),50,5,55,1
20295,노웅래(盧雄來),이채익(李埰益),51,10,61,1
20296,노웅래(盧雄來),이철규(李喆圭),53,5,58,1
20297,노웅래(盧雄來),이탄희(李誕熙),96,59,155,0
20298,노웅래(盧雄來),이태규(李泰珪),28,6,34,1
20299,노웅래(盧雄來),이학영(李學永),104,132,236,0
20300,노웅래(盧雄來),이해식(李海植),107,103,210,0
20301,노웅래(盧雄來),이헌승(李憲昇),52,4,56,1
20302,노웅래(盧雄來),이형석(李炯錫),103,109,212,0
20303,노웅래(盧雄來),인재근(印在謹),109,108,217,0
20304,노웅래(盧雄來),임병헌(林炳憲),25,3,28,1
20305,노웅래(盧雄來),임오경(林五卿),96,119,215,0
20306,노웅래(盧雄來),임이자(林利子),50,4,54,1
20307,노웅래(盧雄來),임종성(林鍾聲),149,142,291,0
20308,노웅래(盧雄來),임호선(林昊宣),125,175,300,0
20309,노웅래(盧雄來),장경태(張耿態),110,105,215,0
20310,노웅래(盧雄來),장동혁(張東赫),25,3,28,1
20311,노웅래(盧雄來),장제원(張濟元),49,3,52,1
20312,노웅래(盧雄來),장철민(張喆敏),126,89,215,0
20313,노웅래(盧雄來),장혜영(張惠英),13,16,29,1
20314,노웅래(盧雄來),전봉민(田奉珉),35,4,39,1
20315,노웅래(盧雄來),전용기(田溶冀),109,127,236,0
20316,노웅래(盧雄來),전재수(田載秀),100,91,191,0
20317,노웅래(盧雄來),전주혜(全珠惠),53,8,61,1
20318,노웅래(盧雄來),전해철(全海澈),79,64,143,0
20319,노웅래(盧雄來),전혜숙(全惠淑),109,96,205,0
20320,노웅래(盧雄來),정경희(丁慶姬),50,5,55,1
20321,노웅래(盧雄來),정동만(鄭東萬),49,3,52,1
20322,노웅래(盧雄來),정성호(鄭成湖),91,91,182,0
20323,노웅래(盧雄來),정우택(鄭宇澤),26,3,29,1
20324,노웅래(盧雄來),정운천(鄭雲天),52,6,58,1
20325,노웅래(盧雄來),정일영(鄭日永),104,122,226,0
20326,노웅래(盧雄來),정점식(鄭点植),51,4,55,1
20327,노웅래(盧雄來),정진석(鄭鎭碩),52,6,58,1
20328,노웅래(盧雄來),정청래(鄭淸來),92,68,160,0
20329,노웅래(盧雄來),정춘숙(鄭春淑),89,58,147,0
20330,노웅래(盧雄來),정태호(鄭泰浩),83,88,171,0
20331,노웅래(盧雄來),정필모(鄭必模),106,100,206,0
20332,노웅래(盧雄來),정희용(鄭熙溶),50,6,56,1
20333,노웅래(盧雄來),조경태(趙慶泰),50,3,53,1
20334,노웅래(盧雄來),조명희(曺明姬),52,7,59,1
20335,노웅래(盧雄來),조수진(趙修眞),52,6,58,1
20336,노웅래(盧雄來),조승래(趙承來),102,73,175,0
20337,노웅래(盧雄來),조오섭(曺五燮),101,110,211,0
20338,노웅래(盧雄來),조은희(趙恩禧),26,3,29,1
20339,노웅래(盧雄來),조응천(趙應天),81,51,132,0
20340,노웅래(盧雄來),조정식(趙正湜),80,66,146,0
20341,노웅래(盧雄來),조정훈(趙廷訓),3,6,9,1
20342,노웅래(盧雄來),조해진(曺海珍),52,4,56,1
20343,노웅래(盧雄來),주철현(朱哲鉉),106,99,205,0
20344,노웅래(盧雄來),주호영(朱豪英),50,4,54,1
20345,노웅래(盧雄來),지성호(池成浩),52,4,56,1
20346,노웅래(盧雄來),진선미(陳善美),83,59,142,0
20347,노웅래(盧雄來),진성준(陳聲準),106,105,211,0
20348,노웅래(盧雄來),천준호(千俊鎬),100,64,164,0
20349,노웅래(盧雄來),최기상(崔基相),95,76,171,0
20350,노웅래(盧雄來),최승재(崔承宰),51,5,56,1
20351,노웅래(盧雄來),최연숙(崔姸淑),30,13,43,1
20352,노웅래(盧雄來),최영희(崔英姬),25,3,28,1
20353,노웅래(盧雄來),최인호(崔仁昊),100,98,198,0
20354,노웅래(盧雄來),최재형(崔在亨),26,3,29,1
20355,노웅래(盧雄來),최종윤(崔鍾允),117,122,239,0
20356,노웅래(盧雄來),최춘식(崔春植),50,6,56,1
20357,노웅래(盧雄來),최형두(崔炯斗),51,7,58,1
20358,노웅래(盧雄來),최혜영(崔惠英),95,96,191,0
20359,노웅래(盧雄來),추경호(秋慶鎬),49,4,53,1
20360,노웅래(盧雄來),태영호(太永浩),51,7,58,1
20361,노웅래(盧雄來),하영제(河榮帝),44,3,47,1
20362,노웅래(盧雄來),하태경(河泰慶),50,5,55,1
20363,노웅래(盧雄來),한기호(韓起鎬),53,3,56,1
20364,노웅래(盧雄來),한무경(韓茂景),50,5,55,1
20365,노웅래(盧雄來),한병도(韓秉道),100,99,199,0
20366,노웅래(盧雄來),한정애(韓貞愛),83,51,134,0
20367,노웅래(盧雄來),한준호(韓俊鎬),122,121,243,0
20368,노웅래(盧雄來),허숙정(許淑湞),1,1,2,0
20369,노웅래(盧雄來),허영(許榮),112,117,229,0
20370,노웅래(盧雄來),허은아(許垠娥),49,6,55,1
20371,노웅래(盧雄來),허종식(許琮植),99,73,172,0
20372,노웅래(盧雄來),홍기원(洪起元),98,90,188,0
20373,노웅래(盧雄來),홍문표(洪文杓),51,6,57,1
20374,노웅래(盧雄來),홍석준(洪碩晙),50,4,54,1
20375,노웅래(盧雄來),홍성국(洪性國),125,187,312,0
20376,노웅래(盧雄來),홍영표(洪永杓),88,61,149,0
20377,노웅래(盧雄來),홍익표(洪翼杓),86,80,166,0
20378,노웅래(盧雄來),홍정민(洪貞敏),109,107,216,0
20379,노웅래(盧雄來),황보승희(皇甫承希),51,6,57,1
20380,노웅래(盧雄來),황운하(黃雲夏),104,117,221,0
20381,노웅래(盧雄來),황희(黃熙),81,43,124,0
20382,도종환(都鍾煥),류성걸(柳性杰),49,5,54,1
20383,도종환(都鍾煥),류호정(柳好貞),19,40,59,1
20384,도종환(都鍾煥),맹성규(孟聖奎),91,55,146,0
20385,도종환(都鍾煥),문정복(文貞福),93,83,176,0
20386,도종환(都鍾煥),문진석(文振碩),110,116,226,0
20387,도종환(都鍾煥),민병덕(閔炳德),96,106,202,0
20388,도종환(都鍾煥),민형배(閔馨培),99,167,266,0
20389,도종환(都鍾煥),민홍철(閔洪喆),88,65,153,0
20390,도종환(都鍾煥),박광온(朴洸瑥),100,99,199,0
20391,도종환(都鍾煥),박대수(朴大壽),50,7,57,1
20392,도종환(都鍾煥),박대출(朴大出),50,5,55,1
20393,도종환(都鍾煥),박덕흠(朴德欽),39,12,51,1
20394,도종환(都鍾煥),박범계(朴範界),82,41,123,0
20395,도종환(都鍾煥),박병석(朴炳錫),41,20,61,0
20396,도종환(都鍾煥),박상혁(朴商赫),85,98,183,0
20397,도종환(都鍾煥),박성민(朴聖敏),50,6,56,1
20398,도종환(都鍾煥),박성준(朴省俊),99,75,174,0
20399,도종환(都鍾煥),박성중(朴成重),51,5,56,1
20400,도종환(都鍾煥),박수영(朴洙瑩),50,5,55,1
20401,도종환(都鍾煥),박영순(朴英淳),91,73,164,0
20402,도종환(都鍾煥),박완주(朴完柱),50,51,101,1
20403,도종환(都鍾煥),박용진(朴用鎭),86,55,141,0
20404,도종환(都鍾煥),박재호(朴在昊),90,57,147,0
20405,도종환(都鍾煥),박정(朴釘),148,127,275,0
20406,도종환(都鍾煥),박정하(朴正河),25,4,29,1
20407,도종환(都鍾煥),박주민(朴柱民),84,53,137,0
20408,도종환(都鍾煥),박진(朴振),50,4,54,1
20409,도종환(都鍾煥),박찬대(朴贊大),92,66,158,0
20410,도종환(都鍾煥),박형수(朴亨修),49,5,54,1
20411,도종환(都鍾煥),박홍근(朴洪根),107,96,203,0
20412,도종환(都鍾煥),배준영(裵俊英),49,4,53,1
20413,도종환(都鍾煥),배진교(裵晋敎),17,30,47,1
20414,도종환(都鍾煥),배현진(裵賢鎭),50,5,55,1
20415,도종환(都鍾煥),백종헌(白宗憲),51,7,58,1
20416,도종환(都鍾煥),백혜련(白惠蓮),89,61,150,0
20417,도종환(都鍾煥),변재일(卞在一),98,88,186,0
20418,도종환(都鍾煥),서동용(徐東榕),127,179,306,0
20419,도종환(都鍾煥),서범수(徐範洙),51,4,55,1
20420,도종환(都鍾煥),서병수(徐秉洙),50,6,56,1
20421,도종환(都鍾煥),서삼석(徐參錫),105,70,175,0
20422,도종환(都鍾煥),서영교(徐瑛敎),113,118,231,0
20423,도종환(都鍾煥),서영석(徐暎錫),111,110,221,0
20424,도종환(都鍾煥),서일준(徐一俊),50,7,57,1
20425,도종환(都鍾煥),서정숙(徐正淑),49,7,56,1
20426,도종환(都鍾煥),설훈(薛勳),85,68,153,0
20427,도종환(都鍾煥),성일종(成一鍾),51,8,59,1
20428,도종환(都鍾煥),소병철(蘇秉哲),91,60,151,0
20429,도종환(都鍾煥),소병훈(蘇秉勳),100,83,183,0
20430,도종환(都鍾煥),송갑석(宋甲錫),102,112,214,0
20431,도종환(都鍾煥),송기헌(宋基憲),90,52,142,0
20432,도종환(都鍾煥),송석준(宋錫俊),51,6,57,1
20433,도종환(都鍾煥),송언석(宋彦錫),47,5,52,1
20434,도종환(都鍾煥),송옥주(宋玉珠),92,70,162,0
20435,도종환(都鍾煥),송재호(宋在祜),97,81,178,0
20436,도종환(都鍾煥),신동근(申東根),107,91,198,0
20437,도종환(都鍾煥),신영대(申榮大),95,63,158,0
20438,도종환(都鍾煥),신원식(申源湜),49,4,53,1
20439,도종환(都鍾煥),신정훈(辛正勳),95,123,218,0
20440,도종환(都鍾煥),신현영(申賢榮),85,64,149,0
20441,도종환(都鍾煥),심상정(沈相奵),16,35,51,1
20442,도종환(都鍾煥),안규백(安圭伯),89,59,148,0
20443,도종환(都鍾煥),안민석(安敏錫),153,197,350,0
20444,도종환(都鍾煥),안병길(安炳吉),50,5,55,1
20445,도종환(都鍾煥),안철수(安哲秀),25,6,31,1
20446,도종환(都鍾煥),안호영(安浩永),82,71,153,0
20447,도종환(都鍾煥),양경숙(梁敬淑),86,79,165,0
20448,도종환(都鍾煥),양금희(梁琴喜),50,5,55,1
20449,도종환(都鍾煥),양기대(梁基大),92,57,149,0
20450,도종환(都鍾煥),양이원영(梁李媛瑛),101,79,180,0
20451,도종환(都鍾煥),양정숙(梁貞淑),56,106,162,1
20452,도종환(都鍾煥),양향자(梁香子),42,43,85,1
20453,도종환(都鍾煥),어기구(魚基龜),89,60,149,0
20454,도종환(都鍾煥),엄태영(嚴泰永),52,6,58,1
20455,도종환(都鍾煥),오기형(吳奇炯),78,40,118,0
20456,도종환(都鍾煥),오영환(吳永煥),119,147,266,0
20457,도종환(都鍾煥),용혜인(龍慧仁),12,30,42,1
20458,도종환(都鍾煥),우상호(禹相虎),84,45,129,0
20459,도종환(都鍾煥),우원식(禹元植),91,72,163,0
20460,도종환(都鍾煥),위성곤(魏聖坤),91,81,172,0
20461,도종환(都鍾煥),유경준(兪京濬),49,4,53,1
20462,도종환(都鍾煥),유기홍(柳基洪),97,87,184,0
20463,도종환(都鍾煥),유동수(柳東秀),90,51,141,0
20464,도종환(都鍾煥),유상범(劉相凡),49,4,53,1
20465,도종환(都鍾煥),유의동(兪義東),49,5,54,1
20466,도종환(都鍾煥),유정주(兪訂炷),145,155,300,0
20467,도종환(都鍾煥),윤건영(尹建永),82,63,145,0
20468,도종환(都鍾煥),윤관석(尹官石),79,48,127,1
20469,도종환(都鍾煥),윤두현(尹斗鉉),49,7,56,1
20470,도종환(都鍾煥),윤미향(尹美香),41,47,88,1
20471,도종환(都鍾煥),윤상현(尹相現),32,7,39,1
20472,도종환(都鍾煥),윤영덕(尹永德),95,106,201,0
20473,도종환(都鍾煥),윤영석(尹永碩),50,6,56,1
20474,도종환(都鍾煥),윤영찬(尹永燦),79,55,134,0
20475,도종환(都鍾煥),윤재갑(尹才鉀),102,76,178,0
20476,도종환(都鍾煥),윤재옥(尹在玉),49,4,53,1
20477,도종환(都鍾煥),윤주경(尹柱卿),49,7,56,1
20478,도종환(都鍾煥),윤준병(尹準炳),99,105,204,0
20479,도종환(都鍾煥),윤창현(尹暢賢),49,8,57,1
20480,도종환(都鍾煥),윤한홍(尹漢洪),51,4,55,1
20481,도종환(都鍾煥),윤호중(尹昊重),80,48,128,0
20482,도종환(都鍾煥),윤후덕(尹厚德),95,62,157,0
20483,도종환(都鍾煥),이개호(李介昊),92,66,158,0
20484,도종환(都鍾煥),이달곤(李達坤),53,8,61,1
20485,도종환(都鍾煥),이동주(李東洲),95,93,188,0
20486,도종환(都鍾煥),이만희(李晩熙),50,4,54,1
20487,도종환(都鍾煥),이명수(李明洙),51,18,69,1
20488,도종환(都鍾煥),이병훈(李炳勳),139,130,269,0
20489,도종환(都鍾煥),이상민(李相珉),84,42,126,0
20490,도종환(都鍾煥),이상헌(李相憲),134,103,237,0
20491,도종환(都鍾煥),이성만(李成萬),87,81,168,1
20492,도종환(都鍾煥),이소영(李素永),84,57,141,0
20493,도종환(都鍾煥),이수진(李壽珍),108,89,197,0
20494,도종환(都鍾煥),이수진(李秀眞),108,92,200,0
20495,도종환(都鍾煥),이양수(李亮壽),52,5,57,1
20496,도종환(都鍾煥),이용(李鏞),49,4,53,1
20497,도종환(都鍾煥),이용빈(李龍彬),113,117,230,0
20498,도종환(都鍾煥),이용선(李庸瑄),98,83,181,0
20499,도종환(都鍾煥),이용우(李龍雨),95,64,159,0
20500,도종환(都鍾煥),이용호(李容鎬),30,8,38,1
20501,도종환(都鍾煥),이원욱(李元旭),95,68,163,0
20502,도종환(都鍾煥),이원택(李源澤),98,76,174,0
20503,도종환(都鍾煥),이은주(李恩周),17,25,42,1
20504,도종환(都鍾煥),이인선(李仁善),25,4,29,1
20505,도종환(都鍾煥),이인영(李仁榮),78,52,130,0
20506,도종환(都鍾煥),이장섭(李將燮),90,91,181,0
20507,도종환(都鍾煥),이재명(李在明),40,22,62,0
20508,도종환(都鍾煥),이재정(李在汀),102,63,165,0
20509,도종환(都鍾煥),이정문(李楨文),141,175,316,0
20510,도종환(都鍾煥),이종배(李鍾培),51,10,61,1
20511,도종환(都鍾煥),이종성(李鍾成),49,7,56,1
20512,도종환(都鍾煥),이주환(李周桓),49,5,54,1
20513,도종환(都鍾煥),이채익(李埰益),52,6,58,1
20514,도종환(都鍾煥),이철규(李喆圭),52,6,58,1
20515,도종환(都鍾煥),이탄희(李誕熙),91,80,171,0
20516,도종환(都鍾煥),이태규(李泰珪),28,7,35,1
20517,도종환(都鍾煥),이학영(李學永),93,81,174,0
20518,도종환(都鍾煥),이해식(李海植),91,70,161,0
20519,도종환(都鍾煥),이헌승(李憲昇),51,5,56,1
20520,도종환(都鍾煥),이형석(李炯錫),95,71,166,0
20521,도종환(都鍾煥),인재근(印在謹),107,125,232,0
20522,도종환(都鍾煥),임병헌(林炳憲),25,6,31,1
20523,도종환(都鍾煥),임오경(林五卿),109,93,202,0
20524,도종환(都鍾煥),임이자(林利子),50,5,55,1
20525,도종환(都鍾煥),임종성(林鍾聲),101,110,211,0
20526,도종환(都鍾煥),임호선(林昊宣),118,142,260,0
20527,도종환(都鍾煥),장경태(張耿態),99,112,211,0
20528,도종환(都鍾煥),장동혁(張東赫),25,4,29,1
20529,도종환(都鍾煥),장제원(張濟元),49,4,53,1
20530,도종환(都鍾煥),장철민(張喆敏),91,69,160,0
20531,도종환(都鍾煥),장혜영(張惠英),12,21,33,1
20532,도종환(都鍾煥),전봉민(田奉珉),35,5,40,1
20533,도종환(都鍾煥),전용기(田溶冀),102,89,191,0
20534,도종환(都鍾煥),전재수(田載秀),86,48,134,0
20535,도종환(都鍾煥),전주혜(全珠惠),51,6,57,1
20536,도종환(都鍾煥),전해철(全海澈),82,54,136,0
20537,도종환(都鍾煥),전혜숙(全惠淑),96,76,172,0
20538,도종환(都鍾煥),정경희(丁慶姬),49,4,53,1
20539,도종환(都鍾煥),정동만(鄭東萬),49,6,55,1
20540,도종환(都鍾煥),정성호(鄭成湖),79,54,133,0
20541,도종환(都鍾煥),정우택(鄭宇澤),26,5,31,1
20542,도종환(都鍾煥),정운천(鄭雲天),50,5,55,1
20543,도종환(都鍾煥),정일영(鄭日永),84,59,143,0
20544,도종환(都鍾煥),정점식(鄭点植),51,4,55,1
20545,도종환(都鍾煥),정진석(鄭鎭碩),50,9,59,1
20546,도종환(都鍾煥),정청래(鄭淸來),91,66,157,0
20547,도종환(都鍾煥),정춘숙(鄭春淑),97,97,194,0
20548,도종환(都鍾煥),정태호(鄭泰浩),88,71,159,0
20549,도종환(都鍾煥),정필모(鄭必模),94,66,160,0
20550,도종환(都鍾煥),정희용(鄭熙溶),50,6,56,1
20551,도종환(都鍾煥),조경태(趙慶泰),49,6,55,1
20552,도종환(都鍾煥),조명희(曺明姬),51,9,60,1
20553,도종환(都鍾煥),조수진(趙修眞),51,5,56,1
20554,도종환(都鍾煥),조승래(趙承來),135,106,241,0
20555,도종환(都鍾煥),조오섭(曺五燮),101,122,223,0
20556,도종환(都鍾煥),조은희(趙恩禧),25,5,30,1
20557,도종환(都鍾煥),조응천(趙應天),76,38,114,0
20558,도종환(都鍾煥),조정식(趙正湜),84,43,127,0
20559,도종환(都鍾煥),조정훈(趙廷訓),2,15,17,1
20560,도종환(都鍾煥),조해진(曺海珍),52,6,58,1
20561,도종환(都鍾煥),주철현(朱哲鉉),97,78,175,0
20562,도종환(都鍾煥),주호영(朱豪英),50,5,55,1
20563,도종환(都鍾煥),지성호(池成浩),50,6,56,1
20564,도종환(都鍾煥),진선미(陳善美),82,67,149,0
20565,도종환(都鍾煥),진성준(陳聲準),97,78,175,0
20566,도종환(都鍾煥),천준호(千俊鎬),89,64,153,0
20567,도종환(都鍾煥),최기상(崔基相),81,57,138,0
20568,도종환(都鍾煥),최승재(崔承宰),50,9,59,1
20569,도종환(都鍾煥),최연숙(崔姸淑),31,16,47,1
20570,도종환(都鍾煥),최영희(崔英姬),25,5,30,1
20571,도종환(都鍾煥),최인호(崔仁昊),89,65,154,0
20572,도종환(都鍾煥),최재형(崔在亨),26,4,30,1
20573,도종환(都鍾煥),최종윤(崔鍾允),106,87,193,0
20574,도종환(都鍾煥),최춘식(崔春植),51,6,57,1
20575,도종환(都鍾煥),최형두(崔炯斗),51,7,58,1
20576,도종환(都鍾煥),최혜영(崔惠英),93,86,179,0
20577,도종환(都鍾煥),추경호(秋慶鎬),49,4,53,1
20578,도종환(都鍾煥),태영호(太永浩),50,6,56,1
20579,도종환(都鍾煥),하영제(河榮帝),41,2,43,1
20580,도종환(都鍾煥),하태경(河泰慶),51,6,57,1
20581,도종환(都鍾煥),한기호(韓起鎬),51,5,56,1
20582,도종환(都鍾煥),한무경(韓茂景),50,7,57,1
20583,도종환(都鍾煥),한병도(韓秉道),89,76,165,0
20584,도종환(都鍾煥),한정애(韓貞愛),78,47,125,0
20585,도종환(都鍾煥),한준호(韓俊鎬),111,89,200,0
20586,도종환(都鍾煥),허숙정(許淑湞),1,1,2,0
20587,도종환(都鍾煥),허영(許榮),101,78,179,0
20588,도종환(都鍾煥),허은아(許垠娥),49,6,55,1
20589,도종환(都鍾煥),허종식(許琮植),91,62,153,0
20590,도종환(都鍾煥),홍기원(洪起元),98,59,157,0
20591,도종환(都鍾煥),홍문표(洪文杓),52,7,59,1
20592,도종환(都鍾煥),홍석준(洪碩晙),50,5,55,1
20593,도종환(都鍾煥),홍성국(洪性國),94,95,189,0
20594,도종환(都鍾煥),홍영표(洪永杓),84,51,135,0
20595,도종환(都鍾煥),홍익표(洪翼杓),89,76,165,0
20596,도종환(都鍾煥),홍정민(洪貞敏),113,92,205,0
20597,도종환(都鍾煥),황보승희(皇甫承希),46,4,50,1
20598,도종환(都鍾煥),황운하(黃雲夏),109,101,210,0
20599,도종환(都鍾煥),황희(黃熙),83,46,129,0
20600,류성걸(柳性杰),류호정(柳好貞),4,12,16,1
20601,류성걸(柳性杰),맹성규(孟聖奎),49,5,54,1
20602,류성걸(柳性杰),문정복(文貞福),49,4,53,1
20603,류성걸(柳性杰),문진석(文振碩),49,4,53,1
20604,류성걸(柳性杰),민병덕(閔炳德),50,4,54,1
20605,류성걸(柳性杰),민형배(閔馨培),33,4,37,1
20606,류성걸(柳性杰),민홍철(閔洪喆),49,4,53,1
20607,류성걸(柳性杰),박광온(朴洸瑥),49,4,53,1
20608,류성걸(柳性杰),박대수(朴大壽),80,130,210,0
20609,류성걸(柳性杰),박대출(朴大出),67,56,123,0
20610,류성걸(柳性杰),박덕흠(朴德欽),64,121,185,0
20611,류성걸(柳性杰),박범계(朴範界),50,4,54,1
20612,류성걸(柳性杰),박병석(朴炳錫),25,3,28,1
20613,류성걸(柳性杰),박상혁(朴商赫),49,4,53,1
20614,류성걸(柳性杰),박성민(朴聖敏),67,72,139,0
20615,류성걸(柳性杰),박성준(朴省俊),49,4,53,1
20616,류성걸(柳性杰),박성중(朴成重),65,64,129,0
20617,류성걸(柳性杰),박수영(朴洙瑩),73,56,129,0
20618,류성걸(柳性杰),박영순(朴英淳),50,3,53,1
20619,류성걸(柳性杰),박완주(朴完柱),24,0,24,1
20620,류성걸(柳性杰),박용진(朴用鎭),49,4,53,1
20621,류성걸(柳性杰),박재호(朴在昊),50,5,55,1
20622,류성걸(柳性杰),박정(朴釘),49,4,53,1
20623,류성걸(柳性杰),박정하(朴正河),37,43,80,0
20624,류성걸(柳性杰),박주민(朴柱民),49,4,53,1
20625,류성걸(柳性杰),박진(朴振),64,61,125,0
20626,류성걸(柳性杰),박찬대(朴贊大),49,4,53,1
20627,류성걸(柳性杰),박형수(朴亨修),67,53,120,0
20628,류성걸(柳性杰),박홍근(朴洪根),49,5,54,1
20629,류성걸(柳性杰),배준영(裵俊英),82,76,158,0
20630,류성걸(柳性杰),배진교(裵晋敎),4,2,6,1
20631,류성걸(柳性杰),배현진(裵賢鎭),67,46,113,0
20632,류성걸(柳性杰),백종헌(白宗憲),76,104,180,0
20633,류성걸(柳性杰),백혜련(白惠蓮),50,4,54,1
20634,류성걸(柳性杰),변재일(卞在一),50,4,54,1
20635,류성걸(柳性杰),서동용(徐東榕),49,4,53,1
20636,류성걸(柳性杰),서범수(徐範洙),69,50,119,0
20637,류성걸(柳性杰),서병수(徐秉洙),83,132,215,0
20638,류성걸(柳性杰),서삼석(徐參錫),49,5,54,1
20639,류성걸(柳性杰),서영교(徐瑛敎),49,4,53,1
20640,류성걸(柳性杰),서영석(徐暎錫),49,4,53,1
20641,류성걸(柳性杰),서일준(徐一俊),84,90,174,0
20642,류성걸(柳性杰),서정숙(徐正淑),69,54,123,0
20643,류성걸(柳性杰),설훈(薛勳),49,4,53,1
20644,류성걸(柳性杰),성일종(成一鍾),87,85,172,0
20645,류성걸(柳性杰),소병철(蘇秉哲),50,4,54,1
20646,류성걸(柳性杰),소병훈(蘇秉勳),49,4,53,1
20647,류성걸(柳性杰),송갑석(宋甲錫),49,4,53,1
20648,류성걸(柳性杰),송기헌(宋基憲),50,4,54,1
20649,류성걸(柳性杰),송석준(宋錫俊),70,58,128,0
20650,류성걸(柳性杰),송언석(宋彦錫),75,64,139,0
20651,류성걸(柳性杰),송옥주(宋玉珠),49,3,52,1
20652,류성걸(柳性杰),송재호(宋在祜),49,5,54,1
20653,류성걸(柳性杰),신동근(申東根),49,3,52,1
20654,류성걸(柳性杰),신영대(申榮大),49,4,53,1
20655,류성걸(柳性杰),신원식(申源湜),69,52,121,0
20656,류성걸(柳性杰),신정훈(辛正勳),50,4,54,1
20657,류성걸(柳性杰),신현영(申賢榮),49,4,53,1
20658,류성걸(柳性杰),심상정(沈相奵),5,2,7,1
20659,류성걸(柳性杰),안규백(安圭伯),51,5,56,1
20660,류성걸(柳性杰),안민석(安敏錫),50,3,53,1
20661,류성걸(柳性杰),안병길(安炳吉),80,145,225,0
20662,류성걸(柳性杰),안철수(安哲秀),26,25,51,0
20663,류성걸(柳性杰),안호영(安浩永),49,4,53,1
20664,류성걸(柳性杰),양경숙(梁敬淑),49,5,54,1
20665,류성걸(柳性杰),양금희(梁琴喜),92,125,217,0
20666,류성걸(柳性杰),양기대(梁基大),49,4,53,1
20667,류성걸(柳性杰),양이원영(梁李媛瑛),45,4,49,1
20668,류성걸(柳性杰),양정숙(梁貞淑),1,2,3,1
20669,류성걸(柳性杰),양향자(梁香子),21,1,22,1
20670,류성걸(柳性杰),어기구(魚基龜),49,5,54,1
20671,류성걸(柳性杰),엄태영(嚴泰永),67,74,141,0
20672,류성걸(柳性杰),오기형(吳奇炯),49,4,53,1
20673,류성걸(柳性杰),오영환(吳永煥),50,5,55,1
20674,류성걸(柳性杰),용혜인(龍慧仁),1,4,5,1
20675,류성걸(柳性杰),우상호(禹相虎),49,4,53,1
20676,류성걸(柳性杰),우원식(禹元植),49,4,53,1
20677,류성걸(柳性杰),위성곤(魏聖坤),49,5,54,1
20678,류성걸(柳性杰),유경준(兪京濬),72,55,127,0
20679,류성걸(柳性杰),유기홍(柳基洪),49,4,53,1
20680,류성걸(柳性杰),유동수(柳東秀),49,4,53,1
20681,류성걸(柳性杰),유상범(劉相凡),65,42,107,0
20682,류성걸(柳性杰),유의동(兪義東),76,70,146,0
20683,류성걸(柳性杰),유정주(兪訂炷),49,4,53,1
20684,류성걸(柳性杰),윤건영(尹建永),49,3,52,1
20685,류성걸(柳性杰),윤관석(尹官石),40,1,41,1
20686,류성걸(柳性杰),윤두현(尹斗鉉),81,117,198,0
20687,류성걸(柳性杰),윤미향(尹美香),20,0,20,1
20688,류성걸(柳性杰),윤상현(尹相現),35,30,65,0
20689,류성걸(柳性杰),윤영덕(尹永德),49,5,54,1
20690,류성걸(柳性杰),윤영석(尹永碩),68,64,132,0
20691,류성걸(柳性杰),윤영찬(尹永燦),49,4,53,1
20692,류성걸(柳性杰),윤재갑(尹才鉀),51,5,56,1
20693,류성걸(柳性杰),윤재옥(尹在玉),79,58,137,0
20694,류성걸(柳性杰),윤주경(尹柱卿),70,59,129,0
20695,류성걸(柳性杰),윤준병(尹準炳),49,4,53,1
20696,류성걸(柳性杰),윤창현(尹暢賢),86,85,171,0
20697,류성걸(柳性杰),윤한홍(尹漢洪),63,47,110,0
20698,류성걸(柳性杰),윤호중(尹昊重),49,4,53,1
20699,류성걸(柳性杰),윤후덕(尹厚德),50,4,54,1
20700,류성걸(柳性杰),이개호(李介昊),49,4,53,1
20701,류성걸(柳性杰),이달곤(李達坤),63,50,113,0
20702,류성걸(柳性杰),이동주(李東洲),49,4,53,1
20703,류성걸(柳性杰),이만희(李晩熙),68,48,116,0
20704,류성걸(柳性杰),이명수(李明洙),80,126,206,0
20705,류성걸(柳性杰),이병훈(李炳勳),52,5,57,1
20706,류성걸(柳性杰),이상민(李相珉),49,4,53,1
20707,류성걸(柳性杰),이상헌(李相憲),50,4,54,1
20708,류성걸(柳性杰),이성만(李成萬),40,1,41,1
20709,류성걸(柳性杰),이소영(李素永),49,4,53,1
20710,류성걸(柳性杰),이수진(李壽珍),49,4,53,1
20711,류성걸(柳性杰),이수진(李秀眞),49,5,54,1
20712,류성걸(柳性杰),이양수(李亮壽),72,46,118,0
20713,류성걸(柳性杰),이용(李鏞),76,101,177,0
20714,류성걸(柳性杰),이용빈(李龍彬),50,5,55,1
20715,류성걸(柳性杰),이용선(李庸瑄),49,4,53,1
20716,류성걸(柳性杰),이용우(李龍雨),49,4,53,1
20717,류성걸(柳性杰),이용호(李容鎬),29,17,46,0
20718,류성걸(柳性杰),이원욱(李元旭),49,4,53,1
20719,류성걸(柳性杰),이원택(李源澤),49,4,53,1
20720,류성걸(柳性杰),이은주(李恩周),4,2,6,1
20721,류성걸(柳性杰),이인선(李仁善),35,38,73,0
20722,류성걸(柳性杰),이인영(李仁榮),49,4,53,1
20723,류성걸(柳性杰),이장섭(李將燮),49,4,53,1
20724,류성걸(柳性杰),이재명(李在明),25,4,29,1
20725,류성걸(柳性杰),이재정(李在汀),49,4,53,1
20726,류성걸(柳性杰),이정문(李楨文),49,4,53,1
20727,류성걸(柳性杰),이종배(李鍾培),90,92,182,0
20728,류성걸(柳性杰),이종성(李鍾成),78,97,175,0
20729,류성걸(柳性杰),이주환(李周桓),74,102,176,0
20730,류성걸(柳性杰),이채익(李埰益),70,70,140,0
20731,류성걸(柳性杰),이철규(李喆圭),73,71,144,0
20732,류성걸(柳性杰),이탄희(李誕熙),50,4,54,1
20733,류성걸(柳性杰),이태규(李泰珪),44,41,85,0
20734,류성걸(柳性杰),이학영(李學永),49,4,53,1
20735,류성걸(柳性杰),이해식(李海植),49,4,53,1
20736,류성걸(柳性杰),이헌승(李憲昇),64,119,183,0
20737,류성걸(柳性杰),이형석(李炯錫),49,4,53,1
20738,류성걸(柳性杰),인재근(印在謹),49,4,53,1
20739,류성걸(柳性杰),임병헌(林炳憲),32,33,65,0
20740,류성걸(柳性杰),임오경(林五卿),49,4,53,1
20741,류성걸(柳性杰),임이자(林利子),74,73,147,0
20742,류성걸(柳性杰),임종성(林鍾聲),50,4,54,1
20743,류성걸(柳性杰),임호선(林昊宣),50,5,55,1
20744,류성걸(柳性杰),장경태(張耿態),49,4,53,1
20745,류성걸(柳性杰),장동혁(張東赫),29,27,56,0
20746,류성걸(柳性杰),장제원(張濟元),61,36,97,0
20747,류성걸(柳性杰),장철민(張喆敏),49,4,53,1
20748,류성걸(柳性杰),장혜영(張惠英),6,7,13,1
20749,류성걸(柳性杰),전봉민(田奉珉),48,74,122,0
20750,류성걸(柳性杰),전용기(田溶冀),49,4,53,1
20751,류성걸(柳性杰),전재수(田載秀),49,4,53,1
20752,류성걸(柳性杰),전주혜(全珠惠),67,50,117,0
20753,류성걸(柳性杰),전해철(全海澈),49,4,53,1
20754,류성걸(柳性杰),전혜숙(全惠淑),49,6,55,1
20755,류성걸(柳性杰),정경희(丁慶姬),76,54,130,0
20756,류성걸(柳性杰),정동만(鄭東萬),67,80,147,0
20757,류성걸(柳性杰),정성호(鄭成湖),49,5,54,1
20758,류성걸(柳性杰),정우택(鄭宇澤),32,49,81,0
20759,류성걸(柳性杰),정운천(鄭雲天),84,93,177,0
20760,류성걸(柳性杰),정일영(鄭日永),50,6,56,1
20761,류성걸(柳性杰),정점식(鄭点植),65,49,114,0
20762,류성걸(柳性杰),정진석(鄭鎭碩),80,70,150,0
20763,류성걸(柳性杰),정청래(鄭淸來),50,4,54,1
20764,류성걸(柳性杰),정춘숙(鄭春淑),50,4,54,1
20765,류성걸(柳性杰),정태호(鄭泰浩),49,4,53,1
20766,류성걸(柳性杰),정필모(鄭必模),49,4,53,1
20767,류성걸(柳性杰),정희용(鄭熙溶),86,118,204,0
20768,류성걸(柳性杰),조경태(趙慶泰),74,78,152,0
20769,류성걸(柳性杰),조명희(曺明姬),74,74,148,0
20770,류성걸(柳性杰),조수진(趙修眞),71,59,130,0
20771,류성걸(柳性杰),조승래(趙承來),49,3,52,1
20772,류성걸(柳性杰),조오섭(曺五燮),51,5,56,1
20773,류성걸(柳性杰),조은희(趙恩禧),38,40,78,0
20774,류성걸(柳性杰),조응천(趙應天),49,3,52,1
20775,류성걸(柳性杰),조정식(趙正湜),49,3,52,1
20776,류성걸(柳性杰),조정훈(趙廷訓),1,2,3,1
20777,류성걸(柳性杰),조해진(曺海珍),65,36,101,0
20778,류성걸(柳性杰),주철현(朱哲鉉),50,4,54,1
20779,류성걸(柳性杰),주호영(朱豪英),83,104,187,0
20780,류성걸(柳性杰),지성호(池成浩),68,71,139,0
20781,류성걸(柳性杰),진선미(陳善美),49,4,53,1
20782,류성걸(柳性杰),진성준(陳聲準),49,4,53,1
20783,류성걸(柳性杰),천준호(千俊鎬),49,3,52,1
20784,류성걸(柳性杰),최기상(崔基相),49,4,53,1
20785,류성걸(柳性杰),최승재(崔承宰),79,64,143,0
20786,류성걸(柳性杰),최연숙(崔姸淑),38,44,82,0
20787,류성걸(柳性杰),최영희(崔英姬),27,37,64,0
20788,류성걸(柳性杰),최인호(崔仁昊),49,4,53,1
20789,류성걸(柳性杰),최재형(崔在亨),27,10,37,0
20790,류성걸(柳性杰),최종윤(崔鍾允),49,4,53,1
20791,류성걸(柳性杰),최춘식(崔春植),75,94,169,0
20792,류성걸(柳性杰),최형두(崔炯斗),73,62,135,0
20793,류성걸(柳性杰),최혜영(崔惠英),50,7,57,1
20794,류성걸(柳性杰),추경호(秋慶鎬),95,92,187,0
20795,류성걸(柳性杰),태영호(太永浩),75,102,177,0
20796,류성걸(柳性杰),하영제(河榮帝),64,58,122,1
20797,류성걸(柳性杰),하태경(河泰慶),65,49,114,0
20798,류성걸(柳性杰),한기호(韓起鎬),66,47,113,0
20799,류성걸(柳性杰),한무경(韓茂景),74,76,150,0
20800,류성걸(柳性杰),한병도(韓秉道),50,4,54,1
20801,류성걸(柳性杰),한정애(韓貞愛),49,5,54,1
20802,류성걸(柳性杰),한준호(韓俊鎬),49,4,53,1
20803,류성걸(柳性杰),허숙정(許淑湞),0,0,0,1
20804,류성걸(柳性杰),허영(許榮),50,4,54,1
20805,류성걸(柳性杰),허은아(許垠娥),71,54,125,0
20806,류성걸(柳性杰),허종식(許琮植),49,5,54,1
20807,류성걸(柳性杰),홍기원(洪起元),49,4,53,1
20808,류성걸(柳性杰),홍문표(洪文杓),68,84,152,0
20809,류성걸(柳性杰),홍석준(洪碩晙),85,79,164,0
20810,류성걸(柳性杰),홍성국(洪性國),49,6,55,1
20811,류성걸(柳性杰),홍영표(洪永杓),49,4,53,1
20812,류성걸(柳性杰),홍익표(洪翼杓),49,4,53,1
20813,류성걸(柳性杰),홍정민(洪貞敏),50,5,55,1
20814,류성걸(柳性杰),황보승희(皇甫承希),68,63,131,1
20815,류성걸(柳性杰),황운하(黃雲夏),49,5,54,1
20816,류성걸(柳性杰),황희(黃熙),49,4,53,1
20817,류호정(柳好貞),맹성규(孟聖奎),19,38,57,1
20818,류호정(柳好貞),문정복(文貞福),23,28,51,1
20819,류호정(柳好貞),문진석(文振碩),21,22,43,1
20820,류호정(柳好貞),민병덕(閔炳德),25,80,105,1
20821,류호정(柳好貞),민형배(閔馨培),29,73,102,1
20822,류호정(柳好貞),민홍철(閔洪喆),17,22,39,1
20823,류호정(柳好貞),박광온(朴洸瑥),14,16,30,1
20824,류호정(柳好貞),박대수(朴大壽),7,12,19,1
20825,류호정(柳好貞),박대출(朴大出),4,2,6,1
20826,류호정(柳好貞),박덕흠(朴德欽),4,17,21,1
20827,류호정(柳好貞),박범계(朴範界),9,8,17,1
20828,류호정(柳好貞),박병석(朴炳錫),6,5,11,1
20829,류호정(柳好貞),박상혁(朴商赫),17,34,51,1
20830,류호정(柳好貞),박성민(朴聖敏),4,5,9,1
20831,류호정(柳好貞),박성준(朴省俊),28,63,91,1
20832,류호정(柳好貞),박성중(朴成重),4,2,6,1
20833,류호정(柳好貞),박수영(朴洙瑩),4,13,17,1
20834,류호정(柳好貞),박영순(朴英淳),30,55,85,1
20835,류호정(柳好貞),박완주(朴完柱),15,20,35,1
20836,류호정(柳好貞),박용진(朴用鎭),11,40,51,1
20837,류호정(柳好貞),박재호(朴在昊),13,17,30,1
20838,류호정(柳好貞),박정(朴釘),20,36,56,1
20839,류호정(柳好貞),박정하(朴正河),0,3,3,1
20840,류호정(柳好貞),박주민(朴柱民),25,78,103,1
20841,류호정(柳好貞),박진(朴振),4,3,7,1
20842,류호정(柳好貞),박찬대(朴贊大),14,25,39,1
20843,류호정(柳好貞),박형수(朴亨修),4,2,6,1
20844,류호정(柳好貞),박홍근(朴洪根),25,52,77,1
20845,류호정(柳好貞),배준영(裵俊英),4,5,9,1
20846,류호정(柳好貞),배진교(裵晋敎),89,356,445,0
20847,류호정(柳好貞),배현진(裵賢鎭),5,4,9,1
20848,류호정(柳好貞),백종헌(白宗憲),4,10,14,1
20849,류호정(柳好貞),백혜련(白惠蓮),19,33,52,1
20850,류호정(柳好貞),변재일(卞在一),11,11,22,1
20851,류호정(柳好貞),서동용(徐東榕),20,39,59,1
20852,류호정(柳好貞),서범수(徐範洙),5,4,9,1
20853,류호정(柳好貞),서병수(徐秉洙),5,6,11,1
20854,류호정(柳好貞),서삼석(徐參錫),19,17,36,1
20855,류호정(柳好貞),서영교(徐瑛敎),23,61,84,1
20856,류호정(柳好貞),서영석(徐暎錫),20,52,72,1
20857,류호정(柳好貞),서일준(徐一俊),5,9,14,1
20858,류호정(柳好貞),서정숙(徐正淑),8,8,16,1
20859,류호정(柳好貞),설훈(薛勳),15,19,34,1
20860,류호정(柳好貞),성일종(成一鍾),6,15,21,1
20861,류호정(柳好貞),소병철(蘇秉哲),15,20,35,1
20862,류호정(柳好貞),소병훈(蘇秉勳),17,38,55,1
20863,류호정(柳好貞),송갑석(宋甲錫),15,31,46,1
20864,류호정(柳好貞),송기헌(宋基憲),16,15,31,1
20865,류호정(柳好貞),송석준(宋錫俊),5,3,8,1
20866,류호정(柳好貞),송언석(宋彦錫),3,1,4,1
20867,류호정(柳好貞),송옥주(宋玉珠),17,53,70,1
20868,류호정(柳好貞),송재호(宋在祜),25,67,92,1
20869,류호정(柳好貞),신동근(申東根),13,17,30,1
20870,류호정(柳好貞),신영대(申榮大),11,21,32,1
20871,류호정(柳好貞),신원식(申源湜),5,3,8,1
20872,류호정(柳好貞),신정훈(辛正勳),29,56,85,1
20873,류호정(柳好貞),신현영(申賢榮),17,13,30,1
20874,류호정(柳好貞),심상정(沈相奵),83,349,432,0
20875,류호정(柳好貞),안규백(安圭伯),21,28,49,1
20876,류호정(柳好貞),안민석(安敏錫),18,28,46,1
20877,류호정(柳好貞),안병길(安炳吉),4,3,7,1
20878,류호정(柳好貞),안철수(安哲秀),1,2,3,1
20879,류호정(柳好貞),안호영(安浩永),17,41,58,1
20880,류호정(柳好貞),양경숙(梁敬淑),25,61,86,1
20881,류호정(柳好貞),양금희(梁琴喜),5,12,17,1
20882,류호정(柳好貞),양기대(梁基大),18,17,35,1
20883,류호정(柳好貞),양이원영(梁李媛瑛),28,69,97,1
20884,류호정(柳好貞),양정숙(梁貞淑),62,232,294,1
20885,류호정(柳好貞),양향자(梁香子),13,25,38,1
20886,류호정(柳好貞),어기구(魚基龜),15,20,35,1
20887,류호정(柳好貞),엄태영(嚴泰永),5,9,14,1
20888,류호정(柳好貞),오기형(吳奇炯),11,13,24,1
20889,류호정(柳好貞),오영환(吳永煥),47,120,167,1
20890,류호정(柳好貞),용혜인(龍慧仁),46,205,251,1
20891,류호정(柳好貞),우상호(禹相虎),10,7,17,1
20892,류호정(柳好貞),우원식(禹元植),15,35,50,1
20893,류호정(柳好貞),위성곤(魏聖坤),18,51,69,1
20894,류호정(柳好貞),유경준(兪京濬),6,8,14,1
20895,류호정(柳好貞),유기홍(柳基洪),13,22,35,1
20896,류호정(柳好貞),유동수(柳東秀),16,16,32,1
20897,류호정(柳好貞),유상범(劉相凡),6,2,8,1
20898,류호정(柳好貞),유의동(兪義東),6,4,10,1
20899,류호정(柳好貞),유정주(兪訂炷),29,93,122,1
20900,류호정(柳好貞),윤건영(尹建永),15,34,49,1
20901,류호정(柳好貞),윤관석(尹官石),14,31,45,1
20902,류호정(柳好貞),윤두현(尹斗鉉),5,8,13,1
20903,류호정(柳好貞),윤미향(尹美香),31,139,170,1
20904,류호정(柳好貞),윤상현(尹相現),0,5,5,1
20905,류호정(柳好貞),윤영덕(尹永德),24,70,94,1
20906,류호정(柳好貞),윤영석(尹永碩),4,3,7,1
20907,류호정(柳好貞),윤영찬(尹永燦),11,17,28,1
20908,류호정(柳好貞),윤재갑(尹才鉀),37,68,105,1
20909,류호정(柳好貞),윤재옥(尹在玉),5,3,8,1
20910,류호정(柳好貞),윤주경(尹柱卿),4,13,17,1
20911,류호정(柳好貞),윤준병(尹準炳),20,72,92,1
20912,류호정(柳好貞),윤창현(尹暢賢),5,10,15,1
20913,류호정(柳好貞),윤한홍(尹漢洪),4,3,7,1
20914,류호정(柳好貞),윤호중(尹昊重),12,13,25,1
20915,류호정(柳好貞),윤후덕(尹厚德),14,31,45,1
20916,류호정(柳好貞),이개호(李介昊),13,22,35,1
20917,류호정(柳好貞),이달곤(李達坤),6,4,10,1
20918,류호정(柳好貞),이동주(李東洲),20,42,62,1
20919,류호정(柳好貞),이만희(李晩熙),6,3,9,1
20920,류호정(柳好貞),이명수(李明洙),6,26,32,1
20921,류호정(柳好貞),이병훈(李炳勳),20,38,58,1
20922,류호정(柳好貞),이상민(李相珉),16,22,38,1
20923,류호정(柳好貞),이상헌(李相憲),29,61,90,1
20924,류호정(柳好貞),이성만(李成萬),27,77,104,1
20925,류호정(柳好貞),이소영(李素永),20,28,48,1
20926,류호정(柳好貞),이수진(李壽珍),48,218,266,1
20927,류호정(柳好貞),이수진(李秀眞),23,44,67,1
20928,류호정(柳好貞),이양수(李亮壽),4,8,12,1
20929,류호정(柳好貞),이용(李鏞),4,8,12,1
20930,류호정(柳好貞),이용빈(李龍彬),36,110,146,1
20931,류호정(柳好貞),이용선(李庸瑄),17,53,70,1
20932,류호정(柳好貞),이용우(李龍雨),24,28,52,1
20933,류호정(柳好貞),이용호(李容鎬),4,14,18,1
20934,류호정(柳好貞),이원욱(李元旭),14,22,36,1
20935,류호정(柳好貞),이원택(李源澤),20,26,46,1
20936,류호정(柳好貞),이은주(李恩周),92,368,460,0
20937,류호정(柳好貞),이인선(李仁善),0,3,3,1
20938,류호정(柳好貞),이인영(李仁榮),11,10,21,1
20939,류호정(柳好貞),이장섭(李將燮),14,20,34,1
20940,류호정(柳好貞),이재명(李在明),5,9,14,1
20941,류호정(柳好貞),이재정(李在汀),18,28,46,1
20942,류호정(柳好貞),이정문(李楨文),12,26,38,1
20943,류호정(柳好貞),이종배(李鍾培),6,7,13,1
20944,류호정(柳好貞),이종성(李鍾成),7,8,15,1
20945,류호정(柳好貞),이주환(李周桓),4,6,10,1
20946,류호정(柳好貞),이채익(李埰益),7,8,15,1
20947,류호정(柳好貞),이철규(李喆圭),4,6,10,1
20948,류호정(柳好貞),이탄희(李誕熙),22,76,98,1
20949,류호정(柳好貞),이태규(李泰珪),8,15,23,1
20950,류호정(柳好貞),이학영(李學永),17,28,45,1
20951,류호정(柳好貞),이해식(李海植),16,36,52,1
20952,류호정(柳好貞),이헌승(李憲昇),4,8,12,1
20953,류호정(柳好貞),이형석(李炯錫),24,46,70,1
20954,류호정(柳好貞),인재근(印在謹),18,56,74,1
20955,류호정(柳好貞),임병헌(林炳憲),0,2,2,1
20956,류호정(柳好貞),임오경(林五卿),13,25,38,1
20957,류호정(柳好貞),임이자(林利子),4,4,8,1
20958,류호정(柳好貞),임종성(林鍾聲),22,43,65,1
20959,류호정(柳好貞),임호선(林昊宣),21,47,68,1
20960,류호정(柳好貞),장경태(張耿態),30,83,113,1
20961,류호정(柳好貞),장동혁(張東赫),0,3,3,1
20962,류호정(柳好貞),장제원(張濟元),4,2,6,1
20963,류호정(柳好貞),장철민(張喆敏),17,48,65,1
20964,류호정(柳好貞),장혜영(張惠英),86,361,447,0
20965,류호정(柳好貞),전봉민(田奉珉),1,1,2,1
20966,류호정(柳好貞),전용기(田溶冀),19,44,63,1
20967,류호정(柳好貞),전재수(田載秀),12,19,31,1
20968,류호정(柳好貞),전주혜(全珠惠),5,10,15,1
20969,류호정(柳好貞),전해철(全海澈),13,19,32,1
20970,류호정(柳好貞),전혜숙(全惠淑),25,52,77,1
20971,류호정(柳好貞),정경희(丁慶姬),4,2,6,1
20972,류호정(柳好貞),정동만(鄭東萬),4,3,7,1
20973,류호정(柳好貞),정성호(鄭成湖),21,51,72,1
20974,류호정(柳好貞),정우택(鄭宇澤),0,0,0,1
20975,류호정(柳好貞),정운천(鄭雲天),6,8,14,1
20976,류호정(柳好貞),정일영(鄭日永),20,32,52,1
20977,류호정(柳好貞),정점식(鄭点植),4,5,9,1
20978,류호정(柳好貞),정진석(鄭鎭碩),5,9,14,1
20979,류호정(柳好貞),정청래(鄭淸來),16,19,35,1
20980,류호정(柳好貞),정춘숙(鄭春淑),16,51,67,1
20981,류호정(柳好貞),정태호(鄭泰浩),18,45,63,1
20982,류호정(柳好貞),정필모(鄭必模),18,25,43,1
20983,류호정(柳好貞),정희용(鄭熙溶),6,5,11,1
20984,류호정(柳好貞),조경태(趙慶泰),7,2,9,1
20985,류호정(柳好貞),조명희(曺明姬),7,6,13,1
20986,류호정(柳好貞),조수진(趙修眞),6,6,12,1
20987,류호정(柳好貞),조승래(趙承來),16,17,33,1
20988,류호정(柳好貞),조오섭(曺五燮),35,91,126,1
20989,류호정(柳好貞),조은희(趙恩禧),2,1,3,1
20990,류호정(柳好貞),조응천(趙應天),8,9,17,1
20991,류호정(柳好貞),조정식(趙正湜),10,9,19,1
20992,류호정(柳好貞),조정훈(趙廷訓),11,65,76,1
20993,류호정(柳好貞),조해진(曺海珍),5,6,11,1
20994,류호정(柳好貞),주철현(朱哲鉉),17,30,47,1
20995,류호정(柳好貞),주호영(朱豪英),4,3,7,1
20996,류호정(柳好貞),지성호(池成浩),5,9,14,1
20997,류호정(柳好貞),진선미(陳善美),17,17,34,1
20998,류호정(柳好貞),진성준(陳聲準),16,34,50,1
20999,류호정(柳好貞),천준호(千俊鎬),19,36,55,1
21000,류호정(柳好貞),최기상(崔基相),13,29,42,1
21001,류호정(柳好貞),최승재(崔承宰),7,16,23,1
21002,류호정(柳好貞),최연숙(崔姸淑),14,32,46,1
21003,류호정(柳好貞),최영희(崔英姬),0,0,0,1
21004,류호정(柳好貞),최인호(崔仁昊),10,17,27,1
21005,류호정(柳好貞),최재형(崔在亨),0,0,0,1
21006,류호정(柳好貞),최종윤(崔鍾允),22,40,62,1
21007,류호정(柳好貞),최춘식(崔春植),6,12,18,1
21008,류호정(柳好貞),최형두(崔炯斗),5,8,13,1
21009,류호정(柳好貞),최혜영(崔惠英),40,120,160,1
21010,류호정(柳好貞),추경호(秋慶鎬),4,5,9,1
21011,류호정(柳好貞),태영호(太永浩),5,22,27,1
21012,류호정(柳好貞),하영제(河榮帝),5,3,8,1
21013,류호정(柳好貞),하태경(河泰慶),6,14,20,1
21014,류호정(柳好貞),한기호(韓起鎬),4,3,7,1
21015,류호정(柳好貞),한무경(韓茂景),5,8,13,1
21016,류호정(柳好貞),한병도(韓秉道),17,26,43,1
21017,류호정(柳好貞),한정애(韓貞愛),12,17,29,1
21018,류호정(柳好貞),한준호(韓俊鎬),16,33,49,1
21019,류호정(柳好貞),허숙정(許淑湞),1,1,2,1
21020,류호정(柳好貞),허영(許榮),23,31,54,1
21021,류호정(柳好貞),허은아(許垠娥),6,5,11,1
21022,류호정(柳好貞),허종식(許琮植),26,67,93,1
21023,류호정(柳好貞),홍기원(洪起元),20,26,46,1
21024,류호정(柳好貞),홍문표(洪文杓),4,5,9,1
21025,류호정(柳好貞),홍석준(洪碩晙),5,6,11,1
21026,류호정(柳好貞),홍성국(洪性國),21,32,53,1
21027,류호정(柳好貞),홍영표(洪永杓),18,19,37,1
21028,류호정(柳好貞),홍익표(洪翼杓),14,26,40,1
21029,류호정(柳好貞),홍정민(洪貞敏),21,39,60,1
21030,류호정(柳好貞),황보승희(皇甫承希),7,8,15,1
21031,류호정(柳好貞),황운하(黃雲夏),25,42,67,1
21032,류호정(柳好貞),황희(黃熙),11,9,20,1
21033,맹성규(孟聖奎),문정복(文貞福),96,56,152,0
21034,맹성규(孟聖奎),문진석(文振碩),94,62,156,0
21035,맹성규(孟聖奎),민병덕(閔炳德),106,89,195,0
21036,맹성규(孟聖奎),민형배(閔馨培),73,80,153,0
21037,맹성규(孟聖奎),민홍철(閔洪喆),86,69,155,0
21038,맹성규(孟聖奎),박광온(朴洸瑥),84,53,137,0
21039,맹성규(孟聖奎),박대수(朴大壽),50,6,56,1
21040,맹성규(孟聖奎),박대출(朴大出),50,4,54,1
21041,맹성규(孟聖奎),박덕흠(朴德欽),36,7,43,1
21042,맹성규(孟聖奎),박범계(朴範界),79,32,111,0
21043,맹성규(孟聖奎),박병석(朴炳錫),40,17,57,0
21044,맹성규(孟聖奎),박상혁(朴商赫),100,95,195,0
21045,맹성규(孟聖奎),박성민(朴聖敏),49,6,55,1
21046,맹성규(孟聖奎),박성준(朴省俊),143,156,299,0
21047,맹성규(孟聖奎),박성중(朴成重),49,4,53,1
21048,맹성규(孟聖奎),박수영(朴洙瑩),50,8,58,1
21049,맹성규(孟聖奎),박영순(朴英淳),109,91,200,0
21050,맹성규(孟聖奎),박완주(朴完柱),51,44,95,1
21051,맹성규(孟聖奎),박용진(朴用鎭),82,42,124,0
21052,맹성규(孟聖奎),박재호(朴在昊),86,55,141,0
21053,맹성규(孟聖奎),박정(朴釘),111,106,217,0
21054,맹성규(孟聖奎),박정하(朴正河),25,4,29,1
21055,맹성규(孟聖奎),박주민(朴柱民),82,52,134,0
21056,맹성규(孟聖奎),박진(朴振),50,5,55,1
21057,맹성규(孟聖奎),박찬대(朴贊大),101,91,192,0
21058,맹성규(孟聖奎),박형수(朴亨修),49,4,53,1
21059,맹성규(孟聖奎),박홍근(朴洪根),125,102,227,0
21060,맹성규(孟聖奎),배준영(裵俊英),51,5,56,1
21061,맹성규(孟聖奎),배진교(裵晋敎),21,40,61,1
21062,맹성규(孟聖奎),배현진(裵賢鎭),49,5,54,1
21063,맹성규(孟聖奎),백종헌(白宗憲),50,4,54,1
21064,맹성규(孟聖奎),백혜련(白惠蓮),96,78,174,0
21065,맹성규(孟聖奎),변재일(卞在一),81,49,130,0
21066,맹성규(孟聖奎),서동용(徐東榕),111,80,191,0
21067,맹성규(孟聖奎),서범수(徐範洙),51,6,57,1
21068,맹성규(孟聖奎),서병수(徐秉洙),50,7,57,1
21069,맹성규(孟聖奎),서삼석(徐參錫),93,65,158,0
21070,맹성규(孟聖奎),서영교(徐瑛敎),102,96,198,0
21071,맹성규(孟聖奎),서영석(徐暎錫),106,76,182,0
21072,맹성규(孟聖奎),서일준(徐一俊),51,6,57,1
21073,맹성규(孟聖奎),서정숙(徐正淑),49,5,54,1
21074,맹성규(孟聖奎),설훈(薛勳),83,52,135,0
21075,맹성규(孟聖奎),성일종(成一鍾),50,6,56,1
21076,맹성규(孟聖奎),소병철(蘇秉哲),92,66,158,0
21077,맹성규(孟聖奎),소병훈(蘇秉勳),97,81,178,0
21078,맹성규(孟聖奎),송갑석(宋甲錫),100,75,175,0
21079,맹성규(孟聖奎),송기헌(宋基憲),82,54,136,0
21080,맹성규(孟聖奎),송석준(宋錫俊),49,4,53,1
21081,맹성규(孟聖奎),송언석(宋彦錫),45,4,49,1
21082,맹성규(孟聖奎),송옥주(宋玉珠),116,102,218,0
21083,맹성규(孟聖奎),송재호(宋在祜),118,111,229,0
21084,맹성규(孟聖奎),신동근(申東根),108,84,192,0
21085,맹성규(孟聖奎),신영대(申榮大),81,60,141,0
21086,맹성규(孟聖奎),신원식(申源湜),49,4,53,1
21087,맹성규(孟聖奎),신정훈(辛正勳),115,111,226,0
21088,맹성규(孟聖奎),신현영(申賢榮),82,45,127,0
21089,맹성규(孟聖奎),심상정(沈相奵),12,34,46,1
21090,맹성규(孟聖奎),안규백(安圭伯),130,100,230,0
21091,맹성규(孟聖奎),안민석(安敏錫),81,57,138,0
21092,맹성규(孟聖奎),안병길(安炳吉),51,5,56,1
21093,맹성규(孟聖奎),안철수(安哲秀),25,4,29,1
21094,맹성규(孟聖奎),안호영(安浩永),95,62,157,0
21095,맹성규(孟聖奎),양경숙(梁敬淑),103,81,184,0
21096,맹성규(孟聖奎),양금희(梁琴喜),50,5,55,1
21097,맹성규(孟聖奎),양기대(梁基大),90,59,149,0
21098,맹성규(孟聖奎),양이원영(梁李媛瑛),117,73,190,0
21099,맹성규(孟聖奎),양정숙(梁貞淑),85,156,241,1
21100,맹성규(孟聖奎),양향자(梁香子),40,35,75,1
21101,맹성규(孟聖奎),어기구(魚基龜),83,50,133,0
21102,맹성규(孟聖奎),엄태영(嚴泰永),50,4,54,1
21103,맹성규(孟聖奎),오기형(吳奇炯),80,46,126,0
21104,맹성규(孟聖奎),오영환(吳永煥),131,147,278,0
21105,맹성규(孟聖奎),용혜인(龍慧仁),22,33,55,1
21106,맹성규(孟聖奎),우상호(禹相虎),78,41,119,0
21107,맹성규(孟聖奎),우원식(禹元植),86,67,153,0
21108,맹성규(孟聖奎),위성곤(魏聖坤),100,86,186,0
21109,맹성규(孟聖奎),유경준(兪京濬),49,4,53,1
21110,맹성규(孟聖奎),유기홍(柳基洪),78,59,137,0
21111,맹성규(孟聖奎),유동수(柳東秀),106,82,188,0
21112,맹성규(孟聖奎),유상범(劉相凡),50,4,54,1
21113,맹성규(孟聖奎),유의동(兪義東),50,4,54,1
21114,맹성규(孟聖奎),유정주(兪訂炷),103,81,184,0
21115,맹성규(孟聖奎),윤건영(尹建永),85,76,161,0
21116,맹성규(孟聖奎),윤관석(尹官石),101,79,180,1
21117,맹성규(孟聖奎),윤두현(尹斗鉉),49,6,55,1
21118,맹성규(孟聖奎),윤미향(尹美香),73,79,152,1
21119,맹성규(孟聖奎),윤상현(尹相現),31,5,36,1
21120,맹성규(孟聖奎),윤영덕(尹永德),91,72,163,0
21121,맹성규(孟聖奎),윤영석(尹永碩),50,5,55,1
21122,맹성규(孟聖奎),윤영찬(尹永燦),88,65,153,0
21123,맹성규(孟聖奎),윤재갑(尹才鉀),113,113,226,0
21124,맹성규(孟聖奎),윤재옥(尹在玉),50,4,54,1
21125,맹성규(孟聖奎),윤주경(尹柱卿),49,5,54,1
21126,맹성규(孟聖奎),윤준병(尹準炳),113,109,222,0
21127,맹성규(孟聖奎),윤창현(尹暢賢),49,5,54,1
21128,맹성규(孟聖奎),윤한홍(尹漢洪),50,4,54,1
21129,맹성규(孟聖奎),윤호중(尹昊重),78,60,138,0
21130,맹성규(孟聖奎),윤후덕(尹厚德),95,64,159,0
21131,맹성규(孟聖奎),이개호(李介昊),91,67,158,0
21132,맹성규(孟聖奎),이달곤(李達坤),51,6,57,1
21133,맹성규(孟聖奎),이동주(李東洲),108,99,207,0
21134,맹성규(孟聖奎),이만희(李晩熙),50,4,54,1
21135,맹성규(孟聖奎),이명수(李明洙),62,11,73,1
21136,맹성규(孟聖奎),이병훈(李炳勳),100,80,180,0
21137,맹성규(孟聖奎),이상민(李相珉),79,41,120,0
21138,맹성규(孟聖奎),이상헌(李相憲),105,84,189,0
21139,맹성규(孟聖奎),이성만(李成萬),127,117,244,1
21140,맹성규(孟聖奎),이소영(李素永),86,59,145,0
21141,맹성규(孟聖奎),이수진(李壽珍),126,125,251,0
21142,맹성규(孟聖奎),이수진(李秀眞),108,81,189,0
21143,맹성규(孟聖奎),이양수(李亮壽),51,8,59,1
21144,맹성규(孟聖奎),이용(李鏞),49,4,53,1
21145,맹성규(孟聖奎),이용빈(李龍彬),122,108,230,0
21146,맹성규(孟聖奎),이용선(李庸瑄),95,80,175,0
21147,맹성규(孟聖奎),이용우(李龍雨),94,66,160,0
21148,맹성규(孟聖奎),이용호(李容鎬),36,15,51,1
21149,맹성규(孟聖奎),이원욱(李元旭),90,68,158,0
21150,맹성규(孟聖奎),이원택(李源澤),105,82,187,0
21151,맹성규(孟聖奎),이은주(李恩周),26,34,60,1
21152,맹성규(孟聖奎),이인선(李仁善),25,4,29,1
21153,맹성규(孟聖奎),이인영(李仁榮),80,42,122,0
21154,맹성규(孟聖奎),이장섭(李將燮),91,63,154,0
21155,맹성규(孟聖奎),이재명(李在明),40,20,60,0
21156,맹성규(孟聖奎),이재정(李在汀),91,57,148,0
21157,맹성규(孟聖奎),이정문(李楨文),92,71,163,0
21158,맹성규(孟聖奎),이종배(李鍾培),50,8,58,1
21159,맹성규(孟聖奎),이종성(李鍾成),49,6,55,1
21160,맹성규(孟聖奎),이주환(李周桓),49,5,54,1
21161,맹성규(孟聖奎),이채익(李埰益),52,6,58,1
21162,맹성규(孟聖奎),이철규(李喆圭),52,5,57,1
21163,맹성규(孟聖奎),이탄희(李誕熙),106,69,175,0
21164,맹성규(孟聖奎),이태규(李泰珪),30,5,35,1
21165,맹성규(孟聖奎),이학영(李學永),94,88,182,0
21166,맹성규(孟聖奎),이해식(李海植),98,84,182,0
21167,맹성규(孟聖奎),이헌승(李憲昇),50,7,57,1
21168,맹성규(孟聖奎),이형석(李炯錫),99,73,172,0
21169,맹성규(孟聖奎),인재근(印在謹),108,84,192,0
21170,맹성규(孟聖奎),임병헌(林炳憲),25,5,30,1
21171,맹성규(孟聖奎),임오경(林五卿),89,53,142,0
21172,맹성규(孟聖奎),임이자(林利子),49,4,53,1
21173,맹성규(孟聖奎),임종성(林鍾聲),104,91,195,0
21174,맹성규(孟聖奎),임호선(林昊宣),105,100,205,0
21175,맹성규(孟聖奎),장경태(張耿態),94,68,162,0
21176,맹성규(孟聖奎),장동혁(張東赫),25,4,29,1
21177,맹성규(孟聖奎),장제원(張濟元),49,5,54,1
21178,맹성규(孟聖奎),장철민(張喆敏),101,89,190,0
21179,맹성규(孟聖奎),장혜영(張惠英),15,20,35,1
21180,맹성규(孟聖奎),전봉민(田奉珉),35,6,41,1
21181,맹성규(孟聖奎),전용기(田溶冀),82,66,148,0
21182,맹성규(孟聖奎),전재수(田載秀),85,63,148,0
21183,맹성규(孟聖奎),전주혜(全珠惠),51,5,56,1
21184,맹성규(孟聖奎),전해철(全海澈),79,75,154,0
21185,맹성규(孟聖奎),전혜숙(全惠淑),112,102,214,0
21186,맹성규(孟聖奎),정경희(丁慶姬),49,4,53,1
21187,맹성규(孟聖奎),정동만(鄭東萬),49,5,54,1
21188,맹성규(孟聖奎),정성호(鄭成湖),89,74,163,0
21189,맹성규(孟聖奎),정우택(鄭宇澤),25,4,29,1
21190,맹성규(孟聖奎),정운천(鄭雲天),50,6,56,1
21191,맹성규(孟聖奎),정일영(鄭日永),129,106,235,0
21192,맹성규(孟聖奎),정점식(鄭点植),50,5,55,1
21193,맹성규(孟聖奎),정진석(鄭鎭碩),50,5,55,1
21194,맹성규(孟聖奎),정청래(鄭淸來),94,65,159,0
21195,맹성규(孟聖奎),정춘숙(鄭春淑),92,75,167,0
21196,맹성규(孟聖奎),정태호(鄭泰浩),87,62,149,0
21197,맹성규(孟聖奎),정필모(鄭必模),90,62,152,0
21198,맹성규(孟聖奎),정희용(鄭熙溶),50,6,56,1
21199,맹성규(孟聖奎),조경태(趙慶泰),49,4,53,1
21200,맹성규(孟聖奎),조명희(曺明姬),49,8,57,1
21201,맹성규(孟聖奎),조수진(趙修眞),49,4,53,1
21202,맹성규(孟聖奎),조승래(趙承來),103,68,171,0
21203,맹성규(孟聖奎),조오섭(曺五燮),100,118,218,0
21204,맹성규(孟聖奎),조은희(趙恩禧),25,5,30,1
21205,맹성규(孟聖奎),조응천(趙應天),78,45,123,0
21206,맹성규(孟聖奎),조정식(趙正湜),89,31,120,0
21207,맹성규(孟聖奎),조정훈(趙廷訓),7,6,13,1
21208,맹성규(孟聖奎),조해진(曺海珍),51,6,57,1
21209,맹성규(孟聖奎),주철현(朱哲鉉),94,86,180,0
21210,맹성규(孟聖奎),주호영(朱豪英),50,4,54,1
21211,맹성규(孟聖奎),지성호(池成浩),49,5,54,1
21212,맹성규(孟聖奎),진선미(陳善美),86,45,131,0
21213,맹성규(孟聖奎),진성준(陳聲準),90,66,156,0
21214,맹성규(孟聖奎),천준호(千俊鎬),90,60,150,0
21215,맹성규(孟聖奎),최기상(崔基相),83,52,135,0
21216,맹성규(孟聖奎),최승재(崔承宰),49,5,54,1
21217,맹성규(孟聖奎),최연숙(崔姸淑),29,13,42,1
21218,맹성규(孟聖奎),최영희(崔英姬),25,5,30,1
21219,맹성규(孟聖奎),최인호(崔仁昊),103,100,203,0
21220,맹성규(孟聖奎),최재형(崔在亨),25,4,29,1
21221,맹성규(孟聖奎),최종윤(崔鍾允),125,107,232,0
21222,맹성규(孟聖奎),최춘식(崔春植),49,5,54,1
21223,맹성규(孟聖奎),최형두(崔炯斗),50,5,55,1
21224,맹성규(孟聖奎),최혜영(崔惠英),103,94,197,0
21225,맹성규(孟聖奎),추경호(秋慶鎬),49,3,52,1
21226,맹성규(孟聖奎),태영호(太永浩),49,7,56,1
21227,맹성규(孟聖奎),하영제(河榮帝),41,5,46,1
21228,맹성규(孟聖奎),하태경(河泰慶),51,8,59,1
21229,맹성규(孟聖奎),한기호(韓起鎬),50,4,54,1
21230,맹성규(孟聖奎),한무경(韓茂景),49,5,54,1
21231,맹성규(孟聖奎),한병도(韓秉道),109,79,188,0
21232,맹성규(孟聖奎),한정애(韓貞愛),86,52,138,0
21233,맹성규(孟聖奎),한준호(韓俊鎬),98,91,189,0
21234,맹성규(孟聖奎),허숙정(許淑湞),1,1,2,0
21235,맹성규(孟聖奎),허영(許榮),107,107,214,0
21236,맹성규(孟聖奎),허은아(許垠娥),49,6,55,1
21237,맹성규(孟聖奎),허종식(許琮植),124,142,266,0
21238,맹성규(孟聖奎),홍기원(洪起元),91,79,170,0
21239,맹성규(孟聖奎),홍문표(洪文杓),51,6,57,1
21240,맹성규(孟聖奎),홍석준(洪碩晙),50,5,55,1
21241,맹성규(孟聖奎),홍성국(洪性國),123,120,243,0
21242,맹성규(孟聖奎),홍영표(洪永杓),97,82,179,0
21243,맹성규(孟聖奎),홍익표(洪翼杓),91,63,154,0
21244,맹성규(孟聖奎),홍정민(洪貞敏),104,85,189,0
21245,맹성규(孟聖奎),황보승희(皇甫承希),47,2,49,1
21246,맹성규(孟聖奎),황운하(黃雲夏),127,130,257,0
21247,맹성규(孟聖奎),황희(黃熙),77,59,136,0
21248,문정복(文貞福),문진석(文振碩),117,80,197,0
21249,문정복(文貞福),민병덕(閔炳德),101,138,239,0
21250,문정복(文貞福),민형배(閔馨培),87,213,300,0
21251,문정복(文貞福),민홍철(閔洪喆),81,42,123,0
21252,문정복(文貞福),박광온(朴洸瑥),82,51,133,0
21253,문정복(文貞福),박대수(朴大壽),49,12,61,1
21254,문정복(文貞福),박대출(朴大出),49,4,53,1
21255,문정복(文貞福),박덕흠(朴德欽),35,7,42,1
21256,문정복(文貞福),박범계(朴範界),79,35,114,0
21257,문정복(文貞福),박병석(朴炳錫),40,15,55,0
21258,문정복(文貞福),박상혁(朴商赫),105,138,243,0
21259,문정복(文貞福),박성민(朴聖敏),51,5,56,1
21260,문정복(文貞福),박성준(朴省俊),110,96,206,0
21261,문정복(文貞福),박성중(朴成重),49,4,53,1
21262,문정복(文貞福),박수영(朴洙瑩),49,5,54,1
21263,문정복(文貞福),박영순(朴英淳),104,106,210,0
21264,문정복(文貞福),박완주(朴完柱),52,31,83,1
21265,문정복(文貞福),박용진(朴用鎭),77,42,119,0
21266,문정복(文貞福),박재호(朴在昊),85,45,130,0
21267,문정복(文貞福),박정(朴釘),103,70,173,0
21268,문정복(文貞福),박정하(朴正河),25,4,29,1
21269,문정복(文貞福),박주민(朴柱民),82,63,145,0
21270,문정복(文貞福),박진(朴振),51,3,54,1
21271,문정복(文貞福),박찬대(朴贊大),97,63,160,0
21272,문정복(文貞福),박형수(朴亨修),49,4,53,1
21273,문정복(文貞福),박홍근(朴洪根),112,87,199,0
21274,문정복(文貞福),배준영(裵俊英),49,8,57,1
21275,문정복(文貞福),배진교(裵晋敎),19,22,41,1
21276,문정복(文貞福),배현진(裵賢鎭),49,4,53,1
21277,문정복(文貞福),백종헌(白宗憲),49,4,53,1
21278,문정복(文貞福),백혜련(白惠蓮),95,58,153,0
21279,문정복(文貞福),변재일(卞在一),78,50,128,0
21280,문정복(文貞福),서동용(徐東榕),100,112,212,0
21281,문정복(文貞福),서범수(徐範洙),49,5,54,1
21282,문정복(文貞福),서병수(徐秉洙),49,5,54,1
21283,문정복(文貞福),서삼석(徐參錫),91,45,136,0
21284,문정복(文貞福),서영교(徐瑛敎),102,80,182,0
21285,문정복(文貞福),서영석(徐暎錫),100,84,184,0
21286,문정복(文貞福),서일준(徐一俊),49,8,57,1
21287,문정복(文貞福),서정숙(徐正淑),49,4,53,1
21288,문정복(文貞福),설훈(薛勳),80,45,125,0
21289,문정복(文貞福),성일종(成一鍾),49,6,55,1
21290,문정복(文貞福),소병철(蘇秉哲),86,49,135,0
21291,문정복(文貞福),소병훈(蘇秉勳),100,88,188,0
21292,문정복(文貞福),송갑석(宋甲錫),86,78,164,0
21293,문정복(文貞福),송기헌(宋基憲),77,37,114,0
21294,문정복(文貞福),송석준(宋錫俊),51,9,60,1
21295,문정복(文貞福),송언석(宋彦錫),47,4,51,1
21296,문정복(文貞福),송옥주(宋玉珠),88,63,151,0
21297,문정복(文貞福),송재호(宋在祜),88,82,170,0
21298,문정복(文貞福),신동근(申東根),91,57,148,0
21299,문정복(文貞福),신영대(申榮大),78,55,133,0
21300,문정복(文貞福),신원식(申源湜),49,4,53,1
21301,문정복(文貞福),신정훈(辛正勳),102,78,180,0
21302,문정복(文貞福),신현영(申賢榮),76,43,119,0
21303,문정복(文貞福),심상정(沈相奵),14,22,36,1
21304,문정복(文貞福),안규백(安圭伯),96,53,149,0
21305,문정복(文貞福),안민석(安敏錫),90,96,186,0
21306,문정복(文貞福),안병길(安炳吉),49,4,53,1
21307,문정복(文貞福),안철수(安哲秀),25,6,31,1
21308,문정복(文貞福),안호영(安浩永),80,66,146,0
21309,문정복(文貞福),양경숙(梁敬淑),83,65,148,0
21310,문정복(文貞福),양금희(梁琴喜),49,4,53,1
21311,문정복(文貞福),양기대(梁基大),84,63,147,0
21312,문정복(文貞福),양이원영(梁李媛瑛),96,86,182,0
21313,문정복(文貞福),양정숙(梁貞淑),42,108,150,1
21314,문정복(文貞福),양향자(梁香子),40,32,72,1
21315,문정복(文貞福),어기구(魚基龜),79,39,118,0
21316,문정복(文貞福),엄태영(嚴泰永),51,6,57,1
21317,문정복(文貞福),오기형(吳奇炯),82,42,124,0
21318,문정복(文貞福),오영환(吳永煥),127,137,264,0
21319,문정복(文貞福),용혜인(龍慧仁),12,34,46,1
21320,문정복(文貞福),우상호(禹相虎),80,34,114,0
21321,문정복(文貞福),우원식(禹元植),90,56,146,0
21322,문정복(文貞福),위성곤(魏聖坤),82,58,140,0
21323,문정복(文貞福),유경준(兪京濬),49,6,55,1
21324,문정복(文貞福),유기홍(柳基洪),89,62,151,0
21325,문정복(文貞福),유동수(柳東秀),93,51,144,0
21326,문정복(文貞福),유상범(劉相凡),49,5,54,1
21327,문정복(文貞福),유의동(兪義東),49,4,53,1
21328,문정복(文貞福),유정주(兪訂炷),97,88,185,0
21329,문정복(文貞福),윤건영(尹建永),86,68,154,0
21330,문정복(文貞福),윤관석(尹官石),84,53,137,1
21331,문정복(文貞福),윤두현(尹斗鉉),49,4,53,1
21332,문정복(文貞福),윤미향(尹美香),51,81,132,1
21333,문정복(文貞福),윤상현(尹相現),30,7,37,1
21334,문정복(文貞福),윤영덕(尹永德),95,128,223,0
21335,문정복(文貞福),윤영석(尹永碩),49,5,54,1
21336,문정복(文貞福),윤영찬(尹永燦),82,46,128,0
21337,문정복(文貞福),윤재갑(尹才鉀),103,67,170,0
21338,문정복(文貞福),윤재옥(尹在玉),49,4,53,1
21339,문정복(文貞福),윤주경(尹柱卿),49,5,54,1
21340,문정복(文貞福),윤준병(尹準炳),92,117,209,0
21341,문정복(文貞福),윤창현(尹暢賢),49,5,54,1
21342,문정복(文貞福),윤한홍(尹漢洪),49,4,53,1
21343,문정복(文貞福),윤호중(尹昊重),79,40,119,0
21344,문정복(文貞福),윤후덕(尹厚德),87,58,145,0
21345,문정복(文貞福),이개호(李介昊),83,47,130,0
21346,문정복(文貞福),이달곤(李達坤),50,4,54,1
21347,문정복(文貞福),이동주(李東洲),91,97,188,0
21348,문정복(文貞福),이만희(李晩熙),49,4,53,1
21349,문정복(文貞福),이명수(李明洙),49,9,58,1
21350,문정복(文貞福),이병훈(李炳勳),98,84,182,0
21351,문정복(文貞福),이상민(李相珉),77,32,109,0
21352,문정복(文貞福),이상헌(李相憲),88,50,138,0
21353,문정복(文貞福),이성만(李成萬),94,79,173,1
21354,문정복(文貞福),이소영(李素永),87,48,135,0
21355,문정복(文貞福),이수진(李壽珍),94,113,207,0
21356,문정복(文貞福),이수진(李秀眞),97,98,195,0
21357,문정복(文貞福),이양수(李亮壽),52,6,58,1
21358,문정복(文貞福),이용(李鏞),49,4,53,1
21359,문정복(文貞福),이용빈(李龍彬),97,101,198,0
21360,문정복(文貞福),이용선(李庸瑄),92,83,175,0
21361,문정복(文貞福),이용우(李龍雨),99,51,150,0
21362,문정복(文貞福),이용호(李容鎬),33,13,46,1
21363,문정복(文貞福),이원욱(李元旭),89,60,149,0
21364,문정복(文貞福),이원택(李源澤),83,65,148,0
21365,문정복(文貞福),이은주(李恩周),26,29,55,1
21366,문정복(文貞福),이인선(李仁善),25,4,29,1
21367,문정복(文貞福),이인영(李仁榮),75,36,111,0
21368,문정복(文貞福),이장섭(李將燮),85,54,139,0
21369,문정복(文貞福),이재명(李在明),39,20,59,0
21370,문정복(文貞福),이재정(李在汀),89,53,142,0
21371,문정복(文貞福),이정문(李楨文),92,84,176,0
21372,문정복(文貞福),이종배(李鍾培),51,9,60,1
21373,문정복(文貞福),이종성(李鍾成),49,6,55,1
21374,문정복(文貞福),이주환(李周桓),51,4,55,1
21375,문정복(文貞福),이채익(李埰益),49,5,54,1
21376,문정복(文貞福),이철규(李喆圭),50,4,54,1
21377,문정복(文貞福),이탄희(李誕熙),89,64,153,0
21378,문정복(文貞福),이태규(李泰珪),29,6,35,1
21379,문정복(文貞福),이학영(李學永),91,64,155,0
21380,문정복(文貞福),이해식(李海植),90,63,153,0
21381,문정복(文貞福),이헌승(李憲昇),52,5,57,1
21382,문정복(文貞福),이형석(李炯錫),96,53,149,0
21383,문정복(文貞福),인재근(印在謹),86,67,153,0
21384,문정복(文貞福),임병헌(林炳憲),25,4,29,1
21385,문정복(文貞福),임오경(林五卿),98,65,163,0
21386,문정복(文貞福),임이자(林利子),49,4,53,1
21387,문정복(文貞福),임종성(林鍾聲),99,97,196,0
21388,문정복(文貞福),임호선(林昊宣),98,93,191,0
21389,문정복(文貞福),장경태(張耿態),114,141,255,0
21390,문정복(文貞福),장동혁(張東赫),25,4,29,1
21391,문정복(文貞福),장제원(張濟元),49,4,53,1
21392,문정복(文貞福),장철민(張喆敏),89,67,156,0
21393,문정복(文貞福),장혜영(張惠英),14,17,31,1
21394,문정복(文貞福),전봉민(田奉珉),34,4,38,1
21395,문정복(文貞福),전용기(田溶冀),97,69,166,0
21396,문정복(文貞福),전재수(田載秀),84,45,129,0
21397,문정복(文貞福),전주혜(全珠惠),49,4,53,1
21398,문정복(文貞福),전해철(全海澈),76,44,120,0
21399,문정복(文貞福),전혜숙(全惠淑),88,60,148,0
21400,문정복(文貞福),정경희(丁慶姬),49,4,53,1
21401,문정복(文貞福),정동만(鄭東萬),51,5,56,1
21402,문정복(文貞福),정성호(鄭成湖),88,74,162,0
21403,문정복(文貞福),정우택(鄭宇澤),25,5,30,1
21404,문정복(文貞福),정운천(鄭雲天),49,4,53,1
21405,문정복(文貞福),정일영(鄭日永),93,67,160,0
21406,문정복(文貞福),정점식(鄭点植),49,4,53,1
21407,문정복(文貞福),정진석(鄭鎭碩),49,5,54,1
21408,문정복(文貞福),정청래(鄭淸來),91,55,146,0
21409,문정복(文貞福),정춘숙(鄭春淑),86,61,147,0
21410,문정복(文貞福),정태호(鄭泰浩),83,62,145,0
21411,문정복(文貞福),정필모(鄭必模),92,66,158,0
21412,문정복(文貞福),정희용(鄭熙溶),49,5,54,1
21413,문정복(文貞福),조경태(趙慶泰),49,5,54,1
21414,문정복(文貞福),조명희(曺明姬),49,5,54,1
21415,문정복(文貞福),조수진(趙修眞),49,4,53,1
21416,문정복(文貞福),조승래(趙承來),92,52,144,0
21417,문정복(文貞福),조오섭(曺五燮),103,133,236,0
21418,문정복(文貞福),조은희(趙恩禧),25,4,29,1
21419,문정복(文貞福),조응천(趙應天),90,34,124,0
21420,문정복(文貞福),조정식(趙正湜),75,59,134,0
21421,문정복(文貞福),조정훈(趙廷訓),1,5,6,1
21422,문정복(文貞福),조해진(曺海珍),50,4,54,1
21423,문정복(文貞福),주철현(朱哲鉉),89,63,152,0
21424,문정복(文貞福),주호영(朱豪英),49,4,53,1
21425,문정복(文貞福),지성호(池成浩),49,4,53,1
21426,문정복(文貞福),진선미(陳善美),91,44,135,0
21427,문정복(文貞福),진성준(陳聲準),113,66,179,0
21428,문정복(文貞福),천준호(千俊鎬),104,66,170,0
21429,문정복(文貞福),최기상(崔基相),84,43,127,0
21430,문정복(文貞福),최승재(崔承宰),49,4,53,1
21431,문정복(文貞福),최연숙(崔姸淑),30,10,40,1
21432,문정복(文貞福),최영희(崔英姬),25,4,29,1
21433,문정복(文貞福),최인호(崔仁昊),82,53,135,0
21434,문정복(文貞福),최재형(崔在亨),25,4,29,1
21435,문정복(文貞福),최종윤(崔鍾允),93,95,188,0
21436,문정복(文貞福),최춘식(崔春植),49,6,55,1
21437,문정복(文貞福),최형두(崔炯斗),50,5,55,1
21438,문정복(文貞福),최혜영(崔惠英),92,119,211,0
21439,문정복(文貞福),추경호(秋慶鎬),49,4,53,1
21440,문정복(文貞福),태영호(太永浩),49,7,56,1
21441,문정복(文貞福),하영제(河榮帝),43,2,45,1
21442,문정복(文貞福),하태경(河泰慶),49,4,53,1
21443,문정복(文貞福),한기호(韓起鎬),49,4,53,1
21444,문정복(文貞福),한무경(韓茂景),49,4,53,1
21445,문정복(文貞福),한병도(韓秉道),91,56,147,0
21446,문정복(文貞福),한정애(韓貞愛),74,50,124,0
21447,문정복(文貞福),한준호(韓俊鎬),106,91,197,0
21448,문정복(文貞福),허숙정(許淑湞),1,1,2,0
21449,문정복(文貞福),허영(許榮),108,73,181,0
21450,문정복(文貞福),허은아(許垠娥),49,4,53,1
21451,문정복(文貞福),허종식(許琮植),102,59,161,0
21452,문정복(文貞福),홍기원(洪起元),113,71,184,0
21453,문정복(文貞福),홍문표(洪文杓),49,6,55,1
21454,문정복(文貞福),홍석준(洪碩晙),49,4,53,1
21455,문정복(文貞福),홍성국(洪性國),109,99,208,0
21456,문정복(文貞福),홍영표(洪永杓),84,58,142,0
21457,문정복(文貞福),홍익표(洪翼杓),80,48,128,0
21458,문정복(文貞福),홍정민(洪貞敏),99,78,177,0
21459,문정복(文貞福),황보승희(皇甫承希),45,1,46,1
21460,문정복(文貞福),황운하(黃雲夏),101,151,252,0
21461,문정복(文貞福),황희(黃熙),79,34,113,0
21462,문진석(文振碩),민병덕(閔炳德),101,138,239,0
21463,문진석(文振碩),민형배(閔馨培),152,333,485,0
21464,문진석(文振碩),민홍철(閔洪喆),97,78,175,0
21465,문진석(文振碩),박광온(朴洸瑥),93,62,155,0
21466,문진석(文振碩),박대수(朴大壽),50,5,55,1
21467,문진석(文振碩),박대출(朴大出),50,4,54,1
21468,문진석(文振碩),박덕흠(朴德欽),38,12,50,1
21469,문진석(文振碩),박범계(朴範界),83,42,125,0
21470,문진석(文振碩),박병석(朴炳錫),41,19,60,0
21471,문진석(文振碩),박상혁(朴商赫),136,194,330,0
21472,문진석(文振碩),박성민(朴聖敏),52,7,59,1
21473,문진석(文振碩),박성준(朴省俊),112,127,239,0
21474,문진석(文振碩),박성중(朴成重),49,4,53,1
21475,문진석(文振碩),박수영(朴洙瑩),50,5,55,1
21476,문진석(文振碩),박영순(朴英淳),142,145,287,0
21477,문진석(文振碩),박완주(朴完柱),62,53,115,1
21478,문진석(文振碩),박용진(朴用鎭),78,45,123,0
21479,문진석(文振碩),박재호(朴在昊),96,70,166,0
21480,문진석(文振碩),박정(朴釘),122,100,222,0
21481,문진석(文振碩),박정하(朴正河),25,4,29,1
21482,문진석(文振碩),박주민(朴柱民),86,63,149,0
21483,문진석(文振碩),박진(朴振),50,4,54,1
21484,문진석(文振碩),박찬대(朴贊大),100,86,186,0
21485,문진석(文振碩),박형수(朴亨修),49,5,54,1
21486,문진석(文振碩),박홍근(朴洪根),128,136,264,0
21487,문진석(文振碩),배준영(裵俊英),49,5,54,1
21488,문진석(文振碩),배진교(裵晋敎),16,22,38,1
21489,문진석(文振碩),배현진(裵賢鎭),49,5,54,1
21490,문진석(文振碩),백종헌(白宗憲),50,6,56,1
21491,문진석(文振碩),백혜련(白惠蓮),90,51,141,0
21492,문진석(文振碩),변재일(卞在一),101,86,187,0
21493,문진석(文振碩),서동용(徐東榕),111,128,239,0
21494,문진석(文振碩),서범수(徐範洙),51,5,56,1
21495,문진석(文振碩),서병수(徐秉洙),51,5,56,1
21496,문진석(文振碩),서삼석(徐參錫),119,124,243,0
21497,문진석(文振碩),서영교(徐瑛敎),115,130,245,0
21498,문진석(文振碩),서영석(徐暎錫),159,230,389,0
21499,문진석(文振碩),서일준(徐一俊),50,8,58,1
21500,문진석(文振碩),서정숙(徐正淑),49,5,54,1
21501,문진석(文振碩),설훈(薛勳),100,87,187,0
21502,문진석(文振碩),성일종(成一鍾),50,9,59,1
21503,문진석(文振碩),소병철(蘇秉哲),89,75,164,0
21504,문진석(文振碩),소병훈(蘇秉勳),116,113,229,0
21505,문진석(文振碩),송갑석(宋甲錫),174,237,411,0
21506,문진석(文振碩),송기헌(宋基憲),84,51,135,0
21507,문진석(文振碩),송석준(宋錫俊),50,5,55,1
21508,문진석(文振碩),송언석(宋彦錫),45,6,51,1
21509,문진석(文振碩),송옥주(宋玉珠),95,86,181,0
21510,문진석(文振碩),송재호(宋在祜),101,145,246,0
21511,문진석(文振碩),신동근(申東根),117,148,265,0
21512,문진석(文振碩),신영대(申榮大),86,60,146,0
21513,문진석(文振碩),신원식(申源湜),49,4,53,1
21514,문진석(文振碩),신정훈(辛正勳),147,232,379,0
21515,문진석(文振碩),신현영(申賢榮),92,63,155,0
21516,문진석(文振碩),심상정(沈相奵),16,26,42,1
21517,문진석(文振碩),안규백(安圭伯),95,95,190,0
21518,문진석(文振碩),안민석(安敏錫),140,175,315,0
21519,문진석(文振碩),안병길(安炳吉),50,4,54,1
21520,문진석(文振碩),안철수(安哲秀),25,4,29,1
21521,문진석(文振碩),안호영(安浩永),94,101,195,0
21522,문진석(文振碩),양경숙(梁敬淑),99,77,176,0
21523,문진석(文振碩),양금희(梁琴喜),50,7,57,1
21524,문진석(文振碩),양기대(梁基大),102,91,193,0
21525,문진석(文振碩),양이원영(梁李媛瑛),95,91,186,0
21526,문진석(文振碩),양정숙(梁貞淑),81,163,244,1
21527,문진석(文振碩),양향자(梁香子),70,83,153,1
21528,문진석(文振碩),어기구(魚基龜),95,65,160,0
21529,문진석(文振碩),엄태영(嚴泰永),52,7,59,1
21530,문진석(文振碩),오기형(吳奇炯),78,48,126,0
21531,문진석(文振碩),오영환(吳永煥),135,221,356,0
21532,문진석(文振碩),용혜인(龍慧仁),18,29,47,1
21533,문진석(文振碩),우상호(禹相虎),81,41,122,0
21534,문진석(文振碩),우원식(禹元植),103,96,199,0
21535,문진석(文振碩),위성곤(魏聖坤),124,151,275,0
21536,문진석(文振碩),유경준(兪京濬),49,4,53,1
21537,문진석(文振碩),유기홍(柳基洪),79,55,134,0
21538,문진석(文振碩),유동수(柳東秀),100,71,171,0
21539,문진석(文振碩),유상범(劉相凡),49,4,53,1
21540,문진석(文振碩),유의동(兪義東),50,5,55,1
21541,문진석(文振碩),유정주(兪訂炷),110,116,226,0
21542,문진석(文振碩),윤건영(尹建永),87,65,152,0
21543,문진석(文振碩),윤관석(尹官石),95,69,164,1
21544,문진석(文振碩),윤두현(尹斗鉉),49,5,54,1
21545,문진석(文振碩),윤미향(尹美香),59,93,152,1
21546,문진석(文振碩),윤상현(尹相現),31,5,36,1
21547,문진석(文振碩),윤영덕(尹永德),153,196,349,0
21548,문진석(文振碩),윤영석(尹永碩),51,6,57,1
21549,문진석(文振碩),윤영찬(尹永燦),89,62,151,0
21550,문진석(文振碩),윤재갑(尹才鉀),159,166,325,0
21551,문진석(文振碩),윤재옥(尹在玉),50,4,54,1
21552,문진석(文振碩),윤주경(尹柱卿),50,6,56,1
21553,문진석(文振碩),윤준병(尹準炳),129,197,326,0
21554,문진석(文振碩),윤창현(尹暢賢),49,6,55,1
21555,문진석(文振碩),윤한홍(尹漢洪),50,6,56,1
21556,문진석(文振碩),윤호중(尹昊重),79,55,134,0
21557,문진석(文振碩),윤후덕(尹厚德),97,78,175,0
21558,문진석(文振碩),이개호(李介昊),116,99,215,0
21559,문진석(文振碩),이달곤(李達坤),52,7,59,1
21560,문진석(文振碩),이동주(李東洲),125,182,307,0
21561,문진석(文振碩),이만희(李晩熙),50,4,54,1
21562,문진석(文振碩),이명수(李明洙),52,18,70,1
21563,문진석(文振碩),이병훈(李炳勳),131,160,291,0
21564,문진석(文振碩),이상민(李相珉),76,42,118,0
21565,문진석(文振碩),이상헌(李相憲),118,116,234,0
21566,문진석(文振碩),이성만(李成萬),125,159,284,1
21567,문진석(文振碩),이소영(李素永),96,61,157,0
21568,문진석(文振碩),이수진(李壽珍),120,152,272,0
21569,문진석(文振碩),이수진(李秀眞),125,144,269,0
21570,문진석(文振碩),이양수(李亮壽),51,5,56,1
21571,문진석(文振碩),이용(李鏞),50,5,55,1
21572,문진석(文振碩),이용빈(李龍彬),184,304,488,0
21573,문진석(文振碩),이용선(李庸瑄),108,106,214,0
21574,문진석(文振碩),이용우(李龍雨),113,91,204,0
21575,문진석(文振碩),이용호(李容鎬),44,36,80,1
21576,문진석(文振碩),이원욱(李元旭),98,87,185,0
21577,문진석(文振碩),이원택(李源澤),103,82,185,0
21578,문진석(文振碩),이은주(李恩周),18,16,34,1
21579,문진석(文振碩),이인선(李仁善),25,4,29,1
21580,문진석(文振碩),이인영(李仁榮),76,42,118,0
21581,문진석(文振碩),이장섭(李將燮),117,87,204,0
21582,문진석(文振碩),이재명(李在明),40,24,64,0
21583,문진석(文振碩),이재정(李在汀),88,66,154,0
21584,문진석(文振碩),이정문(李楨文),156,247,403,0
21585,문진석(文振碩),이종배(李鍾培),51,8,59,1
21586,문진석(文振碩),이종성(李鍾成),49,5,54,1
21587,문진석(文振碩),이주환(李周桓),49,5,54,1
21588,문진석(文振碩),이채익(李埰益),51,6,57,1
21589,문진석(文振碩),이철규(李喆圭),51,5,56,1
21590,문진석(文振碩),이탄희(李誕熙),103,75,178,0
21591,문진석(文振碩),이태규(李泰珪),28,5,33,1
21592,문진석(文振碩),이학영(李學永),121,129,250,0
21593,문진석(文振碩),이해식(李海植),113,117,230,0
21594,문진석(文振碩),이헌승(李憲昇),51,6,57,1
21595,문진석(文振碩),이형석(李炯錫),154,199,353,0
21596,문진석(文振碩),인재근(印在謹),161,166,327,0
21597,문진석(文振碩),임병헌(林炳憲),25,5,30,1
21598,문진석(文振碩),임오경(林五卿),105,103,208,0
21599,문진석(文振碩),임이자(林利子),49,4,53,1
21600,문진석(文振碩),임종성(林鍾聲),105,135,240,0
21601,문진석(文振碩),임호선(林昊宣),133,192,325,0
21602,문진석(文振碩),장경태(張耿態),128,168,296,0
21603,문진석(文振碩),장동혁(張東赫),25,4,29,1
21604,문진석(文振碩),장제원(張濟元),49,5,54,1
21605,문진석(文振碩),장철민(張喆敏),94,99,193,0
21606,문진석(文振碩),장혜영(張惠英),15,12,27,1
21607,문진석(文振碩),전봉민(田奉珉),35,5,40,1
21608,문진석(文振碩),전용기(田溶冀),122,132,254,0
21609,문진석(文振碩),전재수(田載秀),86,48,134,0
21610,문진석(文振碩),전주혜(全珠惠),51,6,57,1
21611,문진석(文振碩),전해철(全海澈),80,50,130,0
21612,문진석(文振碩),전혜숙(全惠淑),100,85,185,0
21613,문진석(文振碩),정경희(丁慶姬),50,4,54,1
21614,문진석(文振碩),정동만(鄭東萬),49,5,54,1
21615,문진석(文振碩),정성호(鄭成湖),88,101,189,0
21616,문진석(文振碩),정우택(鄭宇澤),25,4,29,1
21617,문진석(文振碩),정운천(鄭雲天),49,7,56,1
21618,문진석(文振碩),정일영(鄭日永),110,127,237,0
21619,문진석(文振碩),정점식(鄭点植),50,4,54,1
21620,문진석(文振碩),정진석(鄭鎭碩),51,6,57,1
21621,문진석(文振碩),정청래(鄭淸來),96,66,162,0
21622,문진석(文振碩),정춘숙(鄭春淑),101,105,206,0
21623,문진석(文振碩),정태호(鄭泰浩),90,92,182,0
21624,문진석(文振碩),정필모(鄭必模),95,123,218,0
21625,문진석(文振碩),정희용(鄭熙溶),50,7,57,1
21626,문진석(文振碩),조경태(趙慶泰),55,15,70,1
21627,문진석(文振碩),조명희(曺明姬),50,8,58,1
21628,문진석(文振碩),조수진(趙修眞),49,4,53,1
21629,문진석(文振碩),조승래(趙承來),110,111,221,0
21630,문진석(文振碩),조오섭(曺五燮),188,278,466,0
21631,문진석(文振碩),조은희(趙恩禧),25,4,29,1
21632,문진석(文振碩),조응천(趙應天),111,55,166,0
21633,문진석(文振碩),조정식(趙正湜),79,80,159,0
21634,문진석(文振碩),조정훈(趙廷訓),6,7,13,1
21635,문진석(文振碩),조해진(曺海珍),52,5,57,1
21636,문진석(文振碩),주철현(朱哲鉉),118,161,279,0
21637,문진석(文振碩),주호영(朱豪英),50,7,57,1
21638,문진석(文振碩),지성호(池成浩),49,4,53,1
21639,문진석(文振碩),진선미(陳善美),105,68,173,0
21640,문진석(文振碩),진성준(陳聲準),114,106,220,0
21641,문진석(文振碩),천준호(千俊鎬),108,95,203,0
21642,문진석(文振碩),최기상(崔基相),83,65,148,0
21643,문진석(文振碩),최승재(崔承宰),49,8,57,1
21644,문진석(文振碩),최연숙(崔姸淑),36,13,49,1
21645,문진석(文振碩),최영희(崔英姬),25,4,29,1
21646,문진석(文振碩),최인호(崔仁昊),87,64,151,0
21647,문진석(文振碩),최재형(崔在亨),25,4,29,1
21648,문진석(文振碩),최종윤(崔鍾允),118,126,244,0
21649,문진석(文振碩),최춘식(崔春植),50,5,55,1
21650,문진석(文振碩),최형두(崔炯斗),50,11,61,1
21651,문진석(文振碩),최혜영(崔惠英),119,139,258,0
21652,문진석(文振碩),추경호(秋慶鎬),49,4,53,1
21653,문진석(文振碩),태영호(太永浩),49,7,56,1
21654,문진석(文振碩),하영제(河榮帝),43,10,53,1
21655,문진석(文振碩),하태경(河泰慶),49,5,54,1
21656,문진석(文振碩),한기호(韓起鎬),52,4,56,1
21657,문진석(文振碩),한무경(韓茂景),50,8,58,1
21658,문진석(文振碩),한병도(韓秉道),111,100,211,0
21659,문진석(文振碩),한정애(韓貞愛),79,106,185,0
21660,문진석(文振碩),한준호(韓俊鎬),110,151,261,0
21661,문진석(文振碩),허숙정(許淑湞),1,2,3,0
21662,문진석(文振碩),허영(許榮),143,156,299,0
21663,문진석(文振碩),허은아(許垠娥),49,5,54,1
21664,문진석(文振碩),허종식(許琮植),128,140,268,0
21665,문진석(文振碩),홍기원(洪起元),111,110,221,0
21666,문진석(文振碩),홍문표(洪文杓),65,24,89,1
21667,문진석(文振碩),홍석준(洪碩晙),51,4,55,1
21668,문진석(文振碩),홍성국(洪性國),137,158,295,0
21669,문진석(文振碩),홍영표(洪永杓),87,64,151,0
21670,문진석(文振碩),홍익표(洪翼杓),99,84,183,0
21671,문진석(文振碩),홍정민(洪貞敏),119,123,242,0
21672,문진석(文振碩),황보승희(皇甫承希),48,3,51,1
21673,문진석(文振碩),황운하(黃雲夏),136,191,327,0
21674,문진석(文振碩),황희(黃熙),84,52,136,0
21675,민병덕(閔炳德),민형배(閔馨培),100,334,434,0
21676,민병덕(閔炳德),민홍철(閔洪喆),77,68,145,0
21677,민병덕(閔炳德),박광온(朴洸瑥),90,147,237,0
21678,민병덕(閔炳德),박대수(朴大壽),52,11,63,1
21679,민병덕(閔炳德),박대출(朴大出),50,5,55,1
21680,민병덕(閔炳德),박덕흠(朴德欽),36,9,45,1
21681,민병덕(閔炳德),박범계(朴範界),79,39,118,0
21682,민병덕(閔炳德),박병석(朴炳錫),40,19,59,0
21683,민병덕(閔炳德),박상혁(朴商赫),111,256,367,0
21684,민병덕(閔炳德),박성민(朴聖敏),50,9,59,1
21685,민병덕(閔炳德),박성준(朴省俊),106,165,271,0
21686,민병덕(閔炳德),박성중(朴成重),49,7,56,1
21687,민병덕(閔炳德),박수영(朴洙瑩),49,8,57,1
21688,민병덕(閔炳德),박영순(朴英淳),95,124,219,0
21689,민병덕(閔炳德),박완주(朴完柱),47,46,93,1
21690,민병덕(閔炳德),박용진(朴用鎭),96,143,239,0
21691,민병덕(閔炳德),박재호(朴在昊),98,115,213,0
21692,민병덕(閔炳德),박정(朴釘),101,144,245,0
21693,민병덕(閔炳德),박정하(朴正河),25,8,33,1
21694,민병덕(閔炳德),박주민(朴柱民),92,103,195,0
21695,민병덕(閔炳德),박진(朴振),50,6,56,1
21696,민병덕(閔炳德),박찬대(朴贊大),89,90,179,0
21697,민병덕(閔炳德),박형수(朴亨修),49,7,56,1
21698,민병덕(閔炳德),박홍근(朴洪根),106,158,264,0
21699,민병덕(閔炳德),배준영(裵俊英),50,5,55,1
21700,민병덕(閔炳德),배진교(裵晋敎),20,74,94,1
21701,민병덕(閔炳德),배현진(裵賢鎭),49,5,54,1
21702,민병덕(閔炳德),백종헌(白宗憲),51,13,64,1
21703,민병덕(閔炳德),백혜련(白惠蓮),93,83,176,0
21704,민병덕(閔炳德),변재일(卞在一),80,75,155,0
21705,민병덕(閔炳德),서동용(徐東榕),111,167,278,0
21706,민병덕(閔炳德),서범수(徐範洙),52,14,66,1
21707,민병덕(閔炳德),서병수(徐秉洙),52,7,59,1
21708,민병덕(閔炳德),서삼석(徐參錫),104,106,210,0
21709,민병덕(閔炳德),서영교(徐瑛敎),104,206,310,0
21710,민병덕(閔炳德),서영석(徐暎錫),129,229,358,0
21711,민병덕(閔炳德),서일준(徐一俊),52,8,60,1
21712,민병덕(閔炳德),서정숙(徐正淑),49,10,59,1
21713,민병덕(閔炳德),설훈(薛勳),82,96,178,0
21714,민병덕(閔炳德),성일종(成一鍾),50,9,59,1
21715,민병덕(閔炳德),소병철(蘇秉哲),95,112,207,0
21716,민병덕(閔炳德),소병훈(蘇秉勳),97,134,231,0
21717,민병덕(閔炳德),송갑석(宋甲錫),107,194,301,0
21718,민병덕(閔炳德),송기헌(宋基憲),94,88,182,0
21719,민병덕(閔炳德),송석준(宋錫俊),50,7,57,1
21720,민병덕(閔炳德),송언석(宋彦錫),46,7,53,1
21721,민병덕(閔炳德),송옥주(宋玉珠),112,208,320,0
21722,민병덕(閔炳德),송재호(宋在祜),128,165,293,0
21723,민병덕(閔炳德),신동근(申東根),88,92,180,0
21724,민병덕(閔炳德),신영대(申榮大),90,96,186,0
21725,민병덕(閔炳德),신원식(申源湜),50,6,56,1
21726,민병덕(閔炳德),신정훈(辛正勳),104,230,334,0
21727,민병덕(閔炳德),신현영(申賢榮),82,85,167,0
21728,민병덕(閔炳德),심상정(沈相奵),21,77,98,1
21729,민병덕(閔炳德),안규백(安圭伯),96,112,208,0
21730,민병덕(閔炳德),안민석(安敏錫),87,100,187,0
21731,민병덕(閔炳德),안병길(安炳吉),50,6,56,1
21732,민병덕(閔炳德),안철수(安哲秀),25,5,30,1
21733,민병덕(閔炳德),안호영(安浩永),107,130,237,0
21734,민병덕(閔炳德),양경숙(梁敬淑),88,176,264,0
21735,민병덕(閔炳德),양금희(梁琴喜),51,9,60,1
21736,민병덕(閔炳德),양기대(梁基大),105,118,223,0
21737,민병덕(閔炳德),양이원영(梁李媛瑛),92,139,231,0
21738,민병덕(閔炳德),양정숙(梁貞淑),55,286,341,1
21739,민병덕(閔炳德),양향자(梁香子),54,56,110,1
21740,민병덕(閔炳德),어기구(魚基龜),82,79,161,0
21741,민병덕(閔炳德),엄태영(嚴泰永),51,10,61,1
21742,민병덕(閔炳德),오기형(吳奇炯),89,72,161,0
21743,민병덕(閔炳德),오영환(吳永煥),136,301,437,0
21744,민병덕(閔炳德),용혜인(龍慧仁),27,118,145,1
21745,민병덕(閔炳德),우상호(禹相虎),80,46,126,0
21746,민병덕(閔炳德),우원식(禹元植),99,152,251,0
21747,민병덕(閔炳德),위성곤(魏聖坤),103,161,264,0
21748,민병덕(閔炳德),유경준(兪京濬),49,5,54,1
21749,민병덕(閔炳德),유기홍(柳基洪),81,79,160,0
21750,민병덕(閔炳德),유동수(柳東秀),93,87,180,0
21751,민병덕(閔炳德),유상범(劉相凡),50,5,55,1
21752,민병덕(閔炳德),유의동(兪義東),50,9,59,1
21753,민병덕(閔炳德),유정주(兪訂炷),104,178,282,0
21754,민병덕(閔炳德),윤건영(尹建永),83,100,183,0
21755,민병덕(閔炳德),윤관석(尹官石),79,68,147,1
21756,민병덕(閔炳德),윤두현(尹斗鉉),49,7,56,1
21757,민병덕(閔炳德),윤미향(尹美香),54,161,215,1
21758,민병덕(閔炳德),윤상현(尹相現),30,7,37,1
21759,민병덕(閔炳德),윤영덕(尹永德),105,225,330,0
21760,민병덕(閔炳德),윤영석(尹永碩),51,9,60,1
21761,민병덕(閔炳德),윤영찬(尹永燦),88,109,197,0
21762,민병덕(閔炳德),윤재갑(尹才鉀),108,149,257,0
21763,민병덕(閔炳德),윤재옥(尹在玉),49,4,53,1
21764,민병덕(閔炳德),윤주경(尹柱卿),49,7,56,1
21765,민병덕(閔炳德),윤준병(尹準炳),126,333,459,0
21766,민병덕(閔炳德),윤창현(尹暢賢),49,8,57,1
21767,민병덕(閔炳德),윤한홍(尹漢洪),50,5,55,1
21768,민병덕(閔炳德),윤호중(尹昊重),78,62,140,0
21769,민병덕(閔炳德),윤후덕(尹厚德),91,116,207,0
21770,민병덕(閔炳德),이개호(李介昊),99,130,229,0
21771,민병덕(閔炳德),이달곤(李達坤),52,9,61,1
21772,민병덕(閔炳德),이동주(李東洲),102,228,330,0
21773,민병덕(閔炳德),이만희(李晩熙),49,6,55,1
21774,민병덕(閔炳德),이명수(李明洙),56,24,80,1
21775,민병덕(閔炳德),이병훈(李炳勳),103,194,297,0
21776,민병덕(閔炳德),이상민(李相珉),84,39,123,0
21777,민병덕(閔炳德),이상헌(李相憲),96,144,240,0
21778,민병덕(閔炳德),이성만(李成萬),102,169,271,1
21779,민병덕(閔炳德),이소영(李素永),102,109,211,0
21780,민병덕(閔炳德),이수진(李壽珍),117,251,368,0
21781,민병덕(閔炳德),이수진(李秀眞),106,155,261,0
21782,민병덕(閔炳德),이양수(李亮壽),51,8,59,1
21783,민병덕(閔炳德),이용(李鏞),49,7,56,1
21784,민병덕(閔炳德),이용빈(李龍彬),160,351,511,0
21785,민병덕(閔炳德),이용선(李庸瑄),107,179,286,0
21786,민병덕(閔炳德),이용우(李龍雨),131,173,304,0
21787,민병덕(閔炳德),이용호(李容鎬),44,60,104,1
21788,민병덕(閔炳德),이원욱(李元旭),107,151,258,0
21789,민병덕(閔炳德),이원택(李源澤),92,82,174,0
21790,민병덕(閔炳德),이은주(李恩周),24,66,90,1
21791,민병덕(閔炳德),이인선(李仁善),25,4,29,1
21792,민병덕(閔炳德),이인영(李仁榮),78,80,158,0
21793,민병덕(閔炳德),이장섭(李將燮),91,134,225,0
21794,민병덕(閔炳德),이재명(李在明),39,22,61,0
21795,민병덕(閔炳德),이재정(李在汀),89,102,191,0
21796,민병덕(閔炳德),이정문(李楨文),99,164,263,0
21797,민병덕(閔炳德),이종배(李鍾培),50,6,56,1
21798,민병덕(閔炳德),이종성(李鍾成),51,12,63,1
21799,민병덕(閔炳德),이주환(李周桓),49,5,54,1
21800,민병덕(閔炳德),이채익(李埰益),54,10,64,1
21801,민병덕(閔炳德),이철규(李喆圭),55,11,66,1
21802,민병덕(閔炳德),이탄희(李誕熙),92,125,217,0
21803,민병덕(閔炳德),이태규(李泰珪),29,7,36,1
21804,민병덕(閔炳德),이학영(李學永),117,208,325,0
21805,민병덕(閔炳德),이해식(李海植),106,114,220,0
21806,민병덕(閔炳德),이헌승(李憲昇),51,6,57,1
21807,민병덕(閔炳德),이형석(李炯錫),109,120,229,0
21808,민병덕(閔炳德),인재근(印在謹),117,159,276,0
21809,민병덕(閔炳德),임병헌(林炳憲),25,6,31,1
21810,민병덕(閔炳德),임오경(林五卿),91,103,194,0
21811,민병덕(閔炳德),임이자(林利子),49,7,56,1
21812,민병덕(閔炳德),임종성(林鍾聲),130,209,339,0
21813,민병덕(閔炳德),임호선(林昊宣),116,243,359,0
21814,민병덕(閔炳德),장경태(張耿態),108,192,300,0
21815,민병덕(閔炳德),장동혁(張東赫),25,4,29,1
21816,민병덕(閔炳德),장제원(張濟元),49,4,53,1
21817,민병덕(閔炳德),장철민(張喆敏),105,132,237,0
21818,민병덕(閔炳德),장혜영(張惠英),18,46,64,1
21819,민병덕(閔炳德),전봉민(田奉珉),35,5,40,1
21820,민병덕(閔炳德),전용기(田溶冀),115,200,315,0
21821,민병덕(閔炳德),전재수(田載秀),84,72,156,0
21822,민병덕(閔炳德),전주혜(全珠惠),51,8,59,1
21823,민병덕(閔炳德),전해철(全海澈),79,103,182,0
21824,민병덕(閔炳德),전혜숙(全惠淑),93,87,180,0
21825,민병덕(閔炳德),정경희(丁慶姬),50,6,56,1
21826,민병덕(閔炳德),정동만(鄭東萬),49,6,55,1
21827,민병덕(閔炳德),정성호(鄭成湖),104,167,271,0
21828,민병덕(閔炳德),정우택(鄭宇澤),25,5,30,1
21829,민병덕(閔炳德),정운천(鄭雲天),49,5,54,1
21830,민병덕(閔炳德),정일영(鄭日永),98,162,260,0
21831,민병덕(閔炳德),정점식(鄭点植),50,5,55,1
21832,민병덕(閔炳德),정진석(鄭鎭碩),50,8,58,1
21833,민병덕(閔炳德),정청래(鄭淸來),89,65,154,0
21834,민병덕(閔炳德),정춘숙(鄭春淑),114,187,301,0
21835,민병덕(閔炳德),정태호(鄭泰浩),91,135,226,0
21836,민병덕(閔炳德),정필모(鄭必模),96,139,235,0
21837,민병덕(閔炳德),정희용(鄭熙溶),51,7,58,1
21838,민병덕(閔炳德),조경태(趙慶泰),49,4,53,1
21839,민병덕(閔炳德),조명희(曺明姬),49,9,58,1
21840,민병덕(閔炳德),조수진(趙修眞),50,10,60,1
21841,민병덕(閔炳德),조승래(趙承來),101,106,207,0
21842,민병덕(閔炳德),조오섭(曺五燮),104,299,403,0
21843,민병덕(閔炳德),조은희(趙恩禧),26,8,34,1
21844,민병덕(閔炳德),조응천(趙應天),73,42,115,0
21845,민병덕(閔炳德),조정식(趙正湜),79,45,124,0
21846,민병덕(閔炳德),조정훈(趙廷訓),9,24,33,1
21847,민병덕(閔炳德),조해진(曺海珍),51,7,58,1
21848,민병덕(閔炳德),주철현(朱哲鉉),99,154,253,0
21849,민병덕(閔炳德),주호영(朱豪英),50,7,57,1
21850,민병덕(閔炳德),지성호(池成浩),49,8,57,1
21851,민병덕(閔炳德),진선미(陳善美),84,71,155,0
21852,민병덕(閔炳德),진성준(陳聲準),130,171,301,0
21853,민병덕(閔炳德),천준호(千俊鎬),108,109,217,0
21854,민병덕(閔炳德),최기상(崔基相),80,117,197,0
21855,민병덕(閔炳德),최승재(崔承宰),49,8,57,1
21856,민병덕(閔炳德),최연숙(崔姸淑),34,28,62,1
21857,민병덕(閔炳德),최영희(崔英姬),25,6,31,1
21858,민병덕(閔炳德),최인호(崔仁昊),80,101,181,0
21859,민병덕(閔炳德),최재형(崔在亨),25,5,30,1
21860,민병덕(閔炳德),최종윤(崔鍾允),104,224,328,0
21861,민병덕(閔炳德),최춘식(崔春植),49,7,56,1
21862,민병덕(閔炳德),최형두(崔炯斗),52,15,67,1
21863,민병덕(閔炳德),최혜영(崔惠英),111,206,317,0
21864,민병덕(閔炳德),추경호(秋慶鎬),50,6,56,1
21865,민병덕(閔炳德),태영호(太永浩),50,9,59,1
21866,민병덕(閔炳德),하영제(河榮帝),41,6,47,1
21867,민병덕(閔炳德),하태경(河泰慶),52,10,62,1
21868,민병덕(閔炳德),한기호(韓起鎬),51,4,55,1
21869,민병덕(閔炳德),한무경(韓茂景),49,8,57,1
21870,민병덕(閔炳德),한병도(韓秉道),117,169,286,0
21871,민병덕(閔炳德),한정애(韓貞愛),78,81,159,0
21872,민병덕(閔炳德),한준호(韓俊鎬),107,143,250,0
21873,민병덕(閔炳德),허숙정(許淑湞),1,2,3,0
21874,민병덕(閔炳德),허영(許榮),113,183,296,0
21875,민병덕(閔炳德),허은아(許垠娥),49,8,57,1
21876,민병덕(閔炳德),허종식(許琮植),106,188,294,0
21877,민병덕(閔炳德),홍기원(洪起元),103,133,236,0
21878,민병덕(閔炳德),홍문표(洪文杓),50,10,60,1
21879,민병덕(閔炳德),홍석준(洪碩晙),50,6,56,1
21880,민병덕(閔炳德),홍성국(洪性國),130,219,349,0
21881,민병덕(閔炳德),홍영표(洪永杓),81,68,149,0
21882,민병덕(閔炳德),홍익표(洪翼杓),98,127,225,0
21883,민병덕(閔炳德),홍정민(洪貞敏),124,222,346,0
21884,민병덕(閔炳德),황보승희(皇甫承希),47,8,55,1
21885,민병덕(閔炳德),황운하(黃雲夏),100,198,298,0
21886,민병덕(閔炳德),황희(黃熙),78,61,139,0
21887,민형배(閔馨培),민홍철(閔洪喆),71,82,153,0
21888,민형배(閔馨培),박광온(朴洸瑥),70,124,194,0
21889,민형배(閔馨培),박대수(朴大壽),35,6,41,1
21890,민형배(閔馨培),박대출(朴大出),34,4,38,1
21891,민형배(閔馨培),박덕흠(朴德欽),21,10,31,1
21892,민형배(閔馨培),박범계(朴範界),57,39,96,0
21893,민형배(閔馨培),박병석(朴炳錫),17,15,32,0
21894,민형배(閔馨培),박상혁(朴商赫),118,379,497,0
21895,민형배(閔馨培),박성민(朴聖敏),33,7,40,1
21896,민형배(閔馨培),박성준(朴省俊),100,133,233,0
21897,민형배(閔馨培),박성중(朴成重),33,4,37,1
21898,민형배(閔馨培),박수영(朴洙瑩),33,5,38,1
21899,민형배(閔馨培),박영순(朴英淳),87,152,239,0
21900,민형배(閔馨培),박완주(朴完柱),67,79,146,1
21901,민형배(閔馨培),박용진(朴用鎭),57,63,120,0
21902,민형배(閔馨培),박재호(朴在昊),74,78,152,0
21903,민형배(閔馨培),박정(朴釘),133,165,298,0
21904,민형배(閔馨培),박정하(朴正河),9,4,13,1
21905,민형배(閔馨培),박주민(朴柱民),69,115,184,0
21906,민형배(閔馨培),박진(朴振),34,4,38,1
21907,민형배(閔馨培),박찬대(朴贊大),71,101,172,0
21908,민형배(閔馨培),박형수(朴亨修),33,5,38,1
21909,민형배(閔馨培),박홍근(朴洪根),99,190,289,0
21910,민형배(閔馨培),배준영(裵俊英),33,6,39,1
21911,민형배(閔馨培),배진교(裵晋敎),27,79,106,1
21912,민형배(閔馨培),배현진(裵賢鎭),33,5,38,1
21913,민형배(閔馨培),백종헌(白宗憲),34,5,39,1
21914,민형배(閔馨培),백혜련(白惠蓮),76,73,149,0
21915,민형배(閔馨培),변재일(卞在一),83,137,220,0
21916,민형배(閔馨培),서동용(徐東榕),107,199,306,0
21917,민형배(閔馨培),서범수(徐範洙),34,5,39,1
21918,민형배(閔馨培),서병수(徐秉洙),34,5,39,1
21919,민형배(閔馨培),서삼석(徐參錫),112,134,246,0
21920,민형배(閔馨培),서영교(徐瑛敎),110,210,320,0
21921,민형배(閔馨培),서영석(徐暎錫),102,204,306,0
21922,민형배(閔馨培),서일준(徐一俊),35,6,41,1
21923,민형배(閔馨培),서정숙(徐正淑),33,5,38,1
21924,민형배(閔馨培),설훈(薛勳),62,84,146,0
21925,민형배(閔馨培),성일종(成一鍾),35,8,43,1
21926,민형배(閔馨培),소병철(蘇秉哲),75,74,149,0
21927,민형배(閔馨培),소병훈(蘇秉勳),93,178,271,0
21928,민형배(閔馨培),송갑석(宋甲錫),154,352,506,0
21929,민형배(閔馨培),송기헌(宋基憲),62,56,118,0
21930,민형배(閔馨培),송석준(宋錫俊),34,6,40,1
21931,민형배(閔馨培),송언석(宋彦錫),32,5,37,1
21932,민형배(閔馨培),송옥주(宋玉珠),94,182,276,0
21933,민형배(閔馨培),송재호(宋在祜),121,225,346,0
21934,민형배(閔馨培),신동근(申東根),91,117,208,0
21935,민형배(閔馨培),신영대(申榮大),81,113,194,0
21936,민형배(閔馨培),신원식(申源湜),33,4,37,1
21937,민형배(閔馨培),신정훈(辛正勳),168,365,533,0
21938,민형배(閔馨培),신현영(申賢榮),73,61,134,0
21939,민형배(閔馨培),심상정(沈相奵),24,85,109,1
21940,민형배(閔馨培),안규백(安圭伯),95,147,242,0
21941,민형배(閔馨培),안민석(安敏錫),123,246,369,0
21942,민형배(閔馨培),안병길(安炳吉),35,5,40,1
21943,민형배(閔馨培),안철수(安哲秀),9,4,13,1
21944,민형배(閔馨培),안호영(安浩永),88,157,245,0
21945,민형배(閔馨培),양경숙(梁敬淑),76,249,325,0
21946,민형배(閔馨培),양금희(梁琴喜),35,7,42,1
21947,민형배(閔馨培),양기대(梁基大),98,126,224,0
21948,민형배(閔馨培),양이원영(梁李媛瑛),106,197,303,0
21949,민형배(閔馨培),양정숙(梁貞淑),125,523,648,1
21950,민형배(閔馨培),양향자(梁香子),94,147,241,1
21951,민형배(閔馨培),어기구(魚基龜),94,112,206,0
21952,민형배(閔馨培),엄태영(嚴泰永),34,4,38,1
21953,민형배(閔馨培),오기형(吳奇炯),71,69,140,0
21954,민형배(閔馨培),오영환(吳永煥),182,351,533,0
21955,민형배(閔馨培),용혜인(龍慧仁),25,88,113,1
21956,민형배(閔馨培),우상호(禹相虎),59,50,109,0
21957,민형배(閔馨培),우원식(禹元植),97,128,225,0
21958,민형배(閔馨培),위성곤(魏聖坤),111,252,363,0
21959,민형배(閔馨培),유경준(兪京濬),33,4,37,1
21960,민형배(閔馨培),유기홍(柳基洪),74,75,149,0
21961,민형배(閔馨培),유동수(柳東秀),76,58,134,0
21962,민형배(閔馨培),유상범(劉相凡),33,4,37,1
21963,민형배(閔馨培),유의동(兪義東),35,6,41,1
21964,민형배(閔馨培),유정주(兪訂炷),132,301,433,0
21965,민형배(閔馨培),윤건영(尹建永),78,132,210,0
21966,민형배(閔馨培),윤관석(尹官石),55,63,118,1
21967,민형배(閔馨培),윤두현(尹斗鉉),34,5,39,1
21968,민형배(閔馨培),윤미향(尹美香),73,227,300,1
21969,민형배(閔馨培),윤상현(尹相現),14,5,19,1
21970,민형배(閔馨培),윤영덕(尹永德),149,360,509,0
21971,민형배(閔馨培),윤영석(尹永碩),34,6,40,1
21972,민형배(閔馨培),윤영찬(尹永燦),73,89,162,0
21973,민형배(閔馨培),윤재갑(尹才鉀),135,184,319,0
21974,민형배(閔馨培),윤재옥(尹在玉),34,4,38,1
21975,민형배(閔馨培),윤주경(尹柱卿),33,6,39,1
21976,민형배(閔馨培),윤준병(尹準炳),173,473,646,0
21977,민형배(閔馨培),윤창현(尹暢賢),33,7,40,1
21978,민형배(閔馨培),윤한홍(尹漢洪),34,4,38,1
21979,민형배(閔馨培),윤호중(尹昊重),58,68,126,0
21980,민형배(閔馨培),윤후덕(尹厚德),99,155,254,0
21981,민형배(閔馨培),이개호(李介昊),85,104,189,0
21982,민형배(閔馨培),이달곤(李達坤),36,6,42,1
21983,민형배(閔馨培),이동주(李東洲),107,288,395,0
21984,민형배(閔馨培),이만희(李晩熙),34,4,38,1
21985,민형배(閔馨培),이명수(李明洙),34,14,48,1
21986,민형배(閔馨培),이병훈(李炳勳),157,287,444,0
21987,민형배(閔馨培),이상민(李相珉),53,38,91,0
21988,민형배(閔馨培),이상헌(李相憲),98,123,221,0
21989,민형배(閔馨培),이성만(李成萬),99,198,297,1
21990,민형배(閔馨培),이소영(李素永),97,107,204,0
21991,민형배(閔馨培),이수진(李壽珍),113,360,473,0
21992,민형배(閔馨培),이수진(李秀眞),119,240,359,0
21993,민형배(閔馨培),이양수(李亮壽),34,5,39,1
21994,민형배(閔馨培),이용(李鏞),33,5,38,1
21995,민형배(閔馨培),이용빈(李龍彬),219,582,801,0
21996,민형배(閔馨培),이용선(李庸瑄),118,229,347,0
21997,민형배(閔馨培),이용우(李龍雨),108,186,294,0
21998,민형배(閔馨培),이용호(李容鎬),28,51,79,1
21999,민형배(閔馨培),이원욱(李元旭),88,142,230,0
22000,민형배(閔馨培),이원택(李源澤),96,125,221,0
22001,민형배(閔馨培),이은주(李恩周),31,56,87,1
22002,민형배(閔馨培),이인선(李仁善),9,4,13,1
22003,민형배(閔馨培),이인영(李仁榮),54,46,100,0
22004,민형배(閔馨培),이장섭(李將燮),94,127,221,0
22005,민형배(閔馨培),이재명(李在明),17,18,35,0
22006,민형배(閔馨培),이재정(李在汀),66,68,134,0
22007,민형배(閔馨培),이정문(李楨文),181,413,594,0
22008,민형배(閔馨培),이종배(李鍾培),34,7,41,1
22009,민형배(閔馨培),이종성(李鍾成),33,5,38,1
22010,민형배(閔馨培),이주환(李周桓),33,5,38,1
22011,민형배(閔馨培),이채익(李埰益),36,7,43,1
22012,민형배(閔馨培),이철규(李喆圭),35,5,40,1
22013,민형배(閔馨培),이탄희(李誕熙),90,139,229,0
22014,민형배(閔馨培),이태규(李泰珪),13,5,18,1
22015,민형배(閔馨培),이학영(李學永),105,146,251,0
22016,민형배(閔馨培),이해식(李海植),135,180,315,0
22017,민형배(閔馨培),이헌승(李憲昇),34,4,38,1
22018,민형배(閔馨培),이형석(李炯錫),126,208,334,0
22019,민형배(閔馨培),인재근(印在謹),95,152,247,0
22020,민형배(閔馨培),임병헌(林炳憲),9,4,13,1
22021,민형배(閔馨培),임오경(林五卿),104,155,259,0
22022,민형배(閔馨培),임이자(林利子),33,4,37,1
22023,민형배(閔馨培),임종성(林鍾聲),109,235,344,0
22024,민형배(閔馨培),임호선(林昊宣),141,290,431,0
22025,민형배(閔馨培),장경태(張耿態),136,386,522,0
22026,민형배(閔馨培),장동혁(張東赫),9,4,13,1
22027,민형배(閔馨培),장제원(張濟元),33,4,37,1
22028,민형배(閔馨培),장철민(張喆敏),92,149,241,0
22029,민형배(閔馨培),장혜영(張惠英),28,47,75,1
22030,민형배(閔馨培),전봉민(田奉珉),19,5,24,1
22031,민형배(閔馨培),전용기(田溶冀),102,181,283,0
22032,민형배(閔馨培),전재수(田載秀),73,75,148,0
22033,민형배(閔馨培),전주혜(全珠惠),35,6,41,1
22034,민형배(閔馨培),전해철(全海澈),55,67,122,0
22035,민형배(閔馨培),전혜숙(全惠淑),72,96,168,0
22036,민형배(閔馨培),정경희(丁慶姬),33,4,37,1
22037,민형배(閔馨培),정동만(鄭東萬),33,5,38,1
22038,민형배(閔馨培),정성호(鄭成湖),69,140,209,0
22039,민형배(閔馨培),정우택(鄭宇澤),9,4,13,1
22040,민형배(閔馨培),정운천(鄭雲天),33,8,41,1
22041,민형배(閔馨培),정일영(鄭日永),72,130,202,0
22042,민형배(閔馨培),정점식(鄭点植),34,4,38,1
22043,민형배(閔馨培),정진석(鄭鎭碩),34,7,41,1
22044,민형배(閔馨培),정청래(鄭淸來),74,88,162,0
22045,민형배(閔馨培),정춘숙(鄭春淑),86,138,224,0
22046,민형배(閔馨培),정태호(鄭泰浩),72,145,217,0
22047,민형배(閔馨培),정필모(鄭必模),104,242,346,0
22048,민형배(閔馨培),정희용(鄭熙溶),35,6,41,1
22049,민형배(閔馨培),조경태(趙慶泰),34,6,40,1
22050,민형배(閔馨培),조명희(曺明姬),33,7,40,1
22051,민형배(閔馨培),조수진(趙修眞),33,4,37,1
22052,민형배(閔馨培),조승래(趙承來),83,106,189,0
22053,민형배(閔馨培),조오섭(曺五燮),168,376,544,0
22054,민형배(閔馨培),조은희(趙恩禧),10,6,16,1
22055,민형배(閔馨培),조응천(趙應天),54,30,84,0
22056,민형배(閔馨培),조정식(趙正湜),58,63,121,0
22057,민형배(閔馨培),조정훈(趙廷訓),11,24,35,1
22058,민형배(閔馨培),조해진(曺海珍),35,5,40,1
22059,민형배(閔馨培),주철현(朱哲鉉),139,284,423,0
22060,민형배(閔馨培),주호영(朱豪英),33,4,37,1
22061,민형배(閔馨培),지성호(池成浩),33,4,37,1
22062,민형배(閔馨培),진선미(陳善美),65,66,131,0
22063,민형배(閔馨培),진성준(陳聲準),118,186,304,0
22064,민형배(閔馨培),천준호(千俊鎬),85,73,158,0
22065,민형배(閔馨培),최기상(崔基相),79,95,174,0
22066,민형배(閔馨培),최승재(崔承宰),33,16,49,1
22067,민형배(閔馨培),최연숙(崔姸淑),15,15,30,1
22068,민형배(閔馨培),최영희(崔英姬),9,4,13,1
22069,민형배(閔馨培),최인호(崔仁昊),84,104,188,0
22070,민형배(閔馨培),최재형(崔在亨),9,4,13,1
22071,민형배(閔馨培),최종윤(崔鍾允),99,233,332,0
22072,민형배(閔馨培),최춘식(崔春植),33,4,37,1
22073,민형배(閔馨培),최형두(崔炯斗),34,7,41,1
22074,민형배(閔馨培),최혜영(崔惠英),92,183,275,0
22075,민형배(閔馨培),추경호(秋慶鎬),34,4,38,1
22076,민형배(閔馨培),태영호(太永浩),33,5,38,1
22077,민형배(閔馨培),하영제(河榮帝),25,3,28,1
22078,민형배(閔馨培),하태경(河泰慶),35,4,39,1
22079,민형배(閔馨培),한기호(韓起鎬),35,4,39,1
22080,민형배(閔馨培),한무경(韓茂景),33,6,39,1
22081,민형배(閔馨培),한병도(韓秉道),118,195,313,0
22082,민형배(閔馨培),한정애(韓貞愛),54,57,111,0
22083,민형배(閔馨培),한준호(韓俊鎬),106,198,304,0
22084,민형배(閔馨培),허숙정(許淑湞),1,1,2,0
22085,민형배(閔馨培),허영(許榮),121,218,339,0
22086,민형배(閔馨培),허은아(許垠娥),33,5,38,1
22087,민형배(閔馨培),허종식(許琮植),84,153,237,0
22088,민형배(閔馨培),홍기원(洪起元),94,169,263,0
22089,민형배(閔馨培),홍문표(洪文杓),35,6,41,1
22090,민형배(閔馨培),홍석준(洪碩晙),34,4,38,1
22091,민형배(閔馨培),홍성국(洪性國),125,246,371,0
22092,민형배(閔馨培),홍영표(洪永杓),63,55,118,0
22093,민형배(閔馨培),홍익표(洪翼杓),84,135,219,0
22094,민형배(閔馨培),홍정민(洪貞敏),127,261,388,0
22095,민형배(閔馨培),황보승희(皇甫承希),30,4,34,1
22096,민형배(閔馨培),황운하(黃雲夏),141,394,535,0
22097,민형배(閔馨培),황희(黃熙),58,80,138,0
22098,민홍철(閔洪喆),박광온(朴洸瑥),85,51,136,0
22099,민홍철(閔洪喆),박대수(朴大壽),50,4,54,1
22100,민홍철(閔洪喆),박대출(朴大出),50,4,54,1
22101,민홍철(閔洪喆),박덕흠(朴德欽),37,7,44,1
22102,민홍철(閔洪喆),박범계(朴範界),75,34,109,0
22103,민홍철(閔洪喆),박병석(朴炳錫),40,16,56,0
22104,민홍철(閔洪喆),박상혁(朴商赫),91,147,238,0
22105,민홍철(閔洪喆),박성민(朴聖敏),51,5,56,1
22106,민홍철(閔洪喆),박성준(朴省俊),103,89,192,0
22107,민홍철(閔洪喆),박성중(朴成重),49,4,53,1
22108,민홍철(閔洪喆),박수영(朴洙瑩),49,5,54,1
22109,민홍철(閔洪喆),박영순(朴英淳),94,74,168,0
22110,민홍철(閔洪喆),박완주(朴完柱),53,43,96,1
22111,민홍철(閔洪喆),박용진(朴用鎭),80,38,118,0
22112,민홍철(閔洪喆),박재호(朴在昊),97,101,198,0
22113,민홍철(閔洪喆),박정(朴釘),100,77,177,0
22114,민홍철(閔洪喆),박정하(朴正河),25,4,29,1
22115,민홍철(閔洪喆),박주민(朴柱民),76,40,116,0
22116,민홍철(閔洪喆),박진(朴振),50,6,56,1
22117,민홍철(閔洪喆),박찬대(朴贊大),81,57,138,0
22118,민홍철(閔洪喆),박형수(朴亨修),49,4,53,1
22119,민홍철(閔洪喆),박홍근(朴洪根),92,64,156,0
22120,민홍철(閔洪喆),배준영(裵俊英),49,8,57,1
22121,민홍철(閔洪喆),배진교(裵晋敎),13,16,29,1
22122,민홍철(閔洪喆),배현진(裵賢鎭),49,5,54,1
22123,민홍철(閔洪喆),백종헌(白宗憲),51,4,55,1
22124,민홍철(閔洪喆),백혜련(白惠蓮),81,53,134,0
22125,민홍철(閔洪喆),변재일(卞在一),81,46,127,0
22126,민홍철(閔洪喆),서동용(徐東榕),84,73,157,0
22127,민홍철(閔洪喆),서범수(徐範洙),51,5,56,1
22128,민홍철(閔洪喆),서병수(徐秉洙),51,4,55,1
22129,민홍철(閔洪喆),서삼석(徐參錫),89,60,149,0
22130,민홍철(閔洪喆),서영교(徐瑛敎),103,97,200,0
22131,민홍철(閔洪喆),서영석(徐暎錫),85,65,150,0
22132,민홍철(閔洪喆),서일준(徐一俊),50,7,57,1
22133,민홍철(閔洪喆),서정숙(徐正淑),49,6,55,1
22134,민홍철(閔洪喆),설훈(薛勳),90,65,155,0
22135,민홍철(閔洪喆),성일종(成一鍾),51,6,57,1
22136,민홍철(閔洪喆),소병철(蘇秉哲),83,55,138,0
22137,민홍철(閔洪喆),소병훈(蘇秉勳),81,60,141,0
22138,민홍철(閔洪喆),송갑석(宋甲錫),95,86,181,0
22139,민홍철(閔洪喆),송기헌(宋基憲),77,58,135,0
22140,민홍철(閔洪喆),송석준(宋錫俊),49,4,53,1
22141,민홍철(閔洪喆),송언석(宋彦錫),45,4,49,1
22142,민홍철(閔洪喆),송옥주(宋玉珠),100,91,191,0
22143,민홍철(閔洪喆),송재호(宋在祜),85,67,152,0
22144,민홍철(閔洪喆),신동근(申東根),83,56,139,0
22145,민홍철(閔洪喆),신영대(申榮大),87,73,160,0
22146,민홍철(閔洪喆),신원식(申源湜),50,12,62,1
22147,민홍철(閔洪喆),신정훈(辛正勳),105,113,218,0
22148,민홍철(閔洪喆),신현영(申賢榮),76,37,113,0
22149,민홍철(閔洪喆),심상정(沈相奵),11,31,42,1
22150,민홍철(閔洪喆),안규백(安圭伯),109,97,206,0
22151,민홍철(閔洪喆),안민석(安敏錫),84,60,144,0
22152,민홍철(閔洪喆),안병길(安炳吉),50,4,54,1
22153,민홍철(閔洪喆),안철수(安哲秀),25,5,30,1
22154,민홍철(閔洪喆),안호영(安浩永),81,77,158,0
22155,민홍철(閔洪喆),양경숙(梁敬淑),85,83,168,0
22156,민홍철(閔洪喆),양금희(梁琴喜),50,6,56,1
22157,민홍철(閔洪喆),양기대(梁基大),80,48,128,0
22158,민홍철(閔洪喆),양이원영(梁李媛瑛),78,57,135,0
22159,민홍철(閔洪喆),양정숙(梁貞淑),29,60,89,1
22160,민홍철(閔洪喆),양향자(梁香子),44,31,75,1
22161,민홍철(閔洪喆),어기구(魚基龜),82,70,152,0
22162,민홍철(閔洪喆),엄태영(嚴泰永),51,4,55,1
22163,민홍철(閔洪喆),오기형(吳奇炯),73,34,107,0
22164,민홍철(閔洪喆),오영환(吳永煥),95,82,177,0
22165,민홍철(閔洪喆),용혜인(龍慧仁),10,19,29,1
22166,민홍철(閔洪喆),우상호(禹相虎),75,36,111,0
22167,민홍철(閔洪喆),우원식(禹元植),78,60,138,0
22168,민홍철(閔洪喆),위성곤(魏聖坤),99,69,168,0
22169,민홍철(閔洪喆),유경준(兪京濬),49,4,53,1
22170,민홍철(閔洪喆),유기홍(柳基洪),76,52,128,0
22171,민홍철(閔洪喆),유동수(柳東秀),85,47,132,0
22172,민홍철(閔洪喆),유상범(劉相凡),49,4,53,1
22173,민홍철(閔洪喆),유의동(兪義東),50,5,55,1
22174,민홍철(閔洪喆),유정주(兪訂炷),85,67,152,0
22175,민홍철(閔洪喆),윤건영(尹建永),73,48,121,0
22176,민홍철(閔洪喆),윤관석(尹官石),86,55,141,1
22177,민홍철(閔洪喆),윤두현(尹斗鉉),49,5,54,1
22178,민홍철(閔洪喆),윤미향(尹美香),42,53,95,1
22179,민홍철(閔洪喆),윤상현(尹相現),31,5,36,1
22180,민홍철(閔洪喆),윤영덕(尹永德),87,72,159,0
22181,민홍철(閔洪喆),윤영석(尹永碩),50,6,56,1
22182,민홍철(閔洪喆),윤영찬(尹永燦),78,40,118,0
22183,민홍철(閔洪喆),윤재갑(尹才鉀),111,88,199,0
22184,민홍철(閔洪喆),윤재옥(尹在玉),50,4,54,1
22185,민홍철(閔洪喆),윤주경(尹柱卿),50,5,55,1
22186,민홍철(閔洪喆),윤준병(尹準炳),92,81,173,0
22187,민홍철(閔洪喆),윤창현(尹暢賢),50,5,55,1
22188,민홍철(閔洪喆),윤한홍(尹漢洪),50,4,54,1
22189,민홍철(閔洪喆),윤호중(尹昊重),77,57,134,0
22190,민홍철(閔洪喆),윤후덕(尹厚德),92,86,178,0
22191,민홍철(閔洪喆),이개호(李介昊),94,80,174,0
22192,민홍철(閔洪喆),이달곤(李達坤),51,6,57,1
22193,민홍철(閔洪喆),이동주(李東洲),82,72,154,0
22194,민홍철(閔洪喆),이만희(李晩熙),51,4,55,1
22195,민홍철(閔洪喆),이명수(李明洙),51,7,58,1
22196,민홍철(閔洪喆),이병훈(李炳勳),105,100,205,0
22197,민홍철(閔洪喆),이상민(李相珉),77,36,113,0
22198,민홍철(閔洪喆),이상헌(李相憲),92,111,203,0
22199,민홍철(閔洪喆),이성만(李成萬),80,62,142,1
22200,민홍철(閔洪喆),이소영(李素永),75,52,127,0
22201,민홍철(閔洪喆),이수진(李壽珍),91,84,175,0
22202,민홍철(閔洪喆),이수진(李秀眞),84,58,142,0
22203,민홍철(閔洪喆),이양수(李亮壽),51,6,57,1
22204,민홍철(閔洪喆),이용(李鏞),49,4,53,1
22205,민홍철(閔洪喆),이용빈(李龍彬),89,82,171,0
22206,민홍철(閔洪喆),이용선(李庸瑄),88,57,145,0
22207,민홍철(閔洪喆),이용우(李龍雨),84,51,135,0
22208,민홍철(閔洪喆),이용호(李容鎬),38,14,52,1
22209,민홍철(閔洪喆),이원욱(李元旭),84,64,148,0
22210,민홍철(閔洪喆),이원택(李源澤),92,54,146,0
22211,민홍철(閔洪喆),이은주(李恩周),12,18,30,1
22212,민홍철(閔洪喆),이인선(李仁善),25,4,29,1
22213,민홍철(閔洪喆),이인영(李仁榮),79,42,121,0
22214,민홍철(閔洪喆),이장섭(李將燮),85,70,155,0
22215,민홍철(閔洪喆),이재명(李在明),39,21,60,0
22216,민홍철(閔洪喆),이재정(李在汀),76,52,128,0
22217,민홍철(閔洪喆),이정문(李楨文),88,68,156,0
22218,민홍철(閔洪喆),이종배(李鍾培),50,6,56,1
22219,민홍철(閔洪喆),이종성(李鍾成),49,6,55,1
22220,민홍철(閔洪喆),이주환(李周桓),50,5,55,1
22221,민홍철(閔洪喆),이채익(李埰益),52,7,59,1
22222,민홍철(閔洪喆),이철규(李喆圭),50,5,55,1
22223,민홍철(閔洪喆),이탄희(李誕熙),89,62,151,0
22224,민홍철(閔洪喆),이태규(李泰珪),28,5,33,1
22225,민홍철(閔洪喆),이학영(李學永),92,103,195,0
22226,민홍철(閔洪喆),이해식(李海植),85,54,139,0
22227,민홍철(閔洪喆),이헌승(李憲昇),52,4,56,1
22228,민홍철(閔洪喆),이형석(李炯錫),93,62,155,0
22229,민홍철(閔洪喆),인재근(印在謹),90,68,158,0
22230,민홍철(閔洪喆),임병헌(林炳憲),27,4,31,1
22231,민홍철(閔洪喆),임오경(林五卿),86,65,151,0
22232,민홍철(閔洪喆),임이자(林利子),49,4,53,1
22233,민홍철(閔洪喆),임종성(林鍾聲),91,98,189,0
22234,민홍철(閔洪喆),임호선(林昊宣),97,156,253,0
22235,민홍철(閔洪喆),장경태(張耿態),77,55,132,0
22236,민홍철(閔洪喆),장동혁(張東赫),25,4,29,1
22237,민홍철(閔洪喆),장제원(張濟元),49,4,53,1
22238,민홍철(閔洪喆),장철민(張喆敏),92,118,210,0
22239,민홍철(閔洪喆),장혜영(張惠英),12,14,26,1
22240,민홍철(閔洪喆),전봉민(田奉珉),36,5,41,1
22241,민홍철(閔洪喆),전용기(田溶冀),90,80,170,0
22242,민홍철(閔洪喆),전재수(田載秀),97,132,229,0
22243,민홍철(閔洪喆),전주혜(全珠惠),51,5,56,1
22244,민홍철(閔洪喆),전해철(全海澈),76,49,125,0
22245,민홍철(閔洪喆),전혜숙(全惠淑),102,96,198,0
22246,민홍철(閔洪喆),정경희(丁慶姬),49,4,53,1
22247,민홍철(閔洪喆),정동만(鄭東萬),50,4,54,1
22248,민홍철(閔洪喆),정성호(鄭成湖),87,74,161,0
22249,민홍철(閔洪喆),정우택(鄭宇澤),25,5,30,1
22250,민홍철(閔洪喆),정운천(鄭雲天),49,6,55,1
22251,민홍철(閔洪喆),정일영(鄭日永),79,59,138,0
22252,민홍철(閔洪喆),정점식(鄭点植),50,4,54,1
22253,민홍철(閔洪喆),정진석(鄭鎭碩),50,4,54,1
22254,민홍철(閔洪喆),정청래(鄭淸來),76,43,119,0
22255,민홍철(閔洪喆),정춘숙(鄭春淑),88,74,162,0
22256,민홍철(閔洪喆),정태호(鄭泰浩),79,63,142,0
22257,민홍철(閔洪喆),정필모(鄭必模),80,64,144,0
22258,민홍철(閔洪喆),정희용(鄭熙溶),50,6,56,1
22259,민홍철(閔洪喆),조경태(趙慶泰),50,7,57,1
22260,민홍철(閔洪喆),조명희(曺明姬),49,6,55,1
22261,민홍철(閔洪喆),조수진(趙修眞),49,4,53,1
22262,민홍철(閔洪喆),조승래(趙承來),85,62,147,0
22263,민홍철(閔洪喆),조오섭(曺五燮),88,107,195,0
22264,민홍철(閔洪喆),조은희(趙恩禧),26,4,30,1
22265,민홍철(閔洪喆),조응천(趙應天),76,38,114,0
22266,민홍철(閔洪喆),조정식(趙正湜),78,42,120,0
22267,민홍철(閔洪喆),조정훈(趙廷訓),0,10,10,1
22268,민홍철(閔洪喆),조해진(曺海珍),51,5,56,1
22269,민홍철(閔洪喆),주철현(朱哲鉉),85,54,139,0
22270,민홍철(閔洪喆),주호영(朱豪英),49,4,53,1
22271,민홍철(閔洪喆),지성호(池成浩),49,4,53,1
22272,민홍철(閔洪喆),진선미(陳善美),86,79,165,0
22273,민홍철(閔洪喆),진성준(陳聲準),79,64,143,0
22274,민홍철(閔洪喆),천준호(千俊鎬),80,43,123,0
22275,민홍철(閔洪喆),최기상(崔基相),79,50,129,0
22276,민홍철(閔洪喆),최승재(崔承宰),51,6,57,1
22277,민홍철(閔洪喆),최연숙(崔姸淑),29,12,41,1
22278,민홍철(閔洪喆),최영희(崔英姬),25,5,30,1
22279,민홍철(閔洪喆),최인호(崔仁昊),93,133,226,0
22280,민홍철(閔洪喆),최재형(崔在亨),25,5,30,1
22281,민홍철(閔洪喆),최종윤(崔鍾允),87,78,165,0
22282,민홍철(閔洪喆),최춘식(崔春植),49,8,57,1
22283,민홍철(閔洪喆),최형두(崔炯斗),51,5,56,1
22284,민홍철(閔洪喆),최혜영(崔惠英),85,72,157,0
22285,민홍철(閔洪喆),추경호(秋慶鎬),49,4,53,1
22286,민홍철(閔洪喆),태영호(太永浩),49,5,54,1
22287,민홍철(閔洪喆),하영제(河榮帝),42,2,44,1
22288,민홍철(閔洪喆),하태경(河泰慶),50,4,54,1
22289,민홍철(閔洪喆),한기호(韓起鎬),51,5,56,1
22290,민홍철(閔洪喆),한무경(韓茂景),50,5,55,1
22291,민홍철(閔洪喆),한병도(韓秉道),89,64,153,0
22292,민홍철(閔洪喆),한정애(韓貞愛),88,91,179,0
22293,민홍철(閔洪喆),한준호(韓俊鎬),90,128,218,0
22294,민홍철(閔洪喆),허숙정(許淑湞),1,1,2,0
22295,민홍철(閔洪喆),허영(許榮),93,107,200,0
22296,민홍철(閔洪喆),허은아(許垠娥),49,5,54,1
22297,민홍철(閔洪喆),허종식(許琮植),85,95,180,0
22298,민홍철(閔洪喆),홍기원(洪起元),82,59,141,0
22299,민홍철(閔洪喆),홍문표(洪文杓),57,7,64,1
22300,민홍철(閔洪喆),홍석준(洪碩晙),50,4,54,1
22301,민홍철(閔洪喆),홍성국(洪性國),96,63,159,0
22302,민홍철(閔洪喆),홍영표(洪永杓),90,63,153,0
22303,민홍철(閔洪喆),홍익표(洪翼杓),77,52,129,0
22304,민홍철(閔洪喆),홍정민(洪貞敏),80,58,138,0
22305,민홍철(閔洪喆),황보승희(皇甫承希),46,2,48,1
22306,민홍철(閔洪喆),황운하(黃雲夏),99,99,198,0
22307,민홍철(閔洪喆),황희(黃熙),76,50,126,0
22308,박광온(朴洸瑥),박대수(朴大壽),51,5,56,1
22309,박광온(朴洸瑥),박대출(朴大出),51,4,55,1
22310,박광온(朴洸瑥),박덕흠(朴德欽),37,5,42,1
22311,박광온(朴洸瑥),박범계(朴範界),77,36,113,0
22312,박광온(朴洸瑥),박병석(朴炳錫),41,17,58,0
22313,박광온(朴洸瑥),박상혁(朴商赫),97,82,179,0
22314,박광온(朴洸瑥),박성민(朴聖敏),49,5,54,1
22315,박광온(朴洸瑥),박성준(朴省俊),89,74,163,0
22316,박광온(朴洸瑥),박성중(朴成重),49,5,54,1
22317,박광온(朴洸瑥),박수영(朴洙瑩),49,4,53,1
22318,박광온(朴洸瑥),박영순(朴英淳),81,61,142,0
22319,박광온(朴洸瑥),박완주(朴完柱),49,35,84,1
22320,박광온(朴洸瑥),박용진(朴用鎭),78,57,135,0
22321,박광온(朴洸瑥),박재호(朴在昊),101,49,150,0
22322,박광온(朴洸瑥),박정(朴釘),103,112,215,0
22323,박광온(朴洸瑥),박정하(朴正河),26,4,30,1
22324,박광온(朴洸瑥),박주민(朴柱民),85,67,152,0
22325,박광온(朴洸瑥),박진(朴振),50,5,55,1
22326,박광온(朴洸瑥),박찬대(朴贊大),86,43,129,0
22327,박광온(朴洸瑥),박형수(朴亨修),49,4,53,1
22328,박광온(朴洸瑥),박홍근(朴洪根),98,78,176,0
22329,박광온(朴洸瑥),배준영(裵俊英),49,4,53,1
22330,박광온(朴洸瑥),배진교(裵晋敎),14,21,35,1
22331,박광온(朴洸瑥),배현진(裵賢鎭),49,4,53,1
22332,박광온(朴洸瑥),백종헌(白宗憲),51,4,55,1
22333,박광온(朴洸瑥),백혜련(白惠蓮),91,74,165,0
22334,박광온(朴洸瑥),변재일(卞在一),94,63,157,0
22335,박광온(朴洸瑥),서동용(徐東榕),89,116,205,0
22336,박광온(朴洸瑥),서범수(徐範洙),52,7,59,1
22337,박광온(朴洸瑥),서병수(徐秉洙),50,4,54,1
22338,박광온(朴洸瑥),서삼석(徐參錫),95,60,155,0
22339,박광온(朴洸瑥),서영교(徐瑛敎),95,88,183,0
22340,박광온(朴洸瑥),서영석(徐暎錫),86,67,153,0
22341,박광온(朴洸瑥),서일준(徐一俊),51,4,55,1
22342,박광온(朴洸瑥),서정숙(徐正淑),49,5,54,1
22343,박광온(朴洸瑥),설훈(薛勳),89,75,164,0
22344,박광온(朴洸瑥),성일종(成一鍾),50,5,55,1
22345,박광온(朴洸瑥),소병철(蘇秉哲),88,62,150,0
22346,박광온(朴洸瑥),소병훈(蘇秉勳),89,70,159,0
22347,박광온(朴洸瑥),송갑석(宋甲錫),105,177,282,0
22348,박광온(朴洸瑥),송기헌(宋基憲),80,46,126,0
22349,박광온(朴洸瑥),송석준(宋錫俊),49,4,53,1
22350,박광온(朴洸瑥),송언석(宋彦錫),45,4,49,1
22351,박광온(朴洸瑥),송옥주(宋玉珠),104,73,177,0
22352,박광온(朴洸瑥),송재호(宋在祜),86,63,149,0
22353,박광온(朴洸瑥),신동근(申東根),91,64,155,0
22354,박광온(朴洸瑥),신영대(申榮大),97,78,175,0
22355,박광온(朴洸瑥),신원식(申源湜),50,4,54,1
22356,박광온(朴洸瑥),신정훈(辛正勳),101,96,197,0
22357,박광온(朴洸瑥),신현영(申賢榮),82,54,136,0
22358,박광온(朴洸瑥),심상정(沈相奵),13,21,34,1
22359,박광온(朴洸瑥),안규백(安圭伯),88,70,158,0
22360,박광온(朴洸瑥),안민석(安敏錫),89,83,172,0
22361,박광온(朴洸瑥),안병길(安炳吉),50,4,54,1
22362,박광온(朴洸瑥),안철수(安哲秀),26,5,31,1
22363,박광온(朴洸瑥),안호영(安浩永),81,58,139,0
22364,박광온(朴洸瑥),양경숙(梁敬淑),92,88,180,0
22365,박광온(朴洸瑥),양금희(梁琴喜),51,5,56,1
22366,박광온(朴洸瑥),양기대(梁基大),84,68,152,0
22367,박광온(朴洸瑥),양이원영(梁李媛瑛),79,69,148,0
22368,박광온(朴洸瑥),양정숙(梁貞淑),27,79,106,1
22369,박광온(朴洸瑥),양향자(梁香子),42,34,76,1
22370,박광온(朴洸瑥),어기구(魚基龜),81,70,151,0
22371,박광온(朴洸瑥),엄태영(嚴泰永),51,4,55,1
22372,박광온(朴洸瑥),오기형(吳奇炯),79,40,119,0
22373,박광온(朴洸瑥),오영환(吳永煥),117,135,252,0
22374,박광온(朴洸瑥),용혜인(龍慧仁),12,16,28,1
22375,박광온(朴洸瑥),우상호(禹相虎),81,46,127,0
22376,박광온(朴洸瑥),우원식(禹元植),89,56,145,0
22377,박광온(朴洸瑥),위성곤(魏聖坤),88,70,158,0
22378,박광온(朴洸瑥),유경준(兪京濬),49,4,53,1
22379,박광온(朴洸瑥),유기홍(柳基洪),85,54,139,0
22380,박광온(朴洸瑥),유동수(柳東秀),80,50,130,0
22381,박광온(朴洸瑥),유상범(劉相凡),50,4,54,1
22382,박광온(朴洸瑥),유의동(兪義東),50,5,55,1
22383,박광온(朴洸瑥),유정주(兪訂炷),111,94,205,0
22384,박광온(朴洸瑥),윤건영(尹建永),80,63,143,0
22385,박광온(朴洸瑥),윤관석(尹官石),78,48,126,1
22386,박광온(朴洸瑥),윤두현(尹斗鉉),50,4,54,1
22387,박광온(朴洸瑥),윤미향(尹美香),38,41,79,1
22388,박광온(朴洸瑥),윤상현(尹相現),31,7,38,1
22389,박광온(朴洸瑥),윤영덕(尹永德),92,86,178,0
22390,박광온(朴洸瑥),윤영석(尹永碩),50,10,60,1
22391,박광온(朴洸瑥),윤영찬(尹永燦),97,132,229,0
22392,박광온(朴洸瑥),윤재갑(尹才鉀),89,76,165,0
22393,박광온(朴洸瑥),윤재옥(尹在玉),50,4,54,1
22394,박광온(朴洸瑥),윤주경(尹柱卿),49,4,53,1
22395,박광온(朴洸瑥),윤준병(尹準炳),85,89,174,0
22396,박광온(朴洸瑥),윤창현(尹暢賢),49,4,53,1
22397,박광온(朴洸瑥),윤한홍(尹漢洪),51,5,56,1
22398,박광온(朴洸瑥),윤호중(尹昊重),80,60,140,0
22399,박광온(朴洸瑥),윤후덕(尹厚德),80,68,148,0
22400,박광온(朴洸瑥),이개호(李介昊),91,101,192,0
22401,박광온(朴洸瑥),이달곤(李達坤),52,5,57,1
22402,박광온(朴洸瑥),이동주(李東洲),82,84,166,0
22403,박광온(朴洸瑥),이만희(李晩熙),51,4,55,1
22404,박광온(朴洸瑥),이명수(李明洙),51,8,59,1
22405,박광온(朴洸瑥),이병훈(李炳勳),108,146,254,0
22406,박광온(朴洸瑥),이상민(李相珉),81,39,120,0
22407,박광온(朴洸瑥),이상헌(李相憲),84,58,142,0
22408,박광온(朴洸瑥),이성만(李成萬),81,62,143,1
22409,박광온(朴洸瑥),이소영(李素永),88,60,148,0
22410,박광온(朴洸瑥),이수진(李壽珍),91,71,162,0
22411,박광온(朴洸瑥),이수진(李秀眞),95,74,169,0
22412,박광온(朴洸瑥),이양수(李亮壽),52,4,56,1
22413,박광온(朴洸瑥),이용(李鏞),50,4,54,1
22414,박광온(朴洸瑥),이용빈(李龍彬),111,118,229,0
22415,박광온(朴洸瑥),이용선(李庸瑄),88,72,160,0
22416,박광온(朴洸瑥),이용우(李龍雨),93,72,165,0
22417,박광온(朴洸瑥),이용호(李容鎬),27,9,36,1
22418,박광온(朴洸瑥),이원욱(李元旭),91,104,195,0
22419,박광온(朴洸瑥),이원택(李源澤),86,66,152,0
22420,박광온(朴洸瑥),이은주(李恩周),15,17,32,1
22421,박광온(朴洸瑥),이인선(李仁善),25,4,29,1
22422,박광온(朴洸瑥),이인영(李仁榮),74,49,123,0
22423,박광온(朴洸瑥),이장섭(李將燮),115,176,291,0
22424,박광온(朴洸瑥),이재명(李在明),39,22,61,0
22425,박광온(朴洸瑥),이재정(李在汀),83,52,135,0
22426,박광온(朴洸瑥),이정문(李楨文),90,88,178,0
22427,박광온(朴洸瑥),이종배(李鍾培),51,6,57,1
22428,박광온(朴洸瑥),이종성(李鍾成),50,4,54,1
22429,박광온(朴洸瑥),이주환(李周桓),50,4,54,1
22430,박광온(朴洸瑥),이채익(李埰益),51,11,62,1
22431,박광온(朴洸瑥),이철규(李喆圭),51,4,55,1
22432,박광온(朴洸瑥),이탄희(李誕熙),96,110,206,0
22433,박광온(朴洸瑥),이태규(李泰珪),28,4,32,1
22434,박광온(朴洸瑥),이학영(李學永),123,95,218,0
22435,박광온(朴洸瑥),이해식(李海植),89,52,141,0
22436,박광온(朴洸瑥),이헌승(李憲昇),50,4,54,1
22437,박광온(朴洸瑥),이형석(李炯錫),96,72,168,0
22438,박광온(朴洸瑥),인재근(印在謹),89,64,153,0
22439,박광온(朴洸瑥),임병헌(林炳憲),25,4,29,1
22440,박광온(朴洸瑥),임오경(林五卿),86,72,158,0
22441,박광온(朴洸瑥),임이자(林利子),49,4,53,1
22442,박광온(朴洸瑥),임종성(林鍾聲),88,77,165,0
22443,박광온(朴洸瑥),임호선(林昊宣),116,193,309,0
22444,박광온(朴洸瑥),장경태(張耿態),97,83,180,0
22445,박광온(朴洸瑥),장동혁(張東赫),25,4,29,1
22446,박광온(朴洸瑥),장제원(張濟元),49,4,53,1
22447,박광온(朴洸瑥),장철민(張喆敏),87,68,155,0
22448,박광온(朴洸瑥),장혜영(張惠英),18,12,30,1
22449,박광온(朴洸瑥),전봉민(田奉珉),35,5,40,1
22450,박광온(朴洸瑥),전용기(田溶冀),111,154,265,0
22451,박광온(朴洸瑥),전재수(田載秀),108,70,178,0
22452,박광온(朴洸瑥),전주혜(全珠惠),52,4,56,1
22453,박광온(朴洸瑥),전해철(全海澈),82,67,149,0
22454,박광온(朴洸瑥),전혜숙(全惠淑),92,82,174,0
22455,박광온(朴洸瑥),정경희(丁慶姬),50,4,54,1
22456,박광온(朴洸瑥),정동만(鄭東萬),49,4,53,1
22457,박광온(朴洸瑥),정성호(鄭成湖),80,59,139,0
22458,박광온(朴洸瑥),정우택(鄭宇澤),26,5,31,1
22459,박광온(朴洸瑥),정운천(鄭雲天),50,5,55,1
22460,박광온(朴洸瑥),정일영(鄭日永),81,59,140,0
22461,박광온(朴洸瑥),정점식(鄭点植),50,4,54,1
22462,박광온(朴洸瑥),정진석(鄭鎭碩),50,4,54,1
22463,박광온(朴洸瑥),정청래(鄭淸來),85,53,138,0
22464,박광온(朴洸瑥),정춘숙(鄭春淑),90,66,156,0
22465,박광온(朴洸瑥),정태호(鄭泰浩),87,78,165,0
22466,박광온(朴洸瑥),정필모(鄭必模),101,103,204,0
22467,박광온(朴洸瑥),정희용(鄭熙溶),50,5,55,1
22468,박광온(朴洸瑥),조경태(趙慶泰),50,4,54,1
22469,박광온(朴洸瑥),조명희(曺明姬),50,5,55,1
22470,박광온(朴洸瑥),조수진(趙修眞),51,4,55,1
22471,박광온(朴洸瑥),조승래(趙承來),89,61,150,0
22472,박광온(朴洸瑥),조오섭(曺五燮),94,96,190,0
22473,박광온(朴洸瑥),조은희(趙恩禧),26,4,30,1
22474,박광온(朴洸瑥),조응천(趙應天),84,35,119,0
22475,박광온(朴洸瑥),조정식(趙正湜),78,38,116,0
22476,박광온(朴洸瑥),조정훈(趙廷訓),0,4,4,1
22477,박광온(朴洸瑥),조해진(曺海珍),52,5,57,1
22478,박광온(朴洸瑥),주철현(朱哲鉉),92,66,158,0
22479,박광온(朴洸瑥),주호영(朱豪英),49,4,53,1
22480,박광온(朴洸瑥),지성호(池成浩),50,4,54,1
22481,박광온(朴洸瑥),진선미(陳善美),83,43,126,0
22482,박광온(朴洸瑥),진성준(陳聲準),89,70,159,0
22483,박광온(朴洸瑥),천준호(千俊鎬),86,57,143,0
22484,박광온(朴洸瑥),최기상(崔基相),81,51,132,0
22485,박광온(朴洸瑥),최승재(崔承宰),50,4,54,1
22486,박광온(朴洸瑥),최연숙(崔姸淑),29,10,39,1
22487,박광온(朴洸瑥),최영희(崔英姬),25,6,31,1
22488,박광온(朴洸瑥),최인호(崔仁昊),100,89,189,0
22489,박광온(朴洸瑥),최재형(崔在亨),25,5,30,1
22490,박광온(朴洸瑥),최종윤(崔鍾允),88,95,183,0
22491,박광온(朴洸瑥),최춘식(崔春植),49,5,54,1
22492,박광온(朴洸瑥),최형두(崔炯斗),51,4,55,1
22493,박광온(朴洸瑥),최혜영(崔惠英),98,88,186,0
22494,박광온(朴洸瑥),추경호(秋慶鎬),49,4,53,1
22495,박광온(朴洸瑥),태영호(太永浩),49,4,53,1
22496,박광온(朴洸瑥),하영제(河榮帝),42,1,43,1
22497,박광온(朴洸瑥),하태경(河泰慶),49,4,53,1
22498,박광온(朴洸瑥),한기호(韓起鎬),51,4,55,1
22499,박광온(朴洸瑥),한무경(韓茂景),49,4,53,1
22500,박광온(朴洸瑥),한병도(韓秉道),105,100,205,0
22501,박광온(朴洸瑥),한정애(韓貞愛),78,56,134,0
22502,박광온(朴洸瑥),한준호(韓俊鎬),97,81,178,0
22503,박광온(朴洸瑥),허숙정(許淑湞),1,1,2,0
22504,박광온(朴洸瑥),허영(許榮),101,87,188,0
22505,박광온(朴洸瑥),허은아(許垠娥),49,5,54,1
22506,박광온(朴洸瑥),허종식(許琮植),83,73,156,0
22507,박광온(朴洸瑥),홍기원(洪起元),88,80,168,0
22508,박광온(朴洸瑥),홍문표(洪文杓),50,5,55,1
22509,박광온(朴洸瑥),홍석준(洪碩晙),50,4,54,1
22510,박광온(朴洸瑥),홍성국(洪性國),95,124,219,0
22511,박광온(朴洸瑥),홍영표(洪永杓),83,65,148,0
22512,박광온(朴洸瑥),홍익표(洪翼杓),92,120,212,0
22513,박광온(朴洸瑥),홍정민(洪貞敏),95,84,179,0
22514,박광온(朴洸瑥),황보승희(皇甫承希),48,2,50,1
22515,박광온(朴洸瑥),황운하(黃雲夏),89,75,164,0
22516,박광온(朴洸瑥),황희(黃熙),86,50,136,0
22517,박대수(朴大壽),박대출(朴大出),79,108,187,0
22518,박대수(朴大壽),박덕흠(朴德欽),134,348,482,0
22519,박대수(朴大壽),박범계(朴範界),49,4,53,1
22520,박대수(朴大壽),박병석(朴炳錫),25,3,28,1
22521,박대수(朴大壽),박상혁(朴商赫),52,13,65,1
22522,박대수(朴大壽),박성민(朴聖敏),118,321,439,0
22523,박대수(朴大壽),박성준(朴省俊),49,11,60,1
22524,박대수(朴大壽),박성중(朴成重),78,127,205,0
22525,박대수(朴大壽),박수영(朴洙瑩),77,82,159,0
22526,박대수(朴大壽),박영순(朴英淳),51,8,59,1
22527,박대수(朴大壽),박완주(朴完柱),25,1,26,1
22528,박대수(朴大壽),박용진(朴用鎭),49,14,63,1
22529,박대수(朴大壽),박재호(朴在昊),51,5,56,1
22530,박대수(朴大壽),박정(朴釘),50,6,56,1
22531,박대수(朴大壽),박정하(朴正河),37,67,104,0
22532,박대수(朴大壽),박주민(朴柱民),49,7,56,1
22533,박대수(朴大壽),박진(朴振),82,109,191,0
22534,박대수(朴大壽),박찬대(朴贊大),50,4,54,1
22535,박대수(朴大壽),박형수(朴亨修),74,75,149,0
22536,박대수(朴大壽),박홍근(朴洪根),51,11,62,1
22537,박대수(朴大壽),배준영(裵俊英),100,154,254,0
22538,박대수(朴大壽),배진교(裵晋敎),6,6,12,1
22539,박대수(朴大壽),배현진(裵賢鎭),80,92,172,0
22540,박대수(朴大壽),백종헌(白宗憲),122,314,436,0
22541,박대수(朴大壽),백혜련(白惠蓮),50,7,57,1
22542,박대수(朴大壽),변재일(卞在一),51,6,57,1
22543,박대수(朴大壽),서동용(徐東榕),49,6,55,1
22544,박대수(朴大壽),서범수(徐範洙),104,173,277,0
22545,박대수(朴大壽),서병수(徐秉洙),89,161,250,0
22546,박대수(朴大壽),서삼석(徐參錫),51,7,58,1
22547,박대수(朴大壽),서영교(徐瑛敎),52,8,60,1
22548,박대수(朴大壽),서영석(徐暎錫),53,12,65,1
22549,박대수(朴大壽),서일준(徐一俊),158,322,480,0
22550,박대수(朴大壽),서정숙(徐正淑),82,154,236,0
22551,박대수(朴大壽),설훈(薛勳),50,7,57,1
22552,박대수(朴大壽),성일종(成一鍾),137,289,426,0
22553,박대수(朴大壽),소병철(蘇秉哲),52,6,58,1
22554,박대수(朴大壽),소병훈(蘇秉勳),53,6,59,1
22555,박대수(朴大壽),송갑석(宋甲錫),51,6,57,1
22556,박대수(朴大壽),송기헌(宋基憲),50,6,56,1
22557,박대수(朴大壽),송석준(宋錫俊),84,121,205,0
22558,박대수(朴大壽),송언석(宋彦錫),109,130,239,0
22559,박대수(朴大壽),송옥주(宋玉珠),51,22,73,1
22560,박대수(朴大壽),송재호(宋在祜),50,5,55,1
22561,박대수(朴大壽),신동근(申東根),49,6,55,1
22562,박대수(朴大壽),신영대(申榮大),49,8,57,1
22563,박대수(朴大壽),신원식(申源湜),82,128,210,0
22564,박대수(朴大壽),신정훈(辛正勳),50,6,56,1
22565,박대수(朴大壽),신현영(申賢榮),51,5,56,1
22566,박대수(朴大壽),심상정(沈相奵),6,9,15,1
22567,박대수(朴大壽),안규백(安圭伯),52,10,62,1
22568,박대수(朴大壽),안민석(安敏錫),49,4,53,1
22569,박대수(朴大壽),안병길(安炳吉),115,264,379,0
22570,박대수(朴大壽),안철수(安哲秀),29,42,71,0
22571,박대수(朴大壽),안호영(安浩永),52,11,63,1
22572,박대수(朴大壽),양경숙(梁敬淑),50,6,56,1
22573,박대수(朴大壽),양금희(梁琴喜),115,202,317,0
22574,박대수(朴大壽),양기대(梁基大),52,9,61,1
22575,박대수(朴大壽),양이원영(梁李媛瑛),46,7,53,1
22576,박대수(朴大壽),양정숙(梁貞淑),3,25,28,1
22577,박대수(朴大壽),양향자(梁香子),24,26,50,1
22578,박대수(朴大壽),어기구(魚基龜),50,8,58,1
22579,박대수(朴大壽),엄태영(嚴泰永),91,138,229,0
22580,박대수(朴大壽),오기형(吳奇炯),50,9,59,1
22581,박대수(朴大壽),오영환(吳永煥),52,12,64,1
22582,박대수(朴大壽),용혜인(龍慧仁),1,14,15,1
22583,박대수(朴大壽),우상호(禹相虎),50,4,54,1
22584,박대수(朴大壽),우원식(禹元植),50,8,58,1
22585,박대수(朴大壽),위성곤(魏聖坤),50,6,56,1
22586,박대수(朴大壽),유경준(兪京濬),105,172,277,0
22587,박대수(朴大壽),유기홍(柳基洪),49,4,53,1
22588,박대수(朴大壽),유동수(柳東秀),54,11,65,1
22589,박대수(朴大壽),유상범(劉相凡),72,98,170,0
22590,박대수(朴大壽),유의동(兪義東),81,119,200,0
22591,박대수(朴大壽),유정주(兪訂炷),50,7,57,1
22592,박대수(朴大壽),윤건영(尹建永),49,7,56,1
22593,박대수(朴大壽),윤관석(尹官石),40,2,42,1
22594,박대수(朴大壽),윤두현(尹斗鉉),87,160,247,0
22595,박대수(朴大壽),윤미향(尹美香),21,9,30,1
22596,박대수(朴大壽),윤상현(尹相現),46,80,126,0
22597,박대수(朴大壽),윤영덕(尹永德),51,10,61,1
22598,박대수(朴大壽),윤영석(尹永碩),98,121,219,0
22599,박대수(朴大壽),윤영찬(尹永燦),50,6,56,1
22600,박대수(朴大壽),윤재갑(尹才鉀),50,9,59,1
22601,박대수(朴大壽),윤재옥(尹在玉),81,78,159,0
22602,박대수(朴大壽),윤주경(尹柱卿),78,112,190,0
22603,박대수(朴大壽),윤준병(尹準炳),50,10,60,1
22604,박대수(朴大壽),윤창현(尹暢賢),137,218,355,0
22605,박대수(朴大壽),윤한홍(尹漢洪),76,132,208,0
22606,박대수(朴大壽),윤호중(尹昊重),51,5,56,1
22607,박대수(朴大壽),윤후덕(尹厚德),49,7,56,1
22608,박대수(朴大壽),이개호(李介昊),51,6,57,1
22609,박대수(朴大壽),이달곤(李達坤),76,107,183,0
22610,박대수(朴大壽),이동주(李東洲),52,11,63,1
22611,박대수(朴大壽),이만희(李晩熙),83,81,164,0
22612,박대수(朴大壽),이명수(李明洙),118,232,350,0
22613,박대수(朴大壽),이병훈(李炳勳),52,11,63,1
22614,박대수(朴大壽),이상민(李相珉),50,6,56,1
22615,박대수(朴大壽),이상헌(李相憲),50,11,61,1
22616,박대수(朴大壽),이성만(李成萬),40,2,42,1
22617,박대수(朴大壽),이소영(李素永),51,7,58,1
22618,박대수(朴大壽),이수진(李壽珍),51,25,76,1
22619,박대수(朴大壽),이수진(李秀眞),50,9,59,1
22620,박대수(朴大壽),이양수(李亮壽),88,120,208,0
22621,박대수(朴大壽),이용(李鏞),94,186,280,0
22622,박대수(朴大壽),이용빈(李龍彬),53,13,66,1
22623,박대수(朴大壽),이용선(李庸瑄),50,9,59,1
22624,박대수(朴大壽),이용우(李龍雨),52,16,68,1
22625,박대수(朴大壽),이용호(李容鎬),34,36,70,0
22626,박대수(朴大壽),이원욱(李元旭),53,13,66,1
22627,박대수(朴大壽),이원택(李源澤),50,6,56,1
22628,박대수(朴大壽),이은주(李恩周),6,13,19,1
22629,박대수(朴大壽),이인선(李仁善),35,154,189,0
22630,박대수(朴大壽),이인영(李仁榮),49,4,53,1
22631,박대수(朴大壽),이장섭(李將燮),49,5,54,1
22632,박대수(朴大壽),이재명(李在明),25,4,29,1
22633,박대수(朴大壽),이재정(李在汀),49,6,55,1
22634,박대수(朴大壽),이정문(李楨文),49,9,58,1
22635,박대수(朴大壽),이종배(李鍾培),135,312,447,0
22636,박대수(朴大壽),이종성(李鍾成),179,443,622,0
22637,박대수(朴大壽),이주환(李周桓),152,356,508,0
22638,박대수(朴大壽),이채익(李埰益),90,147,237,0
22639,박대수(朴大壽),이철규(李喆圭),103,128,231,0
22640,박대수(朴大壽),이탄희(李誕熙),49,6,55,1
22641,박대수(朴大壽),이태규(李泰珪),59,75,134,0
22642,박대수(朴大壽),이학영(李學永),50,14,64,1
22643,박대수(朴大壽),이해식(李海植),51,6,57,1
22644,박대수(朴大壽),이헌승(李憲昇),81,212,293,0
22645,박대수(朴大壽),이형석(李炯錫),51,9,60,1
22646,박대수(朴大壽),인재근(印在謹),50,12,62,1
22647,박대수(朴大壽),임병헌(林炳憲),32,85,117,0
22648,박대수(朴大壽),임오경(林五卿),51,6,57,1
22649,박대수(朴大壽),임이자(林利子),157,249,406,0
22650,박대수(朴大壽),임종성(林鍾聲),52,12,64,1
22651,박대수(朴大壽),임호선(林昊宣),52,11,63,1
22652,박대수(朴大壽),장경태(張耿態),49,5,54,1
22653,박대수(朴大壽),장동혁(張東赫),35,63,98,0
22654,박대수(朴大壽),장제원(張濟元),62,58,120,0
22655,박대수(朴大壽),장철민(張喆敏),50,10,60,1
22656,박대수(朴大壽),장혜영(張惠英),7,8,15,1
22657,박대수(朴大壽),전봉민(田奉珉),78,230,308,0
22658,박대수(朴大壽),전용기(田溶冀),49,7,56,1
22659,박대수(朴大壽),전재수(田載秀),50,7,57,1
22660,박대수(朴大壽),전주혜(全珠惠),76,117,193,0
22661,박대수(朴大壽),전해철(全海澈),50,6,56,1
22662,박대수(朴大壽),전혜숙(全惠淑),50,11,61,1
22663,박대수(朴大壽),정경희(丁慶姬),92,113,205,0
22664,박대수(朴大壽),정동만(鄭東萬),88,170,258,0
22665,박대수(朴大壽),정성호(鄭成湖),50,5,55,1
22666,박대수(朴大壽),정우택(鄭宇澤),56,167,223,0
22667,박대수(朴大壽),정운천(鄭雲天),120,238,358,0
22668,박대수(朴大壽),정일영(鄭日永),50,7,57,1
22669,박대수(朴大壽),정점식(鄭点植),82,68,150,0
22670,박대수(朴大壽),정진석(鄭鎭碩),98,103,201,0
22671,박대수(朴大壽),정청래(鄭淸來),49,6,55,1
22672,박대수(朴大壽),정춘숙(鄭春淑),50,8,58,1
22673,박대수(朴大壽),정태호(鄭泰浩),49,8,57,1
22674,박대수(朴大壽),정필모(鄭必模),50,6,56,1
22675,박대수(朴大壽),정희용(鄭熙溶),114,229,343,0
22676,박대수(朴大壽),조경태(趙慶泰),93,102,195,0
22677,박대수(朴大壽),조명희(曺明姬),146,317,463,0
22678,박대수(朴大壽),조수진(趙修眞),95,179,274,0
22679,박대수(朴大壽),조승래(趙承來),49,12,61,1
22680,박대수(朴大壽),조오섭(曺五燮),54,11,65,1
22681,박대수(朴大壽),조은희(趙恩禧),38,92,130,0
22682,박대수(朴大壽),조응천(趙應天),49,3,52,1
22683,박대수(朴大壽),조정식(趙正湜),50,8,58,1
22684,박대수(朴大壽),조정훈(趙廷訓),2,23,25,1
22685,박대수(朴大壽),조해진(曺海珍),65,51,116,0
22686,박대수(朴大壽),주철현(朱哲鉉),51,7,58,1
22687,박대수(朴大壽),주호영(朱豪英),74,87,161,0
22688,박대수(朴大壽),지성호(池成浩),147,386,533,0
22689,박대수(朴大壽),진선미(陳善美),50,5,55,1
22690,박대수(朴大壽),진성준(陳聲準),49,8,57,1
22691,박대수(朴大壽),천준호(千俊鎬),50,5,55,1
22692,박대수(朴大壽),최기상(崔基相),50,4,54,1
22693,박대수(朴大壽),최승재(崔承宰),94,153,247,0
22694,박대수(朴大壽),최연숙(崔姸淑),49,94,143,0
22695,박대수(朴大壽),최영희(崔英姬),52,189,241,0
22696,박대수(朴大壽),최인호(崔仁昊),51,7,58,1
22697,박대수(朴大壽),최재형(崔在亨),37,23,60,0
22698,박대수(朴大壽),최종윤(崔鍾允),51,6,57,1
22699,박대수(朴大壽),최춘식(崔春植),135,340,475,0
22700,박대수(朴大壽),최형두(崔炯斗),90,138,228,0
22701,박대수(朴大壽),최혜영(崔惠英),50,11,61,1
22702,박대수(朴大壽),추경호(秋慶鎬),146,193,339,0
22703,박대수(朴大壽),태영호(太永浩),134,305,439,0
22704,박대수(朴大壽),하영제(河榮帝),130,244,374,1
22705,박대수(朴大壽),하태경(河泰慶),71,60,131,0
22706,박대수(朴大壽),한기호(韓起鎬),83,66,149,0
22707,박대수(朴大壽),한무경(韓茂景),121,214,335,0
22708,박대수(朴大壽),한병도(韓秉道),51,7,58,1
22709,박대수(朴大壽),한정애(韓貞愛),50,12,62,1
22710,박대수(朴大壽),한준호(韓俊鎬),49,7,56,1
22711,박대수(朴大壽),허숙정(許淑湞),0,0,0,1
22712,박대수(朴大壽),허영(許榮),52,5,57,1
22713,박대수(朴大壽),허은아(許垠娥),89,127,216,0
22714,박대수(朴大壽),허종식(許琮植),54,14,68,1
22715,박대수(朴大壽),홍기원(洪起元),51,10,61,1
22716,박대수(朴大壽),홍문표(洪文杓),92,135,227,0
22717,박대수(朴大壽),홍석준(洪碩晙),86,128,214,0
22718,박대수(朴大壽),홍성국(洪性國),51,6,57,1
22719,박대수(朴大壽),홍영표(洪永杓),50,6,56,1
22720,박대수(朴大壽),홍익표(洪翼杓),50,5,55,1
22721,박대수(朴大壽),홍정민(洪貞敏),50,10,60,1
22722,박대수(朴大壽),황보승희(皇甫承希),102,192,294,1
22723,박대수(朴大壽),황운하(黃雲夏),50,10,60,1
22724,박대수(朴大壽),황희(黃熙),49,12,61,1
22725,박대출(朴大出),박덕흠(朴德欽),53,67,120,0
22726,박대출(朴大出),박범계(朴範界),50,4,54,1
22727,박대출(朴大出),박병석(朴炳錫),25,3,28,1
22728,박대출(朴大出),박상혁(朴商赫),50,4,54,1
22729,박대출(朴大出),박성민(朴聖敏),79,103,182,0
22730,박대출(朴大出),박성준(朴省俊),50,5,55,1
22731,박대출(朴大出),박성중(朴成重),71,67,138,0
22732,박대출(朴大出),박수영(朴洙瑩),65,51,116,0
22733,박대출(朴大出),박영순(朴英淳),51,3,54,1
22734,박대출(朴大出),박완주(朴完柱),25,0,25,1
22735,박대출(朴大出),박용진(朴用鎭),49,5,54,1
22736,박대출(朴大出),박재호(朴在昊),50,5,55,1
22737,박대출(朴大出),박정(朴釘),50,5,55,1
22738,박대출(朴大出),박정하(朴正河),31,17,48,0
22739,박대출(朴大出),박주민(朴柱民),50,4,54,1
22740,박대출(朴大出),박진(朴振),67,66,133,0
22741,박대출(朴大出),박찬대(朴贊大),51,4,55,1
22742,박대출(朴大出),박형수(朴亨修),64,46,110,0
22743,박대출(朴大出),박홍근(朴洪根),50,4,54,1
22744,박대출(朴大出),배준영(裵俊英),73,59,132,0
22745,박대출(朴大出),배진교(裵晋敎),5,2,7,1
22746,박대출(朴大出),배현진(裵賢鎭),68,55,123,0
22747,박대출(朴大出),백종헌(白宗憲),73,87,160,0
22748,박대출(朴大出),백혜련(白惠蓮),51,4,55,1
22749,박대출(朴大出),변재일(卞在一),50,4,54,1
22750,박대출(朴大出),서동용(徐東榕),50,4,54,1
22751,박대출(朴大出),서범수(徐範洙),73,57,130,0
22752,박대출(朴大出),서병수(徐秉洙),75,65,140,0
22753,박대출(朴大出),서삼석(徐參錫),49,4,53,1
22754,박대출(朴大出),서영교(徐瑛敎),53,5,58,1
22755,박대출(朴大出),서영석(徐暎錫),49,4,53,1
22756,박대출(朴大出),서일준(徐一俊),83,112,195,0
22757,박대출(朴大出),서정숙(徐正淑),67,58,125,0
22758,박대출(朴大出),설훈(薛勳),52,4,56,1
22759,박대출(朴大出),성일종(成一鍾),70,68,138,0
22760,박대출(朴大出),소병철(蘇秉哲),51,4,55,1
22761,박대출(朴大出),소병훈(蘇秉勳),51,4,55,1
22762,박대출(朴大出),송갑석(宋甲錫),51,4,55,1
22763,박대출(朴大出),송기헌(宋基憲),51,4,55,1
22764,박대출(朴大出),송석준(宋錫俊),75,58,133,0
22765,박대출(朴大出),송언석(宋彦錫),72,69,141,0
22766,박대출(朴大出),송옥주(宋玉珠),50,3,53,1
22767,박대출(朴大出),송재호(宋在祜),51,4,55,1
22768,박대출(朴大出),신동근(申東根),50,4,54,1
22769,박대출(朴大出),신영대(申榮大),50,4,54,1
22770,박대출(朴大出),신원식(申源湜),74,77,151,0
22771,박대출(朴大出),신정훈(辛正勳),51,5,56,1
22772,박대출(朴大出),신현영(申賢榮),50,4,54,1
22773,박대출(朴大出),심상정(沈相奵),5,2,7,1
22774,박대출(朴大出),안규백(安圭伯),52,5,57,1
22775,박대출(朴大出),안민석(安敏錫),50,4,54,1
22776,박대출(朴大出),안병길(安炳吉),75,95,170,0
22777,박대출(朴大出),안철수(安哲秀),28,10,38,0
22778,박대출(朴大出),안호영(安浩永),50,4,54,1
22779,박대출(朴大出),양경숙(梁敬淑),50,5,55,1
22780,박대출(朴大出),양금희(梁琴喜),89,94,183,0
22781,박대출(朴大出),양기대(梁基大),50,5,55,1
22782,박대출(朴大出),양이원영(梁李媛瑛),45,4,49,1
22783,박대출(朴大出),양정숙(梁貞淑),2,0,2,1
22784,박대출(朴大出),양향자(梁香子),22,1,23,1
22785,박대출(朴大出),어기구(魚基龜),50,4,54,1
22786,박대출(朴大出),엄태영(嚴泰永),68,55,123,0
22787,박대출(朴大出),오기형(吳奇炯),49,4,53,1
22788,박대출(朴大出),오영환(吳永煥),50,6,56,1
22789,박대출(朴大出),용혜인(龍慧仁),1,1,2,1
22790,박대출(朴大出),우상호(禹相虎),51,4,55,1
22791,박대출(朴大出),우원식(禹元植),50,4,54,1
22792,박대출(朴大出),위성곤(魏聖坤),50,4,54,1
22793,박대출(朴大出),유경준(兪京濬),72,62,134,0
22794,박대출(朴大出),유기홍(柳基洪),50,4,54,1
22795,박대출(朴大出),유동수(柳東秀),51,4,55,1
22796,박대출(朴大出),유상범(劉相凡),65,61,126,0
22797,박대출(朴大出),유의동(兪義東),62,52,114,0
22798,박대출(朴大出),유정주(兪訂炷),49,5,54,1
22799,박대출(朴大出),윤건영(尹建永),49,3,52,1
22800,박대출(朴大出),윤관석(尹官石),41,0,41,1
22801,박대출(朴大出),윤두현(尹斗鉉),77,92,169,0
22802,박대출(朴大出),윤미향(尹美香),20,0,20,1
22803,박대출(朴大出),윤상현(尹相現),36,28,64,0
22804,박대출(朴大出),윤영덕(尹永德),49,4,53,1
22805,박대출(朴大出),윤영석(尹永碩),70,56,126,0
22806,박대출(朴大出),윤영찬(尹永燦),50,4,54,1
22807,박대출(朴大出),윤재갑(尹才鉀),51,4,55,1
22808,박대출(朴大出),윤재옥(尹在玉),63,51,114,0
22809,박대출(朴大出),윤주경(尹柱卿),65,55,120,0
22810,박대출(朴大出),윤준병(尹準炳),50,4,54,1
22811,박대출(朴大出),윤창현(尹暢賢),73,76,149,0
22812,박대출(朴大出),윤한홍(尹漢洪),66,57,123,0
22813,박대출(朴大出),윤호중(尹昊重),51,4,55,1
22814,박대출(朴大出),윤후덕(尹厚德),50,5,55,1
22815,박대출(朴大出),이개호(李介昊),51,4,55,1
22816,박대출(朴大出),이달곤(李達坤),62,64,126,0
22817,박대출(朴大出),이동주(李東洲),49,4,53,1
22818,박대출(朴大出),이만희(李晩熙),72,75,147,0
22819,박대출(朴大出),이명수(李明洙),78,80,158,0
22820,박대출(朴大出),이병훈(李炳勳),51,6,57,1
22821,박대출(朴大出),이상민(李相珉),50,4,54,1
22822,박대출(朴大出),이상헌(李相憲),51,6,57,1
22823,박대출(朴大出),이성만(李成萬),41,0,41,1
22824,박대출(朴大出),이소영(李素永),51,4,55,1
22825,박대출(朴大出),이수진(李壽珍),50,4,54,1
22826,박대출(朴大出),이수진(李秀眞),50,4,54,1
22827,박대출(朴大出),이양수(李亮壽),71,77,148,0
22828,박대출(朴大出),이용(李鏞),73,72,145,0
22829,박대출(朴大出),이용빈(李龍彬),52,4,56,1
22830,박대출(朴大出),이용선(李庸瑄),50,4,54,1
22831,박대출(朴大出),이용우(李龍雨),49,5,54,1
22832,박대출(朴大出),이용호(李容鎬),29,13,42,0
22833,박대출(朴大出),이원욱(李元旭),52,4,56,1
22834,박대출(朴大出),이원택(李源澤),50,4,54,1
22835,박대출(朴大出),이은주(李恩周),5,2,7,1
22836,박대출(朴大出),이인선(李仁善),30,12,42,0
22837,박대출(朴大出),이인영(李仁榮),50,4,54,1
22838,박대출(朴大出),이장섭(李將燮),50,4,54,1
22839,박대출(朴大出),이재명(李在明),25,4,29,1
22840,박대출(朴大出),이재정(李在汀),50,4,54,1
22841,박대출(朴大出),이정문(李楨文),50,4,54,1
22842,박대출(朴大出),이종배(李鍾培),72,62,134,0
22843,박대출(朴大出),이종성(李鍾成),79,109,188,0
22844,박대출(朴大出),이주환(李周桓),77,94,171,0
22845,박대출(朴大出),이채익(李埰益),67,54,121,0
22846,박대출(朴大出),이철규(李喆圭),69,57,126,0
22847,박대출(朴大出),이탄희(李誕熙),50,4,54,1
22848,박대출(朴大出),이태규(李泰珪),39,31,70,0
22849,박대출(朴大出),이학영(李學永),49,4,53,1
22850,박대출(朴大出),이해식(李海植),51,4,55,1
22851,박대출(朴大出),이헌승(李憲昇),61,52,113,0
22852,박대출(朴大出),이형석(李炯錫),50,4,54,1
22853,박대출(朴大出),인재근(印在謹),50,4,54,1
22854,박대출(朴大出),임병헌(林炳憲),36,23,59,0
22855,박대출(朴大出),임오경(林五卿),50,5,55,1
22856,박대출(朴大出),임이자(林利子),66,48,114,0
22857,박대출(朴大出),임종성(林鍾聲),51,4,55,1
22858,박대출(朴大出),임호선(林昊宣),51,4,55,1
22859,박대출(朴大出),장경태(張耿態),50,4,54,1
22860,박대출(朴大出),장동혁(張東赫),29,17,46,0
22861,박대출(朴大出),장제원(張濟元),62,38,100,0
22862,박대출(朴大出),장철민(張喆敏),51,4,55,1
22863,박대출(朴大出),장혜영(張惠英),6,3,9,1
22864,박대출(朴大出),전봉민(田奉珉),48,46,94,0
22865,박대출(朴大出),전용기(田溶冀),51,4,55,1
22866,박대출(朴大出),전재수(田載秀),50,4,54,1
22867,박대출(朴大出),전주혜(全珠惠),72,58,130,0
22868,박대출(朴大出),전해철(全海澈),52,4,56,1
22869,박대출(朴大出),전혜숙(全惠淑),50,4,54,1
22870,박대출(朴大出),정경희(丁慶姬),76,71,147,0
22871,박대출(朴大出),정동만(鄭東萬),67,64,131,0
22872,박대출(朴大出),정성호(鄭成湖),52,4,56,1
22873,박대출(朴大出),정우택(鄭宇澤),36,27,63,0
22874,박대출(朴大出),정운천(鄭雲天),63,47,110,0
22875,박대출(朴大出),정일영(鄭日永),49,4,53,1
22876,박대출(朴大出),정점식(鄭点植),64,57,121,0
22877,박대출(朴大出),정진석(鄭鎭碩),68,63,131,0
22878,박대출(朴大出),정청래(鄭淸來),49,5,54,1
22879,박대출(朴大出),정춘숙(鄭春淑),50,4,54,1
22880,박대출(朴大出),정태호(鄭泰浩),50,4,54,1
22881,박대출(朴大出),정필모(鄭必模),50,4,54,1
22882,박대출(朴大出),정희용(鄭熙溶),74,56,130,0
22883,박대출(朴大出),조경태(趙慶泰),66,46,112,0
22884,박대출(朴大出),조명희(曺明姬),79,123,202,0
22885,박대출(朴大出),조수진(趙修眞),79,74,153,0
22886,박대출(朴大出),조승래(趙承來),50,5,55,1
22887,박대출(朴大出),조오섭(曺五燮),50,4,54,1
22888,박대출(朴大出),조은희(趙恩禧),32,28,60,0
22889,박대출(朴大出),조응천(趙應天),50,3,53,1
22890,박대출(朴大出),조정식(趙正湜),49,3,52,1
22891,박대출(朴大出),조정훈(趙廷訓),0,1,1,1
22892,박대출(朴大出),조해진(曺海珍),63,39,102,0
22893,박대출(朴大出),주철현(朱哲鉉),51,5,56,1
22894,박대출(朴大出),주호영(朱豪英),63,38,101,0
22895,박대출(朴大出),지성호(池成浩),78,71,149,0
22896,박대출(朴大出),진선미(陳善美),50,4,54,1
22897,박대출(朴大出),진성준(陳聲準),50,4,54,1
22898,박대출(朴大出),천준호(千俊鎬),49,3,52,1
22899,박대출(朴大出),최기상(崔基相),50,4,54,1
22900,박대출(朴大出),최승재(崔承宰),72,60,132,0
22901,박대출(朴大出),최연숙(崔姸淑),35,30,65,0
22902,박대출(朴大出),최영희(崔英姬),32,19,51,0
22903,박대출(朴大出),최인호(崔仁昊),51,4,55,1
22904,박대출(朴大出),최재형(崔在亨),26,11,37,0
22905,박대출(朴大出),최종윤(崔鍾允),51,4,55,1
22906,박대출(朴大出),최춘식(崔春植),67,85,152,0
22907,박대출(朴大出),최형두(崔炯斗),69,69,138,0
22908,박대출(朴大出),최혜영(崔惠英),50,4,54,1
22909,박대출(朴大出),추경호(秋慶鎬),65,68,133,0
22910,박대출(朴大出),태영호(太永浩),82,73,155,0
22911,박대출(朴大出),하영제(河榮帝),67,80,147,1
22912,박대출(朴大出),하태경(河泰慶),61,35,96,0
22913,박대출(朴大出),한기호(韓起鎬),65,51,116,0
22914,박대출(朴大出),한무경(韓茂景),74,95,169,0
22915,박대출(朴大出),한병도(韓秉道),50,5,55,1
22916,박대출(朴大出),한정애(韓貞愛),50,5,55,1
22917,박대출(朴大出),한준호(韓俊鎬),50,4,54,1
22918,박대출(朴大出),허숙정(許淑湞),0,0,0,1
22919,박대출(朴大出),허영(許榮),51,4,55,1
22920,박대출(朴大出),허은아(許垠娥),67,52,119,0
22921,박대출(朴大出),허종식(許琮植),51,4,55,1
22922,박대출(朴大出),홍기원(洪起元),50,4,54,1
22923,박대출(朴大出),홍문표(洪文杓),66,45,111,0
22924,박대출(朴大出),홍석준(洪碩晙),61,55,116,0
22925,박대출(朴大出),홍성국(洪性國),50,4,54,1
22926,박대출(朴大出),홍영표(洪永杓),50,4,54,1
22927,박대출(朴大出),홍익표(洪翼杓),51,4,55,1
22928,박대출(朴大出),홍정민(洪貞敏),52,4,56,1
22929,박대출(朴大出),황보승희(皇甫承希),73,81,154,1
22930,박대출(朴大出),황운하(黃雲夏),50,5,55,1
22931,박대출(朴大出),황희(黃熙),49,5,54,1
22932,박덕흠(朴德欽),박범계(朴範界),36,4,40,1
22933,박덕흠(朴德欽),박병석(朴炳錫),26,4,30,1
22934,박덕흠(朴德欽),박상혁(朴商赫),37,7,44,1
22935,박덕흠(朴德欽),박성민(朴聖敏),74,224,298,0
22936,박덕흠(朴德欽),박성준(朴省俊),37,9,46,1
22937,박덕흠(朴德欽),박성중(朴成重),74,124,198,0
22938,박덕흠(朴德欽),박수영(朴洙瑩),56,43,99,0
22939,박덕흠(朴德欽),박영순(朴英淳),37,8,45,1
22940,박덕흠(朴德欽),박완주(朴完柱),10,0,10,1
22941,박덕흠(朴德欽),박용진(朴用鎭),35,8,43,1
22942,박덕흠(朴德欽),박재호(朴在昊),37,7,44,1
22943,박덕흠(朴德欽),박정(朴釘),37,10,47,1
22944,박덕흠(朴德欽),박정하(朴正河),42,65,107,0
22945,박덕흠(朴德欽),박주민(朴柱民),36,5,41,1
22946,박덕흠(朴德欽),박진(朴振),50,62,112,0
22947,박덕흠(朴德欽),박찬대(朴贊大),37,5,42,1
22948,박덕흠(朴德欽),박형수(朴亨修),47,58,105,0
22949,박덕흠(朴德欽),박홍근(朴洪根),35,4,39,1
22950,박덕흠(朴德欽),배준영(裵俊英),59,138,197,0
22951,박덕흠(朴德欽),배진교(裵晋敎),4,11,15,1
22952,박덕흠(朴德欽),배현진(裵賢鎭),61,51,112,0
22953,박덕흠(朴德欽),백종헌(白宗憲),88,213,301,0
22954,박덕흠(朴德欽),백혜련(白惠蓮),36,5,41,1
22955,박덕흠(朴德欽),변재일(卞在一),37,9,46,1
22956,박덕흠(朴德欽),서동용(徐東榕),38,8,46,1
22957,박덕흠(朴德欽),서범수(徐範洙),69,120,189,0
22958,박덕흠(朴德欽),서병수(徐秉洙),68,123,191,0
22959,박덕흠(朴德欽),서삼석(徐參錫),40,9,49,1
22960,박덕흠(朴德欽),서영교(徐瑛敎),37,11,48,1
22961,박덕흠(朴德欽),서영석(徐暎錫),35,8,43,1
22962,박덕흠(朴德欽),서일준(徐一俊),109,243,352,0
22963,박덕흠(朴德欽),서정숙(徐正淑),61,106,167,0
22964,박덕흠(朴德欽),설훈(薛勳),37,9,46,1
22965,박덕흠(朴德欽),성일종(成一鍾),106,306,412,0
22966,박덕흠(朴德欽),소병철(蘇秉哲),39,6,45,1
22967,박덕흠(朴德欽),소병훈(蘇秉勳),38,7,45,1
22968,박덕흠(朴德欽),송갑석(宋甲錫),36,8,44,1
22969,박덕흠(朴德欽),송기헌(宋基憲),37,10,47,1
22970,박덕흠(朴德欽),송석준(宋錫俊),68,124,192,0
22971,박덕흠(朴德欽),송언석(宋彦錫),90,125,215,0
22972,박덕흠(朴德欽),송옥주(宋玉珠),38,4,42,1
22973,박덕흠(朴德欽),송재호(宋在祜),36,12,48,1
22974,박덕흠(朴德欽),신동근(申東根),37,4,41,1
22975,박덕흠(朴德欽),신영대(申榮大),37,7,44,1
22976,박덕흠(朴德欽),신원식(申源湜),63,81,144,0
22977,박덕흠(朴德欽),신정훈(辛正勳),38,9,47,1
22978,박덕흠(朴德欽),신현영(申賢榮),35,5,40,1
22979,박덕흠(朴德欽),심상정(沈相奵),4,6,10,1
22980,박덕흠(朴德欽),안규백(安圭伯),41,15,56,1
22981,박덕흠(朴德欽),안민석(安敏錫),37,4,41,1
22982,박덕흠(朴德欽),안병길(安炳吉),76,110,186,0
22983,박덕흠(朴德欽),안철수(安哲秀),27,49,76,0
22984,박덕흠(朴德欽),안호영(安浩永),38,11,49,1
22985,박덕흠(朴德欽),양경숙(梁敬淑),36,5,41,1
22986,박덕흠(朴德欽),양금희(梁琴喜),84,124,208,0
22987,박덕흠(朴德欽),양기대(梁基大),36,10,46,1
22988,박덕흠(朴德欽),양이원영(梁李媛瑛),36,7,43,1
22989,박덕흠(朴德欽),양정숙(梁貞淑),7,22,29,1
22990,박덕흠(朴德欽),양향자(梁香子),10,9,19,1
22991,박덕흠(朴德欽),어기구(魚基龜),37,12,49,1
22992,박덕흠(朴德欽),엄태영(嚴泰永),94,160,254,0
22993,박덕흠(朴德欽),오기형(吳奇炯),34,4,38,1
22994,박덕흠(朴德欽),오영환(吳永煥),36,12,48,1
22995,박덕흠(朴德欽),용혜인(龍慧仁),1,2,3,1
22996,박덕흠(朴德欽),우상호(禹相虎),35,5,40,1
22997,박덕흠(朴德欽),우원식(禹元植),35,5,40,1
22998,박덕흠(朴德欽),위성곤(魏聖坤),41,22,63,1
22999,박덕흠(朴德欽),유경준(兪京濬),85,124,209,0
23000,박덕흠(朴德欽),유기홍(柳基洪),37,7,44,1
23001,박덕흠(朴德欽),유동수(柳東秀),39,8,47,1
23002,박덕흠(朴德欽),유상범(劉相凡),59,81,140,0
23003,박덕흠(朴德欽),유의동(兪義東),59,67,126,0
23004,박덕흠(朴德欽),유정주(兪訂炷),35,5,40,1
23005,박덕흠(朴德欽),윤건영(尹建永),35,6,41,1
23006,박덕흠(朴德欽),윤관석(尹官石),28,2,30,1
23007,박덕흠(朴德欽),윤두현(尹斗鉉),67,148,215,0
23008,박덕흠(朴德欽),윤미향(尹美香),11,0,11,1
23009,박덕흠(朴德欽),윤상현(尹相現),41,81,122,0
23010,박덕흠(朴德欽),윤영덕(尹永德),35,8,43,1
23011,박덕흠(朴德欽),윤영석(尹永碩),70,104,174,0
23012,박덕흠(朴德欽),윤영찬(尹永燦),36,7,43,1
23013,박덕흠(朴德欽),윤재갑(尹才鉀),50,32,82,1
23014,박덕흠(朴德欽),윤재옥(尹在玉),57,52,109,0
23015,박덕흠(朴德欽),윤주경(尹柱卿),57,75,132,0
23016,박덕흠(朴德欽),윤준병(尹準炳),37,17,54,1
23017,박덕흠(朴德欽),윤창현(尹暢賢),96,161,257,0
23018,박덕흠(朴德欽),윤한홍(尹漢洪),63,86,149,0
23019,박덕흠(朴德欽),윤호중(尹昊重),36,5,41,1
23020,박덕흠(朴德欽),윤후덕(尹厚德),36,8,44,1
23021,박덕흠(朴德欽),이개호(李介昊),41,8,49,1
23022,박덕흠(朴德欽),이달곤(李達坤),61,113,174,0
23023,박덕흠(朴德欽),이동주(李東洲),35,6,41,1
23024,박덕흠(朴德欽),이만희(李晩熙),61,62,123,0
23025,박덕흠(朴德欽),이명수(李明洙),120,284,404,0
23026,박덕흠(朴德欽),이병훈(李炳勳),39,8,47,1
23027,박덕흠(朴德欽),이상민(李相珉),37,5,42,1
23028,박덕흠(朴德欽),이상헌(李相憲),40,13,53,1
23029,박덕흠(朴德欽),이성만(李成萬),28,3,31,1
23030,박덕흠(朴德欽),이소영(李素永),37,6,43,1
23031,박덕흠(朴德欽),이수진(李壽珍),38,9,47,1
23032,박덕흠(朴德欽),이수진(李秀眞),36,10,46,1
23033,박덕흠(朴德欽),이양수(李亮壽),79,87,166,0
23034,박덕흠(朴德欽),이용(李鏞),82,130,212,0
23035,박덕흠(朴德欽),이용빈(李龍彬),39,10,49,1
23036,박덕흠(朴德欽),이용선(李庸瑄),37,11,48,1
23037,박덕흠(朴德欽),이용우(李龍雨),35,5,40,1
23038,박덕흠(朴德欽),이용호(李容鎬),38,60,98,0
23039,박덕흠(朴德欽),이원욱(李元旭),36,4,40,1
23040,박덕흠(朴德欽),이원택(李源澤),36,8,44,1
23041,박덕흠(朴德欽),이은주(李恩周),4,8,12,1
23042,박덕흠(朴德欽),이인선(李仁善),44,77,121,0
23043,박덕흠(朴德欽),이인영(李仁榮),36,5,41,1
23044,박덕흠(朴德欽),이장섭(李將燮),37,10,47,1
23045,박덕흠(朴德欽),이재명(李在明),26,5,31,1
23046,박덕흠(朴德欽),이재정(李在汀),36,5,41,1
23047,박덕흠(朴德欽),이정문(李楨文),35,11,46,1
23048,박덕흠(朴德欽),이종배(李鍾培),104,221,325,0
23049,박덕흠(朴德欽),이종성(李鍾成),106,266,372,0
23050,박덕흠(朴德欽),이주환(李周桓),90,163,253,0
23051,박덕흠(朴德欽),이채익(李埰益),78,187,265,0
23052,박덕흠(朴德欽),이철규(李喆圭),83,101,184,0
23053,박덕흠(朴德欽),이탄희(李誕熙),36,5,41,1
23054,박덕흠(朴德欽),이태규(李泰珪),47,67,114,0
23055,박덕흠(朴德欽),이학영(李學永),36,6,42,1
23056,박덕흠(朴德欽),이해식(李海植),38,6,44,1
23057,박덕흠(朴德欽),이헌승(李憲昇),57,163,220,0
23058,박덕흠(朴德欽),이형석(李炯錫),35,6,41,1
23059,박덕흠(朴德欽),인재근(印在謹),36,10,46,1
23060,박덕흠(朴德欽),임병헌(林炳憲),34,49,83,0
23061,박덕흠(朴德欽),임오경(林五卿),36,6,42,1
23062,박덕흠(朴德欽),임이자(林利子),102,157,259,0
23063,박덕흠(朴德欽),임종성(林鍾聲),41,6,47,1
23064,박덕흠(朴德欽),임호선(林昊宣),37,18,55,1
23065,박덕흠(朴德欽),장경태(張耿態),36,5,41,1
23066,박덕흠(朴德欽),장동혁(張東赫),36,67,103,0
23067,박덕흠(朴德欽),장제원(張濟元),50,53,103,0
23068,박덕흠(朴德欽),장철민(張喆敏),36,9,45,1
23069,박덕흠(朴德欽),장혜영(張惠英),7,6,13,1
23070,박덕흠(朴德欽),전봉민(田奉珉),63,95,158,0
23071,박덕흠(朴德欽),전용기(田溶冀),36,6,42,1
23072,박덕흠(朴德欽),전재수(田載秀),35,5,40,1
23073,박덕흠(朴德欽),전주혜(全珠惠),53,63,116,0
23074,박덕흠(朴德欽),전해철(全海澈),36,5,41,1
23075,박덕흠(朴德欽),전혜숙(全惠淑),37,8,45,1
23076,박덕흠(朴德欽),정경희(丁慶姬),55,83,138,0
23077,박덕흠(朴德欽),정동만(鄭東萬),67,102,169,0
23078,박덕흠(朴德欽),정성호(鄭成湖),37,5,42,1
23079,박덕흠(朴德欽),정우택(鄭宇澤),43,124,167,0
23080,박덕흠(朴德欽),정운천(鄭雲天),96,174,270,0
23081,박덕흠(朴德欽),정일영(鄭日永),36,5,41,1
23082,박덕흠(朴德欽),정점식(鄭点植),76,70,146,0
23083,박덕흠(朴德欽),정진석(鄭鎭碩),78,121,199,0
23084,박덕흠(朴德欽),정청래(鄭淸來),35,5,40,1
23085,박덕흠(朴德欽),정춘숙(鄭春淑),37,5,42,1
23086,박덕흠(朴德欽),정태호(鄭泰浩),36,6,42,1
23087,박덕흠(朴德欽),정필모(鄭必模),36,5,41,1
23088,박덕흠(朴德欽),정희용(鄭熙溶),102,182,284,0
23089,박덕흠(朴德欽),조경태(趙慶泰),72,134,206,0
23090,박덕흠(朴德欽),조명희(曺明姬),95,254,349,0
23091,박덕흠(朴德欽),조수진(趙修眞),80,138,218,0
23092,박덕흠(朴德欽),조승래(趙承來),36,9,45,1
23093,박덕흠(朴德欽),조오섭(曺五燮),37,7,44,1
23094,박덕흠(朴德欽),조은희(趙恩禧),29,53,82,0
23095,박덕흠(朴德欽),조응천(趙應天),35,4,39,1
23096,박덕흠(朴德欽),조정식(趙正湜),35,4,39,1
23097,박덕흠(朴德欽),조정훈(趙廷訓),0,33,33,1
23098,박덕흠(朴德欽),조해진(曺海珍),52,44,96,0
23099,박덕흠(朴德欽),주철현(朱哲鉉),39,8,47,1
23100,박덕흠(朴德欽),주호영(朱豪英),56,68,124,0
23101,박덕흠(朴德欽),지성호(池成浩),73,185,258,0
23102,박덕흠(朴德欽),진선미(陳善美),37,5,42,1
23103,박덕흠(朴德欽),진성준(陳聲準),37,5,42,1
23104,박덕흠(朴德欽),천준호(千俊鎬),36,4,40,1
23105,박덕흠(朴德欽),최기상(崔基相),35,5,40,1
23106,박덕흠(朴德欽),최승재(崔承宰),79,124,203,0
23107,박덕흠(朴德欽),최연숙(崔姸淑),40,60,100,0
23108,박덕흠(朴德欽),최영희(崔英姬),40,106,146,0
23109,박덕흠(朴德欽),최인호(崔仁昊),39,6,45,1
23110,박덕흠(朴德欽),최재형(崔在亨),32,29,61,0
23111,박덕흠(朴德欽),최종윤(崔鍾允),36,8,44,1
23112,박덕흠(朴德欽),최춘식(崔春植),104,201,305,0
23113,박덕흠(朴德欽),최형두(崔炯斗),83,160,243,0
23114,박덕흠(朴德欽),최혜영(崔惠英),37,13,50,1
23115,박덕흠(朴德欽),추경호(秋慶鎬),151,239,390,0
23116,박덕흠(朴德欽),태영호(太永浩),98,269,367,0
23117,박덕흠(朴德欽),하영제(河榮帝),87,235,322,1
23118,박덕흠(朴德欽),하태경(河泰慶),48,49,97,0
23119,박덕흠(朴德欽),한기호(韓起鎬),54,57,111,0
23120,박덕흠(朴德欽),한무경(韓茂景),89,161,250,0
23121,박덕흠(朴德欽),한병도(韓秉道),37,10,47,1
23122,박덕흠(朴德欽),한정애(韓貞愛),36,5,41,1
23123,박덕흠(朴德欽),한준호(韓俊鎬),37,9,46,1
23124,박덕흠(朴德欽),허숙정(許淑湞),0,0,0,1
23125,박덕흠(朴德欽),허영(許榮),40,8,48,1
23126,박덕흠(朴德欽),허은아(許垠娥),65,71,136,0
23127,박덕흠(朴德欽),허종식(許琮植),38,20,58,1
23128,박덕흠(朴德欽),홍기원(洪起元),36,7,43,1
23129,박덕흠(朴德欽),홍문표(洪文杓),104,230,334,0
23130,박덕흠(朴德欽),홍석준(洪碩晙),65,110,175,0
23131,박덕흠(朴德欽),홍성국(洪性國),38,6,44,1
23132,박덕흠(朴德欽),홍영표(洪永杓),37,8,45,1
23133,박덕흠(朴德欽),홍익표(洪翼杓),36,5,41,1
23134,박덕흠(朴德欽),홍정민(洪貞敏),36,5,41,1
23135,박덕흠(朴德欽),황보승희(皇甫承希),66,144,210,1
23136,박덕흠(朴德欽),황운하(黃雲夏),36,13,49,1
23137,박덕흠(朴德欽),황희(黃熙),35,6,41,1
23138,박범계(朴範界),박병석(朴炳錫),40,19,59,0
23139,박범계(朴範界),박상혁(朴商赫),74,43,117,0
23140,박범계(朴範界),박성민(朴聖敏),49,4,53,1
23141,박범계(朴範界),박성준(朴省俊),81,42,123,0
23142,박범계(朴範界),박성중(朴成重),49,4,53,1
23143,박범계(朴範界),박수영(朴洙瑩),49,4,53,1
23144,박범계(朴範界),박영순(朴英淳),88,60,148,0
23145,박범계(朴範界),박완주(朴完柱),42,32,74,1
23146,박범계(朴範界),박용진(朴用鎭),73,36,109,0
23147,박범계(朴範界),박재호(朴在昊),79,37,116,0
23148,박범계(朴範界),박정(朴釘),76,39,115,0
23149,박범계(朴範界),박정하(朴正河),25,4,29,1
23150,박범계(朴範界),박주민(朴柱民),97,53,150,0
23151,박범계(朴範界),박진(朴振),50,3,53,1
23152,박범계(朴範界),박찬대(朴贊大),74,37,111,0
23153,박범계(朴範界),박형수(朴亨修),49,4,53,1
23154,박범계(朴範界),박홍근(朴洪根),79,42,121,0
23155,박범계(朴範界),배준영(裵俊英),49,4,53,1
23156,박범계(朴範界),배진교(裵晋敎),9,9,18,1
23157,박범계(朴範界),배현진(裵賢鎭),49,4,53,1
23158,박범계(朴範界),백종헌(白宗憲),50,4,54,1
23159,박범계(朴範界),백혜련(白惠蓮),95,33,128,0
23160,박범계(朴範界),변재일(卞在一),76,32,108,0
23161,박범계(朴範界),서동용(徐東榕),79,35,114,0
23162,박범계(朴範界),서범수(徐範洙),50,4,54,1
23163,박범계(朴範界),서병수(徐秉洙),50,4,54,1
23164,박범계(朴範界),서삼석(徐參錫),80,42,122,0
23165,박범계(朴範界),서영교(徐瑛敎),78,47,125,0
23166,박범계(朴範界),서영석(徐暎錫),74,41,115,0
23167,박범계(朴範界),서일준(徐一俊),50,4,54,1
23168,박범계(朴範界),서정숙(徐正淑),50,4,54,1
23169,박범계(朴範界),설훈(薛勳),75,38,113,0
23170,박범계(朴範界),성일종(成一鍾),50,4,54,1
23171,박범계(朴範界),소병철(蘇秉哲),98,42,140,0
23172,박범계(朴範界),소병훈(蘇秉勳),77,42,119,0
23173,박범계(朴範界),송갑석(宋甲錫),84,52,136,0
23174,박범계(朴範界),송기헌(宋基憲),97,41,138,0
23175,박범계(朴範界),송석준(宋錫俊),49,4,53,1
23176,박범계(朴範界),송언석(宋彦錫),47,7,54,1
23177,박범계(朴範界),송옥주(宋玉珠),74,39,113,0
23178,박범계(朴範界),송재호(宋在祜),79,44,123,0
23179,박범계(朴範界),신동근(申東根),97,39,136,0
23180,박범계(朴範界),신영대(申榮大),76,33,109,0
23181,박범계(朴範界),신원식(申源湜),50,4,54,1
23182,박범계(朴範界),신정훈(辛正勳),85,57,142,0
23183,박범계(朴範界),신현영(申賢榮),73,38,111,0
23184,박범계(朴範界),심상정(沈相奵),9,7,16,1
23185,박범계(朴範界),안규백(安圭伯),78,36,114,0
23186,박범계(朴範界),안민석(安敏錫),80,32,112,0
23187,박범계(朴範界),안병길(安炳吉),50,4,54,1
23188,박범계(朴範界),안철수(安哲秀),25,4,29,1
23189,박범계(朴範界),안호영(安浩永),73,37,110,0
23190,박범계(朴範界),양경숙(梁敬淑),80,45,125,0
23191,박범계(朴範界),양금희(梁琴喜),50,4,54,1
23192,박범계(朴範界),양기대(梁基大),75,42,117,0
23193,박범계(朴範界),양이원영(梁李媛瑛),71,40,111,0
23194,박범계(朴範界),양정숙(梁貞淑),18,27,45,1
23195,박범계(朴範界),양향자(梁香子),29,15,44,1
23196,박범계(朴範界),어기구(魚基龜),80,40,120,0
23197,박범계(朴範界),엄태영(嚴泰永),50,4,54,1
23198,박범계(朴範界),오기형(吳奇炯),71,35,106,0
23199,박범계(朴範界),오영환(吳永煥),76,45,121,0
23200,박범계(朴範界),용혜인(龍慧仁),7,11,18,1
23201,박범계(朴範界),우상호(禹相虎),76,34,110,0
23202,박범계(朴範界),우원식(禹元植),77,41,118,0
23203,박범계(朴範界),위성곤(魏聖坤),77,43,120,0
23204,박범계(朴範界),유경준(兪京濬),49,4,53,1
23205,박범계(朴範界),유기홍(柳基洪),74,32,106,0
23206,박범계(朴範界),유동수(柳東秀),77,34,111,0
23207,박범계(朴範界),유상범(劉相凡),50,4,54,1
23208,박범계(朴範界),유의동(兪義東),49,4,53,1
23209,박범계(朴範界),유정주(兪訂炷),77,43,120,0
23210,박범계(朴範界),윤건영(尹建永),73,39,112,0
23211,박범계(朴範界),윤관석(尹官石),64,29,93,1
23212,박범계(朴範界),윤두현(尹斗鉉),50,4,54,1
23213,박범계(朴範界),윤미향(尹美香),32,18,50,1
23214,박범계(朴範界),윤상현(尹相現),30,4,34,1
23215,박범계(朴範界),윤영덕(尹永德),79,52,131,0
23216,박범계(朴範界),윤영석(尹永碩),50,4,54,1
23217,박범계(朴範界),윤영찬(尹永燦),77,35,112,0
23218,박범계(朴範界),윤재갑(尹才鉀),82,42,124,0
23219,박범계(朴範界),윤재옥(尹在玉),49,4,53,1
23220,박범계(朴範界),윤주경(尹柱卿),51,4,55,1
23221,박범계(朴範界),윤준병(尹準炳),76,42,118,0
23222,박범계(朴範界),윤창현(尹暢賢),50,5,55,1
23223,박범계(朴範界),윤한홍(尹漢洪),50,4,54,1
23224,박범계(朴範界),윤호중(尹昊重),74,35,109,0
23225,박범계(朴範界),윤후덕(尹厚德),73,34,107,0
23226,박범계(朴範界),이개호(李介昊),76,42,118,0
23227,박범계(朴範界),이달곤(李達坤),50,4,54,1
23228,박범계(朴範界),이동주(李東洲),73,42,115,0
23229,박범계(朴範界),이만희(李晩熙),50,4,54,1
23230,박범계(朴範界),이명수(李明洙),52,7,59,1
23231,박범계(朴範界),이병훈(李炳勳),80,44,124,0
23232,박범계(朴範界),이상민(李相珉),78,48,126,0
23233,박범계(朴範界),이상헌(李相憲),79,39,118,0
23234,박범계(朴範界),이성만(李成萬),68,43,111,1
23235,박범계(朴範界),이소영(李素永),76,35,111,0
23236,박범계(朴範界),이수진(李壽珍),78,48,126,0
23237,박범계(朴範界),이수진(李秀眞),85,52,137,0
23238,박범계(朴範界),이양수(李亮壽),51,4,55,1
23239,박범계(朴範界),이용(李鏞),50,4,54,1
23240,박범계(朴範界),이용빈(李龍彬),86,57,143,0
23241,박범계(朴範界),이용선(李庸瑄),79,43,122,0
23242,박범계(朴範界),이용우(李龍雨),75,39,114,0
23243,박범계(朴範界),이용호(李容鎬),27,6,33,1
23244,박범계(朴範界),이원욱(李元旭),81,39,120,0
23245,박범계(朴範界),이원택(李源澤),77,41,118,0
23246,박범계(朴範界),이은주(李恩周),10,7,17,1
23247,박범계(朴範界),이인선(李仁善),25,4,29,1
23248,박범계(朴範界),이인영(李仁榮),73,36,109,0
23249,박범계(朴範界),이장섭(李將燮),81,43,124,0
23250,박범계(朴範界),이재명(李在明),39,20,59,0
23251,박범계(朴範界),이재정(李在汀),74,38,112,0
23252,박범계(朴範界),이정문(李楨文),78,46,124,0
23253,박범계(朴範界),이종배(李鍾培),50,4,54,1
23254,박범계(朴範界),이종성(李鍾成),50,4,54,1
23255,박범계(朴範界),이주환(李周桓),49,4,53,1
23256,박범계(朴範界),이채익(李埰益),50,4,54,1
23257,박범계(朴範界),이철규(李喆圭),51,4,55,1
23258,박범계(朴範界),이탄희(李誕熙),77,40,117,0
23259,박범계(朴範界),이태규(李泰珪),28,4,32,1
23260,박범계(朴範界),이학영(李學永),80,39,119,0
23261,박범계(朴範界),이해식(李海植),80,44,124,0
23262,박범계(朴範界),이헌승(李憲昇),50,4,54,1
23263,박범계(朴範界),이형석(李炯錫),79,41,120,0
23264,박범계(朴範界),인재근(印在謹),76,48,124,0
23265,박범계(朴範界),임병헌(林炳憲),26,4,30,1
23266,박범계(朴範界),임오경(林五卿),80,47,127,0
23267,박범계(朴範界),임이자(林利子),49,4,53,1
23268,박범계(朴範界),임종성(林鍾聲),79,46,125,0
23269,박범계(朴範界),임호선(林昊宣),86,58,144,0
23270,박범계(朴範界),장경태(張耿態),83,44,127,0
23271,박범계(朴範界),장동혁(張東赫),25,4,29,1
23272,박범계(朴範界),장제원(張濟元),49,4,53,1
23273,박범계(朴範界),장철민(張喆敏),86,52,138,0
23274,박범계(朴範界),장혜영(張惠英),9,7,16,1
23275,박범계(朴範界),전봉민(田奉珉),34,4,38,1
23276,박범계(朴範界),전용기(田溶冀),79,50,129,0
23277,박범계(朴範界),전재수(田載秀),81,37,118,0
23278,박범계(朴範界),전주혜(全珠惠),50,4,54,1
23279,박범계(朴範界),전해철(全海澈),76,37,113,0
23280,박범계(朴範界),전혜숙(全惠淑),76,33,109,0
23281,박범계(朴範界),정경희(丁慶姬),51,4,55,1
23282,박범계(朴範界),정동만(鄭東萬),49,4,53,1
23283,박범계(朴範界),정성호(鄭成湖),77,35,112,0
23284,박범계(朴範界),정우택(鄭宇澤),25,4,29,1
23285,박범계(朴範界),정운천(鄭雲天),49,4,53,1
23286,박범계(朴範界),정일영(鄭日永),74,39,113,0
23287,박범계(朴範界),정점식(鄭点植),51,4,55,1
23288,박범계(朴範界),정진석(鄭鎭碩),51,4,55,1
23289,박범계(朴範界),정청래(鄭淸來),78,35,113,0
23290,박범계(朴範界),정춘숙(鄭春淑),80,41,121,0
23291,박범계(朴範界),정태호(鄭泰浩),79,46,125,0
23292,박범계(朴範界),정필모(鄭必模),78,41,119,0
23293,박범계(朴範界),정희용(鄭熙溶),49,4,53,1
23294,박범계(朴範界),조경태(趙慶泰),49,4,53,1
23295,박범계(朴範界),조명희(曺明姬),49,4,53,1
23296,박범계(朴範界),조수진(趙修眞),49,4,53,1
23297,박범계(朴範界),조승래(趙承來),87,56,143,0
23298,박범계(朴範界),조오섭(曺五燮),83,44,127,0
23299,박범계(朴範界),조은희(趙恩禧),25,4,29,1
23300,박범계(朴範界),조응천(趙應天),72,29,101,0
23301,박범계(朴範界),조정식(趙正湜),72,32,104,0
23302,박범계(朴範界),조정훈(趙廷訓),0,1,1,1
23303,박범계(朴範界),조해진(曺海珍),50,4,54,1
23304,박범계(朴範界),주철현(朱哲鉉),77,47,124,0
23305,박범계(朴範界),주호영(朱豪英),49,4,53,1
23306,박범계(朴範界),지성호(池成浩),49,4,53,1
23307,박범계(朴範界),진선미(陳善美),75,32,107,0
23308,박범계(朴範界),진성준(陳聲準),80,44,124,0
23309,박범계(朴範界),천준호(千俊鎬),74,38,112,0
23310,박범계(朴範界),최기상(崔基相),93,43,136,0
23311,박범계(朴範界),최승재(崔承宰),50,4,54,1
23312,박범계(朴範界),최연숙(崔姸淑),28,4,32,1
23313,박범계(朴範界),최영희(崔英姬),25,4,29,1
23314,박범계(朴範界),최인호(崔仁昊),78,45,123,0
23315,박범계(朴範界),최재형(崔在亨),25,4,29,1
23316,박범계(朴範界),최종윤(崔鍾允),74,40,114,0
23317,박범계(朴範界),최춘식(崔春植),49,4,53,1
23318,박범계(朴範界),최형두(崔炯斗),50,4,54,1
23319,박범계(朴範界),최혜영(崔惠英),75,47,122,0
23320,박범계(朴範界),추경호(秋慶鎬),50,3,53,1
23321,박범계(朴範界),태영호(太永浩),50,4,54,1
23322,박범계(朴範界),하영제(河榮帝),41,1,42,1
23323,박범계(朴範界),하태경(河泰慶),49,4,53,1
23324,박범계(朴範界),한기호(韓起鎬),51,4,55,1
23325,박범계(朴範界),한무경(韓茂景),49,4,53,1
23326,박범계(朴範界),한병도(韓秉道),77,34,111,0
23327,박범계(朴範界),한정애(韓貞愛),77,38,115,0
23328,박범계(朴範界),한준호(韓俊鎬),83,46,129,0
23329,박범계(朴範界),허숙정(許淑湞),1,2,3,0
23330,박범계(朴範界),허영(許榮),84,43,127,0
23331,박범계(朴範界),허은아(許垠娥),49,4,53,1
23332,박범계(朴範界),허종식(許琮植),78,39,117,0
23333,박범계(朴範界),홍기원(洪起元),77,38,115,0
23334,박범계(朴範界),홍문표(洪文杓),51,4,55,1
23335,박범계(朴範界),홍석준(洪碩晙),50,4,54,1
23336,박범계(朴範界),홍성국(洪性國),85,51,136,0
23337,박범계(朴範界),홍영표(洪永杓),73,38,111,0
23338,박범계(朴範界),홍익표(洪翼杓),81,41,122,0
23339,박범계(朴範界),홍정민(洪貞敏),79,38,117,0
23340,박범계(朴範界),황보승희(皇甫承希),46,1,47,1
23341,박범계(朴範界),황운하(黃雲夏),88,63,151,0
23342,박범계(朴範界),황희(黃熙),78,37,115,0
23343,박병석(朴炳錫),박상혁(朴商赫),39,16,55,0
23344,박병석(朴炳錫),박성민(朴聖敏),25,3,28,1
23345,박병석(朴炳錫),박성준(朴省俊),40,21,61,0
23346,박병석(朴炳錫),박성중(朴成重),25,3,28,1
23347,박병석(朴炳錫),박수영(朴洙瑩),25,3,28,1
23348,박병석(朴炳錫),박영순(朴英淳),40,31,71,0
23349,박병석(朴炳錫),박완주(朴完柱),5,9,14,1
23350,박병석(朴炳錫),박용진(朴用鎭),39,19,58,0
23351,박병석(朴炳錫),박재호(朴在昊),41,18,59,0
23352,박병석(朴炳錫),박정(朴釘),39,21,60,0
23353,박병석(朴炳錫),박정하(朴正河),25,3,28,1
23354,박병석(朴炳錫),박주민(朴柱民),39,17,56,0
23355,박병석(朴炳錫),박진(朴振),25,3,28,1
23356,박병석(朴炳錫),박찬대(朴贊大),40,19,59,0
23357,박병석(朴炳錫),박형수(朴亨修),25,3,28,1
23358,박병석(朴炳錫),박홍근(朴洪根),40,23,63,0
23359,박병석(朴炳錫),배준영(裵俊英),25,3,28,1
23360,박병석(朴炳錫),배진교(裵晋敎),5,5,10,1
23361,박병석(朴炳錫),배현진(裵賢鎭),25,3,28,1
23362,박병석(朴炳錫),백종헌(白宗憲),25,3,28,1
23363,박병석(朴炳錫),백혜련(白惠蓮),39,15,54,0
23364,박병석(朴炳錫),변재일(卞在一),40,17,57,0
23365,박병석(朴炳錫),서동용(徐東榕),40,23,63,0
23366,박병석(朴炳錫),서범수(徐範洙),25,3,28,1
23367,박병석(朴炳錫),서병수(徐秉洙),25,3,28,1
23368,박병석(朴炳錫),서삼석(徐參錫),40,15,55,0
23369,박병석(朴炳錫),서영교(徐瑛敎),40,23,63,0
23370,박병석(朴炳錫),서영석(徐暎錫),39,18,57,0
23371,박병석(朴炳錫),서일준(徐一俊),25,3,28,1
23372,박병석(朴炳錫),서정숙(徐正淑),25,3,28,1
23373,박병석(朴炳錫),설훈(薛勳),40,19,59,0
23374,박병석(朴炳錫),성일종(成一鍾),25,3,28,1
23375,박병석(朴炳錫),소병철(蘇秉哲),39,18,57,0
23376,박병석(朴炳錫),소병훈(蘇秉勳),40,18,58,0
23377,박병석(朴炳錫),송갑석(宋甲錫),39,19,58,0
23378,박병석(朴炳錫),송기헌(宋基憲),40,17,57,0
23379,박병석(朴炳錫),송석준(宋錫俊),25,3,28,1
23380,박병석(朴炳錫),송언석(宋彦錫),25,3,28,1
23381,박병석(朴炳錫),송옥주(宋玉珠),39,17,56,0
23382,박병석(朴炳錫),송재호(宋在祜),40,18,58,0
23383,박병석(朴炳錫),신동근(申東根),39,16,55,0
23384,박병석(朴炳錫),신영대(申榮大),39,18,57,0
23385,박병석(朴炳錫),신원식(申源湜),25,3,28,1
23386,박병석(朴炳錫),신정훈(辛正勳),39,17,56,0
23387,박병석(朴炳錫),신현영(申賢榮),39,18,57,0
23388,박병석(朴炳錫),심상정(沈相奵),5,4,9,1
23389,박병석(朴炳錫),안규백(安圭伯),39,18,57,0
23390,박병석(朴炳錫),안민석(安敏錫),39,20,59,0
23391,박병석(朴炳錫),안병길(安炳吉),25,3,28,1
23392,박병석(朴炳錫),안철수(安哲秀),25,3,28,1
23393,박병석(朴炳錫),안호영(安浩永),39,20,59,0
23394,박병석(朴炳錫),양경숙(梁敬淑),39,20,59,0
23395,박병석(朴炳錫),양금희(梁琴喜),25,3,28,1
23396,박병석(朴炳錫),양기대(梁基大),41,22,63,0
23397,박병석(朴炳錫),양이원영(梁李媛瑛),39,17,56,0
23398,박병석(朴炳錫),양정숙(梁貞淑),7,12,19,1
23399,박병석(朴炳錫),양향자(梁香子),2,4,6,1
23400,박병석(朴炳錫),어기구(魚基龜),40,18,58,0
23401,박병석(朴炳錫),엄태영(嚴泰永),25,3,28,1
23402,박병석(朴炳錫),오기형(吳奇炯),38,14,52,0
23403,박병석(朴炳錫),오영환(吳永煥),40,21,61,0
23404,박병석(朴炳錫),용혜인(龍慧仁),6,6,12,1
23405,박병석(朴炳錫),우상호(禹相虎),39,18,57,0
23406,박병석(朴炳錫),우원식(禹元植),40,20,60,0
23407,박병석(朴炳錫),위성곤(魏聖坤),39,19,58,0
23408,박병석(朴炳錫),유경준(兪京濬),25,3,28,1
23409,박병석(朴炳錫),유기홍(柳基洪),39,22,61,0
23410,박병석(朴炳錫),유동수(柳東秀),39,15,54,0
23411,박병석(朴炳錫),유상범(劉相凡),25,3,28,1
23412,박병석(朴炳錫),유의동(兪義東),25,3,28,1
23413,박병석(朴炳錫),유정주(兪訂炷),39,20,59,0
23414,박병석(朴炳錫),윤건영(尹建永),39,18,57,0
23415,박병석(朴炳錫),윤관석(尹官石),28,14,42,1
23416,박병석(朴炳錫),윤두현(尹斗鉉),25,3,28,1
23417,박병석(朴炳錫),윤미향(尹美香),5,6,11,1
23418,박병석(朴炳錫),윤상현(尹相現),25,3,28,1
23419,박병석(朴炳錫),윤영덕(尹永德),40,18,58,0
23420,박병석(朴炳錫),윤영석(尹永碩),25,3,28,1
23421,박병석(朴炳錫),윤영찬(尹永燦),39,19,58,0
23422,박병석(朴炳錫),윤재갑(尹才鉀),40,18,58,0
23423,박병석(朴炳錫),윤재옥(尹在玉),25,3,28,1
23424,박병석(朴炳錫),윤주경(尹柱卿),25,3,28,1
23425,박병석(朴炳錫),윤준병(尹準炳),39,17,56,0
23426,박병석(朴炳錫),윤창현(尹暢賢),25,4,29,1
23427,박병석(朴炳錫),윤한홍(尹漢洪),25,3,28,1
23428,박병석(朴炳錫),윤호중(尹昊重),40,19,59,0
23429,박병석(朴炳錫),윤후덕(尹厚德),39,16,55,0
23430,박병석(朴炳錫),이개호(李介昊),39,17,56,0
23431,박병석(朴炳錫),이달곤(李達坤),26,5,31,1
23432,박병석(朴炳錫),이동주(李東洲),39,16,55,0
23433,박병석(朴炳錫),이만희(李晩熙),25,3,28,1
23434,박병석(朴炳錫),이명수(李明洙),25,5,30,1
23435,박병석(朴炳錫),이병훈(李炳勳),40,18,58,0
23436,박병석(朴炳錫),이상민(李相珉),39,23,62,0
23437,박병석(朴炳錫),이상헌(李相憲),39,16,55,0
23438,박병석(朴炳錫),이성만(李成萬),28,9,37,1
23439,박병석(朴炳錫),이소영(李素永),39,16,55,0
23440,박병석(朴炳錫),이수진(李壽珍),40,19,59,0
23441,박병석(朴炳錫),이수진(李秀眞),40,15,55,0
23442,박병석(朴炳錫),이양수(李亮壽),25,3,28,1
23443,박병석(朴炳錫),이용(李鏞),25,3,28,1
23444,박병석(朴炳錫),이용빈(李龍彬),40,21,61,0
23445,박병석(朴炳錫),이용선(李庸瑄),40,20,60,0
23446,박병석(朴炳錫),이용우(李龍雨),39,16,55,0
23447,박병석(朴炳錫),이용호(李容鎬),26,4,30,1
23448,박병석(朴炳錫),이원욱(李元旭),40,23,63,0
23449,박병석(朴炳錫),이원택(李源澤),38,15,53,0
23450,박병석(朴炳錫),이은주(李恩周),6,4,10,1
23451,박병석(朴炳錫),이인선(李仁善),25,3,28,1
23452,박병석(朴炳錫),이인영(李仁榮),39,18,57,0
23453,박병석(朴炳錫),이장섭(李將燮),40,17,57,0
23454,박병석(朴炳錫),이재명(李在明),39,17,56,0
23455,박병석(朴炳錫),이재정(李在汀),40,19,59,0
23456,박병석(朴炳錫),이정문(李楨文),39,19,58,0
23457,박병석(朴炳錫),이종배(李鍾培),26,4,30,1
23458,박병석(朴炳錫),이종성(李鍾成),25,3,28,1
23459,박병석(朴炳錫),이주환(李周桓),25,3,28,1
23460,박병석(朴炳錫),이채익(李埰益),26,4,30,1
23461,박병석(朴炳錫),이철규(李喆圭),25,3,28,1
23462,박병석(朴炳錫),이탄희(李誕熙),39,16,55,0
23463,박병석(朴炳錫),이태규(李泰珪),25,3,28,1
23464,박병석(朴炳錫),이학영(李學永),41,17,58,0
23465,박병석(朴炳錫),이해식(李海植),40,17,57,0
23466,박병석(朴炳錫),이헌승(李憲昇),25,3,28,1
23467,박병석(朴炳錫),이형석(李炯錫),39,17,56,0
23468,박병석(朴炳錫),인재근(印在謹),39,20,59,0
23469,박병석(朴炳錫),임병헌(林炳憲),25,3,28,1
23470,박병석(朴炳錫),임오경(林五卿),40,15,55,0
23471,박병석(朴炳錫),임이자(林利子),25,3,28,1
23472,박병석(朴炳錫),임종성(林鍾聲),40,17,57,0
23473,박병석(朴炳錫),임호선(林昊宣),40,22,62,0
23474,박병석(朴炳錫),장경태(張耿態),40,18,58,0
23475,박병석(朴炳錫),장동혁(張東赫),25,3,28,1
23476,박병석(朴炳錫),장제원(張濟元),25,3,28,1
23477,박병석(朴炳錫),장철민(張喆敏),40,20,60,0
23478,박병석(朴炳錫),장혜영(張惠英),5,3,8,1
23479,박병석(朴炳錫),전봉민(田奉珉),26,4,30,1
23480,박병석(朴炳錫),전용기(田溶冀),38,22,60,0
23481,박병석(朴炳錫),전재수(田載秀),39,15,54,0
23482,박병석(朴炳錫),전주혜(全珠惠),26,3,29,1
23483,박병석(朴炳錫),전해철(全海澈),40,22,62,0
23484,박병석(朴炳錫),전혜숙(全惠淑),39,16,55,0
23485,박병석(朴炳錫),정경희(丁慶姬),25,3,28,1
23486,박병석(朴炳錫),정동만(鄭東萬),25,3,28,1
23487,박병석(朴炳錫),정성호(鄭成湖),39,18,57,0
23488,박병석(朴炳錫),정우택(鄭宇澤),25,3,28,1
23489,박병석(朴炳錫),정운천(鄭雲天),25,3,28,1
23490,박병석(朴炳錫),정일영(鄭日永),39,16,55,0
23491,박병석(朴炳錫),정점식(鄭点植),25,3,28,1
23492,박병석(朴炳錫),정진석(鄭鎭碩),25,3,28,1
23493,박병석(朴炳錫),정청래(鄭淸來),40,15,55,0
23494,박병석(朴炳錫),정춘숙(鄭春淑),39,18,57,0
23495,박병석(朴炳錫),정태호(鄭泰浩),40,17,57,0
23496,박병석(朴炳錫),정필모(鄭必模),39,17,56,0
23497,박병석(朴炳錫),정희용(鄭熙溶),26,4,30,1
23498,박병석(朴炳錫),조경태(趙慶泰),25,3,28,1
23499,박병석(朴炳錫),조명희(曺明姬),25,3,28,1
23500,박병석(朴炳錫),조수진(趙修眞),25,3,28,1
23501,박병석(朴炳錫),조승래(趙承來),41,26,67,0
23502,박병석(朴炳錫),조오섭(曺五燮),39,22,61,0
23503,박병석(朴炳錫),조은희(趙恩禧),25,3,28,1
23504,박병석(朴炳錫),조응천(趙應天),38,14,52,0
23505,박병석(朴炳錫),조정식(趙正湜),40,20,60,0
23506,박병석(朴炳錫),조정훈(趙廷訓),0,2,2,1
23507,박병석(朴炳錫),조해진(曺海珍),26,4,30,1
23508,박병석(朴炳錫),주철현(朱哲鉉),39,17,56,0
23509,박병석(朴炳錫),주호영(朱豪英),25,3,28,1
23510,박병석(朴炳錫),지성호(池成浩),25,3,28,1
23511,박병석(朴炳錫),진선미(陳善美),39,16,55,0
23512,박병석(朴炳錫),진성준(陳聲準),40,17,57,0
23513,박병석(朴炳錫),천준호(千俊鎬),39,16,55,0
23514,박병석(朴炳錫),최기상(崔基相),39,16,55,0
23515,박병석(朴炳錫),최승재(崔承宰),25,3,28,1
23516,박병석(朴炳錫),최연숙(崔姸淑),26,4,30,1
23517,박병석(朴炳錫),최영희(崔英姬),25,3,28,1
23518,박병석(朴炳錫),최인호(崔仁昊),40,17,57,0
23519,박병석(朴炳錫),최재형(崔在亨),25,3,28,1
23520,박병석(朴炳錫),최종윤(崔鍾允),39,23,62,0
23521,박병석(朴炳錫),최춘식(崔春植),25,3,28,1
23522,박병석(朴炳錫),최형두(崔炯斗),25,3,28,1
23523,박병석(朴炳錫),최혜영(崔惠英),41,22,63,0
23524,박병석(朴炳錫),추경호(秋慶鎬),25,3,28,1
23525,박병석(朴炳錫),태영호(太永浩),25,3,28,1
23526,박병석(朴炳錫),하영제(河榮帝),16,0,16,1
23527,박병석(朴炳錫),하태경(河泰慶),25,3,28,1
23528,박병석(朴炳錫),한기호(韓起鎬),25,3,28,1
23529,박병석(朴炳錫),한무경(韓茂景),25,3,28,1
23530,박병석(朴炳錫),한병도(韓秉道),39,19,58,0
23531,박병석(朴炳錫),한정애(韓貞愛),39,17,56,0
23532,박병석(朴炳錫),한준호(韓俊鎬),40,22,62,0
23533,박병석(朴炳錫),허숙정(許淑湞),1,1,2,0
23534,박병석(朴炳錫),허영(許榮),39,18,57,0
23535,박병석(朴炳錫),허은아(許垠娥),25,3,28,1
23536,박병석(朴炳錫),허종식(許琮植),39,17,56,0
23537,박병석(朴炳錫),홍기원(洪起元),40,17,57,0
23538,박병석(朴炳錫),홍문표(洪文杓),25,3,28,1
23539,박병석(朴炳錫),홍석준(洪碩晙),25,3,28,1
23540,박병석(朴炳錫),홍성국(洪性國),41,21,62,0
23541,박병석(朴炳錫),홍영표(洪永杓),39,19,58,0
23542,박병석(朴炳錫),홍익표(洪翼杓),41,18,59,0
23543,박병석(朴炳錫),홍정민(洪貞敏),40,21,61,0
23544,박병석(朴炳錫),황보승희(皇甫承希),20,0,20,1
23545,박병석(朴炳錫),황운하(黃雲夏),40,23,63,0
23546,박병석(朴炳錫),황희(黃熙),40,20,60,0
23547,박상혁(朴商赫),박성민(朴聖敏),51,4,55,1
23548,박상혁(朴商赫),박성준(朴省俊),125,150,275,0
23549,박상혁(朴商赫),박성중(朴成重),49,4,53,1
23550,박상혁(朴商赫),박수영(朴洙瑩),50,5,55,1
23551,박상혁(朴商赫),박영순(朴英淳),115,100,215,0
23552,박상혁(朴商赫),박완주(朴完柱),51,51,102,1
23553,박상혁(朴商赫),박용진(朴用鎭),87,69,156,0
23554,박상혁(朴商赫),박재호(朴在昊),120,130,250,0
23555,박상혁(朴商赫),박정(朴釘),134,186,320,0
23556,박상혁(朴商赫),박정하(朴正河),26,4,30,1
23557,박상혁(朴商赫),박주민(朴柱民),82,84,166,0
23558,박상혁(朴商赫),박진(朴振),49,6,55,1
23559,박상혁(朴商赫),박찬대(朴贊大),88,94,182,0
23560,박상혁(朴商赫),박형수(朴亨修),49,4,53,1
23561,박상혁(朴商赫),박홍근(朴洪根),142,185,327,0
23562,박상혁(朴商赫),배준영(裵俊英),51,7,58,1
23563,박상혁(朴商赫),배진교(裵晋敎),20,41,61,1
23564,박상혁(朴商赫),배현진(裵賢鎭),49,4,53,1
23565,박상혁(朴商赫),백종헌(白宗憲),51,6,57,1
23566,박상혁(朴商赫),백혜련(白惠蓮),87,77,164,0
23567,박상혁(朴商赫),변재일(卞在一),87,90,177,0
23568,박상혁(朴商赫),서동용(徐東榕),109,198,307,0
23569,박상혁(朴商赫),서범수(徐範洙),49,6,55,1
23570,박상혁(朴商赫),서병수(徐秉洙),49,5,54,1
23571,박상혁(朴商赫),서삼석(徐參錫),111,111,222,0
23572,박상혁(朴商赫),서영교(徐瑛敎),123,163,286,0
23573,박상혁(朴商赫),서영석(徐暎錫),117,175,292,0
23574,박상혁(朴商赫),서일준(徐一俊),53,9,62,1
23575,박상혁(朴商赫),서정숙(徐正淑),49,6,55,1
23576,박상혁(朴商赫),설훈(薛勳),82,82,164,0
23577,박상혁(朴商赫),성일종(成一鍾),49,8,57,1
23578,박상혁(朴商赫),소병철(蘇秉哲),91,81,172,0
23579,박상혁(朴商赫),소병훈(蘇秉勳),124,157,281,0
23580,박상혁(朴商赫),송갑석(宋甲錫),117,207,324,0
23581,박상혁(朴商赫),송기헌(宋基憲),85,78,163,0
23582,박상혁(朴商赫),송석준(宋錫俊),52,6,58,1
23583,박상혁(朴商赫),송언석(宋彦錫),45,4,49,1
23584,박상혁(朴商赫),송옥주(宋玉珠),128,128,256,0
23585,박상혁(朴商赫),송재호(宋在祜),103,116,219,0
23586,박상혁(朴商赫),신동근(申東根),115,166,281,0
23587,박상혁(朴商赫),신영대(申榮大),104,133,237,0
23588,박상혁(朴商赫),신원식(申源湜),51,5,56,1
23589,박상혁(朴商赫),신정훈(辛正勳),124,185,309,0
23590,박상혁(朴商赫),신현영(申賢榮),82,80,162,0
23591,박상혁(朴商赫),심상정(沈相奵),18,34,52,1
23592,박상혁(朴商赫),안규백(安圭伯),94,123,217,0
23593,박상혁(朴商赫),안민석(安敏錫),90,145,235,0
23594,박상혁(朴商赫),안병길(安炳吉),49,4,53,1
23595,박상혁(朴商赫),안철수(安哲秀),26,5,31,1
23596,박상혁(朴商赫),안호영(安浩永),96,111,207,0
23597,박상혁(朴商赫),양경숙(梁敬淑),95,124,219,0
23598,박상혁(朴商赫),양금희(梁琴喜),52,4,56,1
23599,박상혁(朴商赫),양기대(梁基大),92,103,195,0
23600,박상혁(朴商赫),양이원영(梁李媛瑛),98,102,200,0
23601,박상혁(朴商赫),양정숙(梁貞淑),76,187,263,1
23602,박상혁(朴商赫),양향자(梁香子),46,49,95,1
23603,박상혁(朴商赫),어기구(魚基龜),112,208,320,0
23604,박상혁(朴商赫),엄태영(嚴泰永),50,5,55,1
23605,박상혁(朴商赫),오기형(吳奇炯),82,46,128,0
23606,박상혁(朴商赫),오영환(吳永煥),166,219,385,0
23607,박상혁(朴商赫),용혜인(龍慧仁),18,24,42,1
23608,박상혁(朴商赫),우상호(禹相虎),79,48,127,0
23609,박상혁(朴商赫),우원식(禹元植),109,192,301,0
23610,박상혁(朴商赫),위성곤(魏聖坤),129,188,317,0
23611,박상혁(朴商赫),유경준(兪京濬),50,4,54,1
23612,박상혁(朴商赫),유기홍(柳基洪),83,71,154,0
23613,박상혁(朴商赫),유동수(柳東秀),84,81,165,0
23614,박상혁(朴商赫),유상범(劉相凡),50,5,55,1
23615,박상혁(朴商赫),유의동(兪義東),50,4,54,1
23616,박상혁(朴商赫),유정주(兪訂炷),124,188,312,0
23617,박상혁(朴商赫),윤건영(尹建永),85,84,169,0
23618,박상혁(朴商赫),윤관석(尹官石),88,90,178,1
23619,박상혁(朴商赫),윤두현(尹斗鉉),50,4,54,1
23620,박상혁(朴商赫),윤미향(尹美香),57,107,164,1
23621,박상혁(朴商赫),윤상현(尹相現),30,5,35,1
23622,박상혁(朴商赫),윤영덕(尹永德),104,165,269,0
23623,박상혁(朴商赫),윤영석(尹永碩),49,6,55,1
23624,박상혁(朴商赫),윤영찬(尹永燦),85,83,168,0
23625,박상혁(朴商赫),윤재갑(尹才鉀),116,121,237,0
23626,박상혁(朴商赫),윤재옥(尹在玉),49,4,53,1
23627,박상혁(朴商赫),윤주경(尹柱卿),49,9,58,1
23628,박상혁(朴商赫),윤준병(尹準炳),137,228,365,0
23629,박상혁(朴商赫),윤창현(尹暢賢),49,4,53,1
23630,박상혁(朴商赫),윤한홍(尹漢洪),49,4,53,1
23631,박상혁(朴商赫),윤호중(尹昊重),79,71,150,0
23632,박상혁(朴商赫),윤후덕(尹厚德),140,284,424,0
23633,박상혁(朴商赫),이개호(李介昊),103,157,260,0
23634,박상혁(朴商赫),이달곤(李達坤),50,5,55,1
23635,박상혁(朴商赫),이동주(李東洲),116,346,462,0
23636,박상혁(朴商赫),이만희(李晩熙),50,4,54,1
23637,박상혁(朴商赫),이명수(李明洙),49,11,60,1
23638,박상혁(朴商赫),이병훈(李炳勳),109,167,276,0
23639,박상혁(朴商赫),이상민(李相珉),77,41,118,0
23640,박상혁(朴商赫),이상헌(李相憲),116,170,286,0
23641,박상혁(朴商赫),이성만(李成萬),100,101,201,1
23642,박상혁(朴商赫),이소영(李素永),97,100,197,0
23643,박상혁(朴商赫),이수진(李壽珍),120,187,307,0
23644,박상혁(朴商赫),이수진(李秀眞),132,150,282,0
23645,박상혁(朴商赫),이양수(李亮壽),51,5,56,1
23646,박상혁(朴商赫),이용(李鏞),50,6,56,1
23647,박상혁(朴商赫),이용빈(李龍彬),123,246,369,0
23648,박상혁(朴商赫),이용선(李庸瑄),90,127,217,0
23649,박상혁(朴商赫),이용우(李龍雨),102,97,199,0
23650,박상혁(朴商赫),이용호(李容鎬),46,27,73,1
23651,박상혁(朴商赫),이원욱(李元旭),96,159,255,0
23652,박상혁(朴商赫),이원택(李源澤),104,89,193,0
23653,박상혁(朴商赫),이은주(李恩周),20,29,49,1
23654,박상혁(朴商赫),이인선(李仁善),25,4,29,1
23655,박상혁(朴商赫),이인영(李仁榮),86,89,175,0
23656,박상혁(朴商赫),이장섭(李將燮),87,73,160,0
23657,박상혁(朴商赫),이재명(李在明),40,23,63,0
23658,박상혁(朴商赫),이재정(李在汀),85,74,159,0
23659,박상혁(朴商赫),이정문(李楨文),143,272,415,0
23660,박상혁(朴商赫),이종배(李鍾培),51,8,59,1
23661,박상혁(朴商赫),이종성(李鍾成),50,6,56,1
23662,박상혁(朴商赫),이주환(李周桓),50,5,55,1
23663,박상혁(朴商赫),이채익(李埰益),51,9,60,1
23664,박상혁(朴商赫),이철규(李喆圭),52,7,59,1
23665,박상혁(朴商赫),이탄희(李誕熙),113,91,204,0
23666,박상혁(朴商赫),이태규(李泰珪),28,4,32,1
23667,박상혁(朴商赫),이학영(李學永),134,190,324,0
23668,박상혁(朴商赫),이해식(李海植),119,127,246,0
23669,박상혁(朴商赫),이헌승(李憲昇),50,7,57,1
23670,박상혁(朴商赫),이형석(李炯錫),118,151,269,0
23671,박상혁(朴商赫),인재근(印在謹),110,153,263,0
23672,박상혁(朴商赫),임병헌(林炳憲),26,4,30,1
23673,박상혁(朴商赫),임오경(林五卿),134,162,296,0
23674,박상혁(朴商赫),임이자(林利子),49,5,54,1
23675,박상혁(朴商赫),임종성(林鍾聲),134,251,385,0
23676,박상혁(朴商赫),임호선(林昊宣),134,282,416,0
23677,박상혁(朴商赫),장경태(張耿態),122,149,271,0
23678,박상혁(朴商赫),장동혁(張東赫),25,4,29,1
23679,박상혁(朴商赫),장제원(張濟元),49,4,53,1
23680,박상혁(朴商赫),장철민(張喆敏),109,229,338,0
23681,박상혁(朴商赫),장혜영(張惠英),15,24,39,1
23682,박상혁(朴商赫),전봉민(田奉珉),35,7,42,1
23683,박상혁(朴商赫),전용기(田溶冀),110,111,221,0
23684,박상혁(朴商赫),전재수(田載秀),105,143,248,0
23685,박상혁(朴商赫),전주혜(全珠惠),51,5,56,1
23686,박상혁(朴商赫),전해철(全海澈),75,97,172,0
23687,박상혁(朴商赫),전혜숙(全惠淑),105,96,201,0
23688,박상혁(朴商赫),정경희(丁慶姬),50,4,54,1
23689,박상혁(朴商赫),정동만(鄭東萬),49,6,55,1
23690,박상혁(朴商赫),정성호(鄭成湖),99,209,308,0
23691,박상혁(朴商赫),정우택(鄭宇澤),26,6,32,1
23692,박상혁(朴商赫),정운천(鄭雲天),51,4,55,1
23693,박상혁(朴商赫),정일영(鄭日永),136,194,330,0
23694,박상혁(朴商赫),정점식(鄭点植),49,5,54,1
23695,박상혁(朴商赫),정진석(鄭鎭碩),49,5,54,1
23696,박상혁(朴商赫),정청래(鄭淸來),89,59,148,0
23697,박상혁(朴商赫),정춘숙(鄭春淑),106,149,255,0
23698,박상혁(朴商赫),정태호(鄭泰浩),88,135,223,0
23699,박상혁(朴商赫),정필모(鄭必模),100,113,213,0
23700,박상혁(朴商赫),정희용(鄭熙溶),50,7,57,1
23701,박상혁(朴商赫),조경태(趙慶泰),52,4,56,1
23702,박상혁(朴商赫),조명희(曺明姬),50,6,56,1
23703,박상혁(朴商赫),조수진(趙修眞),50,5,55,1
23704,박상혁(朴商赫),조승래(趙承來),101,104,205,0
23705,박상혁(朴商赫),조오섭(曺五燮),129,309,438,0
23706,박상혁(朴商赫),조은희(趙恩禧),26,4,30,1
23707,박상혁(朴商赫),조응천(趙應天),131,88,219,0
23708,박상혁(朴商赫),조정식(趙正湜),84,94,178,0
23709,박상혁(朴商赫),조정훈(趙廷訓),5,9,14,1
23710,박상혁(朴商赫),조해진(曺海珍),50,5,55,1
23711,박상혁(朴商赫),주철현(朱哲鉉),101,125,226,0
23712,박상혁(朴商赫),주호영(朱豪英),49,4,53,1
23713,박상혁(朴商赫),지성호(池成浩),50,6,56,1
23714,박상혁(朴商赫),진선미(陳善美),108,87,195,0
23715,박상혁(朴商赫),진성준(陳聲準),143,174,317,0
23716,박상혁(朴商赫),천준호(千俊鎬),125,106,231,0
23717,박상혁(朴商赫),최기상(崔基相),101,173,274,0
23718,박상혁(朴商赫),최승재(崔承宰),51,4,55,1
23719,박상혁(朴商赫),최연숙(崔姸淑),34,16,50,1
23720,박상혁(朴商赫),최영희(崔英姬),25,6,31,1
23721,박상혁(朴商赫),최인호(崔仁昊),154,272,426,0
23722,박상혁(朴商赫),최재형(崔在亨),25,5,30,1
23723,박상혁(朴商赫),최종윤(崔鍾允),121,219,340,0
23724,박상혁(朴商赫),최춘식(崔春植),50,4,54,1
23725,박상혁(朴商赫),최형두(崔炯斗),50,6,56,1
23726,박상혁(朴商赫),최혜영(崔惠英),129,164,293,0
23727,박상혁(朴商赫),추경호(秋慶鎬),50,5,55,1
23728,박상혁(朴商赫),태영호(太永浩),50,6,56,1
23729,박상혁(朴商赫),하영제(河榮帝),41,5,46,1
23730,박상혁(朴商赫),하태경(河泰慶),50,5,55,1
23731,박상혁(朴商赫),한기호(韓起鎬),50,5,55,1
23732,박상혁(朴商赫),한무경(韓茂景),52,6,58,1
23733,박상혁(朴商赫),한병도(韓秉道),155,182,337,0
23734,박상혁(朴商赫),한정애(韓貞愛),79,82,161,0
23735,박상혁(朴商赫),한준호(韓俊鎬),110,228,338,0
23736,박상혁(朴商赫),허숙정(許淑湞),1,1,2,0
23737,박상혁(朴商赫),허영(許榮),172,284,456,0
23738,박상혁(朴商赫),허은아(許垠娥),50,4,54,1
23739,박상혁(朴商赫),허종식(許琮植),128,257,385,0
23740,박상혁(朴商赫),홍기원(洪起元),147,220,367,0
23741,박상혁(朴商赫),홍문표(洪文杓),50,7,57,1
23742,박상혁(朴商赫),홍석준(洪碩晙),49,4,53,1
23743,박상혁(朴商赫),홍성국(洪性國),133,201,334,0
23744,박상혁(朴商赫),홍영표(洪永杓),84,81,165,0
23745,박상혁(朴商赫),홍익표(洪翼杓),98,104,202,0
23746,박상혁(朴商赫),홍정민(洪貞敏),106,141,247,0
23747,박상혁(朴商赫),황보승희(皇甫承希),47,4,51,1
23748,박상혁(朴商赫),황운하(黃雲夏),129,201,330,0
23749,박상혁(朴商赫),황희(黃熙),85,119,204,0
23750,박성민(朴聖敏),박성준(朴省俊),49,7,56,1
23751,박성민(朴聖敏),박성중(朴成重),68,74,142,0
23752,박성민(朴聖敏),박수영(朴洙瑩),76,72,148,0
23753,박성민(朴聖敏),박영순(朴英淳),50,5,55,1
23754,박성민(朴聖敏),박완주(朴完柱),24,1,25,1
23755,박성민(朴聖敏),박용진(朴用鎭),49,5,54,1
23756,박성민(朴聖敏),박재호(朴在昊),56,13,69,1
23757,박성민(朴聖敏),박정(朴釘),51,7,58,1
23758,박성민(朴聖敏),박정하(朴正河),33,53,86,0
23759,박성민(朴聖敏),박주민(朴柱民),50,5,55,1
23760,박성민(朴聖敏),박진(朴振),76,97,173,0
23761,박성민(朴聖敏),박찬대(朴贊大),51,5,56,1
23762,박성민(朴聖敏),박형수(朴亨修),68,63,131,0
23763,박성민(朴聖敏),박홍근(朴洪根),49,6,55,1
23764,박성민(朴聖敏),배준영(裵俊英),81,126,207,0
23765,박성민(朴聖敏),배진교(裵晋敎),5,3,8,1
23766,박성민(朴聖敏),배현진(裵賢鎭),71,66,137,0
23767,박성민(朴聖敏),백종헌(白宗憲),99,269,368,0
23768,박성민(朴聖敏),백혜련(白惠蓮),49,5,54,1
23769,박성민(朴聖敏),변재일(卞在一),49,5,54,1
23770,박성민(朴聖敏),서동용(徐東榕),50,7,57,1
23771,박성민(朴聖敏),서범수(徐範洙),89,149,238,0
23772,박성민(朴聖敏),서병수(徐秉洙),98,158,256,0
23773,박성민(朴聖敏),서삼석(徐參錫),51,14,65,1
23774,박성민(朴聖敏),서영교(徐瑛敎),52,9,61,1
23775,박성민(朴聖敏),서영석(徐暎錫),50,7,57,1
23776,박성민(朴聖敏),서일준(徐一俊),113,248,361,0
23777,박성민(朴聖敏),서정숙(徐正淑),78,104,182,0
23778,박성민(朴聖敏),설훈(薛勳),51,7,58,1
23779,박성민(朴聖敏),성일종(成一鍾),92,168,260,0
23780,박성민(朴聖敏),소병철(蘇秉哲),50,6,56,1
23781,박성민(朴聖敏),소병훈(蘇秉勳),51,6,57,1
23782,박성민(朴聖敏),송갑석(宋甲錫),51,9,60,1
23783,박성민(朴聖敏),송기헌(宋基憲),50,11,61,1
23784,박성민(朴聖敏),송석준(宋錫俊),82,97,179,0
23785,박성민(朴聖敏),송언석(宋彦錫),73,96,169,0
23786,박성민(朴聖敏),송옥주(宋玉珠),49,4,53,1
23787,박성민(朴聖敏),송재호(宋在祜),52,11,63,1
23788,박성민(朴聖敏),신동근(申東根),50,3,53,1
23789,박성민(朴聖敏),신영대(申榮大),49,4,53,1
23790,박성민(朴聖敏),신원식(申源湜),78,96,174,0
23791,박성민(朴聖敏),신정훈(辛正勳),51,14,65,1
23792,박성민(朴聖敏),신현영(申賢榮),49,4,53,1
23793,박성민(朴聖敏),심상정(沈相奵),5,3,8,1
23794,박성민(朴聖敏),안규백(安圭伯),53,7,60,1
23795,박성민(朴聖敏),안민석(安敏錫),51,4,55,1
23796,박성민(朴聖敏),안병길(安炳吉),88,160,248,0
23797,박성민(朴聖敏),안철수(安哲秀),27,25,52,0
23798,박성민(朴聖敏),안호영(安浩永),50,13,63,1
23799,박성민(朴聖敏),양경숙(梁敬淑),50,4,54,1
23800,박성민(朴聖敏),양금희(梁琴喜),101,143,244,0
23801,박성민(朴聖敏),양기대(梁基大),50,6,56,1
23802,박성민(朴聖敏),양이원영(梁李媛瑛),45,5,50,1
23803,박성민(朴聖敏),양정숙(梁貞淑),11,21,32,1
23804,박성민(朴聖敏),양향자(梁香子),23,14,37,1
23805,박성민(朴聖敏),어기구(魚基龜),49,9,58,1
23806,박성민(朴聖敏),엄태영(嚴泰永),91,142,233,0
23807,박성민(朴聖敏),오기형(吳奇炯),50,5,55,1
23808,박성민(朴聖敏),오영환(吳永煥),57,19,76,1
23809,박성민(朴聖敏),용혜인(龍慧仁),1,4,5,1
23810,박성민(朴聖敏),우상호(禹相虎),49,4,53,1
23811,박성민(朴聖敏),우원식(禹元植),51,5,56,1
23812,박성민(朴聖敏),위성곤(魏聖坤),56,19,75,1
23813,박성민(朴聖敏),유경준(兪京濬),86,130,216,0
23814,박성민(朴聖敏),유기홍(柳基洪),51,5,56,1
23815,박성민(朴聖敏),유동수(柳東秀),51,5,56,1
23816,박성민(朴聖敏),유상범(劉相凡),70,78,148,0
23817,박성민(朴聖敏),유의동(兪義東),73,102,175,0
23818,박성민(朴聖敏),유정주(兪訂炷),51,5,56,1
23819,박성민(朴聖敏),윤건영(尹建永),49,4,53,1
23820,박성민(朴聖敏),윤관석(尹官石),41,0,41,1
23821,박성민(朴聖敏),윤두현(尹斗鉉),80,132,212,0
23822,박성민(朴聖敏),윤미향(尹美香),21,1,22,1
23823,박성민(朴聖敏),윤상현(尹相現),39,60,99,0
23824,박성민(朴聖敏),윤영덕(尹永德),49,8,57,1
23825,박성민(朴聖敏),윤영석(尹永碩),69,67,136,0
23826,박성민(朴聖敏),윤영찬(尹永燦),49,4,53,1
23827,박성민(朴聖敏),윤재갑(尹才鉀),53,17,70,1
23828,박성민(朴聖敏),윤재옥(尹在玉),77,72,149,0
23829,박성민(朴聖敏),윤주경(尹柱卿),72,79,151,0
23830,박성민(朴聖敏),윤준병(尹準炳),50,8,58,1
23831,박성민(朴聖敏),윤창현(尹暢賢),87,131,218,0
23832,박성민(朴聖敏),윤한홍(尹漢洪),64,88,152,0
23833,박성민(朴聖敏),윤호중(尹昊重),49,5,54,1
23834,박성민(朴聖敏),윤후덕(尹厚德),50,5,55,1
23835,박성민(朴聖敏),이개호(李介昊),50,9,59,1
23836,박성민(朴聖敏),이달곤(李達坤),71,106,177,0
23837,박성민(朴聖敏),이동주(李東洲),49,6,55,1
23838,박성민(朴聖敏),이만희(李晩熙),85,113,198,0
23839,박성민(朴聖敏),이명수(李明洙),99,229,328,0
23840,박성민(朴聖敏),이병훈(李炳勳),51,8,59,1
23841,박성민(朴聖敏),이상민(李相珉),49,5,54,1
23842,박성민(朴聖敏),이상헌(李相憲),50,10,60,1
23843,박성민(朴聖敏),이성만(李成萬),41,2,43,1
23844,박성민(朴聖敏),이소영(李素永),50,6,56,1
23845,박성민(朴聖敏),이수진(李壽珍),51,5,56,1
23846,박성민(朴聖敏),이수진(李秀眞),51,8,59,1
23847,박성민(朴聖敏),이양수(李亮壽),84,108,192,0
23848,박성민(朴聖敏),이용(李鏞),84,113,197,0
23849,박성민(朴聖敏),이용빈(李龍彬),53,12,65,1
23850,박성민(朴聖敏),이용선(李庸瑄),50,4,54,1
23851,박성민(朴聖敏),이용우(李龍雨),49,7,56,1
23852,박성민(朴聖敏),이용호(李容鎬),29,42,71,0
23853,박성민(朴聖敏),이원욱(李元旭),51,8,59,1
23854,박성민(朴聖敏),이원택(李源澤),50,8,58,1
23855,박성민(朴聖敏),이은주(李恩周),6,3,9,1
23856,박성민(朴聖敏),이인선(李仁善),34,103,137,0
23857,박성민(朴聖敏),이인영(李仁榮),49,4,53,1
23858,박성민(朴聖敏),이장섭(李將燮),49,5,54,1
23859,박성민(朴聖敏),이재명(李在明),25,4,29,1
23860,박성민(朴聖敏),이재정(李在汀),49,4,53,1
23861,박성민(朴聖敏),이정문(李楨文),51,9,60,1
23862,박성민(朴聖敏),이종배(李鍾培),88,142,230,0
23863,박성민(朴聖敏),이종성(李鍾成),114,228,342,0
23864,박성민(朴聖敏),이주환(李周桓),115,236,351,0
23865,박성민(朴聖敏),이채익(李埰益),92,201,293,0
23866,박성민(朴聖敏),이철규(李喆圭),71,74,145,0
23867,박성민(朴聖敏),이탄희(李誕熙),49,4,53,1
23868,박성민(朴聖敏),이태규(李泰珪),47,70,117,0
23869,박성민(朴聖敏),이학영(李學永),50,5,55,1
23870,박성민(朴聖敏),이해식(李海植),51,5,56,1
23871,박성민(朴聖敏),이헌승(李憲昇),87,203,290,0
23872,박성민(朴聖敏),이형석(李炯錫),50,6,56,1
23873,박성민(朴聖敏),인재근(印在謹),50,8,58,1
23874,박성민(朴聖敏),임병헌(林炳憲),38,55,93,0
23875,박성민(朴聖敏),임오경(林五卿),49,5,54,1
23876,박성민(朴聖敏),임이자(林利子),94,131,225,0
23877,박성민(朴聖敏),임종성(林鍾聲),51,6,57,1
23878,박성민(朴聖敏),임호선(林昊宣),51,13,64,1
23879,박성민(朴聖敏),장경태(張耿態),52,4,56,1
23880,박성민(朴聖敏),장동혁(張東赫),32,46,78,0
23881,박성민(朴聖敏),장제원(張濟元),68,43,111,0
23882,박성민(朴聖敏),장철민(張喆敏),51,5,56,1
23883,박성민(朴聖敏),장혜영(張惠英),5,3,8,1
23884,박성민(朴聖敏),전봉민(田奉珉),81,192,273,0
23885,박성민(朴聖敏),전용기(田溶冀),50,6,56,1
23886,박성민(朴聖敏),전재수(田載秀),49,4,53,1
23887,박성민(朴聖敏),전주혜(全珠惠),76,116,192,0
23888,박성민(朴聖敏),전해철(全海澈),51,4,55,1
23889,박성민(朴聖敏),전혜숙(全惠淑),49,7,56,1
23890,박성민(朴聖敏),정경희(丁慶姬),78,93,171,0
23891,박성민(朴聖敏),정동만(鄭東萬),103,200,303,0
23892,박성민(朴聖敏),정성호(鄭成湖),52,7,59,1
23893,박성민(朴聖敏),정우택(鄭宇澤),45,127,172,0
23894,박성민(朴聖敏),정운천(鄭雲天),90,149,239,0
23895,박성민(朴聖敏),정일영(鄭日永),50,8,58,1
23896,박성민(朴聖敏),정점식(鄭点植),69,67,136,0
23897,박성민(朴聖敏),정진석(鄭鎭碩),78,94,172,0
23898,박성민(朴聖敏),정청래(鄭淸來),49,4,53,1
23899,박성민(朴聖敏),정춘숙(鄭春淑),55,7,62,1
23900,박성민(朴聖敏),정태호(鄭泰浩),51,6,57,1
23901,박성민(朴聖敏),정필모(鄭必模),49,4,53,1
23902,박성민(朴聖敏),정희용(鄭熙溶),91,123,214,0
23903,박성민(朴聖敏),조경태(趙慶泰),85,136,221,0
23904,박성민(朴聖敏),조명희(曺明姬),101,227,328,0
23905,박성민(朴聖敏),조수진(趙修眞),77,102,179,0
23906,박성민(朴聖敏),조승래(趙承來),49,7,56,1
23907,박성민(朴聖敏),조오섭(曺五燮),52,9,61,1
23908,박성민(朴聖敏),조은희(趙恩禧),42,79,121,0
23909,박성민(朴聖敏),조응천(趙應天),50,5,55,1
23910,박성민(朴聖敏),조정식(趙正湜),49,3,52,1
23911,박성민(朴聖敏),조정훈(趙廷訓),0,12,12,1
23912,박성민(朴聖敏),조해진(曺海珍),70,54,124,0
23913,박성민(朴聖敏),주철현(朱哲鉉),51,11,62,1
23914,박성민(朴聖敏),주호영(朱豪英),66,69,135,0
23915,박성민(朴聖敏),지성호(池成浩),94,147,241,0
23916,박성민(朴聖敏),진선미(陳善美),50,5,55,1
23917,박성민(朴聖敏),진성준(陳聲準),49,5,54,1
23918,박성민(朴聖敏),천준호(千俊鎬),49,4,53,1
23919,박성민(朴聖敏),최기상(崔基相),50,4,54,1
23920,박성민(朴聖敏),최승재(崔承宰),85,127,212,0
23921,박성민(朴聖敏),최연숙(崔姸淑),34,42,76,0
23922,박성민(朴聖敏),최영희(崔英姬),46,117,163,0
23923,박성민(朴聖敏),최인호(崔仁昊),51,5,56,1
23924,박성민(朴聖敏),최재형(崔在亨),33,27,60,0
23925,박성민(朴聖敏),최종윤(崔鍾允),50,8,58,1
23926,박성민(朴聖敏),최춘식(崔春植),86,149,235,0
23927,박성민(朴聖敏),최형두(崔炯斗),95,104,199,0
23928,박성민(朴聖敏),최혜영(崔惠英),50,7,57,1
23929,박성민(朴聖敏),추경호(秋慶鎬),79,99,178,0
23930,박성민(朴聖敏),태영호(太永浩),116,193,309,0
23931,박성민(朴聖敏),하영제(河榮帝),96,244,340,1
23932,박성민(朴聖敏),하태경(河泰慶),64,57,121,0
23933,박성민(朴聖敏),한기호(韓起鎬),67,55,122,0
23934,박성민(朴聖敏),한무경(韓茂景),98,181,279,0
23935,박성민(朴聖敏),한병도(韓秉道),49,4,53,1
23936,박성민(朴聖敏),한정애(韓貞愛),49,4,53,1
23937,박성민(朴聖敏),한준호(韓俊鎬),50,4,54,1
23938,박성민(朴聖敏),허숙정(許淑湞),0,0,0,1
23939,박성민(朴聖敏),허영(許榮),57,9,66,1
23940,박성민(朴聖敏),허은아(許垠娥),81,110,191,0
23941,박성민(朴聖敏),허종식(許琮植),51,10,61,1
23942,박성민(朴聖敏),홍기원(洪起元),50,6,56,1
23943,박성민(朴聖敏),홍문표(洪文杓),69,110,179,0
23944,박성민(朴聖敏),홍석준(洪碩晙),69,82,151,0
23945,박성민(朴聖敏),홍성국(洪性國),53,16,69,1
23946,박성민(朴聖敏),홍영표(洪永杓),49,5,54,1
23947,박성민(朴聖敏),홍익표(洪翼杓),49,4,53,1
23948,박성민(朴聖敏),홍정민(洪貞敏),50,7,57,1
23949,박성민(朴聖敏),황보승희(皇甫承希),90,181,271,1
23950,박성민(朴聖敏),황운하(黃雲夏),50,8,58,1
23951,박성민(朴聖敏),황희(黃熙),49,5,54,1
23952,박성준(朴省俊),박성중(朴成重),49,6,55,1
23953,박성준(朴省俊),박수영(朴洙瑩),49,5,54,1
23954,박성준(朴省俊),박영순(朴英淳),135,150,285,0
23955,박성준(朴省俊),박완주(朴完柱),76,75,151,1
23956,박성준(朴省俊),박용진(朴用鎭),84,73,157,0
23957,박성준(朴省俊),박재호(朴在昊),90,78,168,0
23958,박성준(朴省俊),박정(朴釘),137,183,320,0
23959,박성준(朴省俊),박정하(朴正河),25,4,29,1
23960,박성준(朴省俊),박주민(朴柱民),87,96,183,0
23961,박성준(朴省俊),박진(朴振),50,5,55,1
23962,박성준(朴省俊),박찬대(朴贊大),95,102,197,0
23963,박성준(朴省俊),박형수(朴亨修),49,5,54,1
23964,박성준(朴省俊),박홍근(朴洪根),150,215,365,0
23965,박성준(朴省俊),배준영(裵俊英),49,6,55,1
23966,박성준(朴省俊),배진교(裵晋敎),17,24,41,1
23967,박성준(朴省俊),배현진(裵賢鎭),49,4,53,1
23968,박성준(朴省俊),백종헌(白宗憲),50,5,55,1
23969,박성준(朴省俊),백혜련(白惠蓮),132,129,261,0
23970,박성준(朴省俊),변재일(卞在一),95,56,151,0
23971,박성준(朴省俊),서동용(徐東榕),110,126,236,0
23972,박성준(朴省俊),서범수(徐範洙),50,4,54,1
23973,박성준(朴省俊),서병수(徐秉洙),50,5,55,1
23974,박성준(朴省俊),서삼석(徐參錫),103,80,183,0
23975,박성준(朴省俊),서영교(徐瑛敎),137,191,328,0
23976,박성준(朴省俊),서영석(徐暎錫),123,145,268,0
23977,박성준(朴省俊),서일준(徐一俊),51,11,62,1
23978,박성준(朴省俊),서정숙(徐正淑),50,5,55,1
23979,박성준(朴省俊),설훈(薛勳),87,78,165,0
23980,박성준(朴省俊),성일종(成一鍾),51,9,60,1
23981,박성준(朴省俊),소병철(蘇秉哲),100,129,229,0
23982,박성준(朴省俊),소병훈(蘇秉勳),110,120,230,0
23983,박성준(朴省俊),송갑석(宋甲錫),117,124,241,0
23984,박성준(朴省俊),송기헌(宋基憲),97,101,198,0
23985,박성준(朴省俊),송석준(宋錫俊),49,5,54,1
23986,박성준(朴省俊),송언석(宋彦錫),46,6,52,1
23987,박성준(朴省俊),송옥주(宋玉珠),123,140,263,0
23988,박성준(朴省俊),송재호(宋在祜),143,161,304,0
23989,박성준(朴省俊),신동근(申東根),101,67,168,0
23990,박성준(朴省俊),신영대(申榮大),94,63,157,0
23991,박성준(朴省俊),신원식(申源湜),51,6,57,1
23992,박성준(朴省俊),신정훈(辛正勳),154,228,382,0
23993,박성준(朴省俊),신현영(申賢榮),86,66,152,0
23994,박성준(朴省俊),심상정(沈相奵),14,27,41,1
23995,박성준(朴省俊),안규백(安圭伯),140,155,295,0
23996,박성준(朴省俊),안민석(安敏錫),95,71,166,0
23997,박성준(朴省俊),안병길(安炳吉),50,4,54,1
23998,박성준(朴省俊),안철수(安哲秀),25,4,29,1
23999,박성준(朴省俊),안호영(安浩永),95,89,184,0
24000,박성준(朴省俊),양경숙(梁敬淑),116,166,282,0
24001,박성준(朴省俊),양금희(梁琴喜),50,7,57,1
24002,박성준(朴省俊),양기대(梁基大),108,69,177,0
24003,박성준(朴省俊),양이원영(梁李媛瑛),142,133,275,0
24004,박성준(朴省俊),양정숙(梁貞淑),143,302,445,1
24005,박성준(朴省俊),양향자(梁香子),61,59,120,1
24006,박성준(朴省俊),어기구(魚基龜),95,83,178,0
24007,박성준(朴省俊),엄태영(嚴泰永),50,5,55,1
24008,박성준(朴省俊),오기형(吳奇炯),80,41,121,0
24009,박성준(朴省俊),오영환(吳永煥),218,372,590,0
24010,박성준(朴省俊),용혜인(龍慧仁),29,69,98,1
24011,박성준(朴省俊),우상호(禹相虎),81,46,127,0
24012,박성준(朴省俊),우원식(禹元植),97,81,178,0
24013,박성준(朴省俊),위성곤(魏聖坤),91,141,232,0
24014,박성준(朴省俊),유경준(兪京濬),49,6,55,1
24015,박성준(朴省俊),유기홍(柳基洪),79,62,141,0
24016,박성준(朴省俊),유동수(柳東秀),103,104,207,0
24017,박성준(朴省俊),유상범(劉相凡),49,5,54,1
24018,박성준(朴省俊),유의동(兪義東),49,4,53,1
24019,박성준(朴省俊),유정주(兪訂炷),124,155,279,0
24020,박성준(朴省俊),윤건영(尹建永),100,119,219,0
24021,박성준(朴省俊),윤관석(尹官石),119,104,223,1
24022,박성준(朴省俊),윤두현(尹斗鉉),49,4,53,1
24023,박성준(朴省俊),윤미향(尹美香),131,193,324,1
24024,박성준(朴省俊),윤상현(尹相現),31,7,38,1
24025,박성준(朴省俊),윤영덕(尹永德),93,129,222,0
24026,박성준(朴省俊),윤영석(尹永碩),50,11,61,1
24027,박성준(朴省俊),윤영찬(尹永燦),92,67,159,0
24028,박성준(朴省俊),윤재갑(尹才鉀),164,199,363,0
24029,박성준(朴省俊),윤재옥(尹在玉),49,4,53,1
24030,박성준(朴省俊),윤주경(尹柱卿),49,5,54,1
24031,박성준(朴省俊),윤준병(尹準炳),128,160,288,0
24032,박성준(朴省俊),윤창현(尹暢賢),49,6,55,1
24033,박성준(朴省俊),윤한홍(尹漢洪),51,7,58,1
24034,박성준(朴省俊),윤호중(尹昊重),79,60,139,0
24035,박성준(朴省俊),윤후덕(尹厚德),115,102,217,0
24036,박성준(朴省俊),이개호(李介昊),91,82,173,0
24037,박성준(朴省俊),이달곤(李達坤),51,6,57,1
24038,박성준(朴省俊),이동주(李東洲),89,115,204,0
24039,박성준(朴省俊),이만희(李晩熙),49,4,53,1
24040,박성준(朴省俊),이명수(李明洙),50,19,69,1
24041,박성준(朴省俊),이병훈(李炳勳),137,172,309,0
24042,박성준(朴省俊),이상민(李相珉),93,74,167,0
24043,박성준(朴省俊),이상헌(李相憲),154,202,356,0
24044,박성준(朴省俊),이성만(李成萬),186,268,454,1
24045,박성준(朴省俊),이소영(李素永),83,52,135,0
24046,박성준(朴省俊),이수진(李壽珍),172,228,400,0
24047,박성준(朴省俊),이수진(李秀眞),146,206,352,0
24048,박성준(朴省俊),이양수(李亮壽),51,6,57,1
24049,박성준(朴省俊),이용(李鏞),49,6,55,1
24050,박성준(朴省俊),이용빈(李龍彬),137,213,350,0
24051,박성준(朴省俊),이용선(李庸瑄),95,89,184,0
24052,박성준(朴省俊),이용우(李龍雨),108,116,224,0
24053,박성준(朴省俊),이용호(李容鎬),42,34,76,1
24054,박성준(朴省俊),이원욱(李元旭),105,77,182,0
24055,박성준(朴省俊),이원택(李源澤),119,157,276,0
24056,박성준(朴省俊),이은주(李恩周),31,37,68,1
24057,박성준(朴省俊),이인선(李仁善),25,4,29,1
24058,박성준(朴省俊),이인영(李仁榮),89,52,141,0
24059,박성준(朴省俊),이장섭(李將燮),101,84,185,0
24060,박성준(朴省俊),이재명(李在明),41,17,58,0
24061,박성준(朴省俊),이재정(李在汀),109,77,186,0
24062,박성준(朴省俊),이정문(李楨文),110,111,221,0
24063,박성준(朴省俊),이종배(李鍾培),50,6,56,1
24064,박성준(朴省俊),이종성(李鍾成),49,7,56,1
24065,박성준(朴省俊),이주환(李周桓),49,6,55,1
24066,박성준(朴省俊),이채익(李埰益),52,13,65,1
24067,박성준(朴省俊),이철규(李喆圭),52,4,56,1
24068,박성준(朴省俊),이탄희(李誕熙),121,104,225,0
24069,박성준(朴省俊),이태규(李泰珪),29,5,34,1
24070,박성준(朴省俊),이학영(李學永),106,110,216,0
24071,박성준(朴省俊),이해식(李海植),118,124,242,0
24072,박성준(朴省俊),이헌승(李憲昇),50,4,54,1
24073,박성준(朴省俊),이형석(李炯錫),112,156,268,0
24074,박성준(朴省俊),인재근(印在謹),116,131,247,0
24075,박성준(朴省俊),임병헌(林炳憲),25,4,29,1
24076,박성준(朴省俊),임오경(林五卿),126,165,291,0
24077,박성준(朴省俊),임이자(林利子),50,4,54,1
24078,박성준(朴省俊),임종성(林鍾聲),110,135,245,0
24079,박성준(朴省俊),임호선(林昊宣),120,187,307,0
24080,박성준(朴省俊),장경태(張耿態),101,117,218,0
24081,박성준(朴省俊),장동혁(張東赫),25,4,29,1
24082,박성준(朴省俊),장제원(張濟元),49,5,54,1
24083,박성준(朴省俊),장철민(張喆敏),143,164,307,0
24084,박성준(朴省俊),장혜영(張惠英),16,36,52,1
24085,박성준(朴省俊),전봉민(田奉珉),35,5,40,1
24086,박성준(朴省俊),전용기(田溶冀),135,165,300,0
24087,박성준(朴省俊),전재수(田載秀),96,71,167,0
24088,박성준(朴省俊),전주혜(全珠惠),51,5,56,1
24089,박성준(朴省俊),전해철(全海澈),83,48,131,0
24090,박성준(朴省俊),전혜숙(全惠淑),157,165,322,0
24091,박성준(朴省俊),정경희(丁慶姬),49,5,54,1
24092,박성준(朴省俊),정동만(鄭東萬),49,4,53,1
24093,박성준(朴省俊),정성호(鄭成湖),115,150,265,0
24094,박성준(朴省俊),정우택(鄭宇澤),25,4,29,1
24095,박성준(朴省俊),정운천(鄭雲天),50,7,57,1
24096,박성준(朴省俊),정일영(鄭日永),116,162,278,0
24097,박성준(朴省俊),정점식(鄭点植),50,4,54,1
24098,박성준(朴省俊),정진석(鄭鎭碩),50,7,57,1
24099,박성준(朴省俊),정청래(鄭淸來),122,143,265,0
24100,박성준(朴省俊),정춘숙(鄭春淑),117,108,225,0
24101,박성준(朴省俊),정태호(鄭泰浩),88,71,159,0
24102,박성준(朴省俊),정필모(鄭必模),96,85,181,0
24103,박성준(朴省俊),정희용(鄭熙溶),51,6,57,1
24104,박성준(朴省俊),조경태(趙慶泰),51,5,56,1
24105,박성준(朴省俊),조명희(曺明姬),50,7,57,1
24106,박성준(朴省俊),조수진(趙修眞),51,6,57,1
24107,박성준(朴省俊),조승래(趙承來),113,110,223,0
24108,박성준(朴省俊),조오섭(曺五燮),129,181,310,0
24109,박성준(朴省俊),조은희(趙恩禧),25,7,32,1
24110,박성준(朴省俊),조응천(趙應天),82,51,133,0
24111,박성준(朴省俊),조정식(趙正湜),87,45,132,0
24112,박성준(朴省俊),조정훈(趙廷訓),2,27,29,1
24113,박성준(朴省俊),조해진(曺海珍),51,6,57,1
24114,박성준(朴省俊),주철현(朱哲鉉),113,114,227,0
24115,박성준(朴省俊),주호영(朱豪英),49,4,53,1
24116,박성준(朴省俊),지성호(池成浩),49,6,55,1
24117,박성준(朴省俊),진선미(陳善美),96,68,164,0
24118,박성준(朴省俊),진성준(陳聲準),107,108,215,0
24119,박성준(朴省俊),천준호(千俊鎬),90,80,170,0
24120,박성준(朴省俊),최기상(崔基相),97,99,196,0
24121,박성준(朴省俊),최승재(崔承宰),51,6,57,1
24122,박성준(朴省俊),최연숙(崔姸淑),33,18,51,1
24123,박성준(朴省俊),최영희(崔英姬),25,4,29,1
24124,박성준(朴省俊),최인호(崔仁昊),91,84,175,0
24125,박성준(朴省俊),최재형(崔在亨),25,4,29,1
24126,박성준(朴省俊),최종윤(崔鍾允),143,181,324,0
24127,박성준(朴省俊),최춘식(崔春植),49,4,53,1
24128,박성준(朴省俊),최형두(崔炯斗),50,4,54,1
24129,박성준(朴省俊),최혜영(崔惠英),152,204,356,0
24130,박성준(朴省俊),추경호(秋慶鎬),50,4,54,1
24131,박성준(朴省俊),태영호(太永浩),49,6,55,1
24132,박성준(朴省俊),하영제(河榮帝),41,2,43,1
24133,박성준(朴省俊),하태경(河泰慶),50,6,56,1
24134,박성준(朴省俊),한기호(韓起鎬),53,5,58,1
24135,박성준(朴省俊),한무경(韓茂景),49,5,54,1
24136,박성준(朴省俊),한병도(韓秉道),117,145,262,0
24137,박성준(朴省俊),한정애(韓貞愛),97,88,185,0
24138,박성준(朴省俊),한준호(韓俊鎬),122,147,269,0
24139,박성준(朴省俊),허숙정(許淑湞),1,1,2,0
24140,박성준(朴省俊),허영(許榮),114,105,219,0
24141,박성준(朴省俊),허은아(許垠娥),49,6,55,1
24142,박성준(朴省俊),허종식(許琮植),129,155,284,0
24143,박성준(朴省俊),홍기원(洪起元),104,88,192,0
24144,박성준(朴省俊),홍문표(洪文杓),50,8,58,1
24145,박성준(朴省俊),홍석준(洪碩晙),50,4,54,1
24146,박성준(朴省俊),홍성국(洪性國),160,235,395,0
24147,박성준(朴省俊),홍영표(洪永杓),100,67,167,0
24148,박성준(朴省俊),홍익표(洪翼杓),112,102,214,0
24149,박성준(朴省俊),홍정민(洪貞敏),121,168,289,0
24150,박성준(朴省俊),황보승희(皇甫承希),46,4,50,1
24151,박성준(朴省俊),황운하(黃雲夏),181,238,419,0
24152,박성준(朴省俊),황희(黃熙),78,48,126,0
24153,박성중(朴成重),박수영(朴洙瑩),66,48,114,0
24154,박성중(朴成重),박영순(朴英淳),49,3,52,1
24155,박성중(朴成重),박완주(朴完柱),24,0,24,1
24156,박성중(朴成重),박용진(朴用鎭),49,5,54,1
24157,박성중(朴成重),박재호(朴在昊),50,5,55,1
24158,박성중(朴成重),박정(朴釘),49,4,53,1
24159,박성중(朴成重),박정하(朴正河),27,25,52,0
24160,박성중(朴成重),박주민(朴柱民),49,4,53,1
24161,박성중(朴成重),박진(朴振),73,66,139,0
24162,박성중(朴成重),박찬대(朴贊大),49,4,53,1
24163,박성중(朴成重),박형수(朴亨修),65,45,110,0
24164,박성중(朴成重),박홍근(朴洪根),49,4,53,1
24165,박성중(朴成重),배준영(裵俊英),72,62,134,0
24166,박성중(朴成重),배진교(裵晋敎),4,2,6,1
24167,박성중(朴成重),배현진(裵賢鎭),70,65,135,0
24168,박성중(朴成重),백종헌(白宗憲),85,105,190,0
24169,박성중(朴成重),백혜련(白惠蓮),49,4,53,1
24170,박성중(朴成重),변재일(卞在一),50,6,56,1
24171,박성중(朴成重),서동용(徐東榕),49,4,53,1
24172,박성중(朴成重),서범수(徐範洙),83,66,149,0
24173,박성중(朴成重),서병수(徐秉洙),69,74,143,0
24174,박성중(朴成重),서삼석(徐參錫),50,5,55,1
24175,박성중(朴成重),서영교(徐瑛敎),50,4,54,1
24176,박성중(朴成重),서영석(徐暎錫),49,6,55,1
24177,박성중(朴成重),서일준(徐一俊),89,113,202,0
24178,박성중(朴成重),서정숙(徐正淑),79,68,147,0
24179,박성중(朴成重),설훈(薛勳),49,5,54,1
24180,박성중(朴成重),성일종(成一鍾),93,97,190,0
24181,박성중(朴成重),소병철(蘇秉哲),49,4,53,1
24182,박성중(朴成重),소병훈(蘇秉勳),50,4,54,1
24183,박성중(朴成重),송갑석(宋甲錫),49,7,56,1
24184,박성중(朴成重),송기헌(宋基憲),50,6,56,1
24185,박성중(朴成重),송석준(宋錫俊),81,62,143,0
24186,박성중(朴成重),송언석(宋彦錫),63,66,129,0
24187,박성중(朴成重),송옥주(宋玉珠),49,4,53,1
24188,박성중(朴成重),송재호(宋在祜),49,4,53,1
24189,박성중(朴成重),신동근(申東根),49,3,52,1
24190,박성중(朴成重),신영대(申榮大),49,6,55,1
24191,박성중(朴成重),신원식(申源湜),76,73,149,0
24192,박성중(朴成重),신정훈(辛正勳),50,6,56,1
24193,박성중(朴成重),신현영(申賢榮),49,4,53,1
24194,박성중(朴成重),심상정(沈相奵),4,3,7,1
24195,박성중(朴成重),안규백(安圭伯),50,8,58,1
24196,박성중(朴成重),안민석(安敏錫),49,4,53,1
24197,박성중(朴成重),안병길(安炳吉),69,70,139,0
24198,박성중(朴成重),안철수(安哲秀),25,10,35,0
24199,박성중(朴成重),안호영(安浩永),49,5,54,1
24200,박성중(朴成重),양경숙(梁敬淑),49,5,54,1
24201,박성중(朴成重),양금희(梁琴喜),74,78,152,0
24202,박성중(朴成重),양기대(梁基大),50,6,56,1
24203,박성중(朴成重),양이원영(梁李媛瑛),45,4,49,1
24204,박성중(朴成重),양정숙(梁貞淑),1,2,3,1
24205,박성중(朴成重),양향자(梁香子),20,5,25,1
24206,박성중(朴成重),어기구(魚基龜),51,5,56,1
24207,박성중(朴成重),엄태영(嚴泰永),76,83,159,0
24208,박성중(朴成重),오기형(吳奇炯),49,4,53,1
24209,박성중(朴成重),오영환(吳永煥),50,4,54,1
24210,박성중(朴成重),용혜인(龍慧仁),1,3,4,1
24211,박성중(朴成重),우상호(禹相虎),49,4,53,1
24212,박성중(朴成重),우원식(禹元植),49,4,53,1
24213,박성중(朴成重),위성곤(魏聖坤),49,6,55,1
24214,박성중(朴成重),유경준(兪京濬),98,90,188,0
24215,박성중(朴成重),유기홍(柳基洪),49,6,55,1
24216,박성중(朴成重),유동수(柳東秀),51,5,56,1
24217,박성중(朴成重),유상범(劉相凡),61,40,101,0
24218,박성중(朴成重),유의동(兪義東),66,51,117,0
24219,박성중(朴成重),유정주(兪訂炷),49,4,53,1
24220,박성중(朴成重),윤건영(尹建永),49,3,52,1
24221,박성중(朴成重),윤관석(尹官石),40,0,40,1
24222,박성중(朴成重),윤두현(尹斗鉉),70,87,157,0
24223,박성중(朴成重),윤미향(尹美香),20,0,20,1
24224,박성중(朴成重),윤상현(尹相現),43,33,76,0
24225,박성중(朴成重),윤영덕(尹永德),49,6,55,1
24226,박성중(朴成重),윤영석(尹永碩),77,96,173,0
24227,박성중(朴成重),윤영찬(尹永燦),49,6,55,1
24228,박성중(朴成重),윤재갑(尹才鉀),51,10,61,1
24229,박성중(朴成重),윤재옥(尹在玉),72,48,120,0
24230,박성중(朴成重),윤주경(尹柱卿),69,60,129,0
24231,박성중(朴成重),윤준병(尹準炳),49,4,53,1
24232,박성중(朴成重),윤창현(尹暢賢),77,89,166,0
24233,박성중(朴成重),윤한홍(尹漢洪),75,107,182,0
24234,박성중(朴成重),윤호중(尹昊重),49,5,54,1
24235,박성중(朴成重),윤후덕(尹厚德),49,7,56,1
24236,박성중(朴成重),이개호(李介昊),49,5,54,1
24237,박성중(朴成重),이달곤(李達坤),63,78,141,0
24238,박성중(朴成重),이동주(李東洲),49,4,53,1
24239,박성중(朴成重),이만희(李晩熙),66,57,123,0
24240,박성중(朴成重),이명수(李明洙),94,130,224,0
24241,박성중(朴成重),이병훈(李炳勳),50,7,57,1
24242,박성중(朴成重),이상민(李相珉),50,5,55,1
24243,박성중(朴成重),이상헌(李相憲),50,6,56,1
24244,박성중(朴成重),이성만(李成萬),40,0,40,1
24245,박성중(朴成重),이소영(李素永),49,4,53,1
24246,박성중(朴成重),이수진(李壽珍),49,4,53,1
24247,박성중(朴成重),이수진(李秀眞),49,4,53,1
24248,박성중(朴成重),이양수(李亮壽),62,57,119,0
24249,박성중(朴成重),이용(李鏞),83,79,162,0
24250,박성중(朴成重),이용빈(李龍彬),50,6,56,1
24251,박성중(朴成重),이용선(李庸瑄),50,4,54,1
24252,박성중(朴成重),이용우(李龍雨),49,5,54,1
24253,박성중(朴成重),이용호(李容鎬),27,19,46,0
24254,박성중(朴成重),이원욱(李元旭),50,8,58,1
24255,박성중(朴成重),이원택(李源澤),49,5,54,1
24256,박성중(朴成重),이은주(李恩周),4,2,6,1
24257,박성중(朴成重),이인선(李仁善),28,29,57,0
24258,박성중(朴成重),이인영(李仁榮),49,4,53,1
24259,박성중(朴成重),이장섭(李將燮),49,4,53,1
24260,박성중(朴成重),이재명(李在明),25,4,29,1
24261,박성중(朴成重),이재정(李在汀),49,4,53,1
24262,박성중(朴成重),이정문(李楨文),49,4,53,1
24263,박성중(朴成重),이종배(李鍾培),87,72,159,0
24264,박성중(朴成重),이종성(李鍾成),91,109,200,0
24265,박성중(朴成重),이주환(李周桓),78,76,154,0
24266,박성중(朴成重),이채익(李埰益),76,61,137,0
24267,박성중(朴成重),이철규(李喆圭),70,73,143,0
24268,박성중(朴成重),이탄희(李誕熙),49,4,53,1
24269,박성중(朴成重),이태규(李泰珪),37,34,71,0
24270,박성중(朴成重),이학영(李學永),49,5,54,1
24271,박성중(朴成重),이해식(李海植),49,5,54,1
24272,박성중(朴成重),이헌승(李憲昇),63,45,108,0
24273,박성중(朴成重),이형석(李炯錫),49,5,54,1
24274,박성중(朴成重),인재근(印在謹),49,6,55,1
24275,박성중(朴成重),임병헌(林炳憲),30,35,65,0
24276,박성중(朴成重),임오경(林五卿),49,4,53,1
24277,박성중(朴成重),임이자(林利子),89,78,167,0
24278,박성중(朴成重),임종성(林鍾聲),50,4,54,1
24279,박성중(朴成重),임호선(林昊宣),49,4,53,1
24280,박성중(朴成重),장경태(張耿態),49,4,53,1
24281,박성중(朴成重),장동혁(張東赫),27,18,45,0
24282,박성중(朴成重),장제원(張濟元),60,40,100,0
24283,박성중(朴成重),장철민(張喆敏),49,5,54,1
24284,박성중(朴成重),장혜영(張惠英),4,2,6,1
24285,박성중(朴成重),전봉민(田奉珉),52,45,97,0
24286,박성중(朴成重),전용기(田溶冀),49,4,53,1
24287,박성중(朴成重),전재수(田載秀),49,4,53,1
24288,박성중(朴成重),전주혜(全珠惠),65,58,123,0
24289,박성중(朴成重),전해철(全海澈),49,4,53,1
24290,박성중(朴成重),전혜숙(全惠淑),49,7,56,1
24291,박성중(朴成重),정경희(丁慶姬),65,66,131,0
24292,박성중(朴成重),정동만(鄭東萬),69,59,128,0
24293,박성중(朴成重),정성호(鄭成湖),50,7,57,1
24294,박성중(朴成重),정우택(鄭宇澤),30,38,68,0
24295,박성중(朴成重),정운천(鄭雲天),77,68,145,0
24296,박성중(朴成重),정일영(鄭日永),50,5,55,1
24297,박성중(朴成重),정점식(鄭点植),64,38,102,0
24298,박성중(朴成重),정진석(鄭鎭碩),69,72,141,0
24299,박성중(朴成重),정청래(鄭淸來),49,4,53,1
24300,박성중(朴成重),정춘숙(鄭春淑),49,4,53,1
24301,박성중(朴成重),정태호(鄭泰浩),49,4,53,1
24302,박성중(朴成重),정필모(鄭必模),49,4,53,1
24303,박성중(朴成重),정희용(鄭熙溶),77,99,176,0
24304,박성중(朴成重),조경태(趙慶泰),78,75,153,0
24305,박성중(朴成重),조명희(曺明姬),77,99,176,0
24306,박성중(朴成重),조수진(趙修眞),81,67,148,0
24307,박성중(朴成重),조승래(趙承來),49,8,57,1
24308,박성중(朴成重),조오섭(曺五燮),50,6,56,1
24309,박성중(朴成重),조은희(趙恩禧),28,32,60,0
24310,박성중(朴成重),조응천(趙應天),50,4,54,1
24311,박성중(朴成重),조정식(趙正湜),49,3,52,1
24312,박성중(朴成重),조정훈(趙廷訓),0,2,2,1
24313,박성중(朴成重),조해진(曺海珍),61,39,100,0
24314,박성중(朴成重),주철현(朱哲鉉),50,4,54,1
24315,박성중(朴成重),주호영(朱豪英),67,53,120,0
24316,박성중(朴成重),지성호(池成浩),76,94,170,0
24317,박성중(朴成重),진선미(陳善美),49,4,53,1
24318,박성중(朴成重),진성준(陳聲準),49,4,53,1
24319,박성중(朴成重),천준호(千俊鎬),49,3,52,1
24320,박성중(朴成重),최기상(崔基相),49,4,53,1
24321,박성중(朴成重),최승재(崔承宰),69,53,122,0
24322,박성중(朴成重),최연숙(崔姸淑),34,36,70,0
24323,박성중(朴成重),최영희(崔英姬),27,21,48,0
24324,박성중(朴成重),최인호(崔仁昊),51,4,55,1
24325,박성중(朴成重),최재형(崔在亨),28,16,44,0
24326,박성중(朴成重),최종윤(崔鍾允),49,5,54,1
24327,박성중(朴成重),최춘식(崔春植),73,86,159,0
24328,박성중(朴成重),최형두(崔炯斗),90,127,217,0
24329,박성중(朴成重),최혜영(崔惠英),49,4,53,1
24330,박성중(朴成重),추경호(秋慶鎬),102,118,220,0
24331,박성중(朴成重),태영호(太永浩),93,155,248,0
24332,박성중(朴成重),하영제(河榮帝),70,96,166,1
24333,박성중(朴成重),하태경(河泰慶),62,50,112,0
24334,박성중(朴成重),한기호(韓起鎬),59,51,110,0
24335,박성중(朴成重),한무경(韓茂景),73,86,159,0
24336,박성중(朴成重),한병도(韓秉道),49,5,54,1
24337,박성중(朴成重),한정애(韓貞愛),49,4,53,1
24338,박성중(朴成重),한준호(韓俊鎬),49,6,55,1
24339,박성중(朴成重),허숙정(許淑湞),0,0,0,1
24340,박성중(朴成重),허영(許榮),49,5,54,1
24341,박성중(朴成重),허은아(許垠娥),84,98,182,0
24342,박성중(朴成重),허종식(許琮植),50,4,54,1
24343,박성중(朴成重),홍기원(洪起元),49,4,53,1
24344,박성중(朴成重),홍문표(洪文杓),87,80,167,0
24345,박성중(朴成重),홍석준(洪碩晙),78,81,159,0
24346,박성중(朴成重),홍성국(洪性國),49,4,53,1
24347,박성중(朴成重),홍영표(洪永杓),50,4,54,1
24348,박성중(朴成重),홍익표(洪翼杓),49,4,53,1
24349,박성중(朴成重),홍정민(洪貞敏),50,4,54,1
24350,박성중(朴成重),황보승희(皇甫承希),76,102,178,1
24351,박성중(朴成重),황운하(黃雲夏),49,4,53,1
24352,박성중(朴成重),황희(黃熙),49,4,53,1
24353,박수영(朴洙瑩),박영순(朴英淳),50,4,54,1
24354,박수영(朴洙瑩),박완주(朴完柱),24,2,26,1
24355,박수영(朴洙瑩),박용진(朴用鎭),49,14,63,1
24356,박수영(朴洙瑩),박재호(朴在昊),52,18,70,1
24357,박수영(朴洙瑩),박정(朴釘),49,7,56,1
24358,박수영(朴洙瑩),박정하(朴正河),32,20,52,0
24359,박수영(朴洙瑩),박주민(朴柱民),49,6,55,1
24360,박수영(朴洙瑩),박진(朴振),66,48,114,0
24361,박수영(朴洙瑩),박찬대(朴贊大),49,5,54,1
24362,박수영(朴洙瑩),박형수(朴亨修),62,47,109,0
24363,박수영(朴洙瑩),박홍근(朴洪根),50,13,63,1
24364,박수영(朴洙瑩),배준영(裵俊英),77,52,129,0
24365,박수영(朴洙瑩),배진교(裵晋敎),4,17,21,1
24366,박수영(朴洙瑩),배현진(裵賢鎭),68,47,115,0
24367,박수영(朴洙瑩),백종헌(白宗憲),80,89,169,0
24368,박수영(朴洙瑩),백혜련(白惠蓮),49,4,53,1
24369,박수영(朴洙瑩),변재일(卞在一),50,5,55,1
24370,박수영(朴洙瑩),서동용(徐東榕),49,4,53,1
24371,박수영(朴洙瑩),서범수(徐範洙),70,73,143,0
24372,박수영(朴洙瑩),서병수(徐秉洙),90,100,190,0
24373,박수영(朴洙瑩),서삼석(徐參錫),49,5,54,1
24374,박수영(朴洙瑩),서영교(徐瑛敎),50,5,55,1
24375,박수영(朴洙瑩),서영석(徐暎錫),49,6,55,1
24376,박수영(朴洙瑩),서일준(徐一俊),76,62,138,0
24377,박수영(朴洙瑩),서정숙(徐正淑),65,65,130,0
24378,박수영(朴洙瑩),설훈(薛勳),50,5,55,1
24379,박수영(朴洙瑩),성일종(成一鍾),78,55,133,0
24380,박수영(朴洙瑩),소병철(蘇秉哲),49,4,53,1
24381,박수영(朴洙瑩),소병훈(蘇秉勳),49,5,54,1
24382,박수영(朴洙瑩),송갑석(宋甲錫),49,5,54,1
24383,박수영(朴洙瑩),송기헌(宋基憲),50,6,56,1
24384,박수영(朴洙瑩),송석준(宋錫俊),75,56,131,0
24385,박수영(朴洙瑩),송언석(宋彦錫),63,51,114,0
24386,박수영(朴洙瑩),송옥주(宋玉珠),49,5,54,1
24387,박수영(朴洙瑩),송재호(宋在祜),51,5,56,1
24388,박수영(朴洙瑩),신동근(申東根),49,3,52,1
24389,박수영(朴洙瑩),신영대(申榮大),49,4,53,1
24390,박수영(朴洙瑩),신원식(申源湜),68,60,128,0
24391,박수영(朴洙瑩),신정훈(辛正勳),50,5,55,1
24392,박수영(朴洙瑩),신현영(申賢榮),49,4,53,1
24393,박수영(朴洙瑩),심상정(沈相奵),4,12,16,1
24394,박수영(朴洙瑩),안규백(安圭伯),50,6,56,1
24395,박수영(朴洙瑩),안민석(安敏錫),50,3,53,1
24396,박수영(朴洙瑩),안병길(安炳吉),80,82,162,0
24397,박수영(朴洙瑩),안철수(安哲秀),26,18,44,0
24398,박수영(朴洙瑩),안호영(安浩永),49,5,54,1
24399,박수영(朴洙瑩),양경숙(梁敬淑),49,5,54,1
24400,박수영(朴洙瑩),양금희(梁琴喜),69,79,148,0
24401,박수영(朴洙瑩),양기대(梁基大),49,4,53,1
24402,박수영(朴洙瑩),양이원영(梁李媛瑛),45,14,59,1
24403,박수영(朴洙瑩),양정숙(梁貞淑),0,13,13,1
24404,박수영(朴洙瑩),양향자(梁香子),22,6,28,1
24405,박수영(朴洙瑩),어기구(魚基龜),49,5,54,1
24406,박수영(朴洙瑩),엄태영(嚴泰永),66,52,118,0
24407,박수영(朴洙瑩),오기형(吳奇炯),49,5,54,1
24408,박수영(朴洙瑩),오영환(吳永煥),49,17,66,1
24409,박수영(朴洙瑩),용혜인(龍慧仁),1,9,10,1
24410,박수영(朴洙瑩),우상호(禹相虎),49,4,53,1
24411,박수영(朴洙瑩),우원식(禹元植),49,4,53,1
24412,박수영(朴洙瑩),위성곤(魏聖坤),50,6,56,1
24413,박수영(朴洙瑩),유경준(兪京濬),79,86,165,0
24414,박수영(朴洙瑩),유기홍(柳基洪),49,4,53,1
24415,박수영(朴洙瑩),유동수(柳東秀),49,5,54,1
24416,박수영(朴洙瑩),유상범(劉相凡),63,68,131,0
24417,박수영(朴洙瑩),유의동(兪義東),66,44,110,0
24418,박수영(朴洙瑩),유정주(兪訂炷),49,15,64,1
24419,박수영(朴洙瑩),윤건영(尹建永),49,5,54,1
24420,박수영(朴洙瑩),윤관석(尹官石),40,0,40,1
24421,박수영(朴洙瑩),윤두현(尹斗鉉),73,63,136,0
24422,박수영(朴洙瑩),윤미향(尹美香),20,3,23,1
24423,박수영(朴洙瑩),윤상현(尹相現),35,28,63,0
24424,박수영(朴洙瑩),윤영덕(尹永德),49,4,53,1
24425,박수영(朴洙瑩),윤영석(尹永碩),63,34,97,0
24426,박수영(朴洙瑩),윤영찬(尹永燦),49,4,53,1
24427,박수영(朴洙瑩),윤재갑(尹才鉀),50,7,57,1
24428,박수영(朴洙瑩),윤재옥(尹在玉),65,38,103,0
24429,박수영(朴洙瑩),윤주경(尹柱卿),73,66,139,0
24430,박수영(朴洙瑩),윤준병(尹準炳),50,14,64,1
24431,박수영(朴洙瑩),윤창현(尹暢賢),80,78,158,0
24432,박수영(朴洙瑩),윤한홍(尹漢洪),65,42,107,0
24433,박수영(朴洙瑩),윤호중(尹昊重),49,4,53,1
24434,박수영(朴洙瑩),윤후덕(尹厚德),49,5,54,1
24435,박수영(朴洙瑩),이개호(李介昊),49,5,54,1
24436,박수영(朴洙瑩),이달곤(李達坤),63,44,107,0
24437,박수영(朴洙瑩),이동주(李東洲),49,5,54,1
24438,박수영(朴洙瑩),이만희(李晩熙),67,48,115,0
24439,박수영(朴洙瑩),이명수(李明洙),67,65,132,0
24440,박수영(朴洙瑩),이병훈(李炳勳),51,7,58,1
24441,박수영(朴洙瑩),이상민(李相珉),49,4,53,1
24442,박수영(朴洙瑩),이상헌(李相憲),51,8,59,1
24443,박수영(朴洙瑩),이성만(李成萬),40,1,41,1
24444,박수영(朴洙瑩),이소영(李素永),49,5,54,1
24445,박수영(朴洙瑩),이수진(李壽珍),49,14,63,1
24446,박수영(朴洙瑩),이수진(李秀眞),49,5,54,1
24447,박수영(朴洙瑩),이양수(李亮壽),69,56,125,0
24448,박수영(朴洙瑩),이용(李鏞),69,55,124,0
24449,박수영(朴洙瑩),이용빈(李龍彬),50,5,55,1
24450,박수영(朴洙瑩),이용선(李庸瑄),49,15,64,1
24451,박수영(朴洙瑩),이용우(李龍雨),50,5,55,1
24452,박수영(朴洙瑩),이용호(李容鎬),26,15,41,0
24453,박수영(朴洙瑩),이원욱(李元旭),49,4,53,1
24454,박수영(朴洙瑩),이원택(李源澤),50,4,54,1
24455,박수영(朴洙瑩),이은주(李恩周),6,12,18,1
24456,박수영(朴洙瑩),이인선(李仁善),32,28,60,0
24457,박수영(朴洙瑩),이인영(李仁榮),49,4,53,1
24458,박수영(朴洙瑩),이장섭(李將燮),49,4,53,1
24459,박수영(朴洙瑩),이재명(李在明),25,4,29,1
24460,박수영(朴洙瑩),이재정(李在汀),49,4,53,1
24461,박수영(朴洙瑩),이정문(李楨文),49,5,54,1
24462,박수영(朴洙瑩),이종배(李鍾培),71,67,138,0
24463,박수영(朴洙瑩),이종성(李鍾成),72,67,139,0
24464,박수영(朴洙瑩),이주환(李周桓),80,85,165,0
24465,박수영(朴洙瑩),이채익(李埰益),72,61,133,0
24466,박수영(朴洙瑩),이철규(李喆圭),66,44,110,0
24467,박수영(朴洙瑩),이탄희(李誕熙),49,7,56,1
24468,박수영(朴洙瑩),이태규(李泰珪),34,38,72,0
24469,박수영(朴洙瑩),이학영(李學永),49,5,54,1
24470,박수영(朴洙瑩),이해식(李海植),49,6,55,1
24471,박수영(朴洙瑩),이헌승(李憲昇),76,84,160,0
24472,박수영(朴洙瑩),이형석(李炯錫),50,13,63,1
24473,박수영(朴洙瑩),인재근(印在謹),49,6,55,1
24474,박수영(朴洙瑩),임병헌(林炳憲),27,14,41,0
24475,박수영(朴洙瑩),임오경(林五卿),49,5,54,1
24476,박수영(朴洙瑩),임이자(林利子),70,44,114,0
24477,박수영(朴洙瑩),임종성(林鍾聲),49,5,54,1
24478,박수영(朴洙瑩),임호선(林昊宣),50,14,64,1
24479,박수영(朴洙瑩),장경태(張耿態),50,14,64,1
24480,박수영(朴洙瑩),장동혁(張東赫),27,17,44,0
24481,박수영(朴洙瑩),장제원(張濟元),64,49,113,0
24482,박수영(朴洙瑩),장철민(張喆敏),49,4,53,1
24483,박수영(朴洙瑩),장혜영(張惠英),7,14,21,1
24484,박수영(朴洙瑩),전봉민(田奉珉),59,81,140,0
24485,박수영(朴洙瑩),전용기(田溶冀),50,5,55,1
24486,박수영(朴洙瑩),전재수(田載秀),51,7,58,1
24487,박수영(朴洙瑩),전주혜(全珠惠),73,68,141,0
24488,박수영(朴洙瑩),전해철(全海澈),50,4,54,1
24489,박수영(朴洙瑩),전혜숙(全惠淑),49,6,55,1
24490,박수영(朴洙瑩),정경희(丁慶姬),68,52,120,0
24491,박수영(朴洙瑩),정동만(鄭東萬),81,82,163,0
24492,박수영(朴洙瑩),정성호(鄭成湖),50,7,57,1
24493,박수영(朴洙瑩),정우택(鄭宇澤),36,27,63,0
24494,박수영(朴洙瑩),정운천(鄭雲天),76,50,126,0
24495,박수영(朴洙瑩),정일영(鄭日永),50,6,56,1
24496,박수영(朴洙瑩),정점식(鄭点植),67,44,111,0
24497,박수영(朴洙瑩),정진석(鄭鎭碩),64,50,114,0
24498,박수영(朴洙瑩),정청래(鄭淸來),49,4,53,1
24499,박수영(朴洙瑩),정춘숙(鄭春淑),49,4,53,1
24500,박수영(朴洙瑩),정태호(鄭泰浩),49,7,56,1
24501,박수영(朴洙瑩),정필모(鄭必模),49,5,54,1
24502,박수영(朴洙瑩),정희용(鄭熙溶),71,61,132,0
24503,박수영(朴洙瑩),조경태(趙慶泰),73,75,148,0
24504,박수영(朴洙瑩),조명희(曺明姬),76,61,137,0
24505,박수영(朴洙瑩),조수진(趙修眞),72,71,143,0
24506,박수영(朴洙瑩),조승래(趙承來),49,5,54,1
24507,박수영(朴洙瑩),조오섭(曺五燮),51,6,57,1
24508,박수영(朴洙瑩),조은희(趙恩禧),35,24,59,0
24509,박수영(朴洙瑩),조응천(趙應天),50,5,55,1
24510,박수영(朴洙瑩),조정식(趙正湜),49,3,52,1
24511,박수영(朴洙瑩),조정훈(趙廷訓),2,12,14,1
24512,박수영(朴洙瑩),조해진(曺海珍),61,38,99,0
24513,박수영(朴洙瑩),주철현(朱哲鉉),49,5,54,1
24514,박수영(朴洙瑩),주호영(朱豪英),60,38,98,0
24515,박수영(朴洙瑩),지성호(池成浩),70,64,134,0
24516,박수영(朴洙瑩),진선미(陳善美),49,5,54,1
24517,박수영(朴洙瑩),진성준(陳聲準),49,14,63,1
24518,박수영(朴洙瑩),천준호(千俊鎬),49,12,61,1
24519,박수영(朴洙瑩),최기상(崔基相),49,5,54,1
24520,박수영(朴洙瑩),최승재(崔承宰),76,55,131,0
24521,박수영(朴洙瑩),최연숙(崔姸淑),31,29,60,0
24522,박수영(朴洙瑩),최영희(崔英姬),29,24,53,0
24523,박수영(朴洙瑩),최인호(崔仁昊),51,7,58,1
24524,박수영(朴洙瑩),최재형(崔在亨),27,14,41,0
24525,박수영(朴洙瑩),최종윤(崔鍾允),49,4,53,1
24526,박수영(朴洙瑩),최춘식(崔春植),68,72,140,0
24527,박수영(朴洙瑩),최형두(崔炯斗),72,57,129,0
24528,박수영(朴洙瑩),최혜영(崔惠英),52,13,65,1
24529,박수영(朴洙瑩),추경호(秋慶鎬),75,55,130,0
24530,박수영(朴洙瑩),태영호(太永浩),77,101,178,0
24531,박수영(朴洙瑩),하영제(河榮帝),62,57,119,1
24532,박수영(朴洙瑩),하태경(河泰慶),73,54,127,0
24533,박수영(朴洙瑩),한기호(韓起鎬),63,42,105,0
24534,박수영(朴洙瑩),한무경(韓茂景),66,62,128,0
24535,박수영(朴洙瑩),한병도(韓秉道),49,4,53,1
24536,박수영(朴洙瑩),한정애(韓貞愛),49,4,53,1
24537,박수영(朴洙瑩),한준호(韓俊鎬),50,4,54,1
24538,박수영(朴洙瑩),허숙정(許淑湞),0,0,0,1
24539,박수영(朴洙瑩),허영(許榮),50,5,55,1
24540,박수영(朴洙瑩),허은아(許垠娥),73,58,131,0
24541,박수영(朴洙瑩),허종식(許琮植),49,5,54,1
24542,박수영(朴洙瑩),홍기원(洪起元),49,5,54,1
24543,박수영(朴洙瑩),홍문표(洪文杓),62,46,108,0
24544,박수영(朴洙瑩),홍석준(洪碩晙),66,42,108,0
24545,박수영(朴洙瑩),홍성국(洪性國),49,5,54,1
24546,박수영(朴洙瑩),홍영표(洪永杓),49,5,54,1
24547,박수영(朴洙瑩),홍익표(洪翼杓),49,5,54,1
24548,박수영(朴洙瑩),홍정민(洪貞敏),50,5,55,1
24549,박수영(朴洙瑩),황보승희(皇甫承希),77,89,166,1
24550,박수영(朴洙瑩),황운하(黃雲夏),49,4,53,1
24551,박수영(朴洙瑩),황희(黃熙),49,6,55,1
24552,박영순(朴英淳),박완주(朴完柱),64,53,117,1
24553,박영순(朴英淳),박용진(朴用鎭),85,60,145,0
24554,박영순(朴英淳),박재호(朴在昊),89,76,165,0
24555,박영순(朴英淳),박정(朴釘),112,159,271,0
24556,박영순(朴英淳),박정하(朴正河),25,6,31,1
24557,박영순(朴英淳),박주민(朴柱民),89,59,148,0
24558,박영순(朴英淳),박진(朴振),51,4,55,1
24559,박영순(朴英淳),박찬대(朴贊大),94,77,171,0
24560,박영순(朴英淳),박형수(朴亨修),49,3,52,1
24561,박영순(朴英淳),박홍근(朴洪根),124,128,252,0
24562,박영순(朴英淳),배준영(裵俊英),50,9,59,1
24563,박영순(朴英淳),배진교(裵晋敎),29,40,69,1
24564,박영순(朴英淳),배현진(裵賢鎭),50,4,54,1
24565,박영순(朴英淳),백종헌(白宗憲),51,6,57,1
24566,박영순(朴英淳),백혜련(白惠蓮),98,73,171,0
24567,박영순(朴英淳),변재일(卞在一),87,48,135,0
24568,박영순(朴英淳),서동용(徐東榕),104,110,214,0
24569,박영순(朴英淳),서범수(徐範洙),53,3,56,1
24570,박영순(朴英淳),서병수(徐秉洙),51,4,55,1
24571,박영순(朴英淳),서삼석(徐參錫),95,89,184,0
24572,박영순(朴英淳),서영교(徐瑛敎),107,114,221,0
24573,박영순(朴英淳),서영석(徐暎錫),110,119,229,0
24574,박영순(朴英淳),서일준(徐一俊),51,11,62,1
24575,박영순(朴英淳),서정숙(徐正淑),49,5,54,1
24576,박영순(朴英淳),설훈(薛勳),88,84,172,0
24577,박영순(朴英淳),성일종(成一鍾),51,12,63,1
24578,박영순(朴英淳),소병철(蘇秉哲),85,69,154,0
24579,박영순(朴英淳),소병훈(蘇秉勳),112,102,214,0
24580,박영순(朴英淳),송갑석(宋甲錫),116,122,238,0
24581,박영순(朴英淳),송기헌(宋基憲),83,53,136,0
24582,박영순(朴英淳),송석준(宋錫俊),49,4,53,1
24583,박영순(朴英淳),송언석(宋彦錫),46,3,49,1
24584,박영순(朴英淳),송옥주(宋玉珠),99,92,191,0
24585,박영순(朴英淳),송재호(宋在祜),103,108,211,0
24586,박영순(朴英淳),신동근(申東根),91,63,154,0
24587,박영순(朴英淳),신영대(申榮大),90,70,160,0
24588,박영순(朴英淳),신원식(申源湜),50,4,54,1
24589,박영순(朴英淳),신정훈(辛正勳),150,186,336,0
24590,박영순(朴英淳),신현영(申賢榮),85,53,138,0
24591,박영순(朴英淳),심상정(沈相奵),23,36,59,1
24592,박영순(朴英淳),안규백(安圭伯),94,75,169,0
24593,박영순(朴英淳),안민석(安敏錫),95,89,184,0
24594,박영순(朴英淳),안병길(安炳吉),51,4,55,1
24595,박영순(朴英淳),안철수(安哲秀),25,4,29,1
24596,박영순(朴英淳),안호영(安浩永),100,110,210,0
24597,박영순(朴英淳),양경숙(梁敬淑),100,134,234,0
24598,박영순(朴英淳),양금희(梁琴喜),51,6,57,1
24599,박영순(朴英淳),양기대(梁基大),98,97,195,0
24600,박영순(朴英淳),양이원영(梁李媛瑛),115,109,224,0
24601,박영순(朴英淳),양정숙(梁貞淑),82,170,252,1
24602,박영순(朴英淳),양향자(梁香子),52,46,98,1
24603,박영순(朴英淳),어기구(魚基龜),96,67,163,0
24604,박영순(朴英淳),엄태영(嚴泰永),51,7,58,1
24605,박영순(朴英淳),오기형(吳奇炯),81,54,135,0
24606,박영순(朴英淳),오영환(吳永煥),135,203,338,0
24607,박영순(朴英淳),용혜인(龍慧仁),27,53,80,1
24608,박영순(朴英淳),우상호(禹相虎),78,42,120,0
24609,박영순(朴英淳),우원식(禹元植),93,80,173,0
24610,박영순(朴英淳),위성곤(魏聖坤),101,106,207,0
24611,박영순(朴英淳),유경준(兪京濬),49,4,53,1
24612,박영순(朴英淳),유기홍(柳基洪),80,53,133,0
24613,박영순(朴英淳),유동수(柳東秀),94,75,169,0
24614,박영순(朴英淳),유상범(劉相凡),49,3,52,1
24615,박영순(朴英淳),유의동(兪義東),51,3,54,1
24616,박영순(朴英淳),유정주(兪訂炷),104,109,213,0
24617,박영순(朴英淳),윤건영(尹建永),102,78,180,0
24618,박영순(朴英淳),윤관석(尹官石),84,65,149,1
24619,박영순(朴英淳),윤두현(尹斗鉉),50,4,54,1
24620,박영순(朴英淳),윤미향(尹美香),81,119,200,1
24621,박영순(朴英淳),윤상현(尹相現),31,5,36,1
24622,박영순(朴英淳),윤영덕(尹永德),113,140,253,0
24623,박영순(朴英淳),윤영석(尹永碩),50,6,56,1
24624,박영순(朴英淳),윤영찬(尹永燦),83,66,149,0
24625,박영순(朴英淳),윤재갑(尹才鉀),151,158,309,0
24626,박영순(朴英淳),윤재옥(尹在玉),50,3,53,1
24627,박영순(朴英淳),윤주경(尹柱卿),51,5,56,1
24628,박영순(朴英淳),윤준병(尹準炳),129,146,275,0
24629,박영순(朴英淳),윤창현(尹暢賢),50,5,55,1
24630,박영순(朴英淳),윤한홍(尹漢洪),51,3,54,1
24631,박영순(朴英淳),윤호중(尹昊重),79,49,128,0
24632,박영순(朴英淳),윤후덕(尹厚德),90,82,172,0
24633,박영순(朴英淳),이개호(李介昊),92,91,183,0
24634,박영순(朴英淳),이달곤(李達坤),52,5,57,1
24635,박영순(朴英淳),이동주(李東洲),108,106,214,0
24636,박영순(朴英淳),이만희(李晩熙),50,3,53,1
24637,박영순(朴英淳),이명수(李明洙),51,12,63,1
24638,박영순(朴英淳),이병훈(李炳勳),111,125,236,0
24639,박영순(朴英淳),이상민(李相珉),86,71,157,0
24640,박영순(朴英淳),이상헌(李相憲),112,112,224,0
24641,박영순(朴英淳),이성만(李成萬),117,103,220,1
24642,박영순(朴英淳),이소영(李素永),96,55,151,0
24643,박영순(朴英淳),이수진(李壽珍),141,169,310,0
24644,박영순(朴英淳),이수진(李秀眞),117,135,252,0
24645,박영순(朴英淳),이양수(李亮壽),51,4,55,1
24646,박영순(朴英淳),이용(李鏞),51,3,54,1
24647,박영순(朴英淳),이용빈(李龍彬),123,171,294,0
24648,박영순(朴英淳),이용선(李庸瑄),105,94,199,0
24649,박영순(朴英淳),이용우(李龍雨),115,100,215,0
24650,박영순(朴英淳),이용호(李容鎬),41,44,85,1
24651,박영순(朴英淳),이원욱(李元旭),92,60,152,0
24652,박영순(朴英淳),이원택(李源澤),103,100,203,0
24653,박영순(朴英淳),이은주(李恩周),25,32,57,1
24654,박영순(朴英淳),이인선(李仁善),25,3,28,1
24655,박영순(朴英淳),이인영(李仁榮),84,58,142,0
24656,박영순(朴英淳),이장섭(李將燮),100,97,197,0
24657,박영순(朴英淳),이재명(李在明),40,18,58,0
24658,박영순(朴英淳),이재정(李在汀),87,66,153,0
24659,박영순(朴英淳),이정문(李楨文),103,123,226,0
24660,박영순(朴英淳),이종배(李鍾培),52,4,56,1
24661,박영순(朴英淳),이종성(李鍾成),50,7,57,1
24662,박영순(朴英淳),이주환(李周桓),50,3,53,1
24663,박영순(朴英淳),이채익(李埰益),51,6,57,1
24664,박영순(朴英淳),이철규(李喆圭),51,5,56,1
24665,박영순(朴英淳),이탄희(李誕熙),102,79,181,0
24666,박영순(朴英淳),이태규(李泰珪),29,10,39,1
24667,박영순(朴英淳),이학영(李學永),117,103,220,0
24668,박영순(朴英淳),이해식(李海植),97,102,199,0
24669,박영순(朴英淳),이헌승(李憲昇),51,4,55,1
24670,박영순(朴英淳),이형석(李炯錫),111,86,197,0
24671,박영순(朴英淳),인재근(印在謹),107,91,198,0
24672,박영순(朴英淳),임병헌(林炳憲),26,3,29,1
24673,박영순(朴英淳),임오경(林五卿),99,97,196,0
24674,박영순(朴英淳),임이자(林利子),50,4,54,1
24675,박영순(朴英淳),임종성(林鍾聲),102,98,200,0
24676,박영순(朴英淳),임호선(林昊宣),135,189,324,0
24677,박영순(朴英淳),장경태(張耿態),125,145,270,0
24678,박영순(朴英淳),장동혁(張東赫),25,3,28,1
24679,박영순(朴英淳),장제원(張濟元),49,3,52,1
24680,박영순(朴英淳),장철민(張喆敏),121,139,260,0
24681,박영순(朴英淳),장혜영(張惠英),21,38,59,1
24682,박영순(朴英淳),전봉민(田奉珉),35,4,39,1
24683,박영순(朴英淳),전용기(田溶冀),99,117,216,0
24684,박영순(朴英淳),전재수(田載秀),85,53,138,0
24685,박영순(朴英淳),전주혜(全珠惠),52,5,57,1
24686,박영순(朴英淳),전해철(全海澈),81,57,138,0
24687,박영순(朴英淳),전혜숙(全惠淑),104,113,217,0
24688,박영순(朴英淳),정경희(丁慶姬),51,3,54,1
24689,박영순(朴英淳),정동만(鄭東萬),50,4,54,1
24690,박영순(朴英淳),정성호(鄭成湖),91,71,162,0
24691,박영순(朴英淳),정우택(鄭宇澤),25,4,29,1
24692,박영순(朴英淳),정운천(鄭雲天),49,8,57,1
24693,박영순(朴英淳),정일영(鄭日永),100,87,187,0
24694,박영순(朴英淳),정점식(鄭点植),51,3,54,1
24695,박영순(朴英淳),정진석(鄭鎭碩),52,7,59,1
24696,박영순(朴英淳),정청래(鄭淸來),92,64,156,0
24697,박영순(朴英淳),정춘숙(鄭春淑),90,68,158,0
24698,박영순(朴英淳),정태호(鄭泰浩),94,96,190,0
24699,박영순(朴英淳),정필모(鄭必模),94,85,179,0
24700,박영순(朴英淳),정희용(鄭熙溶),51,4,55,1
24701,박영순(朴英淳),조경태(趙慶泰),50,5,55,1
24702,박영순(朴英淳),조명희(曺明姬),50,6,56,1
24703,박영순(朴英淳),조수진(趙修眞),49,4,53,1
24704,박영순(朴英淳),조승래(趙承來),108,132,240,0
24705,박영순(朴英淳),조오섭(曺五燮),155,154,309,0
24706,박영순(朴英淳),조은희(趙恩禧),25,6,31,1
24707,박영순(朴英淳),조응천(趙應天),100,48,148,0
24708,박영순(朴英淳),조정식(趙正湜),82,83,165,0
24709,박영순(朴英淳),조정훈(趙廷訓),6,19,25,1
24710,박영순(朴英淳),조해진(曺海珍),51,4,55,1
24711,박영순(朴英淳),주철현(朱哲鉉),101,105,206,0
24712,박영순(朴英淳),주호영(朱豪英),49,3,52,1
24713,박영순(朴英淳),지성호(池成浩),50,7,57,1
24714,박영순(朴英淳),진선미(陳善美),108,60,168,0
24715,박영순(朴英淳),진성준(陳聲準),126,121,247,0
24716,박영순(朴英淳),천준호(千俊鎬),111,81,192,0
24717,박영순(朴英淳),최기상(崔基相),96,62,158,0
24718,박영순(朴英淳),최승재(崔承宰),50,6,56,1
24719,박영순(朴英淳),최연숙(崔姸淑),33,13,46,1
24720,박영순(朴英淳),최영희(崔英姬),25,4,29,1
24721,박영순(朴英淳),최인호(崔仁昊),95,85,180,0
24722,박영순(朴英淳),최재형(崔在亨),25,4,29,1
24723,박영순(朴英淳),최종윤(崔鍾允),121,122,243,0
24724,박영순(朴英淳),최춘식(崔春植),49,8,57,1
24725,박영순(朴英淳),최형두(崔炯斗),52,10,62,1
24726,박영순(朴英淳),최혜영(崔惠英),115,90,205,0
24727,박영순(朴英淳),추경호(秋慶鎬),51,5,56,1
24728,박영순(朴英淳),태영호(太永浩),51,11,62,1
24729,박영순(朴英淳),하영제(河榮帝),42,3,45,1
24730,박영순(朴英淳),하태경(河泰慶),51,5,56,1
24731,박영순(朴英淳),한기호(韓起鎬),51,7,58,1
24732,박영순(朴英淳),한무경(韓茂景),49,5,54,1
24733,박영순(朴英淳),한병도(韓秉道),101,87,188,0
24734,박영순(朴英淳),한정애(韓貞愛),82,52,134,0
24735,박영순(朴英淳),한준호(韓俊鎬),107,98,205,0
24736,박영순(朴英淳),허숙정(許淑湞),1,1,2,0
24737,박영순(朴英淳),허영(許榮),144,140,284,0
24738,박영순(朴英淳),허은아(許垠娥),49,4,53,1
24739,박영순(朴英淳),허종식(許琮植),109,99,208,0
24740,박영순(朴英淳),홍기원(洪起元),121,107,228,0
24741,박영순(朴英淳),홍문표(洪文杓),53,12,65,1
24742,박영순(朴英淳),홍석준(洪碩晙),50,3,53,1
24743,박영순(朴英淳),홍성국(洪性國),147,141,288,0
24744,박영순(朴英淳),홍영표(洪永杓),92,80,172,0
24745,박영순(朴英淳),홍익표(洪翼杓),97,77,174,0
24746,박영순(朴英淳),홍정민(洪貞敏),109,117,226,0
24747,박영순(朴英淳),황보승희(皇甫承希),47,1,48,1
24748,박영순(朴英淳),황운하(黃雲夏),164,238,402,0
24749,박영순(朴英淳),황희(黃熙),78,46,124,0
24750,박완주(朴完柱),박용진(朴用鎭),41,23,64,1
24751,박완주(朴完柱),박재호(朴在昊),61,47,108,1
24752,박완주(朴完柱),박정(朴釘),72,41,113,1
24753,박완주(朴完柱),박정하(朴正河),0,0,0,1
24754,박완주(朴完柱),박주민(朴柱民),46,30,76,1
24755,박완주(朴完柱),박진(朴振),25,0,25,1
24756,박완주(朴完柱),박찬대(朴贊大),42,42,84,1
24757,박완주(朴完柱),박형수(朴亨修),24,2,26,1
24758,박완주(朴完柱),박홍근(朴洪根),70,60,130,1
24759,박완주(朴完柱),배준영(裵俊英),24,1,25,1
24760,박완주(朴完柱),배진교(裵晋敎),13,19,32,1
24761,박완주(朴完柱),배현진(裵賢鎭),24,0,24,1
24762,박완주(朴完柱),백종헌(白宗憲),25,1,26,1
24763,박완주(朴完柱),백혜련(白惠蓮),59,44,103,1
24764,박완주(朴完柱),변재일(卞在一),46,54,100,1
24765,박완주(朴完柱),서동용(徐東榕),52,42,94,1
24766,박완주(朴完柱),서범수(徐範洙),25,0,25,1
24767,박완주(朴完柱),서병수(徐秉洙),25,0,25,1
24768,박완주(朴完柱),서삼석(徐參錫),52,39,91,1
24769,박완주(朴完柱),서영교(徐瑛敎),76,67,143,1
24770,박완주(朴完柱),서영석(徐暎錫),55,63,118,1
24771,박완주(朴完柱),서일준(徐一俊),25,0,25,1
24772,박완주(朴完柱),서정숙(徐正淑),24,2,26,1
24773,박완주(朴完柱),설훈(薛勳),46,39,85,1
24774,박완주(朴完柱),성일종(成一鍾),25,1,26,1
24775,박완주(朴完柱),소병철(蘇秉哲),54,41,95,1
24776,박완주(朴完柱),소병훈(蘇秉勳),46,46,92,1
24777,박완주(朴完柱),송갑석(宋甲錫),52,53,105,1
24778,박완주(朴完柱),송기헌(宋基憲),44,37,81,1
24779,박완주(朴完柱),송석준(宋錫俊),24,1,25,1
24780,박완주(朴完柱),송언석(宋彦錫),22,5,27,1
24781,박완주(朴完柱),송옥주(宋玉珠),46,40,86,1
24782,박완주(朴完柱),송재호(宋在祜),58,78,136,1
24783,박완주(朴完柱),신동근(申東根),47,37,84,1
24784,박완주(朴完柱),신영대(申榮大),51,35,86,1
24785,박완주(朴完柱),신원식(申源湜),24,0,24,1
24786,박완주(朴完柱),신정훈(辛正勳),74,107,181,1
24787,박완주(朴完柱),신현영(申賢榮),43,33,76,1
24788,박완주(朴完柱),심상정(沈相奵),13,18,31,1
24789,박완주(朴完柱),안규백(安圭伯),55,47,102,1
24790,박완주(朴完柱),안민석(安敏錫),45,46,91,1
24791,박완주(朴完柱),안병길(安炳吉),25,0,25,1
24792,박완주(朴完柱),안철수(安哲秀),0,0,0,1
24793,박완주(朴完柱),안호영(安浩永),48,48,96,1
24794,박완주(朴完柱),양경숙(梁敬淑),58,66,124,1
24795,박완주(朴完柱),양금희(梁琴喜),25,1,26,1
24796,박완주(朴完柱),양기대(梁基大),62,40,102,1
24797,박완주(朴完柱),양이원영(梁李媛瑛),50,49,99,1
24798,박완주(朴完柱),양정숙(梁貞淑),46,87,133,0
24799,박완주(朴完柱),양향자(梁香子),32,23,55,1
24800,박완주(朴完柱),어기구(魚基龜),46,28,74,1
24801,박완주(朴完柱),엄태영(嚴泰永),26,1,27,1
24802,박완주(朴完柱),오기형(吳奇炯),43,28,71,1
24803,박완주(朴完柱),오영환(吳永煥),86,103,189,1
24804,박완주(朴完柱),용혜인(龍慧仁),12,24,36,1
24805,박완주(朴完柱),우상호(禹相虎),42,31,73,1
24806,박완주(朴完柱),우원식(禹元植),61,46,107,1
24807,박완주(朴完柱),위성곤(魏聖坤),52,51,103,1
24808,박완주(朴完柱),유경준(兪京濬),24,0,24,1
24809,박완주(朴完柱),유기홍(柳基洪),44,32,76,1
24810,박완주(朴完柱),유동수(柳東秀),48,35,83,1
24811,박완주(朴完柱),유상범(劉相凡),25,4,29,1
24812,박완주(朴完柱),유의동(兪義東),24,0,24,1
24813,박완주(朴完柱),유정주(兪訂炷),54,56,110,1
24814,박완주(朴完柱),윤건영(尹建永),45,35,80,1
24815,박완주(朴完柱),윤관석(尹官石),46,36,82,0
24816,박완주(朴完柱),윤두현(尹斗鉉),24,0,24,1
24817,박완주(朴完柱),윤미향(尹美香),40,44,84,0
24818,박완주(朴完柱),윤상현(尹相現),5,0,5,1
24819,박완주(朴完柱),윤영덕(尹永德),59,53,112,1
24820,박완주(朴完柱),윤영석(尹永碩),25,1,26,1
24821,박완주(朴完柱),윤영찬(尹永燦),44,37,81,1
24822,박완주(朴完柱),윤재갑(尹才鉀),72,69,141,1
24823,박완주(朴完柱),윤재옥(尹在玉),24,0,24,1
24824,박완주(朴完柱),윤주경(尹柱卿),24,0,24,1
24825,박완주(朴完柱),윤준병(尹準炳),58,76,134,1
24826,박완주(朴完柱),윤창현(尹暢賢),24,1,25,1
24827,박완주(朴完柱),윤한홍(尹漢洪),25,0,25,1
24828,박완주(朴完柱),윤호중(尹昊重),42,32,74,1
24829,박완주(朴完柱),윤후덕(尹厚德),43,31,74,1
24830,박완주(朴完柱),이개호(李介昊),47,40,87,1
24831,박완주(朴完柱),이달곤(李達坤),25,0,25,1
24832,박완주(朴完柱),이동주(李東洲),50,47,97,1
24833,박완주(朴完柱),이만희(李晩熙),24,0,24,1
24834,박완주(朴完柱),이명수(李明洙),26,3,29,1
24835,박완주(朴完柱),이병훈(李炳勳),58,65,123,1
24836,박완주(朴完柱),이상민(李相珉),43,22,65,1
24837,박완주(朴完柱),이상헌(李相憲),58,72,130,1
24838,박완주(朴完柱),이성만(李成萬),68,72,140,0
24839,박완주(朴完柱),이소영(李素永),51,28,79,1
24840,박완주(朴完柱),이수진(李壽珍),58,62,120,1
24841,박완주(朴完柱),이수진(李秀眞),53,61,114,1
24842,박완주(朴完柱),이양수(李亮壽),26,0,26,1
24843,박완주(朴完柱),이용(李鏞),24,0,24,1
24844,박완주(朴完柱),이용빈(李龍彬),58,77,135,1
24845,박완주(朴完柱),이용선(李庸瑄),54,47,101,1
24846,박완주(朴完柱),이용우(李龍雨),53,38,91,1
24847,박완주(朴完柱),이용호(李容鎬),4,4,8,1
24848,박완주(朴完柱),이원욱(李元旭),44,40,84,1
24849,박완주(朴完柱),이원택(李源澤),54,53,107,1
24850,박완주(朴完柱),이은주(李恩周),19,22,41,1
24851,박완주(朴完柱),이인선(李仁善),0,0,0,1
24852,박완주(朴完柱),이인영(李仁榮),43,31,74,1
24853,박완주(朴完柱),이장섭(李將燮),58,45,103,1
24854,박완주(朴完柱),이재명(李在明),5,4,9,1
24855,박완주(朴完柱),이재정(李在汀),45,29,74,1
24856,박완주(朴完柱),이정문(李楨文),62,54,116,1
24857,박완주(朴完柱),이종배(李鍾培),24,0,24,1
24858,박완주(朴完柱),이종성(李鍾成),24,5,29,1
24859,박완주(朴完柱),이주환(李周桓),24,1,25,1
24860,박완주(朴完柱),이채익(李埰益),25,0,25,1
24861,박완주(朴完柱),이철규(李喆圭),26,0,26,1
24862,박완주(朴完柱),이탄희(李誕熙),56,41,97,1
24863,박완주(朴完柱),이태규(李泰珪),3,0,3,1
24864,박완주(朴完柱),이학영(李學永),57,52,109,1
24865,박완주(朴完柱),이해식(李海植),65,55,120,1
24866,박완주(朴完柱),이헌승(李憲昇),25,0,25,1
24867,박완주(朴完柱),이형석(李炯錫),62,53,115,1
24868,박완주(朴完柱),인재근(印在謹),57,58,115,1
24869,박완주(朴完柱),임병헌(林炳憲),0,0,0,1
24870,박완주(朴完柱),임오경(林五卿),46,45,91,1
24871,박완주(朴完柱),임이자(林利子),24,0,24,1
24872,박완주(朴完柱),임종성(林鍾聲),49,42,91,1
24873,박완주(朴完柱),임호선(林昊宣),75,114,189,1
24874,박완주(朴完柱),장경태(張耿態),58,51,109,1
24875,박완주(朴完柱),장동혁(張東赫),0,1,1,1
24876,박완주(朴完柱),장제원(張濟元),24,0,24,1
24877,박완주(朴完柱),장철민(張喆敏),49,42,91,1
24878,박완주(朴完柱),장혜영(張惠英),12,13,25,1
24879,박완주(朴完柱),전봉민(田奉珉),9,0,9,1
24880,박완주(朴完柱),전용기(田溶冀),46,51,97,1
24881,박완주(朴完柱),전재수(田載秀),52,28,80,1
24882,박완주(朴完柱),전주혜(全珠惠),25,2,27,1
24883,박완주(朴完柱),전해철(全海澈),44,29,73,1
24884,박완주(朴完柱),전혜숙(全惠淑),58,63,121,1
24885,박완주(朴完柱),정경희(丁慶姬),24,0,24,1
24886,박완주(朴完柱),정동만(鄭東萬),24,0,24,1
24887,박완주(朴完柱),정성호(鄭成湖),44,33,77,1
24888,박완주(朴完柱),정우택(鄭宇澤),0,0,0,1
24889,박완주(朴完柱),정운천(鄭雲天),24,2,26,1
24890,박완주(朴完柱),정일영(鄭日永),49,33,82,1
24891,박완주(朴完柱),정점식(鄭点植),25,2,27,1
24892,박완주(朴完柱),정진석(鄭鎭碩),25,1,26,1
24893,박완주(朴完柱),정청래(鄭淸來),48,42,90,1
24894,박완주(朴完柱),정춘숙(鄭春淑),56,50,106,1
24895,박완주(朴完柱),정태호(鄭泰浩),52,58,110,1
24896,박완주(朴完柱),정필모(鄭必模),50,53,103,1
24897,박완주(朴完柱),정희용(鄭熙溶),24,0,24,1
24898,박완주(朴完柱),조경태(趙慶泰),24,0,24,1
24899,박완주(朴完柱),조명희(曺明姬),24,2,26,1
24900,박완주(朴完柱),조수진(趙修眞),24,2,26,1
24901,박완주(朴完柱),조승래(趙承來),53,52,105,1
24902,박완주(朴完柱),조오섭(曺五燮),47,63,110,1
24903,박완주(朴完柱),조은희(趙恩禧),0,0,0,1
24904,박완주(朴完柱),조응천(趙應天),38,20,58,1
24905,박완주(朴完柱),조정식(趙正湜),39,23,62,1
24906,박완주(朴完柱),조정훈(趙廷訓),3,13,16,1
24907,박완주(朴完柱),조해진(曺海珍),25,0,25,1
24908,박완주(朴完柱),주철현(朱哲鉉),55,61,116,1
24909,박완주(朴完柱),주호영(朱豪英),25,0,25,1
24910,박완주(朴完柱),지성호(池成浩),24,0,24,1
24911,박완주(朴完柱),진선미(陳善美),46,36,82,1
24912,박완주(朴完柱),진성준(陳聲準),52,56,108,1
24913,박완주(朴完柱),천준호(千俊鎬),46,41,87,1
24914,박완주(朴完柱),최기상(崔基相),43,36,79,1
24915,박완주(朴完柱),최승재(崔承宰),24,6,30,1
24916,박완주(朴完柱),최연숙(崔姸淑),5,5,10,1
24917,박완주(朴完柱),최영희(崔英姬),0,0,0,1
24918,박완주(朴完柱),최인호(崔仁昊),45,34,79,1
24919,박완주(朴完柱),최재형(崔在亨),0,0,0,1
24920,박완주(朴完柱),최종윤(崔鍾允),56,63,119,1
24921,박완주(朴完柱),최춘식(崔春植),24,1,25,1
24922,박완주(朴完柱),최형두(崔炯斗),25,2,27,1
24923,박완주(朴完柱),최혜영(崔惠英),58,50,108,1
24924,박완주(朴完柱),추경호(秋慶鎬),24,0,24,1
24925,박완주(朴完柱),태영호(太永浩),24,4,28,1
24926,박완주(朴完柱),하영제(河榮帝),25,1,26,0
24927,박완주(朴完柱),하태경(河泰慶),25,1,26,1
24928,박완주(朴完柱),한기호(韓起鎬),25,0,25,1
24929,박완주(朴完柱),한무경(韓茂景),24,0,24,1
24930,박완주(朴完柱),한병도(韓秉道),63,58,121,1
24931,박완주(朴完柱),한정애(韓貞愛),45,40,85,1
24932,박완주(朴完柱),한준호(韓俊鎬),54,55,109,1
24933,박완주(朴完柱),허숙정(許淑湞),1,1,2,1
24934,박완주(朴完柱),허영(許榮),60,65,125,1
24935,박완주(朴完柱),허은아(許垠娥),24,0,24,1
24936,박완주(朴完柱),허종식(許琮植),50,49,99,1
24937,박완주(朴完柱),홍기원(洪起元),52,57,109,1
24938,박완주(朴完柱),홍문표(洪文杓),25,1,26,1
24939,박완주(朴完柱),홍석준(洪碩晙),25,0,25,1
24940,박완주(朴完柱),홍성국(洪性國),65,74,139,1
24941,박완주(朴完柱),홍영표(洪永杓),47,37,84,1
24942,박완주(朴完柱),홍익표(洪翼杓),53,41,94,1
24943,박완주(朴完柱),홍정민(洪貞敏),56,53,109,1
24944,박완주(朴完柱),황보승희(皇甫承希),26,0,26,0
24945,박완주(朴完柱),황운하(黃雲夏),63,58,121,1
24946,박완주(朴完柱),황희(黃熙),40,27,67,1
24947,박용진(朴用鎭),박재호(朴在昊),88,93,181,0
24948,박용진(朴用鎭),박정(朴釘),111,130,241,0
24949,박용진(朴用鎭),박정하(朴正河),25,5,30,1
24950,박용진(朴用鎭),박주민(朴柱民),80,49,129,0
24951,박용진(朴用鎭),박진(朴振),49,4,53,1
24952,박용진(朴用鎭),박찬대(朴贊大),104,120,224,0
24953,박용진(朴用鎭),박형수(朴亨修),49,5,54,1
24954,박용진(朴用鎭),박홍근(朴洪根),82,65,147,0
24955,박용진(朴用鎭),배준영(裵俊英),51,7,58,1
24956,박용진(朴用鎭),배진교(裵晋敎),16,46,62,1
24957,박용진(朴用鎭),배현진(裵賢鎭),49,6,55,1
24958,박용진(朴用鎭),백종헌(白宗憲),49,11,60,1
24959,박용진(朴用鎭),백혜련(白惠蓮),87,71,158,0
24960,박용진(朴用鎭),변재일(卞在一),74,38,112,0
24961,박용진(朴用鎭),서동용(徐東榕),80,52,132,0
24962,박용진(朴用鎭),서범수(徐範洙),49,4,53,1
24963,박용진(朴用鎭),서병수(徐秉洙),49,5,54,1
24964,박용진(朴用鎭),서삼석(徐參錫),111,135,246,0
24965,박용진(朴用鎭),서영교(徐瑛敎),84,60,144,0
24966,박용진(朴用鎭),서영석(徐暎錫),82,55,137,0
24967,박용진(朴用鎭),서일준(徐一俊),49,7,56,1
24968,박용진(朴用鎭),서정숙(徐正淑),49,10,59,1
24969,박용진(朴用鎭),설훈(薛勳),75,39,114,0
24970,박용진(朴用鎭),성일종(成一鍾),49,6,55,1
24971,박용진(朴用鎭),소병철(蘇秉哲),77,50,127,0
24972,박용진(朴用鎭),소병훈(蘇秉勳),79,59,138,0
24973,박용진(朴用鎭),송갑석(宋甲錫),97,130,227,0
24974,박용진(朴用鎭),송기헌(宋基憲),76,43,119,0
24975,박용진(朴用鎭),송석준(宋錫俊),49,7,56,1
24976,박용진(朴用鎭),송언석(宋彦錫),45,4,49,1
24977,박용진(朴用鎭),송옥주(宋玉珠),122,182,304,0
24978,박용진(朴用鎭),송재호(宋在祜),81,84,165,0
24979,박용진(朴用鎭),신동근(申東根),81,43,124,0
24980,박용진(朴用鎭),신영대(申榮大),77,46,123,0
24981,박용진(朴用鎭),신원식(申源湜),49,10,59,1
24982,박용진(朴用鎭),신정훈(辛正勳),84,71,155,0
24983,박용진(朴用鎭),신현영(申賢榮),78,43,121,0
24984,박용진(朴用鎭),심상정(沈相奵),12,40,52,1
24985,박용진(朴用鎭),안규백(安圭伯),83,54,137,0
24986,박용진(朴用鎭),안민석(安敏錫),79,51,130,0
24987,박용진(朴用鎭),안병길(安炳吉),49,6,55,1
24988,박용진(朴用鎭),안철수(安哲秀),25,4,29,1
24989,박용진(朴用鎭),안호영(安浩永),93,85,178,0
24990,박용진(朴用鎭),양경숙(梁敬淑),80,61,141,0
24991,박용진(朴用鎭),양금희(梁琴喜),49,10,59,1
24992,박용진(朴用鎭),양기대(梁基大),82,44,126,0
24993,박용진(朴用鎭),양이원영(梁李媛瑛),80,67,147,0
24994,박용진(朴用鎭),양정숙(梁貞淑),30,109,139,1
24995,박용진(朴用鎭),양향자(梁香子),32,31,63,1
24996,박용진(朴用鎭),어기구(魚基龜),78,46,124,0
24997,박용진(朴用鎭),엄태영(嚴泰永),50,6,56,1
24998,박용진(朴用鎭),오기형(吳奇炯),75,43,118,0
24999,박용진(朴用鎭),오영환(吳永煥),90,99,189,0
25000,박용진(朴用鎭),용혜인(龍慧仁),24,93,117,1
25001,박용진(朴用鎭),우상호(禹相虎),76,39,115,0
25002,박용진(朴用鎭),우원식(禹元植),83,49,132,0
25003,박용진(朴用鎭),위성곤(魏聖坤),85,104,189,0
25004,박용진(朴用鎭),유경준(兪京濬),49,5,54,1
25005,박용진(朴用鎭),유기홍(柳基洪),75,41,116,0
25006,박용진(朴用鎭),유동수(柳東秀),115,136,251,0
25007,박용진(朴用鎭),유상범(劉相凡),49,10,59,1
25008,박용진(朴用鎭),유의동(兪義東),49,11,60,1
25009,박용진(朴用鎭),유정주(兪訂炷),83,71,154,0
25010,박용진(朴用鎭),윤건영(尹建永),76,52,128,0
25011,박용진(朴用鎭),윤관석(尹官石),77,52,129,1
25012,박용진(朴用鎭),윤두현(尹斗鉉),49,11,60,1
25013,박용진(朴用鎭),윤미향(尹美香),37,37,74,1
25014,박용진(朴用鎭),윤상현(尹相現),30,6,36,1
25015,박용진(朴用鎭),윤영덕(尹永德),87,66,153,0
25016,박용진(朴用鎭),윤영석(尹永碩),49,4,53,1
25017,박용진(朴用鎭),윤영찬(尹永燦),80,46,126,0
25018,박용진(朴用鎭),윤재갑(尹才鉀),85,59,144,0
25019,박용진(朴用鎭),윤재옥(尹在玉),49,5,54,1
25020,박용진(朴用鎭),윤주경(尹柱卿),49,13,62,1
25021,박용진(朴用鎭),윤준병(尹準炳),86,93,179,0
25022,박용진(朴用鎭),윤창현(尹暢賢),49,10,59,1
25023,박용진(朴用鎭),윤한홍(尹漢洪),49,11,60,1
25024,박용진(朴用鎭),윤호중(尹昊重),77,43,120,0
25025,박용진(朴用鎭),윤후덕(尹厚德),80,67,147,0
25026,박용진(朴用鎭),이개호(李介昊),77,46,123,0
25027,박용진(朴用鎭),이달곤(李達坤),50,6,56,1
25028,박용진(朴用鎭),이동주(李東洲),84,60,144,0
25029,박용진(朴用鎭),이만희(李晩熙),49,4,53,1
25030,박용진(朴用鎭),이명수(李明洙),49,26,75,1
25031,박용진(朴用鎭),이병훈(李炳勳),80,70,150,0
25032,박용진(朴用鎭),이상민(李相珉),80,53,133,0
25033,박용진(朴用鎭),이상헌(李相憲),80,75,155,0
25034,박용진(朴用鎭),이성만(李成萬),78,54,132,1
25035,박용진(朴用鎭),이소영(李素永),90,90,180,0
25036,박용진(朴用鎭),이수진(李壽珍),86,83,169,0
25037,박용진(朴用鎭),이수진(李秀眞),85,48,133,0
25038,박용진(朴用鎭),이양수(李亮壽),49,7,56,1
25039,박용진(朴用鎭),이용(李鏞),49,10,59,1
25040,박용진(朴用鎭),이용빈(李龍彬),87,89,176,0
25041,박용진(朴用鎭),이용선(李庸瑄),89,55,144,0
25042,박용진(朴用鎭),이용우(李龍雨),80,69,149,0
25043,박용진(朴用鎭),이용호(李容鎬),28,18,46,1
25044,박용진(朴用鎭),이원욱(李元旭),81,71,152,0
25045,박용진(朴用鎭),이원택(李源澤),82,48,130,0
25046,박용진(朴用鎭),이은주(李恩周),14,44,58,1
25047,박용진(朴用鎭),이인선(李仁善),25,5,30,1
25048,박용진(朴用鎭),이인영(李仁榮),78,52,130,0
25049,박용진(朴用鎭),이장섭(李將燮),80,51,131,0
25050,박용진(朴用鎭),이재명(李在明),39,18,57,0
25051,박용진(朴用鎭),이재정(李在汀),77,32,109,0
25052,박용진(朴用鎭),이정문(李楨文),89,90,179,0
25053,박용진(朴用鎭),이종배(李鍾培),50,6,56,1
25054,박용진(朴用鎭),이종성(李鍾成),49,14,63,1
25055,박용진(朴用鎭),이주환(李周桓),49,5,54,1
25056,박용진(朴用鎭),이채익(李埰益),51,9,60,1
25057,박용진(朴用鎭),이철규(李喆圭),49,10,59,1
25058,박용진(朴用鎭),이탄희(李誕熙),85,57,142,0
25059,박용진(朴用鎭),이태규(李泰珪),28,5,33,1
25060,박용진(朴用鎭),이학영(李學永),96,100,196,0
25061,박용진(朴用鎭),이해식(李海植),82,54,136,0
25062,박용진(朴用鎭),이헌승(李憲昇),49,5,54,1
25063,박용진(朴用鎭),이형석(李炯錫),83,56,139,0
25064,박용진(朴用鎭),인재근(印在謹),89,68,157,0
25065,박용진(朴用鎭),임병헌(林炳憲),25,6,31,1
25066,박용진(朴用鎭),임오경(林五卿),84,46,130,0
25067,박용진(朴用鎭),임이자(林利子),49,6,55,1
25068,박용진(朴用鎭),임종성(林鍾聲),119,166,285,0
25069,박용진(朴用鎭),임호선(林昊宣),89,89,178,0
25070,박용진(朴用鎭),장경태(張耿態),90,62,152,0
25071,박용진(朴用鎭),장동혁(張東赫),25,5,30,1
25072,박용진(朴用鎭),장제원(張濟元),49,4,53,1
25073,박용진(朴用鎭),장철민(張喆敏),76,59,135,0
25074,박용진(朴用鎭),장혜영(張惠英),13,43,56,1
25075,박용진(朴用鎭),전봉민(田奉珉),35,5,40,1
25076,박용진(朴用鎭),전용기(田溶冀),101,120,221,0
25077,박용진(朴用鎭),전재수(田載秀),88,56,144,0
25078,박용진(朴用鎭),전주혜(全珠惠),50,6,56,1
25079,박용진(朴用鎭),전해철(全海澈),77,59,136,0
25080,박용진(朴用鎭),전혜숙(全惠淑),86,45,131,0
25081,박용진(朴用鎭),정경희(丁慶姬),49,9,58,1
25082,박용진(朴用鎭),정동만(鄭東萬),49,5,54,1
25083,박용진(朴用鎭),정성호(鄭成湖),92,121,213,0
25084,박용진(朴用鎭),정우택(鄭宇澤),25,4,29,1
25085,박용진(朴用鎭),정운천(鄭雲天),50,8,58,1
25086,박용진(朴用鎭),정일영(鄭日永),84,62,146,0
25087,박용진(朴用鎭),정점식(鄭点植),49,4,53,1
25088,박용진(朴用鎭),정진석(鄭鎭碩),49,4,53,1
25089,박용진(朴用鎭),정청래(鄭淸來),81,43,124,0
25090,박용진(朴用鎭),정춘숙(鄭春淑),136,222,358,0
25091,박용진(朴用鎭),정태호(鄭泰浩),82,70,152,0
25092,박용진(朴用鎭),정필모(鄭必模),83,51,134,0
25093,박용진(朴用鎭),정희용(鄭熙溶),50,6,56,1
25094,박용진(朴用鎭),조경태(趙慶泰),49,4,53,1
25095,박용진(朴用鎭),조명희(曺明姬),49,10,59,1
25096,박용진(朴用鎭),조수진(趙修眞),49,13,62,1
25097,박용진(朴用鎭),조승래(趙承來),77,47,124,0
25098,박용진(朴用鎭),조오섭(曺五燮),99,93,192,0
25099,박용진(朴用鎭),조은희(趙恩禧),25,6,31,1
25100,박용진(朴用鎭),조응천(趙應天),75,46,121,0
25101,박용진(朴用鎭),조정식(趙正湜),74,32,106,0
25102,박용진(朴用鎭),조정훈(趙廷訓),3,24,27,1
25103,박용진(朴用鎭),조해진(曺海珍),50,6,56,1
25104,박용진(朴用鎭),주철현(朱哲鉉),79,49,128,0
25105,박용진(朴用鎭),주호영(朱豪英),49,5,54,1
25106,박용진(朴用鎭),지성호(池成浩),49,5,54,1
25107,박용진(朴用鎭),진선미(陳善美),75,41,116,0
25108,박용진(朴用鎭),진성준(陳聲準),82,51,133,0
25109,박용진(朴用鎭),천준호(千俊鎬),81,49,130,0
25110,박용진(朴用鎭),최기상(崔基相),83,54,137,0
25111,박용진(朴用鎭),최승재(崔承宰),49,15,64,1
25112,박용진(朴用鎭),최연숙(崔姸淑),30,12,42,1
25113,박용진(朴用鎭),최영희(崔英姬),25,5,30,1
25114,박용진(朴用鎭),최인호(崔仁昊),92,60,152,0
25115,박용진(朴用鎭),최재형(崔在亨),25,4,29,1
25116,박용진(朴用鎭),최종윤(崔鍾允),83,73,156,0
25117,박용진(朴用鎭),최춘식(崔春植),49,20,69,1
25118,박용진(朴用鎭),최형두(崔炯斗),49,7,56,1
25119,박용진(朴用鎭),최혜영(崔惠英),89,68,157,0
25120,박용진(朴用鎭),추경호(秋慶鎬),49,5,54,1
25121,박용진(朴用鎭),태영호(太永浩),49,8,57,1
25122,박용진(朴用鎭),하영제(河榮帝),40,2,42,1
25123,박용진(朴用鎭),하태경(河泰慶),49,4,53,1
25124,박용진(朴用鎭),한기호(韓起鎬),49,5,54,1
25125,박용진(朴用鎭),한무경(韓茂景),49,6,55,1
25126,박용진(朴用鎭),한병도(韓秉道),86,66,152,0
25127,박용진(朴用鎭),한정애(韓貞愛),78,53,131,0
25128,박용진(朴用鎭),한준호(韓俊鎬),97,76,173,0
25129,박용진(朴用鎭),허숙정(許淑湞),1,1,2,0
25130,박용진(朴用鎭),허영(許榮),90,62,152,0
25131,박용진(朴用鎭),허은아(許垠娥),49,6,55,1
25132,박용진(朴用鎭),허종식(許琮植),84,51,135,0
25133,박용진(朴用鎭),홍기원(洪起元),82,44,126,0
25134,박용진(朴用鎭),홍문표(洪文杓),49,7,56,1
25135,박용진(朴用鎭),홍석준(洪碩晙),49,5,54,1
25136,박용진(朴用鎭),홍성국(洪性國),85,63,148,0
25137,박용진(朴用鎭),홍영표(洪永杓),82,46,128,0
25138,박용진(朴用鎭),홍익표(洪翼杓),81,55,136,0
25139,박용진(朴用鎭),홍정민(洪貞敏),79,62,141,0
25140,박용진(朴用鎭),황보승희(皇甫承希),44,11,55,1
25141,박용진(朴用鎭),황운하(黃雲夏),95,98,193,0
25142,박용진(朴用鎭),황희(黃熙),75,44,119,0
25143,박재호(朴在昊),박정(朴釘),96,88,184,0
25144,박재호(朴在昊),박정하(朴正河),25,5,30,1
25145,박재호(朴在昊),박주민(朴柱民),85,45,130,0
25146,박재호(朴在昊),박진(朴振),51,6,57,1
25147,박재호(朴在昊),박찬대(朴贊大),87,48,135,0
25148,박재호(朴在昊),박형수(朴亨修),49,6,55,1
25149,박재호(朴在昊),박홍근(朴洪根),97,93,190,0
25150,박재호(朴在昊),배준영(裵俊英),50,5,55,1
25151,박재호(朴在昊),배진교(裵晋敎),16,21,37,1
25152,박재호(朴在昊),배현진(裵賢鎭),49,5,54,1
25153,박재호(朴在昊),백종헌(白宗憲),53,7,60,1
25154,박재호(朴在昊),백혜련(白惠蓮),91,68,159,0
25155,박재호(朴在昊),변재일(卞在一),79,39,118,0
25156,박재호(朴在昊),서동용(徐東榕),109,97,206,0
25157,박재호(朴在昊),서범수(徐範洙),53,6,59,1
25158,박재호(朴在昊),서병수(徐秉洙),53,7,60,1
25159,박재호(朴在昊),서삼석(徐參錫),103,78,181,0
25160,박재호(朴在昊),서영교(徐瑛敎),113,75,188,0
25161,박재호(朴在昊),서영석(徐暎錫),92,91,183,0
25162,박재호(朴在昊),서일준(徐一俊),52,6,58,1
25163,박재호(朴在昊),서정숙(徐正淑),50,6,56,1
25164,박재호(朴在昊),설훈(薛勳),82,51,133,0
25165,박재호(朴在昊),성일종(成一鍾),50,5,55,1
25166,박재호(朴在昊),소병철(蘇秉哲),89,72,161,0
25167,박재호(朴在昊),소병훈(蘇秉勳),82,52,134,0
25168,박재호(朴在昊),송갑석(宋甲錫),94,88,182,0
25169,박재호(朴在昊),송기헌(宋基憲),91,72,163,0
25170,박재호(朴在昊),송석준(宋錫俊),49,5,54,1
25171,박재호(朴在昊),송언석(宋彦錫),47,8,55,1
25172,박재호(朴在昊),송옥주(宋玉珠),107,79,186,0
25173,박재호(朴在昊),송재호(宋在祜),102,100,202,0
25174,박재호(朴在昊),신동근(申東根),92,72,164,0
25175,박재호(朴在昊),신영대(申榮大),95,61,156,0
25176,박재호(朴在昊),신원식(申源湜),52,13,65,1
25177,박재호(朴在昊),신정훈(辛正勳),115,112,227,0
25178,박재호(朴在昊),신현영(申賢榮),91,56,147,0
25179,박재호(朴在昊),심상정(沈相奵),17,26,43,1
25180,박재호(朴在昊),안규백(安圭伯),85,68,153,0
25181,박재호(朴在昊),안민석(安敏錫),86,48,134,0
25182,박재호(朴在昊),안병길(安炳吉),52,7,59,1
25183,박재호(朴在昊),안철수(安哲秀),25,5,30,1
25184,박재호(朴在昊),안호영(安浩永),83,64,147,0
25185,박재호(朴在昊),양경숙(梁敬淑),96,53,149,0
25186,박재호(朴在昊),양금희(梁琴喜),51,6,57,1
25187,박재호(朴在昊),양기대(梁基大),114,67,181,0
25188,박재호(朴在昊),양이원영(梁李媛瑛),81,65,146,0
25189,박재호(朴在昊),양정숙(梁貞淑),36,88,124,1
25190,박재호(朴在昊),양향자(梁香子),41,25,66,1
25191,박재호(朴在昊),어기구(魚基龜),86,63,149,0
25192,박재호(朴在昊),엄태영(嚴泰永),51,4,55,1
25193,박재호(朴在昊),오기형(吳奇炯),80,44,124,0
25194,박재호(朴在昊),오영환(吳永煥),131,149,280,0
25195,박재호(朴在昊),용혜인(龍慧仁),18,23,41,1
25196,박재호(朴在昊),우상호(禹相虎),77,38,115,0
25197,박재호(朴在昊),우원식(禹元植),96,77,173,0
25198,박재호(朴在昊),위성곤(魏聖坤),105,99,204,0
25199,박재호(朴在昊),유경준(兪京濬),50,4,54,1
25200,박재호(朴在昊),유기홍(柳基洪),77,46,123,0
25201,박재호(朴在昊),유동수(柳東秀),84,49,133,0
25202,박재호(朴在昊),유상범(劉相凡),51,5,56,1
25203,박재호(朴在昊),유의동(兪義東),49,5,54,1
25204,박재호(朴在昊),유정주(兪訂炷),99,107,206,0
25205,박재호(朴在昊),윤건영(尹建永),81,58,139,0
25206,박재호(朴在昊),윤관석(尹官石),84,41,125,1
25207,박재호(朴在昊),윤두현(尹斗鉉),50,5,55,1
25208,박재호(朴在昊),윤미향(尹美香),42,42,84,1
25209,박재호(朴在昊),윤상현(尹相現),30,6,36,1
25210,박재호(朴在昊),윤영덕(尹永德),93,86,179,0
25211,박재호(朴在昊),윤영석(尹永碩),51,6,57,1
25212,박재호(朴在昊),윤영찬(尹永燦),81,52,133,0
25213,박재호(朴在昊),윤재갑(尹才鉀),104,79,183,0
25214,박재호(朴在昊),윤재옥(尹在玉),49,5,54,1
25215,박재호(朴在昊),윤주경(尹柱卿),49,5,54,1
25216,박재호(朴在昊),윤준병(尹準炳),97,109,206,0
25217,박재호(朴在昊),윤창현(尹暢賢),49,5,54,1
25218,박재호(朴在昊),윤한홍(尹漢洪),50,6,56,1
25219,박재호(朴在昊),윤호중(尹昊重),79,49,128,0
25220,박재호(朴在昊),윤후덕(尹厚德),102,97,199,0
25221,박재호(朴在昊),이개호(李介昊),91,67,158,0
25222,박재호(朴在昊),이달곤(李達坤),52,6,58,1
25223,박재호(朴在昊),이동주(李東洲),94,86,180,0
25224,박재호(朴在昊),이만희(李晩熙),51,4,55,1
25225,박재호(朴在昊),이명수(李明洙),52,17,69,1
25226,박재호(朴在昊),이병훈(李炳勳),113,103,216,0
25227,박재호(朴在昊),이상민(李相珉),86,35,121,0
25228,박재호(朴在昊),이상헌(李相憲),108,111,219,0
25229,박재호(朴在昊),이성만(李成萬),72,50,122,1
25230,박재호(朴在昊),이소영(李素永),88,61,149,0
25231,박재호(朴在昊),이수진(李壽珍),91,77,168,0
25232,박재호(朴在昊),이수진(李秀眞),100,69,169,0
25233,박재호(朴在昊),이양수(李亮壽),51,5,56,1
25234,박재호(朴在昊),이용(李鏞),49,6,55,1
25235,박재호(朴在昊),이용빈(李龍彬),116,100,216,0
25236,박재호(朴在昊),이용선(李庸瑄),91,68,159,0
25237,박재호(朴在昊),이용우(李龍雨),106,85,191,0
25238,박재호(朴在昊),이용호(李容鎬),39,20,59,1
25239,박재호(朴在昊),이원욱(李元旭),90,55,145,0
25240,박재호(朴在昊),이원택(李源澤),96,85,181,0
25241,박재호(朴在昊),이은주(李恩周),22,27,49,1
25242,박재호(朴在昊),이인선(李仁善),25,5,30,1
25243,박재호(朴在昊),이인영(李仁榮),75,39,114,0
25244,박재호(朴在昊),이장섭(李將燮),97,90,187,0
25245,박재호(朴在昊),이재명(李在明),40,18,58,0
25246,박재호(朴在昊),이재정(李在汀),81,37,118,0
25247,박재호(朴在昊),이정문(李楨文),90,60,150,0
25248,박재호(朴在昊),이종배(李鍾培),50,6,56,1
25249,박재호(朴在昊),이종성(李鍾成),50,6,56,1
25250,박재호(朴在昊),이주환(李周桓),51,7,58,1
25251,박재호(朴在昊),이채익(李埰益),51,8,59,1
25252,박재호(朴在昊),이철규(李喆圭),53,8,61,1
25253,박재호(朴在昊),이탄희(李誕熙),93,52,145,0
25254,박재호(朴在昊),이태규(李泰珪),28,5,33,1
25255,박재호(朴在昊),이학영(李學永),107,82,189,0
25256,박재호(朴在昊),이해식(李海植),106,91,197,0
25257,박재호(朴在昊),이헌승(李憲昇),52,6,58,1
25258,박재호(朴在昊),이형석(李炯錫),114,95,209,0
25259,박재호(朴在昊),인재근(印在謹),95,68,163,0
25260,박재호(朴在昊),임병헌(林炳憲),26,5,31,1
25261,박재호(朴在昊),임오경(林五卿),100,72,172,0
25262,박재호(朴在昊),임이자(林利子),50,4,54,1
25263,박재호(朴在昊),임종성(林鍾聲),112,102,214,0
25264,박재호(朴在昊),임호선(林昊宣),118,158,276,0
25265,박재호(朴在昊),장경태(張耿態),100,93,193,0
25266,박재호(朴在昊),장동혁(張東赫),25,5,30,1
25267,박재호(朴在昊),장제원(張濟元),51,6,57,1
25268,박재호(朴在昊),장철민(張喆敏),91,76,167,0
25269,박재호(朴在昊),장혜영(張惠英),14,15,29,1
25270,박재호(朴在昊),전봉민(田奉珉),37,7,44,1
25271,박재호(朴在昊),전용기(田溶冀),100,104,204,0
25272,박재호(朴在昊),전재수(田載秀),145,179,324,0
25273,박재호(朴在昊),전주혜(全珠惠),51,6,57,1
25274,박재호(朴在昊),전해철(全海澈),76,42,118,0
25275,박재호(朴在昊),전혜숙(全惠淑),88,63,151,0
25276,박재호(朴在昊),정경희(丁慶姬),51,4,55,1
25277,박재호(朴在昊),정동만(鄭東萬),51,6,57,1
25278,박재호(朴在昊),정성호(鄭成湖),89,96,185,0
25279,박재호(朴在昊),정우택(鄭宇澤),25,5,30,1
25280,박재호(朴在昊),정운천(鄭雲天),51,9,60,1
25281,박재호(朴在昊),정일영(鄭日永),104,85,189,0
25282,박재호(朴在昊),정점식(鄭点植),50,4,54,1
25283,박재호(朴在昊),정진석(鄭鎭碩),50,4,54,1
25284,박재호(朴在昊),정청래(鄭淸來),84,40,124,0
25285,박재호(朴在昊),정춘숙(鄭春淑),123,138,261,0
25286,박재호(朴在昊),정태호(鄭泰浩),86,60,146,0
25287,박재호(朴在昊),정필모(鄭必模),87,62,149,0
25288,박재호(朴在昊),정희용(鄭熙溶),52,5,57,1
25289,박재호(朴在昊),조경태(趙慶泰),51,6,57,1
25290,박재호(朴在昊),조명희(曺明姬),50,6,56,1
25291,박재호(朴在昊),조수진(趙修眞),49,6,55,1
25292,박재호(朴在昊),조승래(趙承來),96,69,165,0
25293,박재호(朴在昊),조오섭(曺五燮),89,113,202,0
25294,박재호(朴在昊),조은희(趙恩禧),25,5,30,1
25295,박재호(朴在昊),조응천(趙應天),88,34,122,0
25296,박재호(朴在昊),조정식(趙正湜),82,39,121,0
25297,박재호(朴在昊),조정훈(趙廷訓),3,7,10,1
25298,박재호(朴在昊),조해진(曺海珍),51,5,56,1
25299,박재호(朴在昊),주철현(朱哲鉉),86,75,161,0
25300,박재호(朴在昊),주호영(朱豪英),51,4,55,1
25301,박재호(朴在昊),지성호(池成浩),49,4,53,1
25302,박재호(朴在昊),진선미(陳善美),77,42,119,0
25303,박재호(朴在昊),진성준(陳聲準),97,76,173,0
25304,박재호(朴在昊),천준호(千俊鎬),85,63,148,0
25305,박재호(朴在昊),최기상(崔基相),80,50,130,0
25306,박재호(朴在昊),최승재(崔承宰),50,6,56,1
25307,박재호(朴在昊),최연숙(崔姸淑),31,10,41,1
25308,박재호(朴在昊),최영희(崔英姬),25,7,32,1
25309,박재호(朴在昊),최인호(崔仁昊),138,151,289,0
25310,박재호(朴在昊),최재형(崔在亨),25,5,30,1
25311,박재호(朴在昊),최종윤(崔鍾允),87,78,165,0
25312,박재호(朴在昊),최춘식(崔春植),52,15,67,1
25313,박재호(朴在昊),최형두(崔炯斗),51,7,58,1
25314,박재호(朴在昊),최혜영(崔惠英),90,55,145,0
25315,박재호(朴在昊),추경호(秋慶鎬),51,4,55,1
25316,박재호(朴在昊),태영호(太永浩),49,4,53,1
25317,박재호(朴在昊),하영제(河榮帝),42,5,47,1
25318,박재호(朴在昊),하태경(河泰慶),53,6,59,1
25319,박재호(朴在昊),한기호(韓起鎬),51,6,57,1
25320,박재호(朴在昊),한무경(韓茂景),49,5,54,1
25321,박재호(朴在昊),한병도(韓秉道),137,108,245,0
25322,박재호(朴在昊),한정애(韓貞愛),79,59,138,0
25323,박재호(朴在昊),한준호(韓俊鎬),101,93,194,0
25324,박재호(朴在昊),허숙정(許淑湞),1,1,2,0
25325,박재호(朴在昊),허영(許榮),153,170,323,0
25326,박재호(朴在昊),허은아(許垠娥),50,6,56,1
25327,박재호(朴在昊),허종식(許琮植),95,93,188,0
25328,박재호(朴在昊),홍기원(洪起元),89,64,153,0
25329,박재호(朴在昊),홍문표(洪文杓),55,9,64,1
25330,박재호(朴在昊),홍석준(洪碩晙),50,4,54,1
25331,박재호(朴在昊),홍성국(洪性國),111,110,221,0
25332,박재호(朴在昊),홍영표(洪永杓),85,48,133,0
25333,박재호(朴在昊),홍익표(洪翼杓),87,45,132,0
25334,박재호(朴在昊),홍정민(洪貞敏),93,79,172,0
25335,박재호(朴在昊),황보승희(皇甫承希),49,7,56,1
25336,박재호(朴在昊),황운하(黃雲夏),100,101,201,0
25337,박재호(朴在昊),황희(黃熙),76,43,119,0
25338,박정(朴釘),박정하(朴正河),27,4,31,1
25339,박정(朴釘),박주민(朴柱民),85,63,148,0
25340,박정(朴釘),박진(朴振),51,7,58,1
25341,박정(朴釘),박찬대(朴贊大),102,116,218,0
25342,박정(朴釘),박형수(朴亨修),52,4,56,1
25343,박정(朴釘),박홍근(朴洪根),140,132,272,0
25344,박정(朴釘),배준영(裵俊英),49,9,58,1
25345,박정(朴釘),배진교(裵晋敎),19,29,48,1
25346,박정(朴釘),배현진(裵賢鎭),50,7,57,1
25347,박정(朴釘),백종헌(白宗憲),50,6,56,1
25348,박정(朴釘),백혜련(白惠蓮),121,109,230,0
25349,박정(朴釘),변재일(卞在一),85,51,136,0
25350,박정(朴釘),서동용(徐東榕),114,147,261,0
25351,박정(朴釘),서범수(徐範洙),54,6,60,1
25352,박정(朴釘),서병수(徐秉洙),53,5,58,1
25353,박정(朴釘),서삼석(徐參錫),153,188,341,0
25354,박정(朴釘),서영교(徐瑛敎),165,155,320,0
25355,박정(朴釘),서영석(徐暎錫),105,116,221,0
25356,박정(朴釘),서일준(徐一俊),50,6,56,1
25357,박정(朴釘),서정숙(徐正淑),51,6,57,1
25358,박정(朴釘),설훈(薛勳),85,75,160,0
25359,박정(朴釘),성일종(成一鍾),52,8,60,1
25360,박정(朴釘),소병철(蘇秉哲),96,85,181,0
25361,박정(朴釘),소병훈(蘇秉勳),104,132,236,0
25362,박정(朴釘),송갑석(宋甲錫),141,198,339,0
25363,박정(朴釘),송기헌(宋基憲),87,61,148,0
25364,박정(朴釘),송석준(宋錫俊),56,13,69,1
25365,박정(朴釘),송언석(宋彦錫),46,4,50,1
25366,박정(朴釘),송옥주(宋玉珠),142,206,348,0
25367,박정(朴釘),송재호(宋在祜),108,128,236,0
25368,박정(朴釘),신동근(申東根),103,113,216,0
25369,박정(朴釘),신영대(申榮大),107,81,188,0
25370,박정(朴釘),신원식(申源湜),49,4,53,1
25371,박정(朴釘),신정훈(辛正勳),140,173,313,0
25372,박정(朴釘),신현영(申賢榮),94,53,147,0
25373,박정(朴釘),심상정(沈相奵),17,29,46,1
25374,박정(朴釘),안규백(安圭伯),110,119,229,0
25375,박정(朴釘),안민석(安敏錫),142,147,289,0
25376,박정(朴釘),안병길(安炳吉),53,6,59,1
25377,박정(朴釘),안철수(安哲秀),26,5,31,1
25378,박정(朴釘),안호영(安浩永),111,137,248,0
25379,박정(朴釘),양경숙(梁敬淑),106,128,234,0
25380,박정(朴釘),양금희(梁琴喜),52,8,60,1
25381,박정(朴釘),양기대(梁基大),114,131,245,0
25382,박정(朴釘),양이원영(梁李媛瑛),121,112,233,0
25383,박정(朴釘),양정숙(梁貞淑),81,168,249,1
25384,박정(朴釘),양향자(梁香子),61,87,148,1
25385,박정(朴釘),어기구(魚基龜),122,182,304,0
25386,박정(朴釘),엄태영(嚴泰永),53,5,58,1
25387,박정(朴釘),오기형(吳奇炯),87,52,139,0
25388,박정(朴釘),오영환(吳永煥),195,294,489,0
25389,박정(朴釘),용혜인(龍慧仁),28,51,79,1
25390,박정(朴釘),우상호(禹相虎),81,55,136,0
25391,박정(朴釘),우원식(禹元植),106,104,210,0
25392,박정(朴釘),위성곤(魏聖坤),116,128,244,0
25393,박정(朴釘),유경준(兪京濬),49,5,54,1
25394,박정(朴釘),유기홍(柳基洪),86,74,160,0
25395,박정(朴釘),유동수(柳東秀),130,160,290,0
25396,박정(朴釘),유상범(劉相凡),51,5,56,1
25397,박정(朴釘),유의동(兪義東),53,5,58,1
25398,박정(朴釘),유정주(兪訂炷),180,198,378,0
25399,박정(朴釘),윤건영(尹建永),89,71,160,0
25400,박정(朴釘),윤관석(尹官石),116,100,216,1
25401,박정(朴釘),윤두현(尹斗鉉),49,7,56,1
25402,박정(朴釘),윤미향(尹美香),52,105,157,1
25403,박정(朴釘),윤상현(尹相現),32,10,42,1
25404,박정(朴釘),윤영덕(尹永德),107,133,240,0
25405,박정(朴釘),윤영석(尹永碩),51,11,62,1
25406,박정(朴釘),윤영찬(尹永燦),84,70,154,0
25407,박정(朴釘),윤재갑(尹才鉀),145,169,314,0
25408,박정(朴釘),윤재옥(尹在玉),53,6,59,1
25409,박정(朴釘),윤주경(尹柱卿),51,13,64,1
25410,박정(朴釘),윤준병(尹準炳),132,178,310,0
25411,박정(朴釘),윤창현(尹暢賢),49,6,55,1
25412,박정(朴釘),윤한홍(尹漢洪),50,4,54,1
25413,박정(朴釘),윤호중(尹昊重),81,71,152,0
25414,박정(朴釘),윤후덕(尹厚德),151,220,371,0
25415,박정(朴釘),이개호(李介昊),118,141,259,0
25416,박정(朴釘),이달곤(李達坤),52,7,59,1
25417,박정(朴釘),이동주(李東洲),105,124,229,0
25418,박정(朴釘),이만희(李晩熙),50,5,55,1
25419,박정(朴釘),이명수(李明洙),53,12,65,1
25420,박정(朴釘),이병훈(李炳勳),175,267,442,0
25421,박정(朴釘),이상민(李相珉),81,41,122,0
25422,박정(朴釘),이상헌(李相憲),144,171,315,0
25423,박정(朴釘),이성만(李成萬),117,178,295,1
25424,박정(朴釘),이소영(李素永),105,84,189,0
25425,박정(朴釘),이수진(李壽珍),124,138,262,0
25426,박정(朴釘),이수진(李秀眞),147,121,268,0
25427,박정(朴釘),이양수(李亮壽),53,8,61,1
25428,박정(朴釘),이용(李鏞),50,6,56,1
25429,박정(朴釘),이용빈(李龍彬),131,188,319,0
25430,박정(朴釘),이용선(李庸瑄),115,111,226,0
25431,박정(朴釘),이용우(李龍雨),110,94,204,0
25432,박정(朴釘),이용호(李容鎬),34,22,56,1
25433,박정(朴釘),이원욱(李元旭),121,124,245,0
25434,박정(朴釘),이원택(李源澤),120,102,222,0
25435,박정(朴釘),이은주(李恩周),21,22,43,1
25436,박정(朴釘),이인선(李仁善),27,4,31,1
25437,박정(朴釘),이인영(李仁榮),87,57,144,0
25438,박정(朴釘),이장섭(李將燮),104,91,195,0
25439,박정(朴釘),이재명(李在明),39,23,62,0
25440,박정(朴釘),이재정(李在汀),103,85,188,0
25441,박정(朴釘),이정문(李楨文),125,125,250,0
25442,박정(朴釘),이종배(李鍾培),53,7,60,1
25443,박정(朴釘),이종성(李鍾成),49,6,55,1
25444,박정(朴釘),이주환(李周桓),49,6,55,1
25445,박정(朴釘),이채익(李埰益),53,12,65,1
25446,박정(朴釘),이철규(李喆圭),52,7,59,1
25447,박정(朴釘),이탄희(李誕熙),107,82,189,0
25448,박정(朴釘),이태규(李泰珪),33,6,39,1
25449,박정(朴釘),이학영(李學永),113,101,214,0
25450,박정(朴釘),이해식(李海植),114,107,221,0
25451,박정(朴釘),이헌승(李憲昇),51,4,55,1
25452,박정(朴釘),이형석(李炯錫),126,123,249,0
25453,박정(朴釘),인재근(印在謹),106,131,237,0
25454,박정(朴釘),임병헌(林炳憲),27,6,33,1
25455,박정(朴釘),임오경(林五卿),171,194,365,0
25456,박정(朴釘),임이자(林利子),50,5,55,1
25457,박정(朴釘),임종성(林鍾聲),144,207,351,0
25458,박정(朴釘),임호선(林昊宣),148,189,337,0
25459,박정(朴釘),장경태(張耿態),127,131,258,0
25460,박정(朴釘),장동혁(張東赫),25,4,29,1
25461,박정(朴釘),장제원(張濟元),49,4,53,1
25462,박정(朴釘),장철민(張喆敏),115,110,225,0
25463,박정(朴釘),장혜영(張惠英),16,17,33,1
25464,박정(朴釘),전봉민(田奉珉),35,5,40,1
25465,박정(朴釘),전용기(田溶冀),140,166,306,0
25466,박정(朴釘),전재수(田載秀),103,77,180,0
25467,박정(朴釘),전주혜(全珠惠),53,6,59,1
25468,박정(朴釘),전해철(全海澈),91,83,174,0
25469,박정(朴釘),전혜숙(全惠淑),123,150,273,0
25470,박정(朴釘),정경희(丁慶姬),49,4,53,1
25471,박정(朴釘),정동만(鄭東萬),49,5,54,1
25472,박정(朴釘),정성호(鄭成湖),102,138,240,0
25473,박정(朴釘),정우택(鄭宇澤),27,5,32,1
25474,박정(朴釘),정운천(鄭雲天),51,5,56,1
25475,박정(朴釘),정일영(鄭日永),98,93,191,0
25476,박정(朴釘),정점식(鄭点植),50,5,55,1
25477,박정(朴釘),정진석(鄭鎭碩),52,6,58,1
25478,박정(朴釘),정청래(鄭淸來),95,76,171,0
25479,박정(朴釘),정춘숙(鄭春淑),131,178,309,0
25480,박정(朴釘),정태호(鄭泰浩),95,95,190,0
25481,박정(朴釘),정필모(鄭必模),92,86,178,0
25482,박정(朴釘),정희용(鄭熙溶),50,6,56,1
25483,박정(朴釘),조경태(趙慶泰),49,6,55,1
25484,박정(朴釘),조명희(曺明姬),52,7,59,1
25485,박정(朴釘),조수진(趙修眞),51,4,55,1
25486,박정(朴釘),조승래(趙承來),109,92,201,0
25487,박정(朴釘),조오섭(曺五燮),126,160,286,0
25488,박정(朴釘),조은희(趙恩禧),27,5,32,1
25489,박정(朴釘),조응천(趙應天),82,39,121,0
25490,박정(朴釘),조정식(趙正湜),82,79,161,0
25491,박정(朴釘),조정훈(趙廷訓),8,31,39,1
25492,박정(朴釘),조해진(曺海珍),52,6,58,1
25493,박정(朴釘),주철현(朱哲鉉),112,100,212,0
25494,박정(朴釘),주호영(朱豪英),53,5,58,1
25495,박정(朴釘),지성호(池成浩),49,5,54,1
25496,박정(朴釘),진선미(陳善美),87,52,139,0
25497,박정(朴釘),진성준(陳聲準),120,111,231,0
25498,박정(朴釘),천준호(千俊鎬),103,78,181,0
25499,박정(朴釘),최기상(崔基相),93,69,162,0
25500,박정(朴釘),최승재(崔承宰),52,7,59,1
25501,박정(朴釘),최연숙(崔姸淑),35,12,47,1
25502,박정(朴釘),최영희(崔英姬),25,6,31,1
25503,박정(朴釘),최인호(崔仁昊),108,128,236,0
25504,박정(朴釘),최재형(崔在亨),25,5,30,1
25505,박정(朴釘),최종윤(崔鍾允),110,130,240,0
25506,박정(朴釘),최춘식(崔春植),49,13,62,1
25507,박정(朴釘),최형두(崔炯斗),53,8,61,1
25508,박정(朴釘),최혜영(崔惠英),113,103,216,0
25509,박정(朴釘),추경호(秋慶鎬),49,3,52,1
25510,박정(朴釘),태영호(太永浩),49,6,55,1
25511,박정(朴釘),하영제(河榮帝),42,1,43,1
25512,박정(朴釘),하태경(河泰慶),49,5,54,1
25513,박정(朴釘),한기호(韓起鎬),51,9,60,1
25514,박정(朴釘),한무경(韓茂景),52,8,60,1
25515,박정(朴釘),한병도(韓秉道),126,107,233,0
25516,박정(朴釘),한정애(韓貞愛),86,62,148,0
25517,박정(朴釘),한준호(韓俊鎬),106,123,229,0
25518,박정(朴釘),허숙정(許淑湞),1,1,2,0
25519,박정(朴釘),허영(許榮),155,169,324,0
25520,박정(朴釘),허은아(許垠娥),49,5,54,1
25521,박정(朴釘),허종식(許琮植),111,153,264,0
25522,박정(朴釘),홍기원(洪起元),106,141,247,0
25523,박정(朴釘),홍문표(洪文杓),55,9,64,1
25524,박정(朴釘),홍석준(洪碩晙),50,5,55,1
25525,박정(朴釘),홍성국(洪性國),127,149,276,0
25526,박정(朴釘),홍영표(洪永杓),95,70,165,0
25527,박정(朴釘),홍익표(洪翼杓),99,94,193,0
25528,박정(朴釘),홍정민(洪貞敏),121,137,258,0
25529,박정(朴釘),황보승희(皇甫承希),51,5,56,1
25530,박정(朴釘),황운하(黃雲夏),129,151,280,0
25531,박정(朴釘),황희(黃熙),97,84,181,0
25532,박정하(朴正河),박주민(朴柱民),25,4,29,1
25533,박정하(朴正河),박진(朴振),26,26,52,0
25534,박정하(朴正河),박찬대(朴贊大),25,4,29,1
25535,박정하(朴正河),박형수(朴亨修),31,18,49,0
25536,박정하(朴正河),박홍근(朴洪根),25,4,29,1
25537,박정하(朴正河),배준영(裵俊英),37,35,72,0
25538,박정하(朴正河),배진교(裵晋敎),0,0,0,1
25539,박정하(朴正河),배현진(裵賢鎭),31,19,50,0
25540,박정하(朴正河),백종헌(白宗憲),31,94,125,0
25541,박정하(朴正河),백혜련(白惠蓮),26,5,31,1
25542,박정하(朴正河),변재일(卞在一),25,4,29,1
25543,박정하(朴正河),서동용(徐東榕),25,4,29,1
25544,박정하(朴正河),서범수(徐範洙),30,31,61,0
25545,박정하(朴正河),서병수(徐秉洙),31,24,55,0
25546,박정하(朴正河),서삼석(徐參錫),25,4,29,1
25547,박정하(朴正河),서영교(徐瑛敎),26,4,30,1
25548,박정하(朴正河),서영석(徐暎錫),25,4,29,1
25549,박정하(朴正河),서일준(徐一俊),57,68,125,0
25550,박정하(朴正河),서정숙(徐正淑),34,27,61,0
25551,박정하(朴正河),설훈(薛勳),25,4,29,1
25552,박정하(朴正河),성일종(成一鍾),37,52,89,0
25553,박정하(朴正河),소병철(蘇秉哲),27,5,32,1
25554,박정하(朴正河),소병훈(蘇秉勳),26,4,30,1
25555,박정하(朴正河),송갑석(宋甲錫),26,4,30,1
25556,박정하(朴正河),송기헌(宋基憲),26,7,33,1
25557,박정하(朴正河),송석준(宋錫俊),30,25,55,0
25558,박정하(朴正河),송언석(宋彦錫),29,23,52,0
25559,박정하(朴正河),송옥주(宋玉珠),25,3,28,1
25560,박정하(朴正河),송재호(宋在祜),26,4,30,1
25561,박정하(朴正河),신동근(申東根),25,3,28,1
25562,박정하(朴正河),신영대(申榮大),25,4,29,1
25563,박정하(朴正河),신원식(申源湜),30,29,59,0
25564,박정하(朴正河),신정훈(辛正勳),26,4,30,1
25565,박정하(朴正河),신현영(申賢榮),26,4,30,1
25566,박정하(朴正河),심상정(沈相奵),1,0,1,1
25567,박정하(朴正河),안규백(安圭伯),27,6,33,1
25568,박정하(朴正河),안민석(安敏錫),25,3,28,1
25569,박정하(朴正河),안병길(安炳吉),38,34,72,0
25570,박정하(朴正河),안철수(安哲秀),28,22,50,0
25571,박정하(朴正河),안호영(安浩永),25,4,29,1
25572,박정하(朴正河),양경숙(梁敬淑),25,4,29,1
25573,박정하(朴正河),양금희(梁琴喜),38,41,79,0
25574,박정하(朴正河),양기대(梁基大),25,8,33,1
25575,박정하(朴正河),양이원영(梁李媛瑛),25,4,29,1
25576,박정하(朴正河),양정숙(梁貞淑),0,5,5,1
25577,박정하(朴正河),양향자(梁香子),4,4,8,1
25578,박정하(朴正河),어기구(魚基龜),25,7,32,1
25579,박정하(朴正河),엄태영(嚴泰永),31,40,71,0
25580,박정하(朴正河),오기형(吳奇炯),25,4,29,1
25581,박정하(朴正河),오영환(吳永煥),26,7,33,1
25582,박정하(朴正河),용혜인(龍慧仁),0,1,1,1
25583,박정하(朴正河),우상호(禹相虎),26,4,30,1
25584,박정하(朴正河),우원식(禹元植),26,4,30,1
25585,박정하(朴正河),위성곤(魏聖坤),27,6,33,1
25586,박정하(朴正河),유경준(兪京濬),42,70,112,0
25587,박정하(朴正河),유기홍(柳基洪),25,4,29,1
25588,박정하(朴正河),유동수(柳東秀),25,4,29,1
25589,박정하(朴正河),유상범(劉相凡),36,36,72,0
25590,박정하(朴正河),유의동(兪義東),33,19,52,0
25591,박정하(朴正河),유정주(兪訂炷),25,4,29,1
25592,박정하(朴正河),윤건영(尹建永),25,3,28,1
25593,박정하(朴正河),윤관석(尹官石),16,0,16,1
25594,박정하(朴正河),윤두현(尹斗鉉),33,47,80,0
25595,박정하(朴正河),윤미향(尹美香),0,0,0,1
25596,박정하(朴正河),윤상현(尹相現),29,30,59,0
25597,박정하(朴正河),윤영덕(尹永德),25,4,29,1
25598,박정하(朴正河),윤영석(尹永碩),31,20,51,0
25599,박정하(朴正河),윤영찬(尹永燦),25,4,29,1
25600,박정하(朴正河),윤재갑(尹才鉀),27,4,31,1
25601,박정하(朴正河),윤재옥(尹在玉),30,25,55,0
25602,박정하(朴正河),윤주경(尹柱卿),41,27,68,0
25603,박정하(朴正河),윤준병(尹準炳),25,4,29,1
25604,박정하(朴正河),윤창현(尹暢賢),31,38,69,0
25605,박정하(朴正河),윤한홍(尹漢洪),35,42,77,0
25606,박정하(朴正河),윤호중(尹昊重),26,4,30,1
25607,박정하(朴正河),윤후덕(尹厚德),25,4,29,1
25608,박정하(朴正河),이개호(李介昊),26,4,30,1
25609,박정하(朴正河),이달곤(李達坤),26,23,49,0
25610,박정하(朴正河),이동주(李東洲),25,4,29,1
25611,박정하(朴正河),이만희(李晩熙),32,23,55,0
25612,박정하(朴正河),이명수(李明洙),34,44,78,0
25613,박정하(朴正河),이병훈(李炳勳),27,4,31,1
25614,박정하(朴正河),이상민(李相珉),25,4,29,1
25615,박정하(朴正河),이상헌(李相憲),25,4,29,1
25616,박정하(朴正河),이성만(李成萬),16,0,16,1
25617,박정하(朴正河),이소영(李素永),27,4,31,1
25618,박정하(朴正河),이수진(李壽珍),25,5,30,1
25619,박정하(朴正河),이수진(李秀眞),25,5,30,1
25620,박정하(朴正河),이양수(李亮壽),35,29,64,0
25621,박정하(朴正河),이용(李鏞),32,49,81,0
25622,박정하(朴正河),이용빈(李龍彬),26,4,30,1
25623,박정하(朴正河),이용선(李庸瑄),25,4,29,1
25624,박정하(朴正河),이용우(李龍雨),25,5,30,1
25625,박정하(朴正河),이용호(李容鎬),29,22,51,0
25626,박정하(朴正河),이원욱(李元旭),26,4,30,1
25627,박정하(朴正河),이원택(李源澤),25,4,29,1
25628,박정하(朴正河),이은주(李恩周),0,0,0,1
25629,박정하(朴正河),이인선(李仁善),47,39,86,0
25630,박정하(朴正河),이인영(李仁榮),25,4,29,1
25631,박정하(朴正河),이장섭(李將燮),25,4,29,1
25632,박정하(朴正河),이재명(李在明),25,4,29,1
25633,박정하(朴正河),이재정(李在汀),25,4,29,1
25634,박정하(朴正河),이정문(李楨文),25,7,32,1
25635,박정하(朴正河),이종배(李鍾培),34,36,70,0
25636,박정하(朴正河),이종성(李鍾成),30,48,78,0
25637,박정하(朴正河),이주환(李周桓),34,27,61,0
25638,박정하(朴正河),이채익(李埰益),32,32,64,0
25639,박정하(朴正河),이철규(李喆圭),41,38,79,0
25640,박정하(朴正河),이탄희(李誕熙),25,4,29,1
25641,박정하(朴正河),이태규(李泰珪),35,39,74,0
25642,박정하(朴正河),이학영(李學永),25,4,29,1
25643,박정하(朴正河),이해식(李海植),25,4,29,1
25644,박정하(朴正河),이헌승(李憲昇),26,40,66,0
25645,박정하(朴正河),이형석(李炯錫),26,4,30,1
25646,박정하(朴正河),인재근(印在謹),26,5,31,1
25647,박정하(朴正河),임병헌(林炳憲),30,36,66,0
25648,박정하(朴正河),임오경(林五卿),25,4,29,1
25649,박정하(朴正河),임이자(林利子),28,24,52,0
25650,박정하(朴正河),임종성(林鍾聲),26,7,33,1
25651,박정하(朴正河),임호선(林昊宣),26,4,30,1
25652,박정하(朴正河),장경태(張耿態),25,4,29,1
25653,박정하(朴正河),장동혁(張東赫),31,40,71,0
25654,박정하(朴正河),장제원(張濟元),25,10,35,0
25655,박정하(朴正河),장철민(張喆敏),26,4,30,1
25656,박정하(朴正河),장혜영(張惠英),1,0,1,1
25657,박정하(朴正河),전봉민(田奉珉),27,30,57,0
25658,박정하(朴正河),전용기(田溶冀),25,4,29,1
25659,박정하(朴正河),전재수(田載秀),25,5,30,1
25660,박정하(朴正河),전주혜(全珠惠),32,30,62,0
25661,박정하(朴正河),전해철(全海澈),25,4,29,1
25662,박정하(朴正河),전혜숙(全惠淑),25,4,29,1
25663,박정하(朴正河),정경희(丁慶姬),31,28,59,0
25664,박정하(朴正河),정동만(鄭東萬),35,38,73,0
25665,박정하(朴正河),정성호(鄭成湖),28,6,34,1
25666,박정하(朴正河),정우택(鄭宇澤),34,53,87,0
25667,박정하(朴正河),정운천(鄭雲天),50,30,80,0
25668,박정하(朴正河),정일영(鄭日永),25,5,30,1
25669,박정하(朴正河),정점식(鄭点植),25,17,42,0
25670,박정하(朴正河),정진석(鄭鎭碩),27,17,44,0
25671,박정하(朴正河),정청래(鄭淸來),25,4,29,1
25672,박정하(朴正河),정춘숙(鄭春淑),25,5,30,1
25673,박정하(朴正河),정태호(鄭泰浩),25,4,29,1
25674,박정하(朴正河),정필모(鄭必模),25,4,29,1
25675,박정하(朴正河),정희용(鄭熙溶),29,35,64,0
25676,박정하(朴正河),조경태(趙慶泰),28,19,47,0
25677,박정하(朴正河),조명희(曺明姬),43,54,97,0
25678,박정하(朴正河),조수진(趙修眞),29,27,56,0
25679,박정하(朴正河),조승래(趙承來),25,4,29,1
25680,박정하(朴正河),조오섭(曺五燮),26,4,30,1
25681,박정하(朴正河),조은희(趙恩禧),50,82,132,0
25682,박정하(朴正河),조응천(趙應天),25,3,28,1
25683,박정하(朴正河),조정식(趙正湜),25,3,28,1
25684,박정하(朴正河),조정훈(趙廷訓),0,10,10,1
25685,박정하(朴正河),조해진(曺海珍),28,22,50,0
25686,박정하(朴正河),주철현(朱哲鉉),27,4,31,1
25687,박정하(朴正河),주호영(朱豪英),34,27,61,0
25688,박정하(朴正河),지성호(池成浩),38,59,97,0
25689,박정하(朴正河),진선미(陳善美),25,4,29,1
25690,박정하(朴正河),진성준(陳聲準),25,4,29,1
25691,박정하(朴正河),천준호(千俊鎬),25,3,28,1
25692,박정하(朴正河),최기상(崔基相),26,4,30,1
25693,박정하(朴正河),최승재(崔承宰),37,34,71,0
25694,박정하(朴正河),최연숙(崔姸淑),29,23,52,0
25695,박정하(朴正河),최영희(崔英姬),36,30,66,0
25696,박정하(朴正河),최인호(崔仁昊),26,4,30,1
25697,박정하(朴正河),최재형(崔在亨),27,21,48,0
25698,박정하(朴正河),최종윤(崔鍾允),26,4,30,1
25699,박정하(朴正河),최춘식(崔春植),30,30,60,0
25700,박정하(朴正河),최형두(崔炯斗),29,19,48,0
25701,박정하(朴正河),최혜영(崔惠英),25,4,29,1
25702,박정하(朴正河),추경호(秋慶鎬),25,8,33,0
25703,박정하(朴正河),태영호(太永浩),35,44,79,0
25704,박정하(朴正河),하영제(河榮帝),21,32,53,1
25705,박정하(朴正河),하태경(河泰慶),27,31,58,0
25706,박정하(朴正河),한기호(韓起鎬),35,22,57,0
25707,박정하(朴正河),한무경(韓茂景),40,65,105,0
25708,박정하(朴正河),한병도(韓秉道),26,4,30,1
25709,박정하(朴正河),한정애(韓貞愛),25,6,31,1
25710,박정하(朴正河),한준호(韓俊鎬),26,4,30,1
25711,박정하(朴正河),허숙정(許淑湞),0,0,0,1
25712,박정하(朴正河),허영(許榮),27,5,32,1
25713,박정하(朴正河),허은아(許垠娥),28,19,47,0
25714,박정하(朴正河),허종식(許琮植),25,8,33,1
25715,박정하(朴正河),홍기원(洪起元),25,4,29,1
25716,박정하(朴正河),홍문표(洪文杓),29,37,66,0
25717,박정하(朴正河),홍석준(洪碩晙),32,32,64,0
25718,박정하(朴正河),홍성국(洪性國),25,4,29,1
25719,박정하(朴正河),홍영표(洪永杓),25,4,29,1
25720,박정하(朴正河),홍익표(洪翼杓),26,4,30,1
25721,박정하(朴正河),홍정민(洪貞敏),26,4,30,1
25722,박정하(朴正河),황보승희(皇甫承希),27,32,59,1
25723,박정하(朴正河),황운하(黃雲夏),25,5,30,1
25724,박정하(朴正河),황희(黃熙),25,6,31,1
25725,박주민(朴柱民),박진(朴振),50,3,53,1
25726,박주민(朴柱民),박찬대(朴贊大),83,50,133,0
25727,박주민(朴柱民),박형수(朴亨修),49,4,53,1
25728,박주민(朴柱民),박홍근(朴洪根),90,88,178,0
25729,박주민(朴柱民),배준영(裵俊英),50,5,55,1
25730,박주민(朴柱民),배진교(裵晋敎),20,30,50,1
25731,박주민(朴柱民),배현진(裵賢鎭),49,4,53,1
25732,박주민(朴柱民),백종헌(白宗憲),50,4,54,1
25733,박주민(朴柱民),백혜련(白惠蓮),104,49,153,0
25734,박주민(朴柱民),변재일(卞在一),76,38,114,0
25735,박주민(朴柱民),서동용(徐東榕),90,64,154,0
25736,박주민(朴柱民),서범수(徐範洙),50,5,55,1
25737,박주민(朴柱民),서병수(徐秉洙),50,5,55,1
25738,박주민(朴柱民),서삼석(徐參錫),88,46,134,0
25739,박주민(朴柱民),서영교(徐瑛敎),88,81,169,0
25740,박주민(朴柱民),서영석(徐暎錫),86,73,159,0
25741,박주민(朴柱民),서일준(徐一俊),50,4,54,1
25742,박주민(朴柱民),서정숙(徐正淑),49,4,53,1
25743,박주민(朴柱民),설훈(薛勳),83,51,134,0
25744,박주민(朴柱民),성일종(成一鍾),50,4,54,1
25745,박주민(朴柱民),소병철(蘇秉哲),106,77,183,0
25746,박주민(朴柱民),소병훈(蘇秉勳),81,54,135,0
25747,박주민(朴柱民),송갑석(宋甲錫),81,64,145,0
25748,박주민(朴柱民),송기헌(宋基憲),103,49,152,0
25749,박주민(朴柱民),송석준(宋錫俊),49,4,53,1
25750,박주민(朴柱民),송언석(宋彦錫),45,4,49,1
25751,박주민(朴柱民),송옥주(宋玉珠),81,68,149,0
25752,박주민(朴柱民),송재호(宋在祜),89,69,158,0
25753,박주민(朴柱民),신동근(申東根),100,55,155,0
25754,박주민(朴柱民),신영대(申榮大),79,46,125,0
25755,박주민(朴柱民),신원식(申源湜),50,4,54,1
25756,박주민(朴柱民),신정훈(辛正勳),96,83,179,0
25757,박주민(朴柱民),신현영(申賢榮),82,55,137,0
25758,박주민(朴柱民),심상정(沈相奵),20,33,53,1
25759,박주민(朴柱民),안규백(安圭伯),83,54,137,0
25760,박주민(朴柱民),안민석(安敏錫),80,59,139,0
25761,박주민(朴柱民),안병길(安炳吉),50,4,54,1
25762,박주민(朴柱民),안철수(安哲秀),25,4,29,1
25763,박주민(朴柱民),안호영(安浩永),79,51,130,0
25764,박주민(朴柱民),양경숙(梁敬淑),85,68,153,0
25765,박주민(朴柱民),양금희(梁琴喜),50,5,55,1
25766,박주민(朴柱民),양기대(梁基大),80,48,128,0
25767,박주민(朴柱民),양이원영(梁李媛瑛),91,95,186,0
25768,박주민(朴柱民),양정숙(梁貞淑),24,77,101,1
25769,박주민(朴柱民),양향자(梁香子),37,31,68,1
25770,박주민(朴柱民),어기구(魚基龜),78,40,118,0
25771,박주민(朴柱民),엄태영(嚴泰永),51,4,55,1
25772,박주민(朴柱民),오기형(吳奇炯),78,49,127,0
25773,박주민(朴柱民),오영환(吳永煥),104,107,211,0
25774,박주민(朴柱民),용혜인(龍慧仁),21,68,89,1
25775,박주민(朴柱民),우상호(禹相虎),76,41,117,0
25776,박주민(朴柱民),우원식(禹元植),92,68,160,0
25777,박주민(朴柱民),위성곤(魏聖坤),85,91,176,0
25778,박주민(朴柱民),유경준(兪京濬),49,4,53,1
25779,박주민(朴柱民),유기홍(柳基洪),79,49,128,0
25780,박주민(朴柱民),유동수(柳東秀),78,38,116,0
25781,박주민(朴柱民),유상범(劉相凡),49,4,53,1
25782,박주민(朴柱民),유의동(兪義東),49,4,53,1
25783,박주민(朴柱民),유정주(兪訂炷),100,113,213,0
25784,박주민(朴柱民),윤건영(尹建永),81,86,167,0
25785,박주민(朴柱民),윤관석(尹官石),67,51,118,1
25786,박주민(朴柱民),윤두현(尹斗鉉),49,4,53,1
25787,박주민(朴柱民),윤미향(尹美香),43,89,132,1
25788,박주민(朴柱民),윤상현(尹相現),30,4,34,1
25789,박주민(朴柱民),윤영덕(尹永德),92,109,201,0
25790,박주민(朴柱民),윤영석(尹永碩),50,5,55,1
25791,박주민(朴柱民),윤영찬(尹永燦),82,53,135,0
25792,박주민(朴柱民),윤재갑(尹才鉀),96,83,179,0
25793,박주민(朴柱民),윤재옥(尹在玉),49,4,53,1
25794,박주민(朴柱民),윤주경(尹柱卿),49,4,53,1
25795,박주민(朴柱民),윤준병(尹準炳),87,107,194,0
25796,박주민(朴柱民),윤창현(尹暢賢),49,4,53,1
25797,박주민(朴柱民),윤한홍(尹漢洪),50,4,54,1
25798,박주민(朴柱民),윤호중(尹昊重),77,50,127,0
25799,박주민(朴柱民),윤후덕(尹厚德),76,50,126,0
25800,박주민(朴柱民),이개호(李介昊),79,42,121,0
25801,박주민(朴柱民),이달곤(李達坤),52,5,57,1
25802,박주민(朴柱民),이동주(李東洲),83,84,167,0
25803,박주민(朴柱民),이만희(李晩熙),49,4,53,1
25804,박주민(朴柱民),이명수(李明洙),50,8,58,1
25805,박주민(朴柱民),이병훈(李炳勳),88,70,158,0
25806,박주민(朴柱民),이상민(李相珉),76,37,113,0
25807,박주민(朴柱民),이상헌(李相憲),80,52,132,0
25808,박주민(朴柱民),이성만(李成萬),74,72,146,1
25809,박주민(朴柱民),이소영(李素永),88,63,151,0
25810,박주민(朴柱民),이수진(李壽珍),100,129,229,0
25811,박주민(朴柱民),이수진(李秀眞),96,74,170,0
25812,박주민(朴柱民),이양수(李亮壽),51,5,56,1
25813,박주민(朴柱民),이용(李鏞),49,4,53,1
25814,박주민(朴柱民),이용빈(李龍彬),101,115,216,0
25815,박주민(朴柱民),이용선(李庸瑄),90,61,151,0
25816,박주민(朴柱民),이용우(李龍雨),87,77,164,0
25817,박주민(朴柱民),이용호(李容鎬),30,8,38,1
25818,박주민(朴柱民),이원욱(李元旭),82,70,152,0
25819,박주민(朴柱民),이원택(李源澤),85,55,140,0
25820,박주민(朴柱民),이은주(李恩周),18,29,47,1
25821,박주민(朴柱民),이인선(李仁善),25,4,29,1
25822,박주민(朴柱民),이인영(李仁榮),75,41,116,0
25823,박주민(朴柱民),이장섭(李將燮),80,44,124,0
25824,박주민(朴柱民),이재명(李在明),40,25,65,0
25825,박주민(朴柱民),이재정(李在汀),93,78,171,0
25826,박주민(朴柱民),이정문(李楨文),83,61,144,0
25827,박주민(朴柱民),이종배(李鍾培),50,6,56,1
25828,박주민(朴柱民),이종성(李鍾成),49,4,53,1
25829,박주민(朴柱民),이주환(李周桓),49,4,53,1
25830,박주민(朴柱民),이채익(李埰益),51,5,56,1
25831,박주민(朴柱民),이철규(李喆圭),50,4,54,1
25832,박주민(朴柱民),이탄희(李誕熙),98,132,230,0
25833,박주민(朴柱民),이태규(李泰珪),30,6,36,1
25834,박주민(朴柱民),이학영(李學永),86,71,157,0
25835,박주민(朴柱民),이해식(李海植),85,61,146,0
25836,박주민(朴柱民),이헌승(李憲昇),50,4,54,1
25837,박주민(朴柱民),이형석(李炯錫),93,99,192,0
25838,박주민(朴柱民),인재근(印在謹),79,72,151,0
25839,박주민(朴柱民),임병헌(林炳憲),26,5,31,1
25840,박주민(朴柱民),임오경(林五卿),82,67,149,0
25841,박주민(朴柱民),임이자(林利子),49,4,53,1
25842,박주민(朴柱民),임종성(林鍾聲),87,66,153,0
25843,박주민(朴柱民),임호선(林昊宣),92,96,188,0
25844,박주민(朴柱民),장경태(張耿態),101,102,203,0
25845,박주민(朴柱民),장동혁(張東赫),25,4,29,1
25846,박주민(朴柱民),장제원(張濟元),49,4,53,1
25847,박주민(朴柱民),장철민(張喆敏),85,54,139,0
25848,박주민(朴柱民),장혜영(張惠英),18,30,48,1
25849,박주민(朴柱民),전봉민(田奉珉),35,5,40,1
25850,박주민(朴柱民),전용기(田溶冀),93,76,169,0
25851,박주민(朴柱民),전재수(田載秀),81,48,129,0
25852,박주민(朴柱民),전주혜(全珠惠),51,4,55,1
25853,박주민(朴柱民),전해철(全海澈),79,50,129,0
25854,박주민(朴柱民),전혜숙(全惠淑),90,54,144,0
25855,박주민(朴柱民),정경희(丁慶姬),49,4,53,1
25856,박주민(朴柱民),정동만(鄭東萬),49,4,53,1
25857,박주민(朴柱民),정성호(鄭成湖),83,52,135,0
25858,박주민(朴柱民),정우택(鄭宇澤),26,5,31,1
25859,박주민(朴柱民),정운천(鄭雲天),49,4,53,1
25860,박주민(朴柱民),정일영(鄭日永),83,77,160,0
25861,박주민(朴柱民),정점식(鄭点植),50,4,54,1
25862,박주민(朴柱民),정진석(鄭鎭碩),50,5,55,1
25863,박주민(朴柱民),정청래(鄭淸來),85,43,128,0
25864,박주민(朴柱民),정춘숙(鄭春淑),82,68,150,0
25865,박주민(朴柱民),정태호(鄭泰浩),82,65,147,0
25866,박주민(朴柱民),정필모(鄭必模),92,76,168,0
25867,박주민(朴柱民),정희용(鄭熙溶),50,5,55,1
25868,박주민(朴柱民),조경태(趙慶泰),49,4,53,1
25869,박주민(朴柱民),조명희(曺明姬),49,6,55,1
25870,박주민(朴柱民),조수진(趙修眞),49,4,53,1
25871,박주민(朴柱民),조승래(趙承來),85,52,137,0
25872,박주민(朴柱民),조오섭(曺五燮),91,87,178,0
25873,박주민(朴柱民),조은희(趙恩禧),25,4,29,1
25874,박주민(朴柱民),조응천(趙應天),72,32,104,0
25875,박주민(朴柱民),조정식(趙正湜),75,42,117,0
25876,박주민(朴柱民),조정훈(趙廷訓),2,11,13,1
25877,박주민(朴柱民),조해진(曺海珍),51,5,56,1
25878,박주민(朴柱民),주철현(朱哲鉉),89,62,151,0
25879,박주민(朴柱民),주호영(朱豪英),49,4,53,1
25880,박주민(朴柱民),지성호(池成浩),49,4,53,1
25881,박주민(朴柱民),진선미(陳善美),85,53,138,0
25882,박주민(朴柱民),진성준(陳聲準),95,79,174,0
25883,박주민(朴柱民),천준호(千俊鎬),89,56,145,0
25884,박주민(朴柱民),최기상(崔基相),102,91,193,0
25885,박주민(朴柱民),최승재(崔承宰),49,4,53,1
25886,박주민(朴柱民),최연숙(崔姸淑),34,7,41,1
25887,박주민(朴柱民),최영희(崔英姬),25,5,30,1
25888,박주민(朴柱民),최인호(崔仁昊),80,62,142,0
25889,박주민(朴柱民),최재형(崔在亨),25,4,29,1
25890,박주민(朴柱民),최종윤(崔鍾允),82,67,149,0
25891,박주민(朴柱民),최춘식(崔春植),49,5,54,1
25892,박주민(朴柱民),최형두(崔炯斗),50,6,56,1
25893,박주민(朴柱民),최혜영(崔惠英),103,135,238,0
25894,박주민(朴柱民),추경호(秋慶鎬),49,3,52,1
25895,박주민(朴柱民),태영호(太永浩),49,5,54,1
25896,박주민(朴柱民),하영제(河榮帝),41,3,44,1
25897,박주민(朴柱民),하태경(河泰慶),50,5,55,1
25898,박주민(朴柱民),한기호(韓起鎬),50,4,54,1
25899,박주민(朴柱民),한무경(韓茂景),49,4,53,1
25900,박주민(朴柱民),한병도(韓秉道),83,50,133,0
25901,박주민(朴柱民),한정애(韓貞愛),75,49,124,0
25902,박주민(朴柱民),한준호(韓俊鎬),90,81,171,0
25903,박주민(朴柱民),허숙정(許淑湞),1,2,3,0
25904,박주민(朴柱民),허영(許榮),94,70,164,0
25905,박주민(朴柱民),허은아(許垠娥),49,4,53,1
25906,박주민(朴柱民),허종식(許琮植),86,64,150,0
25907,박주민(朴柱民),홍기원(洪起元),89,66,155,0
25908,박주민(朴柱民),홍문표(洪文杓),50,5,55,1
25909,박주민(朴柱民),홍석준(洪碩晙),50,4,54,1
25910,박주민(朴柱民),홍성국(洪性國),85,59,144,0
25911,박주민(朴柱民),홍영표(洪永杓),83,51,134,0
25912,박주민(朴柱民),홍익표(洪翼杓),83,64,147,0
25913,박주민(朴柱民),홍정민(洪貞敏),95,102,197,0
25914,박주민(朴柱民),황보승희(皇甫承希),46,1,47,1
25915,박주민(朴柱民),황운하(黃雲夏),91,93,184,0
25916,박주민(朴柱民),황희(黃熙),76,41,117,0
25917,박진(朴振),박찬대(朴贊大),51,4,55,1
25918,박진(朴振),박형수(朴亨修),63,45,108,0
25919,박진(朴振),박홍근(朴洪根),50,3,53,1
25920,박진(朴振),배준영(裵俊英),76,79,155,0
25921,박진(朴振),배진교(裵晋敎),5,3,8,1
25922,박진(朴振),배현진(裵賢鎭),68,60,128,0
25923,박진(朴振),백종헌(白宗憲),78,103,181,0
25924,박진(朴振),백혜련(白惠蓮),52,5,57,1
25925,박진(朴振),변재일(卞在一),51,4,55,1
25926,박진(朴振),서동용(徐東榕),50,3,53,1
25927,박진(朴振),서범수(徐範洙),73,67,140,0
25928,박진(朴振),서병수(徐秉洙),74,80,154,0
25929,박진(朴振),서삼석(徐參錫),50,3,53,1
25930,박진(朴振),서영교(徐瑛敎),51,4,55,1
25931,박진(朴振),서영석(徐暎錫),51,7,58,1
25932,박진(朴振),서일준(徐一俊),95,124,219,0
25933,박진(朴振),서정숙(徐正淑),68,70,138,0
25934,박진(朴振),설훈(薛勳),50,5,55,1
25935,박진(朴振),성일종(成一鍾),84,99,183,0
25936,박진(朴振),소병철(蘇秉哲),50,4,54,1
25937,박진(朴振),소병훈(蘇秉勳),51,4,55,1
25938,박진(朴振),송갑석(宋甲錫),50,4,54,1
25939,박진(朴振),송기헌(宋基憲),50,5,55,1
25940,박진(朴振),송석준(宋錫俊),72,66,138,0
25941,박진(朴振),송언석(宋彦錫),68,60,128,0
25942,박진(朴振),송옥주(宋玉珠),50,4,54,1
25943,박진(朴振),송재호(宋在祜),50,5,55,1
25944,박진(朴振),신동근(申東根),50,3,53,1
25945,박진(朴振),신영대(申榮大),50,3,53,1
25946,박진(朴振),신원식(申源湜),77,102,179,0
25947,박진(朴振),신정훈(辛正勳),51,5,56,1
25948,박진(朴振),신현영(申賢榮),49,3,52,1
25949,박진(朴振),심상정(沈相奵),5,3,8,1
25950,박진(朴振),안규백(安圭伯),50,5,55,1
25951,박진(朴振),안민석(安敏錫),51,3,54,1
25952,박진(朴振),안병길(安炳吉),71,76,147,0
25953,박진(朴振),안철수(安哲秀),26,22,48,0
25954,박진(朴振),안호영(安浩永),50,6,56,1
25955,박진(朴振),양경숙(梁敬淑),50,4,54,1
25956,박진(朴振),양금희(梁琴喜),95,121,216,0
25957,박진(朴振),양기대(梁基大),51,3,54,1
25958,박진(朴振),양이원영(梁李媛瑛),45,4,49,1
25959,박진(朴振),양정숙(梁貞淑),1,2,3,1
25960,박진(朴振),양향자(梁香子),22,1,23,1
25961,박진(朴振),어기구(魚基龜),50,4,54,1
25962,박진(朴振),엄태영(嚴泰永),71,70,141,0
25963,박진(朴振),오기형(吳奇炯),49,4,53,1
25964,박진(朴振),오영환(吳永煥),50,5,55,1
25965,박진(朴振),용혜인(龍慧仁),1,2,3,1
25966,박진(朴振),우상호(禹相虎),50,3,53,1
25967,박진(朴振),우원식(禹元植),49,4,53,1
25968,박진(朴振),위성곤(魏聖坤),51,6,57,1
25969,박진(朴振),유경준(兪京濬),83,82,165,0
25970,박진(朴振),유기홍(柳基洪),50,3,53,1
25971,박진(朴振),유동수(柳東秀),52,5,57,1
25972,박진(朴振),유상범(劉相凡),64,52,116,0
25973,박진(朴振),유의동(兪義東),61,43,104,0
25974,박진(朴振),유정주(兪訂炷),50,5,55,1
25975,박진(朴振),윤건영(尹建永),49,5,54,1
25976,박진(朴振),윤관석(尹官石),41,1,42,1
25977,박진(朴振),윤두현(尹斗鉉),69,86,155,0
25978,박진(朴振),윤미향(尹美香),20,1,21,1
25979,박진(朴振),윤상현(尹相現),37,29,66,0
25980,박진(朴振),윤영덕(尹永德),49,5,54,1
25981,박진(朴振),윤영석(尹永碩),64,44,108,0
25982,박진(朴振),윤영찬(尹永燦),50,5,55,1
25983,박진(朴振),윤재갑(尹才鉀),53,8,61,1
25984,박진(朴振),윤재옥(尹在玉),64,59,123,0
25985,박진(朴振),윤주경(尹柱卿),68,73,141,0
25986,박진(朴振),윤준병(尹準炳),51,4,55,1
25987,박진(朴振),윤창현(尹暢賢),71,68,139,0
25988,박진(朴振),윤한홍(尹漢洪),75,88,163,0
25989,박진(朴振),윤호중(尹昊重),50,5,55,1
25990,박진(朴振),윤후덕(尹厚德),50,4,54,1
25991,박진(朴振),이개호(李介昊),50,4,54,1
25992,박진(朴振),이달곤(李達坤),64,51,115,0
25993,박진(朴振),이동주(李東洲),49,4,53,1
25994,박진(朴振),이만희(李晩熙),72,64,136,0
25995,박진(朴振),이명수(李明洙),76,90,166,0
25996,박진(朴振),이병훈(李炳勳),52,7,59,1
25997,박진(朴振),이상민(李相珉),50,4,54,1
25998,박진(朴振),이상헌(李相憲),51,5,56,1
25999,박진(朴振),이성만(李成萬),41,1,42,1
26000,박진(朴振),이소영(李素永),50,6,56,1
26001,박진(朴振),이수진(李壽珍),50,4,54,1
26002,박진(朴振),이수진(李秀眞),50,6,56,1
26003,박진(朴振),이양수(李亮壽),72,81,153,0
26004,박진(朴振),이용(李鏞),83,95,178,0
26005,박진(朴振),이용빈(李龍彬),51,7,58,1
26006,박진(朴振),이용선(李庸瑄),50,5,55,1
26007,박진(朴振),이용우(李龍雨),49,5,54,1
26008,박진(朴振),이용호(李容鎬),28,20,48,0
26009,박진(朴振),이원욱(李元旭),50,5,55,1
26010,박진(朴振),이원택(李源澤),50,4,54,1
26011,박진(朴振),이은주(李恩周),5,3,8,1
26012,박진(朴振),이인선(李仁善),28,22,50,0
26013,박진(朴振),이인영(李仁榮),50,3,53,1
26014,박진(朴振),이장섭(李將燮),50,3,53,1
26015,박진(朴振),이재명(李在明),25,3,28,1
26016,박진(朴振),이재정(李在汀),50,5,55,1
26017,박진(朴振),이정문(李楨文),50,3,53,1
26018,박진(朴振),이종배(李鍾培),76,68,144,0
26019,박진(朴振),이종성(李鍾成),76,90,166,0
26020,박진(朴振),이주환(李周桓),86,90,176,0
26021,박진(朴振),이채익(李埰益),73,81,154,0
26022,박진(朴振),이철규(李喆圭),70,59,129,0
26023,박진(朴振),이탄희(李誕熙),50,5,55,1
26024,박진(朴振),이태규(李泰珪),37,40,77,0
26025,박진(朴振),이학영(李學永),49,5,54,1
26026,박진(朴振),이해식(李海植),51,5,56,1
26027,박진(朴振),이헌승(李憲昇),68,77,145,0
26028,박진(朴振),이형석(李炯錫),49,5,54,1
26029,박진(朴振),인재근(印在謹),49,6,55,1
26030,박진(朴振),임병헌(林炳憲),26,16,42,0
26031,박진(朴振),임오경(林五卿),50,6,56,1
26032,박진(朴振),임이자(林利子),73,80,153,0
26033,박진(朴振),임종성(林鍾聲),50,5,55,1
26034,박진(朴振),임호선(林昊宣),50,3,53,1
26035,박진(朴振),장경태(張耿態),50,4,54,1
26036,박진(朴振),장동혁(張東赫),26,10,36,0
26037,박진(朴振),장제원(張濟元),61,29,90,0
26038,박진(朴振),장철민(張喆敏),50,5,55,1
26039,박진(朴振),장혜영(張惠英),6,4,10,1
26040,박진(朴振),전봉민(田奉珉),51,48,99,0
26041,박진(朴振),전용기(田溶冀),50,4,54,1
26042,박진(朴振),전재수(田載秀),50,5,55,1
26043,박진(朴振),전주혜(全珠惠),68,66,134,0
26044,박진(朴振),전해철(全海澈),50,3,53,1
26045,박진(朴振),전혜숙(全惠淑),50,9,59,1
26046,박진(朴振),정경희(丁慶姬),68,83,151,0
26047,박진(朴振),정동만(鄭東萬),68,51,119,0
26048,박진(朴振),정성호(鄭成湖),51,6,57,1
26049,박진(朴振),정우택(鄭宇澤),33,53,86,0
26050,박진(朴振),정운천(鄭雲天),68,67,135,0
26051,박진(朴振),정일영(鄭日永),50,6,56,1
26052,박진(朴振),정점식(鄭点植),64,44,108,0
26053,박진(朴振),정진석(鄭鎭碩),74,80,154,0
26054,박진(朴振),정청래(鄭淸來),49,4,53,1
26055,박진(朴振),정춘숙(鄭春淑),50,4,54,1
26056,박진(朴振),정태호(鄭泰浩),50,3,53,1
26057,박진(朴振),정필모(鄭必模),50,4,54,1
26058,박진(朴振),정희용(鄭熙溶),75,75,150,0
26059,박진(朴振),조경태(趙慶泰),71,62,133,0
26060,박진(朴振),조명희(曺明姬),98,145,243,0
26061,박진(朴振),조수진(趙修眞),70,77,147,0
26062,박진(朴振),조승래(趙承來),51,5,56,1
26063,박진(朴振),조오섭(曺五燮),50,7,57,1
26064,박진(朴振),조은희(趙恩禧),28,26,54,0
26065,박진(朴振),조응천(趙應天),52,6,58,1
26066,박진(朴振),조정식(趙正湜),49,4,53,1
26067,박진(朴振),조정훈(趙廷訓),0,3,3,1
26068,박진(朴振),조해진(曺海珍),63,35,98,0
26069,박진(朴振),주철현(朱哲鉉),50,4,54,1
26070,박진(朴振),주호영(朱豪英),63,69,132,0
26071,박진(朴振),지성호(池成浩),86,114,200,0
26072,박진(朴振),진선미(陳善美),50,4,54,1
26073,박진(朴振),진성준(陳聲準),52,3,55,1
26074,박진(朴振),천준호(千俊鎬),49,3,52,1
26075,박진(朴振),최기상(崔基相),49,4,53,1
26076,박진(朴振),최승재(崔承宰),72,70,142,0
26077,박진(朴振),최연숙(崔姸淑),33,28,61,0
26078,박진(朴振),최영희(崔英姬),27,31,58,0
26079,박진(朴振),최인호(崔仁昊),51,4,55,1
26080,박진(朴振),최재형(崔在亨),26,11,37,0
26081,박진(朴振),최종윤(崔鍾允),50,3,53,1
26082,박진(朴振),최춘식(崔春植),71,63,134,0
26083,박진(朴振),최형두(崔炯斗),82,92,174,0
26084,박진(朴振),최혜영(崔惠英),50,4,54,1
26085,박진(朴振),추경호(秋慶鎬),93,103,196,0
26086,박진(朴振),태영호(太永浩),93,135,228,0
26087,박진(朴振),하영제(河榮帝),84,104,188,1
26088,박진(朴振),하태경(河泰慶),64,52,116,0
26089,박진(朴振),한기호(韓起鎬),64,55,119,0
26090,박진(朴振),한무경(韓茂景),74,109,183,0
26091,박진(朴振),한병도(韓秉道),49,6,55,1
26092,박진(朴振),한정애(韓貞愛),50,4,54,1
26093,박진(朴振),한준호(韓俊鎬),50,5,55,1
26094,박진(朴振),허숙정(許淑湞),0,0,0,1
26095,박진(朴振),허영(許榮),50,6,56,1
26096,박진(朴振),허은아(許垠娥),72,50,122,0
26097,박진(朴振),허종식(許琮植),51,5,56,1
26098,박진(朴振),홍기원(洪起元),50,5,55,1
26099,박진(朴振),홍문표(洪文杓),92,120,212,0
26100,박진(朴振),홍석준(洪碩晙),65,48,113,0
26101,박진(朴振),홍성국(洪性國),50,6,56,1
26102,박진(朴振),홍영표(洪永杓),50,4,54,1
26103,박진(朴振),홍익표(洪翼杓),50,4,54,1
26104,박진(朴振),홍정민(洪貞敏),50,6,56,1
26105,박진(朴振),황보승희(皇甫承希),71,95,166,1
26106,박진(朴振),황운하(黃雲夏),50,4,54,1
26107,박진(朴振),황희(黃熙),49,4,53,1
26108,박찬대(朴贊大),박형수(朴亨修),49,4,53,1
26109,박찬대(朴贊大),박홍근(朴洪根),93,81,174,0
26110,박찬대(朴贊大),배준영(裵俊英),55,18,73,1
26111,박찬대(朴贊大),배진교(裵晋敎),25,50,75,1
26112,박찬대(朴贊大),배현진(裵賢鎭),49,5,54,1
26113,박찬대(朴贊大),백종헌(白宗憲),50,5,55,1
26114,박찬대(朴贊大),백혜련(白惠蓮),84,56,140,0
26115,박찬대(朴贊大),변재일(卞在一),78,51,129,0
26116,박찬대(朴贊大),서동용(徐東榕),106,113,219,0
26117,박찬대(朴贊大),서범수(徐範洙),51,4,55,1
26118,박찬대(朴贊大),서병수(徐秉洙),50,5,55,1
26119,박찬대(朴贊大),서삼석(徐參錫),116,138,254,0
26120,박찬대(朴贊大),서영교(徐瑛敎),95,85,180,0
26121,박찬대(朴贊大),서영석(徐暎錫),89,86,175,0
26122,박찬대(朴贊大),서일준(徐一俊),51,7,58,1
26123,박찬대(朴贊大),서정숙(徐正淑),49,5,54,1
26124,박찬대(朴贊大),설훈(薛勳),80,49,129,0
26125,박찬대(朴贊大),성일종(成一鍾),50,5,55,1
26126,박찬대(朴贊大),소병철(蘇秉哲),81,53,134,0
26127,박찬대(朴贊大),소병훈(蘇秉勳),90,54,144,0
26128,박찬대(朴贊大),송갑석(宋甲錫),99,118,217,0
26129,박찬대(朴贊大),송기헌(宋基憲),85,49,134,0
26130,박찬대(朴贊大),송석준(宋錫俊),50,5,55,1
26131,박찬대(朴贊大),송언석(宋彦錫),45,4,49,1
26132,박찬대(朴贊大),송옥주(宋玉珠),109,146,255,0
26133,박찬대(朴贊大),송재호(宋在祜),93,79,172,0
26134,박찬대(朴贊大),신동근(申東根),117,87,204,0
26135,박찬대(朴贊大),신영대(申榮大),89,65,154,0
26136,박찬대(朴贊大),신원식(申源湜),50,4,54,1
26137,박찬대(朴贊大),신정훈(辛正勳),91,105,196,0
26138,박찬대(朴贊大),신현영(申賢榮),80,53,133,0
26139,박찬대(朴贊大),심상정(沈相奵),14,41,55,1
26140,박찬대(朴贊大),안규백(安圭伯),82,71,153,0
26141,박찬대(朴贊大),안민석(安敏錫),92,68,160,0
26142,박찬대(朴贊大),안병길(安炳吉),50,4,54,1
26143,박찬대(朴贊大),안철수(安哲秀),25,4,29,1
26144,박찬대(朴贊大),안호영(安浩永),97,96,193,0
26145,박찬대(朴贊大),양경숙(梁敬淑),93,59,152,0
26146,박찬대(朴贊大),양금희(梁琴喜),51,6,57,1
26147,박찬대(朴贊大),양기대(梁基大),92,50,142,0
26148,박찬대(朴贊大),양이원영(梁李媛瑛),81,68,149,0
26149,박찬대(朴贊大),양정숙(梁貞淑),31,84,115,1
26150,박찬대(朴贊大),양향자(梁香子),45,27,72,1
26151,박찬대(朴贊大),어기구(魚基龜),97,74,171,0
26152,박찬대(朴贊大),엄태영(嚴泰永),51,4,55,1
26153,박찬대(朴贊大),오기형(吳奇炯),81,46,127,0
26154,박찬대(朴贊大),오영환(吳永煥),109,99,208,0
26155,박찬대(朴贊大),용혜인(龍慧仁),11,34,45,1
26156,박찬대(朴贊大),우상호(禹相虎),77,37,114,0
26157,박찬대(朴贊大),우원식(禹元植),93,54,147,0
26158,박찬대(朴贊大),위성곤(魏聖坤),90,78,168,0
26159,박찬대(朴贊大),유경준(兪京濬),49,4,53,1
26160,박찬대(朴贊大),유기홍(柳基洪),96,66,162,0
26161,박찬대(朴贊大),유동수(柳東秀),144,190,334,0
26162,박찬대(朴贊大),유상범(劉相凡),49,4,53,1
26163,박찬대(朴贊大),유의동(兪義東),49,4,53,1
26164,박찬대(朴贊大),유정주(兪訂炷),99,115,214,0
26165,박찬대(朴贊大),윤건영(尹建永),81,54,135,0
26166,박찬대(朴贊大),윤관석(尹官石),98,83,181,1
26167,박찬대(朴贊大),윤두현(尹斗鉉),49,5,54,1
26168,박찬대(朴贊大),윤미향(尹美香),38,50,88,1
26169,박찬대(朴贊大),윤상현(尹相現),34,11,45,1
26170,박찬대(朴贊大),윤영덕(尹永德),112,125,237,0
26171,박찬대(朴贊大),윤영석(尹永碩),51,4,55,1
26172,박찬대(朴贊大),윤영찬(尹永燦),81,55,136,0
26173,박찬대(朴贊大),윤재갑(尹才鉀),93,63,156,0
26174,박찬대(朴贊大),윤재옥(尹在玉),50,4,54,1
26175,박찬대(朴贊大),윤주경(尹柱卿),49,5,54,1
26176,박찬대(朴贊大),윤준병(尹準炳),97,94,191,0
26177,박찬대(朴贊大),윤창현(尹暢賢),50,6,56,1
26178,박찬대(朴贊大),윤한홍(尹漢洪),51,4,55,1
26179,박찬대(朴贊大),윤호중(尹昊重),79,53,132,0
26180,박찬대(朴贊大),윤후덕(尹厚德),89,60,149,0
26181,박찬대(朴贊大),이개호(李介昊),85,49,134,0
26182,박찬대(朴贊大),이달곤(李達坤),52,6,58,1
26183,박찬대(朴贊大),이동주(李東洲),98,112,210,0
26184,박찬대(朴贊大),이만희(李晩熙),50,4,54,1
26185,박찬대(朴贊大),이명수(李明洙),50,10,60,1
26186,박찬대(朴贊大),이병훈(李炳勳),101,87,188,0
26187,박찬대(朴贊大),이상민(李相珉),73,38,111,0
26188,박찬대(朴贊大),이상헌(李相憲),90,65,155,0
26189,박찬대(朴贊大),이성만(李成萬),125,160,285,1
26190,박찬대(朴贊大),이소영(李素永),84,48,132,0
26191,박찬대(朴贊大),이수진(李壽珍),102,91,193,0
26192,박찬대(朴贊大),이수진(李秀眞),94,86,180,0
26193,박찬대(朴贊大),이양수(李亮壽),51,5,56,1
26194,박찬대(朴贊大),이용(李鏞),49,4,53,1
26195,박찬대(朴贊大),이용빈(李龍彬),103,123,226,0
26196,박찬대(朴贊大),이용선(李庸瑄),97,62,159,0
26197,박찬대(朴贊大),이용우(李龍雨),96,65,161,0
26198,박찬대(朴贊大),이용호(李容鎬),29,15,44,1
26199,박찬대(朴贊大),이원욱(李元旭),82,65,147,0
26200,박찬대(朴贊大),이원택(李源澤),76,51,127,0
26201,박찬대(朴贊大),이은주(李恩周),15,25,40,1
26202,박찬대(朴贊大),이인선(李仁善),25,4,29,1
26203,박찬대(朴贊大),이인영(李仁榮),76,63,139,0
26204,박찬대(朴贊大),이장섭(李將燮),85,51,136,0
26205,박찬대(朴贊大),이재명(李在明),40,23,63,0
26206,박찬대(朴贊大),이재정(李在汀),79,50,129,0
26207,박찬대(朴贊大),이정문(李楨文),100,100,200,0
26208,박찬대(朴贊大),이종배(李鍾培),50,6,56,1
26209,박찬대(朴贊大),이종성(李鍾成),49,5,54,1
26210,박찬대(朴贊大),이주환(李周桓),50,5,55,1
26211,박찬대(朴贊大),이채익(李埰益),51,6,57,1
26212,박찬대(朴贊大),이철규(李喆圭),52,5,57,1
26213,박찬대(朴贊大),이탄희(李誕熙),97,71,168,0
26214,박찬대(朴贊大),이태규(李泰珪),29,5,34,1
26215,박찬대(朴贊大),이학영(李學永),93,73,166,0
26216,박찬대(朴贊大),이해식(李海植),96,58,154,0
26217,박찬대(朴贊大),이헌승(李憲昇),50,4,54,1
26218,박찬대(朴贊大),이형석(李炯錫),87,81,168,0
26219,박찬대(朴贊大),인재근(印在謹),86,78,164,0
26220,박찬대(朴贊大),임병헌(林炳憲),25,4,29,1
26221,박찬대(朴贊大),임오경(林五卿),86,69,155,0
26222,박찬대(朴贊大),임이자(林利子),49,4,53,1
26223,박찬대(朴贊大),임종성(林鍾聲),116,148,264,0
26224,박찬대(朴贊大),임호선(林昊宣),94,97,191,0
26225,박찬대(朴贊大),장경태(張耿態),94,105,199,0
26226,박찬대(朴贊大),장동혁(張東赫),25,4,29,1
26227,박찬대(朴贊大),장제원(張濟元),49,4,53,1
26228,박찬대(朴贊大),장철민(張喆敏),88,71,159,0
26229,박찬대(朴贊大),장혜영(張惠英),17,22,39,1
26230,박찬대(朴贊大),전봉민(田奉珉),35,5,40,1
26231,박찬대(朴贊大),전용기(田溶冀),88,72,160,0
26232,박찬대(朴贊大),전재수(田載秀),84,63,147,0
26233,박찬대(朴贊大),전주혜(全珠惠),51,5,56,1
26234,박찬대(朴贊大),전해철(全海澈),74,52,126,0
26235,박찬대(朴贊大),전혜숙(全惠淑),82,53,135,0
26236,박찬대(朴贊大),정경희(丁慶姬),50,5,55,1
26237,박찬대(朴贊大),정동만(鄭東萬),50,4,54,1
26238,박찬대(朴贊大),정성호(鄭成湖),83,69,152,0
26239,박찬대(朴贊大),정우택(鄭宇澤),25,4,29,1
26240,박찬대(朴贊大),정운천(鄭雲天),50,5,55,1
26241,박찬대(朴贊大),정일영(鄭日永),128,140,268,0
26242,박찬대(朴贊大),정점식(鄭点植),50,4,54,1
26243,박찬대(朴贊大),정진석(鄭鎭碩),50,6,56,1
26244,박찬대(朴贊大),정청래(鄭淸來),89,57,146,0
26245,박찬대(朴贊大),정춘숙(鄭春淑),116,139,255,0
26246,박찬대(朴贊大),정태호(鄭泰浩),88,67,155,0
26247,박찬대(朴贊大),정필모(鄭必模),81,70,151,0
26248,박찬대(朴贊大),정희용(鄭熙溶),51,6,57,1
26249,박찬대(朴贊大),조경태(趙慶泰),49,4,53,1
26250,박찬대(朴贊大),조명희(曺明姬),50,6,56,1
26251,박찬대(朴贊大),조수진(趙修眞),50,4,54,1
26252,박찬대(朴贊大),조승래(趙承來),99,79,178,0
26253,박찬대(朴贊大),조오섭(曺五燮),91,105,196,0
26254,박찬대(朴贊大),조은희(趙恩禧),25,4,29,1
26255,박찬대(朴贊大),조응천(趙應天),86,45,131,0
26256,박찬대(朴贊大),조정식(趙正湜),77,36,113,0
26257,박찬대(朴贊大),조정훈(趙廷訓),0,7,7,1
26258,박찬대(朴贊大),조해진(曺海珍),52,7,59,1
26259,박찬대(朴贊大),주철현(朱哲鉉),90,63,153,0
26260,박찬대(朴贊大),주호영(朱豪英),49,4,53,1
26261,박찬대(朴贊大),지성호(池成浩),49,4,53,1
26262,박찬대(朴贊大),진선미(陳善美),79,44,123,0
26263,박찬대(朴贊大),진성준(陳聲準),96,58,154,0
26264,박찬대(朴贊大),천준호(千俊鎬),97,61,158,0
26265,박찬대(朴贊大),최기상(崔基相),86,74,160,0
26266,박찬대(朴贊大),최승재(崔承宰),49,5,54,1
26267,박찬대(朴贊大),최연숙(崔姸淑),30,8,38,1
26268,박찬대(朴贊大),최영희(崔英姬),25,4,29,1
26269,박찬대(朴贊大),최인호(崔仁昊),83,67,150,0
26270,박찬대(朴贊大),최재형(崔在亨),25,4,29,1
26271,박찬대(朴贊大),최종윤(崔鍾允),100,99,199,0
26272,박찬대(朴贊大),최춘식(崔春植),50,5,55,1
26273,박찬대(朴贊大),최형두(崔炯斗),50,8,58,1
26274,박찬대(朴贊大),최혜영(崔惠英),92,81,173,0
26275,박찬대(朴贊大),추경호(秋慶鎬),50,3,53,1
26276,박찬대(朴贊大),태영호(太永浩),49,6,55,1
26277,박찬대(朴贊大),하영제(河榮帝),42,1,43,1
26278,박찬대(朴贊大),하태경(河泰慶),50,6,56,1
26279,박찬대(朴贊大),한기호(韓起鎬),50,4,54,1
26280,박찬대(朴贊大),한무경(韓茂景),49,6,55,1
26281,박찬대(朴贊大),한병도(韓秉道),87,82,169,0
26282,박찬대(朴贊大),한정애(韓貞愛),79,56,135,0
26283,박찬대(朴贊大),한준호(韓俊鎬),88,93,181,0
26284,박찬대(朴贊大),허숙정(許淑湞),1,1,2,0
26285,박찬대(朴贊大),허영(許榮),95,94,189,0
26286,박찬대(朴贊大),허은아(許垠娥),49,5,54,1
26287,박찬대(朴贊大),허종식(許琮植),149,178,327,0
26288,박찬대(朴贊大),홍기원(洪起元),99,64,163,0
26289,박찬대(朴贊大),홍문표(洪文杓),51,5,56,1
26290,박찬대(朴贊大),홍석준(洪碩晙),50,4,54,1
26291,박찬대(朴贊大),홍성국(洪性國),93,77,170,0
26292,박찬대(朴贊大),홍영표(洪永杓),93,88,181,0
26293,박찬대(朴贊大),홍익표(洪翼杓),78,51,129,0
26294,박찬대(朴贊大),홍정민(洪貞敏),100,90,190,0
26295,박찬대(朴贊大),황보승희(皇甫承希),45,3,48,1
26296,박찬대(朴贊大),황운하(黃雲夏),102,90,192,0
26297,박찬대(朴贊大),황희(黃熙),79,36,115,0
26298,박형수(朴亨修),박홍근(朴洪根),49,4,53,1
26299,박형수(朴亨修),배준영(裵俊英),66,44,110,0
26300,박형수(朴亨修),배진교(裵晋敎),4,2,6,1
26301,박형수(朴亨修),배현진(裵賢鎭),64,39,103,0
26302,박형수(朴亨修),백종헌(白宗憲),63,60,123,0
26303,박형수(朴亨修),백혜련(白惠蓮),49,4,53,1
26304,박형수(朴亨修),변재일(卞在一),49,4,53,1
26305,박형수(朴亨修),서동용(徐東榕),49,4,53,1
26306,박형수(朴亨修),서범수(徐範洙),70,68,138,0
26307,박형수(朴亨修),서병수(徐秉洙),73,70,143,0
26308,박형수(朴亨修),서삼석(徐參錫),49,4,53,1
26309,박형수(朴亨修),서영교(徐瑛敎),50,4,54,1
26310,박형수(朴亨修),서영석(徐暎錫),49,5,54,1
26311,박형수(朴亨修),서일준(徐一俊),77,83,160,0
26312,박형수(朴亨修),서정숙(徐正淑),75,50,125,0
26313,박형수(朴亨修),설훈(薛勳),50,7,57,1
26314,박형수(朴亨修),성일종(成一鍾),68,70,138,0
26315,박형수(朴亨修),소병철(蘇秉哲),50,4,54,1
26316,박형수(朴亨修),소병훈(蘇秉勳),49,5,54,1
26317,박형수(朴亨修),송갑석(宋甲錫),49,4,53,1
26318,박형수(朴亨修),송기헌(宋基憲),49,5,54,1
26319,박형수(朴亨修),송석준(宋錫俊),68,54,122,0
26320,박형수(朴亨修),송언석(宋彦錫),63,46,109,0
26321,박형수(朴亨修),송옥주(宋玉珠),49,3,52,1
26322,박형수(朴亨修),송재호(宋在祜),49,6,55,1
26323,박형수(朴亨修),신동근(申東根),49,4,53,1
26324,박형수(朴亨修),신영대(申榮大),49,4,53,1
26325,박형수(朴亨修),신원식(申源湜),66,50,116,0
26326,박형수(朴亨修),신정훈(辛正勳),50,4,54,1
26327,박형수(朴亨修),신현영(申賢榮),49,4,53,1
26328,박형수(朴亨修),심상정(沈相奵),4,2,6,1
26329,박형수(朴亨修),안규백(安圭伯),51,8,59,1
26330,박형수(朴亨修),안민석(安敏錫),50,3,53,1
26331,박형수(朴亨修),안병길(安炳吉),62,49,111,0
26332,박형수(朴亨修),안철수(安哲秀),30,11,41,0
26333,박형수(朴亨修),안호영(安浩永),49,5,54,1
26334,박형수(朴亨修),양경숙(梁敬淑),49,5,54,1
26335,박형수(朴亨修),양금희(梁琴喜),70,94,164,0
26336,박형수(朴亨修),양기대(梁基大),49,4,53,1
26337,박형수(朴亨修),양이원영(梁李媛瑛),45,4,49,1
26338,박형수(朴亨修),양정숙(梁貞淑),2,4,6,1
26339,박형수(朴亨修),양향자(梁香子),22,2,24,1
26340,박형수(朴亨修),어기구(魚基龜),49,5,54,1
26341,박형수(朴亨修),엄태영(嚴泰永),66,76,142,0
26342,박형수(朴亨修),오기형(吳奇炯),49,4,53,1
26343,박형수(朴亨修),오영환(吳永煥),49,6,55,1
26344,박형수(朴亨修),용혜인(龍慧仁),1,1,2,1
26345,박형수(朴亨修),우상호(禹相虎),49,4,53,1
26346,박형수(朴亨修),우원식(禹元植),49,4,53,1
26347,박형수(朴亨修),위성곤(魏聖坤),49,5,54,1
26348,박형수(朴亨修),유경준(兪京濬),65,62,127,0
26349,박형수(朴亨修),유기홍(柳基洪),49,4,53,1
26350,박형수(朴亨修),유동수(柳東秀),49,5,54,1
26351,박형수(朴亨修),유상범(劉相凡),67,91,158,0
26352,박형수(朴亨修),유의동(兪義東),61,45,106,0
26353,박형수(朴亨修),유정주(兪訂炷),50,5,55,1
26354,박형수(朴亨修),윤건영(尹建永),49,3,52,1
26355,박형수(朴亨修),윤관석(尹官石),40,1,41,1
26356,박형수(朴亨修),윤두현(尹斗鉉),72,69,141,0
26357,박형수(朴亨修),윤미향(尹美香),20,0,20,1
26358,박형수(朴亨修),윤상현(尹相現),39,22,61,0
26359,박형수(朴亨修),윤영덕(尹永德),49,5,54,1
26360,박형수(朴亨修),윤영석(尹永碩),61,58,119,0
26361,박형수(朴亨修),윤영찬(尹永燦),49,4,53,1
26362,박형수(朴亨修),윤재갑(尹才鉀),49,9,58,1
26363,박형수(朴亨修),윤재옥(尹在玉),63,50,113,0
26364,박형수(朴亨修),윤주경(尹柱卿),72,58,130,0
26365,박형수(朴亨修),윤준병(尹準炳),49,4,53,1
26366,박형수(朴亨修),윤창현(尹暢賢),71,50,121,0
26367,박형수(朴亨修),윤한홍(尹漢洪),61,60,121,0
26368,박형수(朴亨修),윤호중(尹昊重),49,4,53,1
26369,박형수(朴亨修),윤후덕(尹厚德),49,5,54,1
26370,박형수(朴亨修),이개호(李介昊),50,4,54,1
26371,박형수(朴亨修),이달곤(李達坤),60,57,117,0
26372,박형수(朴亨修),이동주(李東洲),49,4,53,1
26373,박형수(朴亨修),이만희(李晩熙),66,57,123,0
26374,박형수(朴亨修),이명수(李明洙),66,82,148,0
26375,박형수(朴亨修),이병훈(李炳勳),52,5,57,1
26376,박형수(朴亨修),이상민(李相珉),49,4,53,1
26377,박형수(朴亨修),이상헌(李相憲),49,4,53,1
26378,박형수(朴亨修),이성만(李成萬),41,1,42,1
26379,박형수(朴亨修),이소영(李素永),49,4,53,1
26380,박형수(朴亨修),이수진(李壽珍),49,4,53,1
26381,박형수(朴亨修),이수진(李秀眞),49,5,54,1
26382,박형수(朴亨修),이양수(李亮壽),69,54,123,0
26383,박형수(朴亨修),이용(李鏞),70,64,134,0
26384,박형수(朴亨修),이용빈(李龍彬),49,4,53,1
26385,박형수(朴亨修),이용선(李庸瑄),49,4,53,1
26386,박형수(朴亨修),이용우(李龍雨),49,5,54,1
26387,박형수(朴亨修),이용호(李容鎬),27,11,38,0
26388,박형수(朴亨修),이원욱(李元旭),50,4,54,1
26389,박형수(朴亨修),이원택(李源澤),49,5,54,1
26390,박형수(朴亨修),이은주(李恩周),4,2,6,1
26391,박형수(朴亨修),이인선(李仁善),28,23,51,0
26392,박형수(朴亨修),이인영(李仁榮),49,4,53,1
26393,박형수(朴亨修),이장섭(李將燮),49,4,53,1
26394,박형수(朴亨修),이재명(李在明),25,4,29,1
26395,박형수(朴亨修),이재정(李在汀),49,4,53,1
26396,박형수(朴亨修),이정문(李楨文),49,4,53,1
26397,박형수(朴亨修),이종배(李鍾培),70,56,126,0
26398,박형수(朴亨修),이종성(李鍾成),79,111,190,0
26399,박형수(朴亨修),이주환(李周桓),64,45,109,0
26400,박형수(朴亨修),이채익(李埰益),64,55,119,0
26401,박형수(朴亨修),이철규(李喆圭),65,44,109,0
26402,박형수(朴亨修),이탄희(李誕熙),49,5,54,1
26403,박형수(朴亨修),이태규(李泰珪),36,28,64,0
26404,박형수(朴亨修),이학영(李學永),50,4,54,1
26405,박형수(朴亨修),이해식(李海植),49,4,53,1
26406,박형수(朴亨修),이헌승(李憲昇),61,42,103,0
26407,박형수(朴亨修),이형석(李炯錫),49,4,53,1
26408,박형수(朴亨修),인재근(印在謹),49,4,53,1
26409,박형수(朴亨修),임병헌(林炳憲),36,60,96,0
26410,박형수(朴亨修),임오경(林五卿),49,4,53,1
26411,박형수(朴亨修),임이자(林利子),74,69,143,0
26412,박형수(朴亨修),임종성(林鍾聲),49,4,53,1
26413,박형수(朴亨修),임호선(林昊宣),49,4,53,1
26414,박형수(朴亨修),장경태(張耿態),49,5,54,1
26415,박형수(朴亨修),장동혁(張東赫),33,35,68,0
26416,박형수(朴亨修),장제원(張濟元),59,34,93,0
26417,박형수(朴亨修),장철민(張喆敏),49,4,53,1
26418,박형수(朴亨修),장혜영(張惠英),4,2,6,1
26419,박형수(朴亨修),전봉민(田奉珉),48,48,96,0
26420,박형수(朴亨修),전용기(田溶冀),49,4,53,1
26421,박형수(朴亨修),전재수(田載秀),49,4,53,1
26422,박형수(朴亨修),전주혜(全珠惠),74,66,140,0
26423,박형수(朴亨修),전해철(全海澈),50,4,54,1
26424,박형수(朴亨修),전혜숙(全惠淑),49,5,54,1
26425,박형수(朴亨修),정경희(丁慶姬),67,54,121,0
26426,박형수(朴亨修),정동만(鄭東萬),65,48,113,0
26427,박형수(朴亨修),정성호(鄭成湖),52,4,56,1
26428,박형수(朴亨修),정우택(鄭宇澤),30,27,57,0
26429,박형수(朴亨修),정운천(鄭雲天),70,66,136,0
26430,박형수(朴亨修),정일영(鄭日永),49,4,53,1
26431,박형수(朴亨修),정점식(鄭点植),66,49,115,0
26432,박형수(朴亨修),정진석(鄭鎭碩),66,47,113,0
26433,박형수(朴亨修),정청래(鄭淸來),49,4,53,1
26434,박형수(朴亨修),정춘숙(鄭春淑),49,5,54,1
26435,박형수(朴亨修),정태호(鄭泰浩),49,4,53,1
26436,박형수(朴亨修),정필모(鄭必模),49,4,53,1
26437,박형수(朴亨修),정희용(鄭熙溶),66,48,114,0
26438,박형수(朴亨修),조경태(趙慶泰),66,36,102,0
26439,박형수(朴亨修),조명희(曺明姬),84,98,182,0
26440,박형수(朴亨修),조수진(趙修眞),66,94,160,0
26441,박형수(朴亨修),조승래(趙承來),49,5,54,1
26442,박형수(朴亨修),조오섭(曺五燮),50,5,55,1
26443,박형수(朴亨修),조은희(趙恩禧),33,22,55,0
26444,박형수(朴亨修),조응천(趙應天),49,3,52,1
26445,박형수(朴亨修),조정식(趙正湜),49,3,52,1
26446,박형수(朴亨修),조정훈(趙廷訓),2,13,15,1
26447,박형수(朴亨修),조해진(曺海珍),61,48,109,0
26448,박형수(朴亨修),주철현(朱哲鉉),50,4,54,1
26449,박형수(朴亨修),주호영(朱豪英),62,40,102,0
26450,박형수(朴亨修),지성호(池成浩),67,58,125,0
26451,박형수(朴亨修),진선미(陳善美),49,4,53,1
26452,박형수(朴亨修),진성준(陳聲準),49,5,54,1
26453,박형수(朴亨修),천준호(千俊鎬),49,3,52,1
26454,박형수(朴亨修),최기상(崔基相),49,4,53,1
26455,박형수(朴亨修),최승재(崔承宰),68,53,121,0
26456,박형수(朴亨修),최연숙(崔姸淑),36,38,74,0
26457,박형수(朴亨修),최영희(崔英姬),30,29,59,0
26458,박형수(朴亨修),최인호(崔仁昊),49,4,53,1
26459,박형수(朴亨修),최재형(崔在亨),26,13,39,0
26460,박형수(朴亨修),최종윤(崔鍾允),49,5,54,1
26461,박형수(朴亨修),최춘식(崔春植),66,57,123,0
26462,박형수(朴亨修),최형두(崔炯斗),71,52,123,0
26463,박형수(朴亨修),최혜영(崔惠英),49,5,54,1
26464,박형수(朴亨修),추경호(秋慶鎬),64,58,122,0
26465,박형수(朴亨修),태영호(太永浩),66,71,137,0
26466,박형수(朴亨修),하영제(河榮帝),60,59,119,1
26467,박형수(朴亨修),하태경(河泰慶),59,45,104,0
26468,박형수(朴亨修),한기호(韓起鎬),60,53,113,0
26469,박형수(朴亨修),한무경(韓茂景),71,70,141,0
26470,박형수(朴亨修),한병도(韓秉道),49,5,54,1
26471,박형수(朴亨修),한정애(韓貞愛),49,4,53,1
26472,박형수(朴亨修),한준호(韓俊鎬),49,5,54,1
26473,박형수(朴亨修),허숙정(許淑湞),0,0,0,1
26474,박형수(朴亨修),허영(許榮),49,6,55,1
26475,박형수(朴亨修),허은아(許垠娥),67,45,112,0
26476,박형수(朴亨修),허종식(許琮植),50,6,56,1
26477,박형수(朴亨修),홍기원(洪起元),49,4,53,1
26478,박형수(朴亨修),홍문표(洪文杓),60,65,125,0
26479,박형수(朴亨修),홍석준(洪碩晙),60,49,109,0
26480,박형수(朴亨修),홍성국(洪性國),49,5,54,1
26481,박형수(朴亨修),홍영표(洪永杓),49,4,53,1
26482,박형수(朴亨修),홍익표(洪翼杓),49,4,53,1
26483,박형수(朴亨修),홍정민(洪貞敏),49,4,53,1
26484,박형수(朴亨修),황보승희(皇甫承希),66,49,115,1
26485,박형수(朴亨修),황운하(黃雲夏),49,5,54,1
26486,박형수(朴亨修),황희(黃熙),49,5,54,1
26487,박홍근(朴洪根),배준영(裵俊英),49,4,53,1
26488,박홍근(朴洪根),배진교(裵晋敎),22,38,60,1
26489,박홍근(朴洪根),배현진(裵賢鎭),49,4,53,1
26490,박홍근(朴洪根),백종헌(白宗憲),50,5,55,1
26491,박홍근(朴洪根),백혜련(白惠蓮),108,91,199,0
26492,박홍근(朴洪根),변재일(卞在一),103,91,194,0
26493,박홍근(朴洪根),서동용(徐東榕),123,133,256,0
26494,박홍근(朴洪根),서범수(徐範洙),51,5,56,1
26495,박홍근(朴洪根),서병수(徐秉洙),50,7,57,1
26496,박홍근(朴洪根),서삼석(徐參錫),103,105,208,0
26497,박홍근(朴洪根),서영교(徐瑛敎),137,172,309,0
26498,박홍근(朴洪根),서영석(徐暎錫),139,175,314,0
26499,박홍근(朴洪根),서일준(徐一俊),50,6,56,1
26500,박홍근(朴洪根),서정숙(徐正淑),49,4,53,1
26501,박홍근(朴洪根),설훈(薛勳),90,84,174,0
26502,박홍근(朴洪根),성일종(成一鍾),50,5,55,1
26503,박홍근(朴洪根),소병철(蘇秉哲),94,70,164,0
26504,박홍근(朴洪根),소병훈(蘇秉勳),91,114,205,0
26505,박홍근(朴洪根),송갑석(宋甲錫),111,153,264,0
26506,박홍근(朴洪根),송기헌(宋基憲),85,66,151,0
26507,박홍근(朴洪根),송석준(宋錫俊),50,4,54,1
26508,박홍근(朴洪根),송언석(宋彦錫),47,5,52,1
26509,박홍근(朴洪根),송옥주(宋玉珠),108,131,239,0
26510,박홍근(朴洪根),송재호(宋在祜),112,138,250,0
26511,박홍근(朴洪根),신동근(申東根),112,109,221,0
26512,박홍근(朴洪根),신영대(申榮大),86,72,158,0
26513,박홍근(朴洪根),신원식(申源湜),49,4,53,1
26514,박홍근(朴洪根),신정훈(辛正勳),163,215,378,0
26515,박홍근(朴洪根),신현영(申賢榮),95,69,164,0
26516,박홍근(朴洪根),심상정(沈相奵),18,39,57,1
26517,박홍근(朴洪根),안규백(安圭伯),114,104,218,0
26518,박홍근(朴洪根),안민석(安敏錫),110,103,213,0
26519,박홍근(朴洪根),안병길(安炳吉),50,4,54,1
26520,박홍근(朴洪根),안철수(安哲秀),25,4,29,1
26521,박홍근(朴洪根),안호영(安浩永),100,119,219,0
26522,박홍근(朴洪根),양경숙(梁敬淑),124,127,251,0
26523,박홍근(朴洪根),양금희(梁琴喜),50,5,55,1
26524,박홍근(朴洪根),양기대(梁基大),96,95,191,0
26525,박홍근(朴洪根),양이원영(梁李媛瑛),143,164,307,0
26526,박홍근(朴洪根),양정숙(梁貞淑),89,233,322,1
26527,박홍근(朴洪根),양향자(梁香子),70,88,158,1
26528,박홍근(朴洪根),어기구(魚基龜),90,87,177,0
26529,박홍근(朴洪根),엄태영(嚴泰永),51,4,55,1
26530,박홍근(朴洪根),오기형(吳奇炯),88,50,138,0
26531,박홍근(朴洪根),오영환(吳永煥),166,253,419,0
26532,박홍근(朴洪根),용혜인(龍慧仁),27,60,87,1
26533,박홍근(朴洪根),우상호(禹相虎),84,58,142,0
26534,박홍근(朴洪根),우원식(禹元植),129,173,302,0
26535,박홍근(朴洪根),위성곤(魏聖坤),110,124,234,0
26536,박홍근(朴洪根),유경준(兪京濬),49,4,53,1
26537,박홍근(朴洪根),유기홍(柳基洪),81,76,157,0
26538,박홍근(朴洪根),유동수(柳東秀),99,58,157,0
26539,박홍근(朴洪根),유상범(劉相凡),51,6,57,1
26540,박홍근(朴洪根),유의동(兪義東),50,4,54,1
26541,박홍근(朴洪根),유정주(兪訂炷),143,174,317,0
26542,박홍근(朴洪根),윤건영(尹建永),106,109,215,0
26543,박홍근(朴洪根),윤관석(尹官石),112,105,217,1
26544,박홍근(朴洪根),윤두현(尹斗鉉),49,4,53,1
26545,박홍근(朴洪根),윤미향(尹美香),87,145,232,1
26546,박홍근(朴洪根),윤상현(尹相現),31,4,35,1
26547,박홍근(朴洪根),윤영덕(尹永德),116,148,264,0
26548,박홍근(朴洪根),윤영석(尹永碩),50,5,55,1
26549,박홍근(朴洪根),윤영찬(尹永燦),95,74,169,0
26550,박홍근(朴洪根),윤재갑(尹才鉀),130,149,279,0
26551,박홍근(朴洪根),윤재옥(尹在玉),50,4,54,1
26552,박홍근(朴洪根),윤주경(尹柱卿),49,4,53,1
26553,박홍근(朴洪根),윤준병(尹準炳),139,225,364,0
26554,박홍근(朴洪根),윤창현(尹暢賢),49,5,54,1
26555,박홍근(朴洪根),윤한홍(尹漢洪),50,5,55,1
26556,박홍근(朴洪根),윤호중(尹昊重),78,82,160,0
26557,박홍근(朴洪根),윤후덕(尹厚德),107,110,217,0
26558,박홍근(朴洪根),이개호(李介昊),87,80,167,0
26559,박홍근(朴洪根),이달곤(李達坤),50,7,57,1
26560,박홍근(朴洪根),이동주(李東洲),124,187,311,0
26561,박홍근(朴洪根),이만희(李晩熙),50,4,54,1
26562,박홍근(朴洪根),이명수(李明洙),53,22,75,1
26563,박홍근(朴洪根),이병훈(李炳勳),119,124,243,0
26564,박홍근(朴洪根),이상민(李相珉),78,40,118,0
26565,박홍근(朴洪根),이상헌(李相憲),113,109,222,0
26566,박홍근(朴洪根),이성만(李成萬),115,130,245,1
26567,박홍근(朴洪根),이소영(李素永),100,77,177,0
26568,박홍근(朴洪根),이수진(李壽珍),158,235,393,0
26569,박홍근(朴洪根),이수진(李秀眞),139,146,285,0
26570,박홍근(朴洪根),이양수(李亮壽),53,4,57,1
26571,박홍근(朴洪根),이용(李鏞),49,4,53,1
26572,박홍근(朴洪根),이용빈(李龍彬),138,203,341,0
26573,박홍근(朴洪根),이용선(李庸瑄),103,124,227,0
26574,박홍근(朴洪根),이용우(李龍雨),139,118,257,0
26575,박홍근(朴洪根),이용호(李容鎬),35,25,60,1
26576,박홍근(朴洪根),이원욱(李元旭),105,111,216,0
26577,박홍근(朴洪根),이원택(李源澤),103,128,231,0
26578,박홍근(朴洪根),이은주(李恩周),31,44,75,1
26579,박홍근(朴洪根),이인선(李仁善),25,4,29,1
26580,박홍근(朴洪根),이인영(李仁榮),80,54,134,0
26581,박홍근(朴洪根),이장섭(李將燮),104,97,201,0
26582,박홍근(朴洪根),이재명(李在明),38,24,62,0
26583,박홍근(朴洪根),이재정(李在汀),91,73,164,0
26584,박홍근(朴洪根),이정문(李楨文),139,163,302,0
26585,박홍근(朴洪根),이종배(李鍾培),50,5,55,1
26586,박홍근(朴洪根),이종성(李鍾成),49,4,53,1
26587,박홍근(朴洪根),이주환(李周桓),50,6,56,1
26588,박홍근(朴洪根),이채익(李埰益),50,4,54,1
26589,박홍근(朴洪根),이철규(李喆圭),51,4,55,1
26590,박홍근(朴洪根),이탄희(李誕熙),126,99,225,0
26591,박홍근(朴洪根),이태규(李泰珪),28,4,32,1
26592,박홍근(朴洪根),이학영(李學永),112,207,319,0
26593,박홍근(朴洪根),이해식(李海植),124,130,254,0
26594,박홍근(朴洪根),이헌승(李憲昇),56,8,64,1
26595,박홍근(朴洪根),이형석(李炯錫),123,136,259,0
26596,박홍근(朴洪根),인재근(印在謹),119,136,255,0
26597,박홍근(朴洪根),임병헌(林炳憲),25,4,29,1
26598,박홍근(朴洪根),임오경(林五卿),116,115,231,0
26599,박홍근(朴洪根),임이자(林利子),50,4,54,1
26600,박홍근(朴洪根),임종성(林鍾聲),121,165,286,0
26601,박홍근(朴洪根),임호선(林昊宣),134,225,359,0
26602,박홍근(朴洪根),장경태(張耿態),129,192,321,0
26603,박홍근(朴洪根),장동혁(張東赫),25,4,29,1
26604,박홍근(朴洪根),장제원(張濟元),49,5,54,1
26605,박홍근(朴洪根),장철민(張喆敏),105,89,194,0
26606,박홍근(朴洪根),장혜영(張惠英),18,33,51,1
26607,박홍근(朴洪根),전봉민(田奉珉),35,6,41,1
26608,박홍근(朴洪根),전용기(田溶冀),112,114,226,0
26609,박홍근(朴洪根),전재수(田載秀),90,80,170,0
26610,박홍근(朴洪根),전주혜(全珠惠),50,4,54,1
26611,박홍근(朴洪根),전해철(全海澈),78,58,136,0
26612,박홍근(朴洪根),전혜숙(全惠淑),118,122,240,0
26613,박홍근(朴洪根),정경희(丁慶姬),49,4,53,1
26614,박홍근(朴洪根),정동만(鄭東萬),49,4,53,1
26615,박홍근(朴洪根),정성호(鄭成湖),94,111,205,0
26616,박홍근(朴洪根),정우택(鄭宇澤),25,6,31,1
26617,박홍근(朴洪根),정운천(鄭雲天),49,6,55,1
26618,박홍근(朴洪根),정일영(鄭日永),117,125,242,0
26619,박홍근(朴洪根),정점식(鄭点植),50,4,54,1
26620,박홍근(朴洪根),정진석(鄭鎭碩),50,5,55,1
26621,박홍근(朴洪根),정청래(鄭淸來),99,77,176,0
26622,박홍근(朴洪根),정춘숙(鄭春淑),112,123,235,0
26623,박홍근(朴洪根),정태호(鄭泰浩),97,119,216,0
26624,박홍근(朴洪根),정필모(鄭必模),113,144,257,0
26625,박홍근(朴洪根),정희용(鄭熙溶),49,4,53,1
26626,박홍근(朴洪根),조경태(趙慶泰),49,4,53,1
26627,박홍근(朴洪根),조명희(曺明姬),49,8,57,1
26628,박홍근(朴洪根),조수진(趙修眞),49,4,53,1
26629,박홍근(朴洪根),조승래(趙承來),121,113,234,0
26630,박홍근(朴洪根),조오섭(曺五燮),134,208,342,0
26631,박홍근(朴洪根),조은희(趙恩禧),25,4,29,1
26632,박홍근(朴洪根),조응천(趙應天),86,43,129,0
26633,박홍근(朴洪根),조정식(趙正湜),87,86,173,0
26634,박홍근(朴洪根),조정훈(趙廷訓),8,13,21,1
26635,박홍근(朴洪根),조해진(曺海珍),50,4,54,1
26636,박홍근(朴洪根),주철현(朱哲鉉),102,119,221,0
26637,박홍근(朴洪根),주호영(朱豪英),50,4,54,1
26638,박홍근(朴洪根),지성호(池成浩),49,5,54,1
26639,박홍근(朴洪根),진선미(陳善美),94,86,180,0
26640,박홍근(朴洪根),진성준(陳聲準),125,154,279,0
26641,박홍근(朴洪根),천준호(千俊鎬),121,113,234,0
26642,박홍근(朴洪根),최기상(崔基相),88,88,176,0
26643,박홍근(朴洪根),최승재(崔承宰),50,8,58,1
26644,박홍근(朴洪根),최연숙(崔姸淑),31,11,42,1
26645,박홍근(朴洪根),최영희(崔英姬),25,4,29,1
26646,박홍근(朴洪根),최인호(崔仁昊),93,96,189,0
26647,박홍근(朴洪根),최재형(崔在亨),25,4,29,1
26648,박홍근(朴洪根),최종윤(崔鍾允),122,149,271,0
26649,박홍근(朴洪根),최춘식(崔春植),50,15,65,1
26650,박홍근(朴洪根),최형두(崔炯斗),53,4,57,1
26651,박홍근(朴洪根),최혜영(崔惠英),153,154,307,0
26652,박홍근(朴洪根),추경호(秋慶鎬),49,3,52,1
26653,박홍근(朴洪根),태영호(太永浩),49,6,55,1
26654,박홍근(朴洪根),하영제(河榮帝),41,3,44,1
26655,박홍근(朴洪根),하태경(河泰慶),51,5,56,1
26656,박홍근(朴洪根),한기호(韓起鎬),51,4,55,1
26657,박홍근(朴洪根),한무경(韓茂景),51,6,57,1
26658,박홍근(朴洪根),한병도(韓秉道),122,131,253,0
26659,박홍근(朴洪根),한정애(韓貞愛),99,93,192,0
26660,박홍근(朴洪根),한준호(韓俊鎬),129,135,264,0
26661,박홍근(朴洪根),허숙정(許淑湞),1,1,2,0
26662,박홍근(朴洪根),허영(許榮),145,171,316,0
26663,박홍근(朴洪根),허은아(許垠娥),50,5,55,1
26664,박홍근(朴洪根),허종식(許琮植),141,141,282,0
26665,박홍근(朴洪根),홍기원(洪起元),107,105,212,0
26666,박홍근(朴洪根),홍문표(洪文杓),50,5,55,1
26667,박홍근(朴洪根),홍석준(洪碩晙),52,7,59,1
26668,박홍근(朴洪根),홍성국(洪性國),155,179,334,0
26669,박홍근(朴洪根),홍영표(洪永杓),91,74,165,0
26670,박홍근(朴洪根),홍익표(洪翼杓),109,113,222,0
26671,박홍근(朴洪根),홍정민(洪貞敏),142,153,295,0
26672,박홍근(朴洪根),황보승희(皇甫承希),47,1,48,1
26673,박홍근(朴洪根),황운하(黃雲夏),136,165,301,0
26674,박홍근(朴洪根),황희(黃熙),82,50,132,0
26675,배준영(裵俊英),배진교(裵晋敎),6,11,17,1
26676,배준영(裵俊英),배현진(裵賢鎭),75,58,133,0
26677,배준영(裵俊英),백종헌(白宗憲),74,117,191,0
26678,배준영(裵俊英),백혜련(白惠蓮),49,5,54,1
26679,배준영(裵俊英),변재일(卞在一),50,6,56,1
26680,배준영(裵俊英),서동용(徐東榕),49,5,54,1
26681,배준영(裵俊英),서범수(徐範洙),70,75,145,0
26682,배준영(裵俊英),서병수(徐秉洙),75,90,165,0
26683,배준영(裵俊英),서삼석(徐參錫),49,5,54,1
26684,배준영(裵俊英),서영교(徐瑛敎),52,13,65,1
26685,배준영(裵俊英),서영석(徐暎錫),53,7,60,1
26686,배준영(裵俊英),서일준(徐一俊),112,123,235,0
26687,배준영(裵俊英),서정숙(徐正淑),84,68,152,0
26688,배준영(裵俊英),설훈(薛勳),49,6,55,1
26689,배준영(裵俊英),성일종(成一鍾),97,119,216,0
26690,배준영(裵俊英),소병철(蘇秉哲),49,5,54,1
26691,배준영(裵俊英),소병훈(蘇秉勳),50,6,56,1
26692,배준영(裵俊英),송갑석(宋甲錫),49,5,54,1
26693,배준영(裵俊英),송기헌(宋基憲),49,5,54,1
26694,배준영(裵俊英),송석준(宋錫俊),81,102,183,0
26695,배준영(裵俊英),송언석(宋彦錫),81,81,162,0
26696,배준영(裵俊英),송옥주(宋玉珠),49,4,53,1
26697,배준영(裵俊英),송재호(宋在祜),49,8,57,1
26698,배준영(裵俊英),신동근(申東根),52,7,59,1
26699,배준영(裵俊英),신영대(申榮大),49,4,53,1
26700,배준영(裵俊英),신원식(申源湜),84,72,156,0
26701,배준영(裵俊英),신정훈(辛正勳),50,6,56,1
26702,배준영(裵俊英),신현영(申賢榮),50,4,54,1
26703,배준영(裵俊英),심상정(沈相奵),4,3,7,1
26704,배준영(裵俊英),안규백(安圭伯),49,6,55,1
26705,배준영(裵俊英),안민석(安敏錫),50,3,53,1
26706,배준영(裵俊英),안병길(安炳吉),74,96,170,0
26707,배준영(裵俊英),안철수(安哲秀),27,30,57,0
26708,배준영(裵俊英),안호영(安浩永),49,4,53,1
26709,배준영(裵俊英),양경숙(梁敬淑),49,4,53,1
26710,배준영(裵俊英),양금희(梁琴喜),101,120,221,0
26711,배준영(裵俊英),양기대(梁基大),49,4,53,1
26712,배준영(裵俊英),양이원영(梁李媛瑛),45,4,49,1
26713,배준영(裵俊英),양정숙(梁貞淑),3,3,6,1
26714,배준영(裵俊英),양향자(梁香子),23,10,33,1
26715,배준영(裵俊英),어기구(魚基龜),52,17,69,1
26716,배준영(裵俊英),엄태영(嚴泰永),71,85,156,0
26717,배준영(裵俊英),오기형(吳奇炯),49,4,53,1
26718,배준영(裵俊英),오영환(吳永煥),49,14,63,1
26719,배준영(裵俊英),용혜인(龍慧仁),1,1,2,1
26720,배준영(裵俊英),우상호(禹相虎),49,4,53,1
26721,배준영(裵俊英),우원식(禹元植),49,4,53,1
26722,배준영(裵俊英),위성곤(魏聖坤),50,6,56,1
26723,배준영(裵俊英),유경준(兪京濬),88,111,199,0
26724,배준영(裵俊英),유기홍(柳基洪),49,4,53,1
26725,배준영(裵俊英),유동수(柳東秀),56,17,73,1
26726,배준영(裵俊英),유상범(劉相凡),75,79,154,0
26727,배준영(裵俊英),유의동(兪義東),70,57,127,0
26728,배준영(裵俊英),유정주(兪訂炷),50,6,56,1
26729,배준영(裵俊英),윤건영(尹建永),49,3,52,1
26730,배준영(裵俊英),윤관석(尹官石),40,2,42,1
26731,배준영(裵俊英),윤두현(尹斗鉉),73,96,169,0
26732,배준영(裵俊英),윤미향(尹美香),20,0,20,1
26733,배준영(裵俊英),윤상현(尹相現),36,34,70,0
26734,배준영(裵俊英),윤영덕(尹永德),49,5,54,1
26735,배준영(裵俊英),윤영석(尹永碩),63,48,111,0
26736,배준영(裵俊英),윤영찬(尹永燦),49,4,53,1
26737,배준영(裵俊英),윤재갑(尹才鉀),52,5,57,1
26738,배준영(裵俊英),윤재옥(尹在玉),76,49,125,0
26739,배준영(裵俊英),윤주경(尹柱卿),69,75,144,0
26740,배준영(裵俊英),윤준병(尹準炳),50,6,56,1
26741,배준영(裵俊英),윤창현(尹暢賢),104,131,235,0
26742,배준영(裵俊英),윤한홍(尹漢洪),69,59,128,0
26743,배준영(裵俊英),윤호중(尹昊重),49,4,53,1
26744,배준영(裵俊英),윤후덕(尹厚德),49,8,57,1
26745,배준영(裵俊英),이개호(李介昊),50,4,54,1
26746,배준영(裵俊英),이달곤(李達坤),62,53,115,0
26747,배준영(裵俊英),이동주(李東洲),49,5,54,1
26748,배준영(裵俊英),이만희(李晩熙),74,75,149,0
26749,배준영(裵俊英),이명수(李明洙),89,136,225,0
26750,배준영(裵俊英),이병훈(李炳勳),52,5,57,1
26751,배준영(裵俊英),이상민(李相珉),49,6,55,1
26752,배준영(裵俊英),이상헌(李相憲),50,6,56,1
26753,배준영(裵俊英),이성만(李成萬),44,6,50,1
26754,배준영(裵俊英),이소영(李素永),50,5,55,1
26755,배준영(裵俊英),이수진(李壽珍),49,5,54,1
26756,배준영(裵俊英),이수진(李秀眞),50,5,55,1
26757,배준영(裵俊英),이양수(李亮壽),77,71,148,0
26758,배준영(裵俊英),이용(李鏞),93,116,209,0
26759,배준영(裵俊英),이용빈(李龍彬),50,5,55,1
26760,배준영(裵俊英),이용선(李庸瑄),50,5,55,1
26761,배준영(裵俊英),이용우(李龍雨),49,5,54,1
26762,배준영(裵俊英),이용호(李容鎬),27,17,44,0
26763,배준영(裵俊英),이원욱(李元旭),49,4,53,1
26764,배준영(裵俊英),이원택(李源澤),50,4,54,1
26765,배준영(裵俊英),이은주(李恩周),4,2,6,1
26766,배준영(裵俊英),이인선(李仁善),34,67,101,0
26767,배준영(裵俊英),이인영(李仁榮),49,4,53,1
26768,배준영(裵俊英),이장섭(李將燮),49,4,53,1
26769,배준영(裵俊英),이재명(李在明),25,4,29,1
26770,배준영(裵俊英),이재정(李在汀),49,4,53,1
26771,배준영(裵俊英),이정문(李楨文),49,8,57,1
26772,배준영(裵俊英),이종배(李鍾培),92,123,215,0
26773,배준영(裵俊英),이종성(李鍾成),85,114,199,0
26774,배준영(裵俊英),이주환(李周桓),91,101,192,0
26775,배준영(裵俊英),이채익(李埰益),73,65,138,0
26776,배준영(裵俊英),이철규(李喆圭),73,57,130,0
26777,배준영(裵俊英),이탄희(李誕熙),49,4,53,1
26778,배준영(裵俊英),이태규(李泰珪),57,64,121,0
26779,배준영(裵俊英),이학영(李學永),49,4,53,1
26780,배준영(裵俊英),이해식(李海植),52,6,58,1
26781,배준영(裵俊英),이헌승(李憲昇),66,74,140,0
26782,배준영(裵俊英),이형석(李炯錫),49,6,55,1
26783,배준영(裵俊英),인재근(印在謹),50,9,59,1
26784,배준영(裵俊英),임병헌(林炳憲),35,42,77,0
26785,배준영(裵俊英),임오경(林五卿),49,8,57,1
26786,배준영(裵俊英),임이자(林利子),74,70,144,0
26787,배준영(裵俊英),임종성(林鍾聲),49,7,56,1
26788,배준영(裵俊英),임호선(林昊宣),50,5,55,1
26789,배준영(裵俊英),장경태(張耿態),49,4,53,1
26790,배준영(裵俊英),장동혁(張東赫),29,39,68,0
26791,배준영(裵俊英),장제원(張濟元),69,43,112,0
26792,배준영(裵俊英),장철민(張喆敏),49,5,54,1
26793,배준영(裵俊英),장혜영(張惠英),7,5,12,1
26794,배준영(裵俊英),전봉민(田奉珉),46,45,91,0
26795,배준영(裵俊英),전용기(田溶冀),49,4,53,1
26796,배준영(裵俊英),전재수(田載秀),49,4,53,1
26797,배준영(裵俊英),전주혜(全珠惠),71,85,156,0
26798,배준영(裵俊英),전해철(全海澈),49,5,54,1
26799,배준영(裵俊英),전혜숙(全惠淑),49,6,55,1
26800,배준영(裵俊英),정경희(丁慶姬),81,105,186,0
26801,배준영(裵俊英),정동만(鄭東萬),76,72,148,0
26802,배준영(裵俊英),정성호(鄭成湖),51,5,56,1
26803,배준영(裵俊英),정우택(鄭宇澤),53,86,139,0
26804,배준영(裵俊英),정운천(鄭雲天),86,83,169,0
26805,배준영(裵俊英),정일영(鄭日永),54,12,66,1
26806,배준영(裵俊英),정점식(鄭点植),62,49,111,0
26807,배준영(裵俊英),정진석(鄭鎭碩),75,71,146,0
26808,배준영(裵俊英),정청래(鄭淸來),50,5,55,1
26809,배준영(裵俊英),정춘숙(鄭春淑),50,6,56,1
26810,배준영(裵俊英),정태호(鄭泰浩),49,6,55,1
26811,배준영(裵俊英),정필모(鄭必模),49,4,53,1
26812,배준영(裵俊英),정희용(鄭熙溶),75,114,189,0
26813,배준영(裵俊英),조경태(趙慶泰),79,75,154,0
26814,배준영(裵俊英),조명희(曺明姬),98,117,215,0
26815,배준영(裵俊英),조수진(趙修眞),82,103,185,0
26816,배준영(裵俊英),조승래(趙承來),49,6,55,1
26817,배준영(裵俊英),조오섭(曺五燮),50,6,56,1
26818,배준영(裵俊英),조은희(趙恩禧),44,31,75,0
26819,배준영(裵俊英),조응천(趙應天),50,4,54,1
26820,배준영(裵俊英),조정식(趙正湜),49,4,53,1
26821,배준영(裵俊英),조정훈(趙廷訓),0,14,14,1
26822,배준영(裵俊英),조해진(曺海珍),61,50,111,0
26823,배준영(裵俊英),주철현(朱哲鉉),49,6,55,1
26824,배준영(裵俊英),주호영(朱豪英),78,68,146,0
26825,배준영(裵俊英),지성호(池成浩),95,127,222,0
26826,배준영(裵俊英),진선미(陳善美),49,4,53,1
26827,배준영(裵俊英),진성준(陳聲準),50,8,58,1
26828,배준영(裵俊英),천준호(千俊鎬),49,3,52,1
26829,배준영(裵俊英),최기상(崔基相),50,11,61,1
26830,배준영(裵俊英),최승재(崔承宰),93,101,194,0
26831,배준영(裵俊英),최연숙(崔姸淑),37,44,81,0
26832,배준영(裵俊英),최영희(崔英姬),31,34,65,0
26833,배준영(裵俊英),최인호(崔仁昊),51,5,56,1
26834,배준영(裵俊英),최재형(崔在亨),30,19,49,0
26835,배준영(裵俊英),최종윤(崔鍾允),50,9,59,1
26836,배준영(裵俊英),최춘식(崔春植),99,139,238,0
26837,배준영(裵俊英),최형두(崔炯斗),72,76,148,0
26838,배준영(裵俊英),최혜영(崔惠英),53,6,59,1
26839,배준영(裵俊英),추경호(秋慶鎬),80,81,161,0
26840,배준영(裵俊英),태영호(太永浩),97,141,238,0
26841,배준영(裵俊英),하영제(河榮帝),75,97,172,1
26842,배준영(裵俊英),하태경(河泰慶),69,55,124,0
26843,배준영(裵俊英),한기호(韓起鎬),66,45,111,0
26844,배준영(裵俊英),한무경(韓茂景),82,85,167,0
26845,배준영(裵俊英),한병도(韓秉道),50,8,58,1
26846,배준영(裵俊英),한정애(韓貞愛),50,4,54,1
26847,배준영(裵俊英),한준호(韓俊鎬),49,7,56,1
26848,배준영(裵俊英),허숙정(許淑湞),0,0,0,1
26849,배준영(裵俊英),허영(許榮),50,4,54,1
26850,배준영(裵俊英),허은아(許垠娥),72,71,143,0
26851,배준영(裵俊英),허종식(許琮植),56,36,92,1
26852,배준영(裵俊英),홍기원(洪起元),49,5,54,1
26853,배준영(裵俊英),홍문표(洪文杓),81,92,173,0
26854,배준영(裵俊英),홍석준(洪碩晙),68,64,132,0
26855,배준영(裵俊英),홍성국(洪性國),49,4,53,1
26856,배준영(裵俊英),홍영표(洪永杓),51,8,59,1
26857,배준영(裵俊英),홍익표(洪翼杓),49,4,53,1
26858,배준영(裵俊英),홍정민(洪貞敏),49,9,58,1
26859,배준영(裵俊英),황보승희(皇甫承希),76,90,166,1
26860,배준영(裵俊英),황운하(黃雲夏),50,7,57,1
26861,배준영(裵俊英),황희(黃熙),49,7,56,1
26862,배진교(裵晋敎),배현진(裵賢鎭),4,4,8,1
26863,배진교(裵晋敎),백종헌(白宗憲),6,8,14,1
26864,배진교(裵晋敎),백혜련(白惠蓮),13,13,26,1
26865,배진교(裵晋敎),변재일(卞在一),11,11,22,1
26866,배진교(裵晋敎),서동용(徐東榕),25,48,73,1
26867,배진교(裵晋敎),서범수(徐範洙),5,3,8,1
26868,배진교(裵晋敎),서병수(徐秉洙),6,2,8,1
26869,배진교(裵晋敎),서삼석(徐參錫),15,15,30,1
26870,배진교(裵晋敎),서영교(徐瑛敎),21,41,62,1
26871,배진교(裵晋敎),서영석(徐暎錫),17,53,70,1
26872,배진교(裵晋敎),서일준(徐一俊),5,4,9,1
26873,배진교(裵晋敎),서정숙(徐正淑),4,10,14,1
26874,배진교(裵晋敎),설훈(薛勳),15,26,41,1
26875,배진교(裵晋敎),성일종(成一鍾),6,5,11,1
26876,배진교(裵晋敎),소병철(蘇秉哲),14,22,36,1
26877,배진교(裵晋敎),소병훈(蘇秉勳),16,29,45,1
26878,배진교(裵晋敎),송갑석(宋甲錫),15,28,43,1
26879,배진교(裵晋敎),송기헌(宋基憲),13,13,26,1
26880,배진교(裵晋敎),송석준(宋錫俊),5,3,8,1
26881,배진교(裵晋敎),송언석(宋彦錫),3,0,3,1
26882,배진교(裵晋敎),송옥주(宋玉珠),17,39,56,1
26883,배진교(裵晋敎),송재호(宋在祜),16,51,67,1
26884,배진교(裵晋敎),신동근(申東根),19,31,50,1
26885,배진교(裵晋敎),신영대(申榮大),12,23,35,1
26886,배진교(裵晋敎),신원식(申源湜),5,2,7,1
26887,배진교(裵晋敎),신정훈(辛正勳),26,51,77,1
26888,배진교(裵晋敎),신현영(申賢榮),14,16,30,1
26889,배진교(裵晋敎),심상정(沈相奵),86,337,423,0
26890,배진교(裵晋敎),안규백(安圭伯),17,16,33,1
26891,배진교(裵晋敎),안민석(安敏錫),16,21,37,1
26892,배진교(裵晋敎),안병길(安炳吉),6,4,10,1
26893,배진교(裵晋敎),안철수(安哲秀),0,0,0,1
26894,배진교(裵晋敎),안호영(安浩永),16,40,56,1
26895,배진교(裵晋敎),양경숙(梁敬淑),18,41,59,1
26896,배진교(裵晋敎),양금희(梁琴喜),6,5,11,1
26897,배진교(裵晋敎),양기대(梁基大),20,20,40,1
26898,배진교(裵晋敎),양이원영(梁李媛瑛),20,46,66,1
26899,배진교(裵晋敎),양정숙(梁貞淑),55,184,239,1
26900,배진교(裵晋敎),양향자(梁香子),10,17,27,1
26901,배진교(裵晋敎),어기구(魚基龜),26,28,54,1
26902,배진교(裵晋敎),엄태영(嚴泰永),6,5,11,1
26903,배진교(裵晋敎),오기형(吳奇炯),14,18,32,1
26904,배진교(裵晋敎),오영환(吳永煥),29,86,115,1
26905,배진교(裵晋敎),용혜인(龍慧仁),40,166,206,1
26906,배진교(裵晋敎),우상호(禹相虎),14,9,23,1
26907,배진교(裵晋敎),우원식(禹元植),18,29,47,1
26908,배진교(裵晋敎),위성곤(魏聖坤),16,47,63,1
26909,배진교(裵晋敎),유경준(兪京濬),5,3,8,1
26910,배진교(裵晋敎),유기홍(柳基洪),15,19,34,1
26911,배진교(裵晋敎),유동수(柳東秀),28,44,72,1
26912,배진교(裵晋敎),유상범(劉相凡),5,3,8,1
26913,배진교(裵晋敎),유의동(兪義東),6,5,11,1
26914,배진교(裵晋敎),유정주(兪訂炷),28,52,80,1
26915,배진교(裵晋敎),윤건영(尹建永),13,21,34,1
26916,배진교(裵晋敎),윤관석(尹官石),19,24,43,1
26917,배진교(裵晋敎),윤두현(尹斗鉉),5,4,9,1
26918,배진교(裵晋敎),윤미향(尹美香),23,106,129,1
26919,배진교(裵晋敎),윤상현(尹相現),1,8,9,1
26920,배진교(裵晋敎),윤영덕(尹永德),22,64,86,1
26921,배진교(裵晋敎),윤영석(尹永碩),5,3,8,1
26922,배진교(裵晋敎),윤영찬(尹永燦),11,15,26,1
26923,배진교(裵晋敎),윤재갑(尹才鉀),31,46,77,1
26924,배진교(裵晋敎),윤재옥(尹在玉),5,2,7,1
26925,배진교(裵晋敎),윤주경(尹柱卿),5,12,17,1
26926,배진교(裵晋敎),윤준병(尹準炳),17,66,83,1
26927,배진교(裵晋敎),윤창현(尹暢賢),5,9,14,1
26928,배진교(裵晋敎),윤한홍(尹漢洪),5,2,7,1
26929,배진교(裵晋敎),윤호중(尹昊重),12,15,27,1
26930,배진교(裵晋敎),윤후덕(尹厚德),14,32,46,1
26931,배진교(裵晋敎),이개호(李介昊),13,17,30,1
26932,배진교(裵晋敎),이달곤(李達坤),7,4,11,1
26933,배진교(裵晋敎),이동주(李東洲),27,50,77,1
26934,배진교(裵晋敎),이만희(李晩熙),4,2,6,1
26935,배진교(裵晋敎),이명수(李明洙),5,20,25,1
26936,배진교(裵晋敎),이병훈(李炳勳),17,37,54,1
26937,배진교(裵晋敎),이상민(李相珉),12,17,29,1
26938,배진교(裵晋敎),이상헌(李相憲),21,35,56,1
26939,배진교(裵晋敎),이성만(李成萬),27,45,72,1
26940,배진교(裵晋敎),이소영(李素永),20,29,49,1
26941,배진교(裵晋敎),이수진(李壽珍),43,172,215,1
26942,배진교(裵晋敎),이수진(李秀眞),22,30,52,1
26943,배진교(裵晋敎),이양수(李亮壽),7,10,17,1
26944,배진교(裵晋敎),이용(李鏞),4,6,10,1
26945,배진교(裵晋敎),이용빈(李龍彬),35,110,145,1
26946,배진교(裵晋敎),이용선(李庸瑄),23,64,87,1
26947,배진교(裵晋敎),이용우(李龍雨),24,24,48,1
26948,배진교(裵晋敎),이용호(李容鎬),10,26,36,1
26949,배진교(裵晋敎),이원욱(李元旭),13,19,32,1
26950,배진교(裵晋敎),이원택(李源澤),15,23,38,1
26951,배진교(裵晋敎),이은주(李恩周),90,347,437,0
26952,배진교(裵晋敎),이인선(李仁善),0,0,0,1
26953,배진교(裵晋敎),이인영(李仁榮),10,9,19,1
26954,배진교(裵晋敎),이장섭(李將燮),13,21,34,1
26955,배진교(裵晋敎),이재명(李在明),5,9,14,1
26956,배진교(裵晋敎),이재정(李在汀),17,21,38,1
26957,배진교(裵晋敎),이정문(李楨文),14,26,40,1
26958,배진교(裵晋敎),이종배(李鍾培),5,4,9,1
26959,배진교(裵晋敎),이종성(李鍾成),5,5,10,1
26960,배진교(裵晋敎),이주환(李周桓),5,3,8,1
26961,배진교(裵晋敎),이채익(李埰益),8,11,19,1
26962,배진교(裵晋敎),이철규(李喆圭),5,4,9,1
26963,배진교(裵晋敎),이탄희(李誕熙),19,47,66,1
26964,배진교(裵晋敎),이태규(李泰珪),5,6,11,1
26965,배진교(裵晋敎),이학영(李學永),14,25,39,1
26966,배진교(裵晋敎),이해식(李海植),20,40,60,1
26967,배진교(裵晋敎),이헌승(李憲昇),7,2,9,1
26968,배진교(裵晋敎),이형석(李炯錫),18,33,51,1
26969,배진교(裵晋敎),인재근(印在謹),19,31,50,1
26970,배진교(裵晋敎),임병헌(林炳憲),1,1,2,1
26971,배진교(裵晋敎),임오경(林五卿),15,23,38,1
26972,배진교(裵晋敎),임이자(林利子),4,3,7,1
26973,배진교(裵晋敎),임종성(林鍾聲),21,41,62,1
26974,배진교(裵晋敎),임호선(林昊宣),19,60,79,1
26975,배진교(裵晋敎),장경태(張耿態),24,63,87,1
26976,배진교(裵晋敎),장동혁(張東赫),0,0,0,1
26977,배진교(裵晋敎),장제원(張濟元),4,2,6,1
26978,배진교(裵晋敎),장철민(張喆敏),16,38,54,1
26979,배진교(裵晋敎),장혜영(張惠英),84,344,428,0
26980,배진교(裵晋敎),전봉민(田奉珉),2,1,3,1
26981,배진교(裵晋敎),전용기(田溶冀),13,34,47,1
26982,배진교(裵晋敎),전재수(田載秀),14,12,26,1
26983,배진교(裵晋敎),전주혜(全珠惠),6,4,10,1
26984,배진교(裵晋敎),전해철(全海澈),11,18,29,1
26985,배진교(裵晋敎),전혜숙(全惠淑),18,25,43,1
26986,배진교(裵晋敎),정경희(丁慶姬),4,2,6,1
26987,배진교(裵晋敎),정동만(鄭東萬),5,3,8,1
26988,배진교(裵晋敎),정성호(鄭成湖),20,39,59,1
26989,배진교(裵晋敎),정우택(鄭宇澤),0,0,0,1
26990,배진교(裵晋敎),정운천(鄭雲天),5,5,10,1
26991,배진교(裵晋敎),정일영(鄭日永),23,38,61,1
26992,배진교(裵晋敎),정점식(鄭点植),5,2,7,1
26993,배진교(裵晋敎),정진석(鄭鎭碩),5,2,7,1
26994,배진교(裵晋敎),정청래(鄭淸來),13,16,29,1
26995,배진교(裵晋敎),정춘숙(鄭春淑),17,34,51,1
26996,배진교(裵晋敎),정태호(鄭泰浩),17,32,49,1
26997,배진교(裵晋敎),정필모(鄭必模),19,27,46,1
26998,배진교(裵晋敎),정희용(鄭熙溶),5,4,9,1
26999,배진교(裵晋敎),조경태(趙慶泰),4,2,6,1
27000,배진교(裵晋敎),조명희(曺明姬),4,4,8,1
27001,배진교(裵晋敎),조수진(趙修眞),4,4,8,1
27002,배진교(裵晋敎),조승래(趙承來),14,14,28,1
27003,배진교(裵晋敎),조오섭(曺五燮),31,75,106,1
27004,배진교(裵晋敎),조은희(趙恩禧),3,1,4,1
27005,배진교(裵晋敎),조응천(趙應天),9,4,13,1
27006,배진교(裵晋敎),조정식(趙正湜),9,7,16,1
27007,배진교(裵晋敎),조정훈(趙廷訓),8,49,57,1
27008,배진교(裵晋敎),조해진(曺海珍),7,5,12,1
27009,배진교(裵晋敎),주철현(朱哲鉉),15,37,52,1
27010,배진교(裵晋敎),주호영(朱豪英),4,3,7,1
27011,배진교(裵晋敎),지성호(池成浩),5,3,8,1
27012,배진교(裵晋敎),진선미(陳善美),16,14,30,1
27013,배진교(裵晋敎),진성준(陳聲準),22,39,61,1
27014,배진교(裵晋敎),천준호(千俊鎬),16,34,50,1
27015,배진교(裵晋敎),최기상(崔基相),15,22,37,1
27016,배진교(裵晋敎),최승재(崔承宰),6,9,15,1
27017,배진교(裵晋敎),최연숙(崔姸淑),9,21,30,1
27018,배진교(裵晋敎),최영희(崔英姬),0,0,0,1
27019,배진교(裵晋敎),최인호(崔仁昊),12,15,27,1
27020,배진교(裵晋敎),최재형(崔在亨),0,0,0,1
27021,배진교(裵晋敎),최종윤(崔鍾允),21,34,55,1
27022,배진교(裵晋敎),최춘식(崔春植),6,12,18,1
27023,배진교(裵晋敎),최형두(崔炯斗),7,5,12,1
27024,배진교(裵晋敎),최혜영(崔惠英),33,61,94,1
27025,배진교(裵晋敎),추경호(秋慶鎬),4,3,7,1
27026,배진교(裵晋敎),태영호(太永浩),5,6,11,1
27027,배진교(裵晋敎),하영제(河榮帝),5,3,8,1
27028,배진교(裵晋敎),하태경(河泰慶),4,6,10,1
27029,배진교(裵晋敎),한기호(韓起鎬),6,2,8,1
27030,배진교(裵晋敎),한무경(韓茂景),4,4,8,1
27031,배진교(裵晋敎),한병도(韓秉道),20,24,44,1
27032,배진교(裵晋敎),한정애(韓貞愛),10,13,23,1
27033,배진교(裵晋敎),한준호(韓俊鎬),19,26,45,1
27034,배진교(裵晋敎),허숙정(許淑湞),1,1,2,1
27035,배진교(裵晋敎),허영(許榮),23,29,52,1
27036,배진교(裵晋敎),허은아(許垠娥),4,8,12,1
27037,배진교(裵晋敎),허종식(許琮植),35,91,126,1
27038,배진교(裵晋敎),홍기원(洪起元),25,24,49,1
27039,배진교(裵晋敎),홍문표(洪文杓),5,3,8,1
27040,배진교(裵晋敎),홍석준(洪碩晙),5,3,8,1
27041,배진교(裵晋敎),홍성국(洪性國),20,37,57,1
27042,배진교(裵晋敎),홍영표(洪永杓),17,30,47,1
27043,배진교(裵晋敎),홍익표(洪翼杓),14,24,38,1
27044,배진교(裵晋敎),홍정민(洪貞敏),24,24,48,1
27045,배진교(裵晋敎),황보승희(皇甫承希),6,6,12,1
27046,배진교(裵晋敎),황운하(黃雲夏),26,38,64,1
27047,배진교(裵晋敎),황희(黃熙),11,10,21,1
27048,배현진(裵賢鎭),백종헌(白宗憲),76,74,150,0
27049,배현진(裵賢鎭),백혜련(白惠蓮),49,5,54,1
27050,배현진(裵賢鎭),변재일(卞在一),52,5,57,1
27051,배현진(裵賢鎭),서동용(徐東榕),49,4,53,1
27052,배현진(裵賢鎭),서범수(徐範洙),71,56,127,0
27053,배현진(裵賢鎭),서병수(徐秉洙),75,50,125,0
27054,배현진(裵賢鎭),서삼석(徐參錫),50,4,54,1
27055,배현진(裵賢鎭),서영교(徐瑛敎),51,5,56,1
27056,배현진(裵賢鎭),서영석(徐暎錫),49,5,54,1
27057,배현진(裵賢鎭),서일준(徐一俊),92,83,175,0
27058,배현진(裵賢鎭),서정숙(徐正淑),78,66,144,0
27059,배현진(裵賢鎭),설훈(薛勳),51,6,57,1
27060,배현진(裵賢鎭),성일종(成一鍾),76,72,148,0
27061,배현진(裵賢鎭),소병철(蘇秉哲),50,5,55,1
27062,배현진(裵賢鎭),소병훈(蘇秉勳),49,5,54,1
27063,배현진(裵賢鎭),송갑석(宋甲錫),49,4,53,1
27064,배현진(裵賢鎭),송기헌(宋基憲),49,6,55,1
27065,배현진(裵賢鎭),송석준(宋錫俊),68,48,116,0
27066,배현진(裵賢鎭),송언석(宋彦錫),63,49,112,0
27067,배현진(裵賢鎭),송옥주(宋玉珠),49,3,52,1
27068,배현진(裵賢鎭),송재호(宋在祜),49,5,54,1
27069,배현진(裵賢鎭),신동근(申東根),49,3,52,1
27070,배현진(裵賢鎭),신영대(申榮大),49,4,53,1
27071,배현진(裵賢鎭),신원식(申源湜),82,58,140,0
27072,배현진(裵賢鎭),신정훈(辛正勳),50,6,56,1
27073,배현진(裵賢鎭),신현영(申賢榮),49,4,53,1
27074,배현진(裵賢鎭),심상정(沈相奵),5,4,9,1
27075,배현진(裵賢鎭),안규백(安圭伯),52,5,57,1
27076,배현진(裵賢鎭),안민석(安敏錫),51,3,54,1
27077,배현진(裵賢鎭),안병길(安炳吉),71,56,127,0
27078,배현진(裵賢鎭),안철수(安哲秀),28,11,39,0
27079,배현진(裵賢鎭),안호영(安浩永),49,7,56,1
27080,배현진(裵賢鎭),양경숙(梁敬淑),49,5,54,1
27081,배현진(裵賢鎭),양금희(梁琴喜),82,75,157,0
27082,배현진(裵賢鎭),양기대(梁基大),50,4,54,1
27083,배현진(裵賢鎭),양이원영(梁李媛瑛),45,5,50,1
27084,배현진(裵賢鎭),양정숙(梁貞淑),3,1,4,1
27085,배현진(裵賢鎭),양향자(梁香子),21,4,25,1
27086,배현진(裵賢鎭),어기구(魚基龜),50,5,55,1
27087,배현진(裵賢鎭),엄태영(嚴泰永),72,55,127,0
27088,배현진(裵賢鎭),오기형(吳奇炯),49,5,54,1
27089,배현진(裵賢鎭),오영환(吳永煥),50,5,55,1
27090,배현진(裵賢鎭),용혜인(龍慧仁),1,5,6,1
27091,배현진(裵賢鎭),우상호(禹相虎),49,4,53,1
27092,배현진(裵賢鎭),우원식(禹元植),49,4,53,1
27093,배현진(裵賢鎭),위성곤(魏聖坤),49,6,55,1
27094,배현진(裵賢鎭),유경준(兪京濬),79,67,146,0
27095,배현진(裵賢鎭),유기홍(柳基洪),50,4,54,1
27096,배현진(裵賢鎭),유동수(柳東秀),50,4,54,1
27097,배현진(裵賢鎭),유상범(劉相凡),74,54,128,0
27098,배현진(裵賢鎭),유의동(兪義東),67,48,115,0
27099,배현진(裵賢鎭),유정주(兪訂炷),50,7,57,1
27100,배현진(裵賢鎭),윤건영(尹建永),49,4,53,1
27101,배현진(裵賢鎭),윤관석(尹官石),40,0,40,1
27102,배현진(裵賢鎭),윤두현(尹斗鉉),77,73,150,0
27103,배현진(裵賢鎭),윤미향(尹美香),20,1,21,1
27104,배현진(裵賢鎭),윤상현(尹相現),45,43,88,0
27105,배현진(裵賢鎭),윤영덕(尹永德),49,4,53,1
27106,배현진(裵賢鎭),윤영석(尹永碩),72,55,127,0
27107,배현진(裵賢鎭),윤영찬(尹永燦),49,4,53,1
27108,배현진(裵賢鎭),윤재갑(尹才鉀),50,5,55,1
27109,배현진(裵賢鎭),윤재옥(尹在玉),68,49,117,0
27110,배현진(裵賢鎭),윤주경(尹柱卿),65,52,117,0
27111,배현진(裵賢鎭),윤준병(尹準炳),49,4,53,1
27112,배현진(裵賢鎭),윤창현(尹暢賢),79,82,161,0
27113,배현진(裵賢鎭),윤한홍(尹漢洪),73,68,141,0
27114,배현진(裵賢鎭),윤호중(尹昊重),49,4,53,1
27115,배현진(裵賢鎭),윤후덕(尹厚德),49,4,53,1
27116,배현진(裵賢鎭),이개호(李介昊),49,5,54,1
27117,배현진(裵賢鎭),이달곤(李達坤),66,51,117,0
27118,배현진(裵賢鎭),이동주(李東洲),49,5,54,1
27119,배현진(裵賢鎭),이만희(李晩熙),70,50,120,0
27120,배현진(裵賢鎭),이명수(李明洙),81,66,147,0
27121,배현진(裵賢鎭),이병훈(李炳勳),52,7,59,1
27122,배현진(裵賢鎭),이상민(李相珉),50,4,54,1
27123,배현진(裵賢鎭),이상헌(李相憲),50,8,58,1
27124,배현진(裵賢鎭),이성만(李成萬),40,1,41,1
27125,배현진(裵賢鎭),이소영(李素永),50,5,55,1
27126,배현진(裵賢鎭),이수진(李壽珍),49,5,54,1
27127,배현진(裵賢鎭),이수진(李秀眞),49,6,55,1
27128,배현진(裵賢鎭),이양수(李亮壽),76,51,127,0
27129,배현진(裵賢鎭),이용(李鏞),83,72,155,0
27130,배현진(裵賢鎭),이용빈(李龍彬),50,5,55,1
27131,배현진(裵賢鎭),이용선(李庸瑄),49,5,54,1
27132,배현진(裵賢鎭),이용우(李龍雨),49,5,54,1
27133,배현진(裵賢鎭),이용호(李容鎬),42,17,59,0
27134,배현진(裵賢鎭),이원욱(李元旭),50,5,55,1
27135,배현진(裵賢鎭),이원택(李源澤),49,4,53,1
27136,배현진(裵賢鎭),이은주(李恩周),5,4,9,1
27137,배현진(裵賢鎭),이인선(李仁善),31,17,48,0
27138,배현진(裵賢鎭),이인영(李仁榮),49,4,53,1
27139,배현진(裵賢鎭),이장섭(李將燮),49,4,53,1
27140,배현진(裵賢鎭),이재명(李在明),25,4,29,1
27141,배현진(裵賢鎭),이재정(李在汀),49,4,53,1
27142,배현진(裵賢鎭),이정문(李楨文),49,4,53,1
27143,배현진(裵賢鎭),이종배(李鍾培),80,75,155,0
27144,배현진(裵賢鎭),이종성(李鍾成),79,81,160,0
27145,배현진(裵賢鎭),이주환(李周桓),86,69,155,0
27146,배현진(裵賢鎭),이채익(李埰益),70,53,123,0
27147,배현진(裵賢鎭),이철규(李喆圭),86,54,140,0
27148,배현진(裵賢鎭),이탄희(李誕熙),49,5,54,1
27149,배현진(裵賢鎭),이태규(李泰珪),45,36,81,0
27150,배현진(裵賢鎭),이학영(李學永),49,5,54,1
27151,배현진(裵賢鎭),이해식(李海植),49,5,54,1
27152,배현진(裵賢鎭),이헌승(李憲昇),67,44,111,0
27153,배현진(裵賢鎭),이형석(李炯錫),49,4,53,1
27154,배현진(裵賢鎭),인재근(印在謹),49,5,54,1
27155,배현진(裵賢鎭),임병헌(林炳憲),42,17,59,0
27156,배현진(裵賢鎭),임오경(林五卿),49,6,55,1
27157,배현진(裵賢鎭),임이자(林利子),77,56,133,0
27158,배현진(裵賢鎭),임종성(林鍾聲),49,6,55,1
27159,배현진(裵賢鎭),임호선(林昊宣),49,5,54,1
27160,배현진(裵賢鎭),장경태(張耿態),49,5,54,1
27161,배현진(裵賢鎭),장동혁(張東赫),30,20,50,0
27162,배현진(裵賢鎭),장제원(張濟元),68,46,114,0
27163,배현진(裵賢鎭),장철민(張喆敏),49,4,53,1
27164,배현진(裵賢鎭),장혜영(張惠英),6,7,13,1
27165,배현진(裵賢鎭),전봉민(田奉珉),49,28,77,0
27166,배현진(裵賢鎭),전용기(田溶冀),50,5,55,1
27167,배현진(裵賢鎭),전재수(田載秀),49,4,53,1
27168,배현진(裵賢鎭),전주혜(全珠惠),74,65,139,0
27169,배현진(裵賢鎭),전해철(全海澈),51,4,55,1
27170,배현진(裵賢鎭),전혜숙(全惠淑),49,5,54,1
27171,배현진(裵賢鎭),정경희(丁慶姬),72,60,132,0
27172,배현진(裵賢鎭),정동만(鄭東萬),68,44,112,0
27173,배현진(裵賢鎭),정성호(鄭成湖),52,6,58,1
27174,배현진(裵賢鎭),정우택(鄭宇澤),31,20,51,0
27175,배현진(裵賢鎭),정운천(鄭雲天),71,57,128,0
27176,배현진(裵賢鎭),정일영(鄭日永),50,6,56,1
27177,배현진(裵賢鎭),정점식(鄭点植),78,45,123,0
27178,배현진(裵賢鎭),정진석(鄭鎭碩),71,53,124,0
27179,배현진(裵賢鎭),정청래(鄭淸來),49,5,54,1
27180,배현진(裵賢鎭),정춘숙(鄭春淑),49,5,54,1
27181,배현진(裵賢鎭),정태호(鄭泰浩),49,4,53,1
27182,배현진(裵賢鎭),정필모(鄭必模),49,5,54,1
27183,배현진(裵賢鎭),정희용(鄭熙溶),95,66,161,0
27184,배현진(裵賢鎭),조경태(趙慶泰),76,52,128,0
27185,배현진(裵賢鎭),조명희(曺明姬),108,111,219,0
27186,배현진(裵賢鎭),조수진(趙修眞),73,62,135,0
27187,배현진(裵賢鎭),조승래(趙承來),49,4,53,1
27188,배현진(裵賢鎭),조오섭(曺五燮),50,5,55,1
27189,배현진(裵賢鎭),조은희(趙恩禧),33,14,47,0
27190,배현진(裵賢鎭),조응천(趙應天),50,5,55,1
27191,배현진(裵賢鎭),조정식(趙正湜),49,3,52,1
27192,배현진(裵賢鎭),조정훈(趙廷訓),1,1,2,1
27193,배현진(裵賢鎭),조해진(曺海珍),63,32,95,0
27194,배현진(裵賢鎭),주철현(朱哲鉉),50,4,54,1
27195,배현진(裵賢鎭),주호영(朱豪英),70,44,114,0
27196,배현진(裵賢鎭),지성호(池成浩),78,71,149,0
27197,배현진(裵賢鎭),진선미(陳善美),49,5,54,1
27198,배현진(裵賢鎭),진성준(陳聲準),49,4,53,1
27199,배현진(裵賢鎭),천준호(千俊鎬),49,3,52,1
27200,배현진(裵賢鎭),최기상(崔基相),49,5,54,1
27201,배현진(裵賢鎭),최승재(崔承宰),82,79,161,0
27202,배현진(裵賢鎭),최연숙(崔姸淑),38,29,67,0
27203,배현진(裵賢鎭),최영희(崔英姬),33,21,54,0
27204,배현진(裵賢鎭),최인호(崔仁昊),49,4,53,1
27205,배현진(裵賢鎭),최재형(崔在亨),28,11,39,0
27206,배현진(裵賢鎭),최종윤(崔鍾允),49,4,53,1
27207,배현진(裵賢鎭),최춘식(崔春植),70,61,131,0
27208,배현진(裵賢鎭),최형두(崔炯斗),98,74,172,0
27209,배현진(裵賢鎭),최혜영(崔惠英),50,5,55,1
27210,배현진(裵賢鎭),추경호(秋慶鎬),85,102,187,0
27211,배현진(裵賢鎭),태영호(太永浩),82,96,178,0
27212,배현진(裵賢鎭),하영제(河榮帝),67,72,139,1
27213,배현진(裵賢鎭),하태경(河泰慶),64,41,105,0
27214,배현진(裵賢鎭),한기호(韓起鎬),66,42,108,0
27215,배현진(裵賢鎭),한무경(韓茂景),80,73,153,0
27216,배현진(裵賢鎭),한병도(韓秉道),49,4,53,1
27217,배현진(裵賢鎭),한정애(韓貞愛),49,4,53,1
27218,배현진(裵賢鎭),한준호(韓俊鎬),50,4,54,1
27219,배현진(裵賢鎭),허숙정(許淑湞),0,0,0,1
27220,배현진(裵賢鎭),허영(許榮),50,5,55,1
27221,배현진(裵賢鎭),허은아(許垠娥),72,59,131,0
27222,배현진(裵賢鎭),허종식(許琮植),50,5,55,1
27223,배현진(裵賢鎭),홍기원(洪起元),49,5,54,1
27224,배현진(裵賢鎭),홍문표(洪文杓),68,62,130,0
27225,배현진(裵賢鎭),홍석준(洪碩晙),73,59,132,0
27226,배현진(裵賢鎭),홍성국(洪性國),49,5,54,1
27227,배현진(裵賢鎭),홍영표(洪永杓),50,5,55,1
27228,배현진(裵賢鎭),홍익표(洪翼杓),49,5,54,1
27229,배현진(裵賢鎭),홍정민(洪貞敏),49,5,54,1
27230,배현진(裵賢鎭),황보승희(皇甫承希),97,78,175,1
27231,배현진(裵賢鎭),황운하(黃雲夏),49,5,54,1
27232,배현진(裵賢鎭),황희(黃熙),49,7,56,1
27233,백종헌(白宗憲),백혜련(白惠蓮),51,4,55,1
27234,백종헌(白宗憲),변재일(卞在一),51,6,57,1
27235,백종헌(白宗憲),서동용(徐東榕),50,5,55,1
27236,백종헌(白宗憲),서범수(徐範洙),92,171,263,0
27237,백종헌(白宗憲),서병수(徐秉洙),107,172,279,0
27238,백종헌(白宗憲),서삼석(徐參錫),50,5,55,1
27239,백종헌(白宗憲),서영교(徐瑛敎),52,6,58,1
27240,백종헌(白宗憲),서영석(徐暎錫),49,7,56,1
27241,백종헌(白宗憲),서일준(徐一俊),116,187,303,0
27242,백종헌(白宗憲),서정숙(徐正淑),92,174,266,0
27243,백종헌(白宗憲),설훈(薛勳),50,5,55,1
27244,백종헌(白宗憲),성일종(成一鍾),91,181,272,0
27245,백종헌(白宗憲),소병철(蘇秉哲),51,4,55,1
27246,백종헌(白宗憲),소병훈(蘇秉勳),51,4,55,1
27247,백종헌(白宗憲),송갑석(宋甲錫),51,4,55,1
27248,백종헌(白宗憲),송기헌(宋基憲),51,4,55,1
27249,백종헌(白宗憲),송석준(宋錫俊),78,109,187,0
27250,백종헌(白宗憲),송언석(宋彦錫),78,81,159,0
27251,백종헌(白宗憲),송옥주(宋玉珠),50,5,55,1
27252,백종헌(白宗憲),송재호(宋在祜),53,6,59,1
27253,백종헌(白宗憲),신동근(申東根),50,3,53,1
27254,백종헌(白宗憲),신영대(申榮大),50,4,54,1
27255,백종헌(白宗憲),신원식(申源湜),83,160,243,0
27256,백종헌(白宗憲),신정훈(辛正勳),52,6,58,1
27257,백종헌(白宗憲),신현영(申賢榮),50,4,54,1
27258,백종헌(白宗憲),심상정(沈相奵),6,4,10,1
27259,백종헌(白宗憲),안규백(安圭伯),54,8,62,1
27260,백종헌(白宗憲),안민석(安敏錫),51,4,55,1
27261,백종헌(白宗憲),안병길(安炳吉),100,209,309,0
27262,백종헌(白宗憲),안철수(安哲秀),28,44,72,0
27263,백종헌(白宗憲),안호영(安浩永),51,4,55,1
27264,백종헌(白宗憲),양경숙(梁敬淑),50,5,55,1
27265,백종헌(白宗憲),양금희(梁琴喜),106,191,297,0
27266,백종헌(白宗憲),양기대(梁基大),51,4,55,1
27267,백종헌(白宗憲),양이원영(梁李媛瑛),45,4,49,1
27268,백종헌(白宗憲),양정숙(梁貞淑),7,26,33,1
27269,백종헌(白宗憲),양향자(梁香子),22,11,33,1
27270,백종헌(白宗憲),어기구(魚基龜),51,8,59,1
27271,백종헌(白宗憲),엄태영(嚴泰永),90,113,203,0
27272,백종헌(白宗憲),오기형(吳奇炯),49,9,58,1
27273,백종헌(白宗憲),오영환(吳永煥),51,10,61,1
27274,백종헌(白宗憲),용혜인(龍慧仁),1,6,7,1
27275,백종헌(白宗憲),우상호(禹相虎),51,4,55,1
27276,백종헌(白宗憲),우원식(禹元植),50,4,54,1
27277,백종헌(白宗憲),위성곤(魏聖坤),50,7,57,1
27278,백종헌(白宗憲),유경준(兪京濬),99,150,249,0
27279,백종헌(白宗憲),유기홍(柳基洪),50,4,54,1
27280,백종헌(白宗憲),유동수(柳東秀),51,4,55,1
27281,백종헌(白宗憲),유상범(劉相凡),64,95,159,0
27282,백종헌(白宗憲),유의동(兪義東),79,91,170,0
27283,백종헌(白宗憲),유정주(兪訂炷),49,4,53,1
27284,백종헌(白宗憲),윤건영(尹建永),49,4,53,1
27285,백종헌(白宗憲),윤관석(尹官石),41,0,41,1
27286,백종헌(白宗憲),윤두현(尹斗鉉),87,177,264,0
27287,백종헌(白宗憲),윤미향(尹美香),20,0,20,1
27288,백종헌(白宗憲),윤상현(尹相現),38,69,107,0
27289,백종헌(白宗憲),윤영덕(尹永德),49,8,57,1
27290,백종헌(白宗憲),윤영석(尹永碩),73,79,152,0
27291,백종헌(白宗憲),윤영찬(尹永燦),50,6,56,1
27292,백종헌(白宗憲),윤재갑(尹才鉀),52,13,65,1
27293,백종헌(白宗憲),윤재옥(尹在玉),74,77,151,0
27294,백종헌(白宗憲),윤주경(尹柱卿),79,120,199,0
27295,백종헌(白宗憲),윤준병(尹準炳),50,6,56,1
27296,백종헌(白宗憲),윤창현(尹暢賢),96,155,251,0
27297,백종헌(白宗憲),윤한홍(尹漢洪),71,114,185,0
27298,백종헌(白宗憲),윤호중(尹昊重),51,4,55,1
27299,백종헌(白宗憲),윤후덕(尹厚德),51,4,55,1
27300,백종헌(白宗憲),이개호(李介昊),51,4,55,1
27301,백종헌(白宗憲),이달곤(李達坤),69,103,172,0
27302,백종헌(白宗憲),이동주(李東洲),49,5,54,1
27303,백종헌(白宗憲),이만희(李晩熙),81,103,184,0
27304,백종헌(白宗憲),이명수(李明洙),92,179,271,0
27305,백종헌(白宗憲),이병훈(李炳勳),53,11,64,1
27306,백종헌(白宗憲),이상민(李相珉),51,5,56,1
27307,백종헌(白宗憲),이상헌(李相憲),53,5,58,1
27308,백종헌(白宗憲),이성만(李成萬),41,0,41,1
27309,백종헌(白宗憲),이소영(李素永),52,5,57,1
27310,백종헌(白宗憲),이수진(李壽珍),51,6,57,1
27311,백종헌(白宗憲),이수진(李秀眞),50,5,55,1
27312,백종헌(白宗憲),이양수(李亮壽),81,112,193,0
27313,백종헌(白宗憲),이용(李鏞),73,117,190,0
27314,백종헌(白宗憲),이용빈(李龍彬),52,8,60,1
27315,백종헌(白宗憲),이용선(李庸瑄),50,7,57,1
27316,백종헌(白宗憲),이용우(李龍雨),49,11,60,1
27317,백종헌(白宗憲),이용호(李容鎬),33,26,59,0
27318,백종헌(白宗憲),이원욱(李元旭),51,4,55,1
27319,백종헌(白宗憲),이원택(李源澤),50,4,54,1
27320,백종헌(白宗憲),이은주(李恩周),6,3,9,1
27321,백종헌(白宗憲),이인선(李仁善),38,119,157,0
27322,백종헌(白宗憲),이인영(李仁榮),50,4,54,1
27323,백종헌(白宗憲),이장섭(李將燮),50,4,54,1
27324,백종헌(白宗憲),이재명(李在明),25,4,29,1
27325,백종헌(白宗憲),이재정(李在汀),50,4,54,1
27326,백종헌(白宗憲),이정문(李楨文),50,8,58,1
27327,백종헌(白宗憲),이종배(李鍾培),100,89,189,0
27328,백종헌(白宗憲),이종성(李鍾成),116,309,425,0
27329,백종헌(白宗憲),이주환(李周桓),128,246,374,0
27330,백종헌(白宗憲),이채익(李埰益),96,162,258,0
27331,백종헌(白宗憲),이철규(李喆圭),88,104,192,0
27332,백종헌(白宗憲),이탄희(李誕熙),50,4,54,1
27333,백종헌(白宗憲),이태규(李泰珪),51,67,118,0
27334,백종헌(白宗憲),이학영(李學永),49,4,53,1
27335,백종헌(白宗憲),이해식(李海植),50,4,54,1
27336,백종헌(白宗憲),이헌승(李憲昇),86,207,293,0
27337,백종헌(白宗憲),이형석(李炯錫),50,4,54,1
27338,백종헌(白宗憲),인재근(印在謹),51,9,60,1
27339,백종헌(白宗憲),임병헌(林炳憲),36,116,152,0
27340,백종헌(白宗憲),임오경(林五卿),50,5,55,1
27341,백종헌(白宗憲),임이자(林利子),91,116,207,0
27342,백종헌(白宗憲),임종성(林鍾聲),53,4,57,1
27343,백종헌(白宗憲),임호선(林昊宣),53,7,60,1
27344,백종헌(白宗憲),장경태(張耿態),50,4,54,1
27345,백종헌(白宗憲),장동혁(張東赫),33,70,103,0
27346,백종헌(白宗憲),장제원(張濟元),76,73,149,0
27347,백종헌(白宗憲),장철민(張喆敏),51,6,57,1
27348,백종헌(白宗憲),장혜영(張惠英),7,4,11,1
27349,백종헌(白宗憲),전봉민(田奉珉),86,232,318,0
27350,백종헌(白宗憲),전용기(田溶冀),50,6,56,1
27351,백종헌(白宗憲),전재수(田載秀),51,9,60,1
27352,백종헌(白宗憲),전주혜(全珠惠),73,104,177,0
27353,백종헌(白宗憲),전해철(全海澈),50,5,55,1
27354,백종헌(白宗憲),전혜숙(全惠淑),51,8,59,1
27355,백종헌(白宗憲),정경희(丁慶姬),87,129,216,0
27356,백종헌(白宗憲),정동만(鄭東萬),102,185,287,0
27357,백종헌(白宗憲),정성호(鄭成湖),52,5,57,1
27358,백종헌(白宗憲),정우택(鄭宇澤),47,96,143,0
27359,백종헌(白宗憲),정운천(鄭雲天),88,160,248,0
27360,백종헌(白宗憲),정일영(鄭日永),49,5,54,1
27361,백종헌(白宗憲),정점식(鄭点植),69,66,135,0
27362,백종헌(白宗憲),정진석(鄭鎭碩),79,91,170,0
27363,백종헌(白宗憲),정청래(鄭淸來),50,4,54,1
27364,백종헌(白宗憲),정춘숙(鄭春淑),50,5,55,1
27365,백종헌(白宗憲),정태호(鄭泰浩),50,5,55,1
27366,백종헌(白宗憲),정필모(鄭必模),50,4,54,1
27367,백종헌(白宗憲),정희용(鄭熙溶),86,147,233,0
27368,백종헌(白宗憲),조경태(趙慶泰),100,156,256,0
27369,백종헌(白宗憲),조명희(曺明姬),116,234,350,0
27370,백종헌(白宗憲),조수진(趙修眞),89,152,241,0
27371,백종헌(白宗憲),조승래(趙承來),50,6,56,1
27372,백종헌(白宗憲),조오섭(曺五燮),55,7,62,1
27373,백종헌(白宗憲),조은희(趙恩禧),34,88,122,0
27374,백종헌(白宗憲),조응천(趙應天),50,3,53,1
27375,백종헌(白宗憲),조정식(趙正湜),49,3,52,1
27376,백종헌(白宗憲),조정훈(趙廷訓),4,20,24,1
27377,백종헌(白宗憲),조해진(曺海珍),66,60,126,0
27378,백종헌(白宗憲),주철현(朱哲鉉),51,5,56,1
27379,백종헌(白宗憲),주호영(朱豪英),67,64,131,0
27380,백종헌(白宗憲),지성호(池成浩),111,212,323,0
27381,백종헌(白宗憲),진선미(陳善美),50,4,54,1
27382,백종헌(白宗憲),진성준(陳聲準),50,5,55,1
27383,백종헌(白宗憲),천준호(千俊鎬),49,3,52,1
27384,백종헌(白宗憲),최기상(崔基相),50,4,54,1
27385,백종헌(白宗憲),최승재(崔承宰),94,128,222,0
27386,백종헌(白宗憲),최연숙(崔姸淑),45,84,129,0
27387,백종헌(白宗憲),최영희(崔英姬),36,108,144,0
27388,백종헌(白宗憲),최인호(崔仁昊),53,7,60,1
27389,백종헌(白宗憲),최재형(崔在亨),30,33,63,0
27390,백종헌(白宗憲),최종윤(崔鍾允),51,6,57,1
27391,백종헌(白宗憲),최춘식(崔春植),88,164,252,0
27392,백종헌(白宗憲),최형두(崔炯斗),82,96,178,0
27393,백종헌(白宗憲),최혜영(崔惠英),50,8,58,1
27394,백종헌(白宗憲),추경호(秋慶鎬),112,96,208,0
27395,백종헌(白宗憲),태영호(太永浩),97,222,319,0
27396,백종헌(白宗憲),하영제(河榮帝),98,258,356,1
27397,백종헌(白宗憲),하태경(河泰慶),76,110,186,0
27398,백종헌(白宗憲),한기호(韓起鎬),76,92,168,0
27399,백종헌(白宗憲),한무경(韓茂景),94,158,252,0
27400,백종헌(白宗憲),한병도(韓秉道),50,4,54,1
27401,백종헌(白宗憲),한정애(韓貞愛),50,5,55,1
27402,백종헌(白宗憲),한준호(韓俊鎬),51,5,56,1
27403,백종헌(白宗憲),허숙정(許淑湞),0,0,0,1
27404,백종헌(白宗憲),허영(許榮),53,4,57,1
27405,백종헌(白宗憲),허은아(許垠娥),81,93,174,0
27406,백종헌(白宗憲),허종식(許琮植),51,7,58,1
27407,백종헌(白宗憲),홍기원(洪起元),50,5,55,1
27408,백종헌(白宗憲),홍문표(洪文杓),80,114,194,0
27409,백종헌(白宗憲),홍석준(洪碩晙),81,113,194,0
27410,백종헌(白宗憲),홍성국(洪性國),50,4,54,1
27411,백종헌(白宗憲),홍영표(洪永杓),51,4,55,1
27412,백종헌(白宗憲),홍익표(洪翼杓),51,4,55,1
27413,백종헌(白宗憲),홍정민(洪貞敏),52,6,58,1
27414,백종헌(白宗憲),황보승희(皇甫承希),119,270,389,1
27415,백종헌(白宗憲),황운하(黃雲夏),50,8,58,1
27416,백종헌(白宗憲),황희(黃熙),49,11,60,1
27417,백혜련(白惠蓮),변재일(卞在一),89,46,135,0
27418,백혜련(白惠蓮),서동용(徐東榕),87,55,142,0
27419,백혜련(白惠蓮),서범수(徐範洙),51,5,56,1
27420,백혜련(白惠蓮),서병수(徐秉洙),50,5,55,1
27421,백혜련(白惠蓮),서삼석(徐參錫),97,65,162,0
27422,백혜련(白惠蓮),서영교(徐瑛敎),114,110,224,0
27423,백혜련(白惠蓮),서영석(徐暎錫),89,71,160,0
27424,백혜련(白惠蓮),서일준(徐一俊),51,5,56,1
27425,백혜련(白惠蓮),서정숙(徐正淑),49,6,55,1
27426,백혜련(白惠蓮),설훈(薛勳),86,48,134,0
27427,백혜련(白惠蓮),성일종(成一鍾),50,5,55,1
27428,백혜련(白惠蓮),소병철(蘇秉哲),121,64,185,0
27429,백혜련(白惠蓮),소병훈(蘇秉勳),93,81,174,0
27430,백혜련(白惠蓮),송갑석(宋甲錫),94,66,160,0
27431,백혜련(白惠蓮),송기헌(宋基憲),116,77,193,0
27432,백혜련(白惠蓮),송석준(宋錫俊),50,5,55,1
27433,백혜련(白惠蓮),송언석(宋彦錫),47,4,51,1
27434,백혜련(白惠蓮),송옥주(宋玉珠),96,76,172,0
27435,백혜련(白惠蓮),송재호(宋在祜),102,70,172,0
27436,백혜련(白惠蓮),신동근(申東根),114,50,164,0
27437,백혜련(白惠蓮),신영대(申榮大),82,54,136,0
27438,백혜련(白惠蓮),신원식(申源湜),50,5,55,1
27439,백혜련(白惠蓮),신정훈(辛正勳),98,78,176,0
27440,백혜련(白惠蓮),신현영(申賢榮),86,52,138,0
27441,백혜련(白惠蓮),심상정(沈相奵),15,16,31,1
27442,백혜련(白惠蓮),안규백(安圭伯),107,94,201,0
27443,백혜련(白惠蓮),안민석(安敏錫),89,64,153,0
27444,백혜련(白惠蓮),안병길(安炳吉),51,4,55,1
27445,백혜련(白惠蓮),안철수(安哲秀),26,4,30,1
27446,백혜련(白惠蓮),안호영(安浩永),89,51,140,0
27447,백혜련(白惠蓮),양경숙(梁敬淑),96,80,176,0
27448,백혜련(白惠蓮),양금희(梁琴喜),51,7,58,1
27449,백혜련(白惠蓮),양기대(梁基大),91,48,139,0
27450,백혜련(白惠蓮),양이원영(梁李媛瑛),95,74,169,0
27451,백혜련(白惠蓮),양정숙(梁貞淑),40,83,123,1
27452,백혜련(白惠蓮),양향자(梁香子),50,36,86,1
27453,백혜련(白惠蓮),어기구(魚基龜),81,41,122,0
27454,백혜련(白惠蓮),엄태영(嚴泰永),51,4,55,1
27455,백혜련(白惠蓮),오기형(吳奇炯),81,37,118,0
27456,백혜련(白惠蓮),오영환(吳永煥),136,144,280,0
27457,백혜련(白惠蓮),용혜인(龍慧仁),18,28,46,1
27458,백혜련(白惠蓮),우상호(禹相虎),81,48,129,0
27459,백혜련(白惠蓮),우원식(禹元植),92,52,144,0
27460,백혜련(白惠蓮),위성곤(魏聖坤),89,65,154,0
27461,백혜련(白惠蓮),유경준(兪京濬),49,4,53,1
27462,백혜련(白惠蓮),유기홍(柳基洪),76,44,120,0
27463,백혜련(白惠蓮),유동수(柳東秀),91,54,145,0
27464,백혜련(白惠蓮),유상범(劉相凡),50,4,54,1
27465,백혜련(白惠蓮),유의동(兪義東),50,4,54,1
27466,백혜련(白惠蓮),유정주(兪訂炷),100,76,176,0
27467,백혜련(白惠蓮),윤건영(尹建永),87,54,141,0
27468,백혜련(白惠蓮),윤관석(尹官石),103,98,201,1
27469,백혜련(白惠蓮),윤두현(尹斗鉉),50,6,56,1
27470,백혜련(白惠蓮),윤미향(尹美香),42,42,84,1
27471,백혜련(白惠蓮),윤상현(尹相現),32,4,36,1
27472,백혜련(白惠蓮),윤영덕(尹永德),94,76,170,0
27473,백혜련(白惠蓮),윤영석(尹永碩),50,5,55,1
27474,백혜련(白惠蓮),윤영찬(尹永燦),84,44,128,0
27475,백혜련(白惠蓮),윤재갑(尹才鉀),94,59,153,0
27476,백혜련(白惠蓮),윤재옥(尹在玉),50,5,55,1
27477,백혜련(白惠蓮),윤주경(尹柱卿),49,5,54,1
27478,백혜련(白惠蓮),윤준병(尹準炳),96,79,175,0
27479,백혜련(白惠蓮),윤창현(尹暢賢),49,6,55,1
27480,백혜련(白惠蓮),윤한홍(尹漢洪),51,5,56,1
27481,백혜련(白惠蓮),윤호중(尹昊重),82,52,134,0
27482,백혜련(白惠蓮),윤후덕(尹厚德),105,90,195,0
27483,백혜련(白惠蓮),이개호(李介昊),86,54,140,0
27484,백혜련(白惠蓮),이달곤(李達坤),54,5,59,1
27485,백혜련(白惠蓮),이동주(李東洲),85,62,147,0
27486,백혜련(白惠蓮),이만희(李晩熙),50,4,54,1
27487,백혜련(白惠蓮),이명수(李明洙),50,7,57,1
27488,백혜련(白惠蓮),이병훈(李炳勳),100,78,178,0
27489,백혜련(白惠蓮),이상민(李相珉),78,35,113,0
27490,백혜련(白惠蓮),이상헌(李相憲),88,62,150,0
27491,백혜련(白惠蓮),이성만(李成萬),87,87,174,1
27492,백혜련(白惠蓮),이소영(李素永),84,46,130,0
27493,백혜련(白惠蓮),이수진(李壽珍),103,81,184,0
27494,백혜련(白惠蓮),이수진(李秀眞),90,55,145,0
27495,백혜련(白惠蓮),이양수(李亮壽),53,4,57,1
27496,백혜련(白惠蓮),이용(李鏞),50,4,54,1
27497,백혜련(白惠蓮),이용빈(李龍彬),103,104,207,0
27498,백혜련(白惠蓮),이용선(李庸瑄),91,62,153,0
27499,백혜련(白惠蓮),이용우(李龍雨),90,51,141,0
27500,백혜련(白惠蓮),이용호(李容鎬),31,8,39,1
27501,백혜련(白惠蓮),이원욱(李元旭),109,101,210,0
27502,백혜련(白惠蓮),이원택(李源澤),90,64,154,0
27503,백혜련(白惠蓮),이은주(李恩周),18,27,45,1
27504,백혜련(白惠蓮),이인선(李仁善),25,5,30,1
27505,백혜련(白惠蓮),이인영(李仁榮),81,46,127,0
27506,백혜련(白惠蓮),이장섭(李將燮),87,69,156,0
27507,백혜련(白惠蓮),이재명(李在明),39,18,57,0
27508,백혜련(白惠蓮),이재정(李在汀),88,49,137,0
27509,백혜련(白惠蓮),이정문(李楨文),96,92,188,0
27510,백혜련(白惠蓮),이종배(李鍾培),53,5,58,1
27511,백혜련(白惠蓮),이종성(李鍾成),50,4,54,1
27512,백혜련(白惠蓮),이주환(李周桓),52,4,56,1
27513,백혜련(白惠蓮),이채익(李埰益),52,6,58,1
27514,백혜련(白惠蓮),이철규(李喆圭),52,5,57,1
27515,백혜련(白惠蓮),이탄희(李誕熙),95,51,146,0
27516,백혜련(白惠蓮),이태규(李泰珪),29,5,34,1
27517,백혜련(白惠蓮),이학영(李學永),99,82,181,0
27518,백혜련(白惠蓮),이해식(李海植),108,79,187,0
27519,백혜련(白惠蓮),이헌승(李憲昇),52,6,58,1
27520,백혜련(白惠蓮),이형석(李炯錫),118,97,215,0
27521,백혜련(白惠蓮),인재근(印在謹),87,80,167,0
27522,백혜련(白惠蓮),임병헌(林炳憲),25,5,30,1
27523,백혜련(白惠蓮),임오경(林五卿),92,53,145,0
27524,백혜련(白惠蓮),임이자(林利子),49,5,54,1
27525,백혜련(白惠蓮),임종성(林鍾聲),105,78,183,0
27526,백혜련(白惠蓮),임호선(林昊宣),124,124,248,0
27527,백혜련(白惠蓮),장경태(張耿態),98,67,165,0
27528,백혜련(白惠蓮),장동혁(張東赫),25,4,29,1
27529,백혜련(白惠蓮),장제원(張濟元),49,4,53,1
27530,백혜련(白惠蓮),장철민(張喆敏),89,52,141,0
27531,백혜련(白惠蓮),장혜영(張惠英),13,11,24,1
27532,백혜련(白惠蓮),전봉민(田奉珉),35,7,42,1
27533,백혜련(白惠蓮),전용기(田溶冀),108,80,188,0
27534,백혜련(白惠蓮),전재수(田載秀),88,53,141,0
27535,백혜련(白惠蓮),전주혜(全珠惠),52,6,58,1
27536,백혜련(白惠蓮),전해철(全海澈),82,58,140,0
27537,백혜련(白惠蓮),전혜숙(全惠淑),97,70,167,0
27538,백혜련(白惠蓮),정경희(丁慶姬),50,5,55,1
27539,백혜련(白惠蓮),정동만(鄭東萬),51,6,57,1
27540,백혜련(白惠蓮),정성호(鄭成湖),100,96,196,0
27541,백혜련(白惠蓮),정우택(鄭宇澤),26,5,31,1
27542,백혜련(白惠蓮),정운천(鄭雲天),50,4,54,1
27543,백혜련(白惠蓮),정일영(鄭日永),93,79,172,0
27544,백혜련(白惠蓮),정점식(鄭点植),50,5,55,1
27545,백혜련(白惠蓮),정진석(鄭鎭碩),50,5,55,1
27546,백혜련(白惠蓮),정청래(鄭淸來),88,46,134,0
27547,백혜련(白惠蓮),정춘숙(鄭春淑),92,68,160,0
27548,백혜련(白惠蓮),정태호(鄭泰浩),84,55,139,0
27549,백혜련(白惠蓮),정필모(鄭必模),90,46,136,0
27550,백혜련(白惠蓮),정희용(鄭熙溶),50,6,56,1
27551,백혜련(白惠蓮),조경태(趙慶泰),50,4,54,1
27552,백혜련(白惠蓮),조명희(曺明姬),50,8,58,1
27553,백혜련(白惠蓮),조수진(趙修眞),50,4,54,1
27554,백혜련(白惠蓮),조승래(趙承來),98,55,153,0
27555,백혜련(白惠蓮),조오섭(曺五燮),101,97,198,0
27556,백혜련(白惠蓮),조은희(趙恩禧),26,4,30,1
27557,백혜련(白惠蓮),조응천(趙應天),75,45,120,0
27558,백혜련(白惠蓮),조정식(趙正湜),83,41,124,0
27559,백혜련(白惠蓮),조정훈(趙廷訓),4,2,6,1
27560,백혜련(白惠蓮),조해진(曺海珍),51,5,56,1
27561,백혜련(白惠蓮),주철현(朱哲鉉),87,53,140,0
27562,백혜련(白惠蓮),주호영(朱豪英),49,4,53,1
27563,백혜련(白惠蓮),지성호(池成浩),50,4,54,1
27564,백혜련(白惠蓮),진선미(陳善美),78,45,123,0
27565,백혜련(白惠蓮),진성준(陳聲準),94,55,149,0
27566,백혜련(白惠蓮),천준호(千俊鎬),90,46,136,0
27567,백혜련(白惠蓮),최기상(崔基相),114,57,171,0
27568,백혜련(白惠蓮),최승재(崔承宰),50,6,56,1
27569,백혜련(白惠蓮),최연숙(崔姸淑),32,10,42,1
27570,백혜련(白惠蓮),최영희(崔英姬),25,4,29,1
27571,백혜련(白惠蓮),최인호(崔仁昊),89,50,139,0
27572,백혜련(白惠蓮),최재형(崔在亨),25,5,30,1
27573,백혜련(白惠蓮),최종윤(崔鍾允),110,112,222,0
27574,백혜련(白惠蓮),최춘식(崔春植),49,5,54,1
27575,백혜련(白惠蓮),최형두(崔炯斗),52,6,58,1
27576,백혜련(白惠蓮),최혜영(崔惠英),99,98,197,0
27577,백혜련(白惠蓮),추경호(秋慶鎬),50,4,54,1
27578,백혜련(白惠蓮),태영호(太永浩),49,5,54,1
27579,백혜련(白惠蓮),하영제(河榮帝),44,3,47,1
27580,백혜련(白惠蓮),하태경(河泰慶),50,4,54,1
27581,백혜련(白惠蓮),한기호(韓起鎬),52,5,57,1
27582,백혜련(白惠蓮),한무경(韓茂景),49,6,55,1
27583,백혜련(白惠蓮),한병도(韓秉道),104,84,188,0
27584,백혜련(白惠蓮),한정애(韓貞愛),77,51,128,0
27585,백혜련(白惠蓮),한준호(韓俊鎬),92,77,169,0
27586,백혜련(白惠蓮),허숙정(許淑湞),1,1,2,0
27587,백혜련(白惠蓮),허영(許榮),102,77,179,0
27588,백혜련(白惠蓮),허은아(許垠娥),49,4,53,1
27589,백혜련(白惠蓮),허종식(許琮植),90,57,147,0
27590,백혜련(白惠蓮),홍기원(洪起元),90,52,142,0
27591,백혜련(白惠蓮),홍문표(洪文杓),50,4,54,1
27592,백혜련(白惠蓮),홍석준(洪碩晙),51,4,55,1
27593,백혜련(白惠蓮),홍성국(洪性國),101,75,176,0
27594,백혜련(白惠蓮),홍영표(洪永杓),92,56,148,0
27595,백혜련(白惠蓮),홍익표(洪翼杓),96,54,150,0
27596,백혜련(白惠蓮),홍정민(洪貞敏),102,74,176,0
27597,백혜련(白惠蓮),황보승희(皇甫承希),47,2,49,1
27598,백혜련(白惠蓮),황운하(黃雲夏),102,90,192,0
27599,백혜련(白惠蓮),황희(黃熙),77,40,117,0
27600,변재일(卞在一),서동용(徐東榕),78,55,133,0
27601,변재일(卞在一),서범수(徐範洙),52,4,56,1
27602,변재일(卞在一),서병수(徐秉洙),50,4,54,1
27603,변재일(卞在一),서삼석(徐參錫),82,46,128,0
27604,변재일(卞在一),서영교(徐瑛敎),89,79,168,0
27605,변재일(卞在一),서영석(徐暎錫),99,81,180,0
27606,변재일(卞在一),서일준(徐一俊),51,4,55,1
27607,변재일(卞在一),서정숙(徐正淑),49,5,54,1
27608,변재일(卞在一),설훈(薛勳),86,55,141,0
27609,변재일(卞在一),성일종(成一鍾),51,7,58,1
27610,변재일(卞在一),소병철(蘇秉哲),81,43,124,0
27611,변재일(卞在一),소병훈(蘇秉勳),83,58,141,0
27612,변재일(卞在一),송갑석(宋甲錫),91,69,160,0
27613,변재일(卞在一),송기헌(宋基憲),78,40,118,0
27614,변재일(卞在一),송석준(宋錫俊),50,5,55,1
27615,변재일(卞在一),송언석(宋彦錫),45,4,49,1
27616,변재일(卞在一),송옥주(宋玉珠),88,51,139,0
27617,변재일(卞在一),송재호(宋在祜),85,57,142,0
27618,변재일(卞在一),신동근(申東根),94,70,164,0
27619,변재일(卞在一),신영대(申榮大),90,45,135,0
27620,변재일(卞在一),신원식(申源湜),50,5,55,1
27621,변재일(卞在一),신정훈(辛正勳),92,92,184,0
27622,변재일(卞在一),신현영(申賢榮),78,50,128,0
27623,변재일(卞在一),심상정(沈相奵),11,14,25,1
27624,변재일(卞在一),안규백(安圭伯),88,66,154,0
27625,변재일(卞在一),안민석(安敏錫),96,66,162,0
27626,변재일(卞在一),안병길(安炳吉),50,4,54,1
27627,변재일(卞在一),안철수(安哲秀),25,6,31,1
27628,변재일(卞在一),안호영(安浩永),81,61,142,0
27629,변재일(卞在一),양경숙(梁敬淑),80,59,139,0
27630,변재일(卞在一),양금희(梁琴喜),53,6,59,1
27631,변재일(卞在一),양기대(梁基大),80,61,141,0
27632,변재일(卞在一),양이원영(梁李媛瑛),79,53,132,0
27633,변재일(卞在一),양정숙(梁貞淑),38,93,131,1
27634,변재일(卞在一),양향자(梁香子),42,40,82,1
27635,변재일(卞在一),어기구(魚基龜),78,39,117,0
27636,변재일(卞在一),엄태영(嚴泰永),51,5,56,1
27637,변재일(卞在一),오기형(吳奇炯),74,34,108,0
27638,변재일(卞在一),오영환(吳永煥),97,86,183,0
27639,변재일(卞在一),용혜인(龍慧仁),11,14,25,1
27640,변재일(卞在一),우상호(禹相虎),77,36,113,0
27641,변재일(卞在一),우원식(禹元植),80,53,133,0
27642,변재일(卞在一),위성곤(魏聖坤),81,43,124,0
27643,변재일(卞在一),유경준(兪京濬),50,5,55,1
27644,변재일(卞在一),유기홍(柳基洪),75,44,119,0
27645,변재일(卞在一),유동수(柳東秀),77,38,115,0
27646,변재일(卞在一),유상범(劉相凡),49,4,53,1
27647,변재일(卞在一),유의동(兪義東),50,7,57,1
27648,변재일(卞在一),유정주(兪訂炷),97,73,170,0
27649,변재일(卞在一),윤건영(尹建永),81,38,119,0
27650,변재일(卞在一),윤관석(尹官石),75,58,133,1
27651,변재일(卞在一),윤두현(尹斗鉉),50,5,55,1
27652,변재일(卞在一),윤미향(尹美香),37,33,70,1
27653,변재일(卞在一),윤상현(尹相現),30,4,34,1
27654,변재일(卞在一),윤영덕(尹永德),81,68,149,0
27655,변재일(卞在一),윤영석(尹永碩),51,5,56,1
27656,변재일(卞在一),윤영찬(尹永燦),93,83,176,0
27657,변재일(卞在一),윤재갑(尹才鉀),86,46,132,0
27658,변재일(卞在一),윤재옥(尹在玉),50,4,54,1
27659,변재일(卞在一),윤주경(尹柱卿),49,5,54,1
27660,변재일(卞在一),윤준병(尹準炳),91,83,174,0
27661,변재일(卞在一),윤창현(尹暢賢),49,5,54,1
27662,변재일(卞在一),윤한홍(尹漢洪),50,4,54,1
27663,변재일(卞在一),윤호중(尹昊重),80,53,133,0
27664,변재일(卞在一),윤후덕(尹厚德),83,54,137,0
27665,변재일(卞在一),이개호(李介昊),79,50,129,0
27666,변재일(卞在一),이달곤(李達坤),51,5,56,1
27667,변재일(卞在一),이동주(李東洲),79,58,137,0
27668,변재일(卞在一),이만희(李晩熙),50,4,54,1
27669,변재일(卞在一),이명수(李明洙),51,8,59,1
27670,변재일(卞在一),이병훈(李炳勳),84,57,141,0
27671,변재일(卞在一),이상민(李相珉),74,37,111,0
27672,변재일(卞在一),이상헌(李相憲),83,51,134,0
27673,변재일(卞在一),이성만(李成萬),80,47,127,1
27674,변재일(卞在一),이소영(李素永),78,37,115,0
27675,변재일(卞在一),이수진(李壽珍),90,56,146,0
27676,변재일(卞在一),이수진(李秀眞),87,64,151,0
27677,변재일(卞在一),이양수(李亮壽),50,5,55,1
27678,변재일(卞在一),이용(李鏞),49,4,53,1
27679,변재일(卞在一),이용빈(李龍彬),114,108,222,0
27680,변재일(卞在一),이용선(李庸瑄),81,62,143,0
27681,변재일(卞在一),이용우(李龍雨),83,42,125,0
27682,변재일(卞在一),이용호(李容鎬),32,7,39,1
27683,변재일(卞在一),이원욱(李元旭),89,66,155,0
27684,변재일(卞在一),이원택(李源澤),77,60,137,0
27685,변재일(卞在一),이은주(李恩周),12,12,24,1
27686,변재일(卞在一),이인선(李仁善),25,5,30,1
27687,변재일(卞在一),이인영(李仁榮),76,49,125,0
27688,변재일(卞在一),이장섭(李將燮),95,92,187,0
27689,변재일(卞在一),이재명(李在明),39,16,55,0
27690,변재일(卞在一),이재정(李在汀),79,41,120,0
27691,변재일(卞在一),이정문(李楨文),127,133,260,0
27692,변재일(卞在一),이종배(李鍾培),50,9,59,1
27693,변재일(卞在一),이종성(李鍾成),49,5,54,1
27694,변재일(卞在一),이주환(李周桓),49,4,53,1
27695,변재일(卞在一),이채익(李埰益),51,5,56,1
27696,변재일(卞在一),이철규(李喆圭),51,4,55,1
27697,변재일(卞在一),이탄희(李誕熙),90,53,143,0
27698,변재일(卞在一),이태규(李泰珪),29,4,33,1
27699,변재일(卞在一),이학영(李學永),103,101,204,0
27700,변재일(卞在一),이해식(李海植),84,47,131,0
27701,변재일(卞在一),이헌승(李憲昇),52,5,57,1
27702,변재일(卞在一),이형석(李炯錫),88,49,137,0
27703,변재일(卞在一),인재근(印在謹),83,69,152,0
27704,변재일(卞在一),임병헌(林炳憲),25,4,29,1
27705,변재일(卞在一),임오경(林五卿),85,66,151,0
27706,변재일(卞在一),임이자(林利子),49,4,53,1
27707,변재일(卞在一),임종성(林鍾聲),96,88,184,0
27708,변재일(卞在一),임호선(林昊宣),109,115,224,0
27709,변재일(卞在一),장경태(張耿態),82,77,159,0
27710,변재일(卞在一),장동혁(張東赫),25,4,29,1
27711,변재일(卞在一),장제원(張濟元),49,4,53,1
27712,변재일(卞在一),장철민(張喆敏),90,57,147,0
27713,변재일(卞在一),장혜영(張惠英),12,6,18,1
27714,변재일(卞在一),전봉민(田奉珉),35,6,41,1
27715,변재일(卞在一),전용기(田溶冀),86,64,150,0
27716,변재일(卞在一),전재수(田載秀),79,46,125,0
27717,변재일(卞在一),전주혜(全珠惠),52,6,58,1
27718,변재일(卞在一),전해철(全海澈),78,42,120,0
27719,변재일(卞在一),전혜숙(全惠淑),91,58,149,0
27720,변재일(卞在一),정경희(丁慶姬),50,4,54,1
27721,변재일(卞在一),정동만(鄭東萬),50,4,54,1
27722,변재일(卞在一),정성호(鄭成湖),79,60,139,0
27723,변재일(卞在一),정우택(鄭宇澤),26,6,32,1
27724,변재일(卞在一),정운천(鄭雲天),50,5,55,1
27725,변재일(卞在一),정일영(鄭日永),75,48,123,0
27726,변재일(卞在一),정점식(鄭点植),50,4,54,1
27727,변재일(卞在一),정진석(鄭鎭碩),50,5,55,1
27728,변재일(卞在一),정청래(鄭淸來),79,48,127,0
27729,변재일(卞在一),정춘숙(鄭春淑),83,63,146,0
27730,변재일(卞在一),정태호(鄭泰浩),85,69,154,0
27731,변재일(卞在一),정필모(鄭必模),103,77,180,0
27732,변재일(卞在一),정희용(鄭熙溶),53,7,60,1
27733,변재일(卞在一),조경태(趙慶泰),49,5,54,1
27734,변재일(卞在一),조명희(曺明姬),51,7,58,1
27735,변재일(卞在一),조수진(趙修眞),50,5,55,1
27736,변재일(卞在一),조승래(趙承來),112,86,198,0
27737,변재일(卞在一),조오섭(曺五燮),90,69,159,0
27738,변재일(卞在一),조은희(趙恩禧),25,5,30,1
27739,변재일(卞在一),조응천(趙應天),72,34,106,0
27740,변재일(卞在一),조정식(趙正湜),74,51,125,0
27741,변재일(卞在一),조정훈(趙廷訓),3,3,6,1
27742,변재일(卞在一),조해진(曺海珍),51,5,56,1
27743,변재일(卞在一),주철현(朱哲鉉),82,62,144,0
27744,변재일(卞在一),주호영(朱豪英),49,4,53,1
27745,변재일(卞在一),지성호(池成浩),50,7,57,1
27746,변재일(卞在一),진선미(陳善美),77,41,118,0
27747,변재일(卞在一),진성준(陳聲準),83,53,136,0
27748,변재일(卞在一),천준호(千俊鎬),80,46,126,0
27749,변재일(卞在一),최기상(崔基相),76,49,125,0
27750,변재일(卞在一),최승재(崔承宰),49,5,54,1
27751,변재일(卞在一),최연숙(崔姸淑),30,11,41,1
27752,변재일(卞在一),최영희(崔英姬),25,6,31,1
27753,변재일(卞在一),최인호(崔仁昊),79,44,123,0
27754,변재일(卞在一),최재형(崔在亨),25,4,29,1
27755,변재일(卞在一),최종윤(崔鍾允),89,63,152,0
27756,변재일(卞在一),최춘식(崔春植),49,5,54,1
27757,변재일(卞在一),최형두(崔炯斗),51,5,56,1
27758,변재일(卞在一),최혜영(崔惠英),91,79,170,0
27759,변재일(卞在一),추경호(秋慶鎬),50,3,53,1
27760,변재일(卞在一),태영호(太永浩),50,5,55,1
27761,변재일(卞在一),하영제(河榮帝),43,2,45,1
27762,변재일(卞在一),하태경(河泰慶),50,4,54,1
27763,변재일(卞在一),한기호(韓起鎬),50,4,54,1
27764,변재일(卞在一),한무경(韓茂景),50,6,56,1
27765,변재일(卞在一),한병도(韓秉道),87,72,159,0
27766,변재일(卞在一),한정애(韓貞愛),80,42,122,0
27767,변재일(卞在一),한준호(韓俊鎬),105,82,187,0
27768,변재일(卞在一),허숙정(許淑湞),1,1,2,0
27769,변재일(卞在一),허영(許榮),98,61,159,0
27770,변재일(卞在一),허은아(許垠娥),50,7,57,1
27771,변재일(卞在一),허종식(許琮植),83,55,138,0
27772,변재일(卞在一),홍기원(洪起元),83,43,126,0
27773,변재일(卞在一),홍문표(洪文杓),50,6,56,1
27774,변재일(卞在一),홍석준(洪碩晙),50,5,55,1
27775,변재일(卞在一),홍성국(洪性國),102,92,194,0
27776,변재일(卞在一),홍영표(洪永杓),78,47,125,0
27777,변재일(卞在一),홍익표(洪翼杓),90,83,173,0
27778,변재일(卞在一),홍정민(洪貞敏),91,98,189,0
27779,변재일(卞在一),황보승희(皇甫承希),47,4,51,1
27780,변재일(卞在一),황운하(黃雲夏),94,93,187,0
27781,변재일(卞在一),황희(黃熙),76,34,110,0
27782,서동용(徐東榕),서범수(徐範洙),53,6,59,1
27783,서동용(徐東榕),서병수(徐秉洙),50,5,55,1
27784,서동용(徐東榕),서삼석(徐參錫),112,114,226,0
27785,서동용(徐東榕),서영교(徐瑛敎),112,145,257,0
27786,서동용(徐東榕),서영석(徐暎錫),105,110,215,0
27787,서동용(徐東榕),서일준(徐一俊),51,8,59,1
27788,서동용(徐東榕),서정숙(徐正淑),49,4,53,1
27789,서동용(徐東榕),설훈(薛勳),86,91,177,0
27790,서동용(徐東榕),성일종(成一鍾),50,7,57,1
27791,서동용(徐東榕),소병철(蘇秉哲),104,112,216,0
27792,서동용(徐東榕),소병훈(蘇秉勳),98,104,202,0
27793,서동용(徐東榕),송갑석(宋甲錫),109,162,271,0
27794,서동용(徐東榕),송기헌(宋基憲),91,71,162,0
27795,서동용(徐東榕),송석준(宋錫俊),50,5,55,1
27796,서동용(徐東榕),송언석(宋彦錫),45,4,49,1
27797,서동용(徐東榕),송옥주(宋玉珠),103,102,205,0
27798,서동용(徐東榕),송재호(宋在祜),113,134,247,0
27799,서동용(徐東榕),신동근(申東根),98,82,180,0
27800,서동용(徐東榕),신영대(申榮大),91,74,165,0
27801,서동용(徐東榕),신원식(申源湜),49,4,53,1
27802,서동용(徐東榕),신정훈(辛正勳),138,226,364,0
27803,서동용(徐東榕),신현영(申賢榮),93,69,162,0
27804,서동용(徐東榕),심상정(沈相奵),23,53,76,1
27805,서동용(徐東榕),안규백(安圭伯),97,78,175,0
27806,서동용(徐東榕),안민석(安敏錫),130,205,335,0
27807,서동용(徐東榕),안병길(安炳吉),50,4,54,1
27808,서동용(徐東榕),안철수(安哲秀),25,4,29,1
27809,서동용(徐東榕),안호영(安浩永),88,94,182,0
27810,서동용(徐東榕),양경숙(梁敬淑),94,91,185,0
27811,서동용(徐東榕),양금희(梁琴喜),50,5,55,1
27812,서동용(徐東榕),양기대(梁基大),94,72,166,0
27813,서동용(徐東榕),양이원영(梁李媛瑛),115,111,226,0
27814,서동용(徐東榕),양정숙(梁貞淑),74,170,244,1
27815,서동용(徐東榕),양향자(梁香子),54,52,106,1
27816,서동용(徐東榕),어기구(魚基龜),93,161,254,0
27817,서동용(徐東榕),엄태영(嚴泰永),51,5,56,1
27818,서동용(徐東榕),오기형(吳奇炯),78,56,134,0
27819,서동용(徐東榕),오영환(吳永煥),121,183,304,0
27820,서동용(徐東榕),용혜인(龍慧仁),22,56,78,1
27821,서동용(徐東榕),우상호(禹相虎),84,41,125,0
27822,서동용(徐東榕),우원식(禹元植),92,101,193,0
27823,서동용(徐東榕),위성곤(魏聖坤),105,155,260,0
27824,서동용(徐東榕),유경준(兪京濬),49,4,53,1
27825,서동용(徐東榕),유기홍(柳基洪),118,133,251,0
27826,서동용(徐東榕),유동수(柳東秀),95,71,166,0
27827,서동용(徐東榕),유상범(劉相凡),49,4,53,1
27828,서동용(徐東榕),유의동(兪義東),50,4,54,1
27829,서동용(徐東榕),유정주(兪訂炷),140,189,329,0
27830,서동용(徐東榕),윤건영(尹建永),89,68,157,0
27831,서동용(徐東榕),윤관석(尹官石),79,53,132,1
27832,서동용(徐東榕),윤두현(尹斗鉉),49,4,53,1
27833,서동용(徐東榕),윤미향(尹美香),64,83,147,1
27834,서동용(徐東榕),윤상현(尹相現),30,5,35,1
27835,서동용(徐東榕),윤영덕(尹永德),119,179,298,0
27836,서동용(徐東榕),윤영석(尹永碩),50,6,56,1
27837,서동용(徐東榕),윤영찬(尹永燦),91,97,188,0
27838,서동용(徐東榕),윤재갑(尹才鉀),146,181,327,0
27839,서동용(徐東榕),윤재옥(尹在玉),50,4,54,1
27840,서동용(徐東榕),윤주경(尹柱卿),49,4,53,1
27841,서동용(徐東榕),윤준병(尹準炳),108,208,316,0
27842,서동용(徐東榕),윤창현(尹暢賢),49,5,54,1
27843,서동용(徐東榕),윤한홍(尹漢洪),50,4,54,1
27844,서동용(徐東榕),윤호중(尹昊重),81,54,135,0
27845,서동용(徐東榕),윤후덕(尹厚德),110,184,294,0
27846,서동용(徐東榕),이개호(李介昊),100,156,256,0
27847,서동용(徐東榕),이달곤(李達坤),52,6,58,1
27848,서동용(徐東榕),이동주(李東洲),127,209,336,0
27849,서동용(徐東榕),이만희(李晩熙),51,5,56,1
27850,서동용(徐東榕),이명수(李明洙),52,18,70,1
27851,서동용(徐東榕),이병훈(李炳勳),124,192,316,0
27852,서동용(徐東榕),이상민(李相珉),77,47,124,0
27853,서동용(徐東榕),이상헌(李相憲),117,120,237,0
27854,서동용(徐東榕),이성만(李成萬),108,132,240,1
27855,서동용(徐東榕),이소영(李素永),88,65,153,0
27856,서동용(徐東榕),이수진(李壽珍),115,157,272,0
27857,서동용(徐東榕),이수진(李秀眞),118,122,240,0
27858,서동용(徐東榕),이양수(李亮壽),51,7,58,1
27859,서동용(徐東榕),이용(李鏞),49,4,53,1
27860,서동용(徐東榕),이용빈(李龍彬),127,180,307,0
27861,서동용(徐東榕),이용선(李庸瑄),94,103,197,0
27862,서동용(徐東榕),이용우(李龍雨),105,90,195,0
27863,서동용(徐東榕),이용호(李容鎬),31,25,56,1
27864,서동용(徐東榕),이원욱(李元旭),104,110,214,0
27865,서동용(徐東榕),이원택(李源澤),95,92,187,0
27866,서동용(徐東榕),이은주(李恩周),22,43,65,1
27867,서동용(徐東榕),이인선(李仁善),25,4,29,1
27868,서동용(徐東榕),이인영(李仁榮),79,49,128,0
27869,서동용(徐東榕),이장섭(李將燮),93,94,187,0
27870,서동용(徐東榕),이재명(李在明),40,21,61,0
27871,서동용(徐東榕),이재정(李在汀),89,59,148,0
27872,서동용(徐東榕),이정문(李楨文),102,145,247,0
27873,서동용(徐東榕),이종배(李鍾培),50,7,57,1
27874,서동용(徐東榕),이종성(李鍾成),49,8,57,1
27875,서동용(徐東榕),이주환(李周桓),49,5,54,1
27876,서동용(徐東榕),이채익(李埰益),51,6,57,1
27877,서동용(徐東榕),이철규(李喆圭),50,7,57,1
27878,서동용(徐東榕),이탄희(李誕熙),110,97,207,0
27879,서동용(徐東榕),이태규(李泰珪),28,5,33,1
27880,서동용(徐東榕),이학영(李學永),103,110,213,0
27881,서동용(徐東榕),이해식(李海植),93,91,184,0
27882,서동용(徐東榕),이헌승(李憲昇),50,5,55,1
27883,서동용(徐東榕),이형석(李炯錫),115,105,220,0
27884,서동용(徐東榕),인재근(印在謹),127,144,271,0
27885,서동용(徐東榕),임병헌(林炳憲),25,4,29,1
27886,서동용(徐東榕),임오경(林五卿),101,107,208,0
27887,서동용(徐東榕),임이자(林利子),49,4,53,1
27888,서동용(徐東榕),임종성(林鍾聲),107,150,257,0
27889,서동용(徐東榕),임호선(林昊宣),116,152,268,0
27890,서동용(徐東榕),장경태(張耿態),106,141,247,0
27891,서동용(徐東榕),장동혁(張東赫),25,4,29,1
27892,서동용(徐東榕),장제원(張濟元),49,4,53,1
27893,서동용(徐東榕),장철민(張喆敏),94,94,188,0
27894,서동용(徐東榕),장혜영(張惠英),17,44,61,1
27895,서동용(徐東榕),전봉민(田奉珉),35,5,40,1
27896,서동용(徐東榕),전용기(田溶冀),87,106,193,0
27897,서동용(徐東榕),전재수(田載秀),100,83,183,0
27898,서동용(徐東榕),전주혜(全珠惠),51,5,56,1
27899,서동용(徐東榕),전해철(全海澈),81,65,146,0
27900,서동용(徐東榕),전혜숙(全惠淑),99,121,220,0
27901,서동용(徐東榕),정경희(丁慶姬),49,5,54,1
27902,서동용(徐東榕),정동만(鄭東萬),50,5,55,1
27903,서동용(徐東榕),정성호(鄭成湖),102,128,230,0
27904,서동용(徐東榕),정우택(鄭宇澤),25,4,29,1
27905,서동용(徐東榕),정운천(鄭雲天),49,6,55,1
27906,서동용(徐東榕),정일영(鄭日永),97,101,198,0
27907,서동용(徐東榕),정점식(鄭点植),50,4,54,1
27908,서동용(徐東榕),정진석(鄭鎭碩),50,8,58,1
27909,서동용(徐東榕),정청래(鄭淸來),100,82,182,0
27910,서동용(徐東榕),정춘숙(鄭春淑),103,160,263,0
27911,서동용(徐東榕),정태호(鄭泰浩),87,98,185,0
27912,서동용(徐東榕),정필모(鄭必模),93,85,178,0
27913,서동용(徐東榕),정희용(鄭熙溶),50,5,55,1
27914,서동용(徐東榕),조경태(趙慶泰),50,5,55,1
27915,서동용(徐東榕),조명희(曺明姬),49,6,55,1
27916,서동용(徐東榕),조수진(趙修眞),49,4,53,1
27917,서동용(徐東榕),조승래(趙承來),128,117,245,0
27918,서동용(徐東榕),조오섭(曺五燮),125,222,347,0
27919,서동용(徐東榕),조은희(趙恩禧),25,4,29,1
27920,서동용(徐東榕),조응천(趙應天),76,39,115,0
27921,서동용(徐東榕),조정식(趙正湜),76,39,115,0
27922,서동용(徐東榕),조정훈(趙廷訓),7,18,25,1
27923,서동용(徐東榕),조해진(曺海珍),52,7,59,1
27924,서동용(徐東榕),주철현(朱哲鉉),111,181,292,0
27925,서동용(徐東榕),주호영(朱豪英),49,4,53,1
27926,서동용(徐東榕),지성호(池成浩),49,4,53,1
27927,서동용(徐東榕),진선미(陳善美),84,63,147,0
27928,서동용(徐東榕),진성준(陳聲準),102,88,190,0
27929,서동용(徐東榕),천준호(千俊鎬),88,67,155,0
27930,서동용(徐東榕),최기상(崔基相),89,94,183,0
27931,서동용(徐東榕),최승재(崔承宰),49,5,54,1
27932,서동용(徐東榕),최연숙(崔姸淑),34,14,48,1
27933,서동용(徐東榕),최영희(崔英姬),25,4,29,1
27934,서동용(徐東榕),최인호(崔仁昊),96,102,198,0
27935,서동용(徐東榕),최재형(崔在亨),25,4,29,1
27936,서동용(徐東榕),최종윤(崔鍾允),118,138,256,0
27937,서동용(徐東榕),최춘식(崔春植),49,5,54,1
27938,서동용(徐東榕),최형두(崔炯斗),50,11,61,1
27939,서동용(徐東榕),최혜영(崔惠英),101,134,235,0
27940,서동용(徐東榕),추경호(秋慶鎬),50,4,54,1
27941,서동용(徐東榕),태영호(太永浩),49,4,53,1
27942,서동용(徐東榕),하영제(河榮帝),41,2,43,1
27943,서동용(徐東榕),하태경(河泰慶),50,5,55,1
27944,서동용(徐東榕),한기호(韓起鎬),50,6,56,1
27945,서동용(徐東榕),한무경(韓茂景),50,5,55,1
27946,서동용(徐東榕),한병도(韓秉道),96,124,220,0
27947,서동용(徐東榕),한정애(韓貞愛),77,57,134,0
27948,서동용(徐東榕),한준호(韓俊鎬),101,119,220,0
27949,서동용(徐東榕),허숙정(許淑湞),1,1,2,0
27950,서동용(徐東榕),허영(許榮),106,130,236,0
27951,서동용(徐東榕),허은아(許垠娥),49,4,53,1
27952,서동용(徐東榕),허종식(許琮植),106,208,314,0
27953,서동용(徐東榕),홍기원(洪起元),92,91,183,0
27954,서동용(徐東榕),홍문표(洪文杓),51,22,73,1
27955,서동용(徐東榕),홍석준(洪碩晙),50,4,54,1
27956,서동용(徐東榕),홍성국(洪性國),124,142,266,0
27957,서동용(徐東榕),홍영표(洪永杓),86,61,147,0
27958,서동용(徐東榕),홍익표(洪翼杓),94,105,199,0
27959,서동용(徐東榕),홍정민(洪貞敏),116,120,236,0
27960,서동용(徐東榕),황보승희(皇甫承希),47,2,49,1
27961,서동용(徐東榕),황운하(黃雲夏),106,136,242,0
27962,서동용(徐東榕),황희(黃熙),83,49,132,0
27963,서범수(徐範洙),서병수(徐秉洙),84,101,185,0
27964,서범수(徐範洙),서삼석(徐參錫),50,5,55,1
27965,서범수(徐範洙),서영교(徐瑛敎),54,6,60,1
27966,서범수(徐範洙),서영석(徐暎錫),49,5,54,1
27967,서범수(徐範洙),서일준(徐一俊),95,105,200,0
27968,서범수(徐範洙),서정숙(徐正淑),76,89,165,0
27969,서범수(徐範洙),설훈(薛勳),53,6,59,1
27970,서범수(徐範洙),성일종(成一鍾),79,97,176,0
27971,서범수(徐範洙),소병철(蘇秉哲),50,7,57,1
27972,서범수(徐範洙),소병훈(蘇秉勳),51,5,56,1
27973,서범수(徐範洙),송갑석(宋甲錫),54,7,61,1
27974,서범수(徐範洙),송기헌(宋基憲),50,9,59,1
27975,서범수(徐範洙),송석준(宋錫俊),75,64,139,0
27976,서범수(徐範洙),송언석(宋彦錫),65,77,142,0
27977,서범수(徐範洙),송옥주(宋玉珠),53,5,58,1
27978,서범수(徐範洙),송재호(宋在祜),51,7,58,1
27979,서범수(徐範洙),신동근(申東根),50,5,55,1
27980,서범수(徐範洙),신영대(申榮大),50,4,54,1
27981,서범수(徐範洙),신원식(申源湜),78,78,156,0
27982,서범수(徐範洙),신정훈(辛正勳),52,6,58,1
27983,서범수(徐範洙),신현영(申賢榮),50,4,54,1
27984,서범수(徐範洙),심상정(沈相奵),5,5,10,1
27985,서범수(徐範洙),안규백(安圭伯),53,14,67,1
27986,서범수(徐範洙),안민석(安敏錫),51,4,55,1
27987,서범수(徐範洙),안병길(安炳吉),79,111,190,0
27988,서범수(徐範洙),안철수(安哲秀),27,19,46,0
27989,서범수(徐範洙),안호영(安浩永),51,7,58,1
27990,서범수(徐範洙),양경숙(梁敬淑),51,4,55,1
27991,서범수(徐範洙),양금희(梁琴喜),91,121,212,0
27992,서범수(徐範洙),양기대(梁基大),51,5,56,1
27993,서범수(徐範洙),양이원영(梁李媛瑛),46,5,51,1
27994,서범수(徐範洙),양정숙(梁貞淑),7,14,21,1
27995,서범수(徐範洙),양향자(梁香子),23,11,34,1
27996,서범수(徐範洙),어기구(魚基龜),51,6,57,1
27997,서범수(徐範洙),엄태영(嚴泰永),83,103,186,0
27998,서범수(徐範洙),오기형(吳奇炯),50,7,57,1
27999,서범수(徐範洙),오영환(吳永煥),54,12,66,1
28000,서범수(徐範洙),용혜인(龍慧仁),3,7,10,1
28001,서범수(徐範洙),우상호(禹相虎),50,5,55,1
28002,서범수(徐範洙),우원식(禹元植),49,4,53,1
28003,서범수(徐範洙),위성곤(魏聖坤),50,4,54,1
28004,서범수(徐範洙),유경준(兪京濬),79,80,159,0
28005,서범수(徐範洙),유기홍(柳基洪),50,4,54,1
28006,서범수(徐範洙),유동수(柳東秀),53,5,58,1
28007,서범수(徐範洙),유상범(劉相凡),63,66,129,0
28008,서범수(徐範洙),유의동(兪義東),66,59,125,0
28009,서범수(徐範洙),유정주(兪訂炷),52,7,59,1
28010,서범수(徐範洙),윤건영(尹建永),50,5,55,1
28011,서범수(徐範洙),윤관석(尹官石),41,0,41,1
28012,서범수(徐範洙),윤두현(尹斗鉉),76,95,171,0
28013,서범수(徐範洙),윤미향(尹美香),20,0,20,1
28014,서범수(徐範洙),윤상현(尹相現),43,34,77,0
28015,서범수(徐範洙),윤영덕(尹永德),49,5,54,1
28016,서범수(徐範洙),윤영석(尹永碩),82,91,173,0
28017,서범수(徐範洙),윤영찬(尹永燦),50,6,56,1
28018,서범수(徐範洙),윤재갑(尹才鉀),54,6,60,1
28019,서범수(徐範洙),윤재옥(尹在玉),69,61,130,0
28020,서범수(徐範洙),윤주경(尹柱卿),83,80,163,0
28021,서범수(徐範洙),윤준병(尹準炳),51,7,58,1
28022,서범수(徐範洙),윤창현(尹暢賢),90,93,183,0
28023,서범수(徐範洙),윤한홍(尹漢洪),76,73,149,0
28024,서범수(徐範洙),윤호중(尹昊重),50,6,56,1
28025,서범수(徐範洙),윤후덕(尹厚德),51,4,55,1
28026,서범수(徐範洙),이개호(李介昊),50,4,54,1
28027,서범수(徐範洙),이달곤(李達坤),74,72,146,0
28028,서범수(徐範洙),이동주(李東洲),50,4,54,1
28029,서범수(徐範洙),이만희(李晩熙),77,75,152,0
28030,서범수(徐範洙),이명수(李明洙),91,110,201,0
28031,서범수(徐範洙),이병훈(李炳勳),55,8,63,1
28032,서범수(徐範洙),이상민(李相珉),51,5,56,1
28033,서범수(徐範洙),이상헌(李相憲),54,14,68,1
28034,서범수(徐範洙),이성만(李成萬),41,0,41,1
28035,서범수(徐範洙),이소영(李素永),50,5,55,1
28036,서범수(徐範洙),이수진(李壽珍),51,6,57,1
28037,서범수(徐範洙),이수진(李秀眞),52,5,57,1
28038,서범수(徐範洙),이양수(李亮壽),73,88,161,0
28039,서범수(徐範洙),이용(李鏞),69,75,144,0
28040,서범수(徐範洙),이용빈(李龍彬),54,16,70,1
28041,서범수(徐範洙),이용선(李庸瑄),51,5,56,1
28042,서범수(徐範洙),이용우(李龍雨),51,5,56,1
28043,서범수(徐範洙),이용호(李容鎬),34,44,78,0
28044,서범수(徐範洙),이원욱(李元旭),54,6,60,1
28045,서범수(徐範洙),이원택(李源澤),50,4,54,1
28046,서범수(徐範洙),이은주(李恩周),7,5,12,1
28047,서범수(徐範洙),이인선(李仁善),29,46,75,0
28048,서범수(徐範洙),이인영(李仁榮),50,4,54,1
28049,서범수(徐範洙),이장섭(李將燮),52,5,57,1
28050,서범수(徐範洙),이재명(李在明),25,4,29,1
28051,서범수(徐範洙),이재정(李在汀),50,4,54,1
28052,서범수(徐範洙),이정문(李楨文),50,4,54,1
28053,서범수(徐範洙),이종배(李鍾培),86,104,190,0
28054,서범수(徐範洙),이종성(李鍾成),84,143,227,0
28055,서범수(徐範洙),이주환(李周桓),79,125,204,0
28056,서범수(徐範洙),이채익(李埰益),88,108,196,0
28057,서범수(徐範洙),이철규(李喆圭),72,68,140,0
28058,서범수(徐範洙),이탄희(李誕熙),50,4,54,1
28059,서범수(徐範洙),이태규(李泰珪),39,43,82,0
28060,서범수(徐範洙),이학영(李學永),49,4,53,1
28061,서범수(徐範洙),이해식(李海植),52,7,59,1
28062,서범수(徐範洙),이헌승(李憲昇),62,94,156,0
28063,서범수(徐範洙),이형석(李炯錫),53,6,59,1
28064,서범수(徐範洙),인재근(印在謹),49,6,55,1
28065,서범수(徐範洙),임병헌(林炳憲),33,66,99,0
28066,서범수(徐範洙),임오경(林五卿),50,5,55,1
28067,서범수(徐範洙),임이자(林利子),86,93,179,0
28068,서범수(徐範洙),임종성(林鍾聲),55,8,63,1
28069,서범수(徐範洙),임호선(林昊宣),52,9,61,1
28070,서범수(徐範洙),장경태(張耿態),50,5,55,1
28071,서범수(徐範洙),장동혁(張東赫),29,32,61,0
28072,서범수(徐範洙),장제원(張濟元),63,43,106,0
28073,서범수(徐範洙),장철민(張喆敏),54,5,59,1
28074,서범수(徐範洙),장혜영(張惠英),6,3,9,1
28075,서범수(徐範洙),전봉민(田奉珉),67,116,183,0
28076,서범수(徐範洙),전용기(田溶冀),51,4,55,1
28077,서범수(徐範洙),전재수(田載秀),50,4,54,1
28078,서범수(徐範洙),전주혜(全珠惠),70,84,154,0
28079,서범수(徐範洙),전해철(全海澈),52,5,57,1
28080,서범수(徐範洙),전혜숙(全惠淑),53,8,61,1
28081,서범수(徐範洙),정경희(丁慶姬),73,82,155,0
28082,서범수(徐範洙),정동만(鄭東萬),81,99,180,0
28083,서범수(徐範洙),정성호(鄭成湖),52,14,66,1
28084,서범수(徐範洙),정우택(鄭宇澤),27,46,73,0
28085,서범수(徐範洙),정운천(鄭雲天),68,75,143,0
28086,서범수(徐範洙),정일영(鄭日永),49,6,55,1
28087,서범수(徐範洙),정점식(鄭点植),67,43,110,0
28088,서범수(徐範洙),정진석(鄭鎭碩),73,59,132,0
28089,서범수(徐範洙),정청래(鄭淸來),50,4,54,1
28090,서범수(徐範洙),정춘숙(鄭春淑),50,8,58,1
28091,서범수(徐範洙),정태호(鄭泰浩),50,6,56,1
28092,서범수(徐範洙),정필모(鄭必模),50,4,54,1
28093,서범수(徐範洙),정희용(鄭熙溶),88,100,188,0
28094,서범수(徐範洙),조경태(趙慶泰),72,83,155,0
28095,서범수(徐範洙),조명희(曺明姬),76,125,201,0
28096,서범수(徐範洙),조수진(趙修眞),76,81,157,0
28097,서범수(徐範洙),조승래(趙承來),54,8,62,1
28098,서범수(徐範洙),조오섭(曺五燮),54,6,60,1
28099,서범수(徐範洙),조은희(趙恩禧),28,28,56,0
28100,서범수(徐範洙),조응천(趙應天),50,5,55,1
28101,서범수(徐範洙),조정식(趙正湜),49,3,52,1
28102,서범수(徐範洙),조정훈(趙廷訓),0,4,4,1
28103,서범수(徐範洙),조해진(曺海珍),67,39,106,0
28104,서범수(徐範洙),주철현(朱哲鉉),51,7,58,1
28105,서범수(徐範洙),주호영(朱豪英),64,47,111,0
28106,서범수(徐範洙),지성호(池成浩),81,104,185,0
28107,서범수(徐範洙),진선미(陳善美),52,4,56,1
28108,서범수(徐範洙),진성준(陳聲準),50,5,55,1
28109,서범수(徐範洙),천준호(千俊鎬),49,3,52,1
28110,서범수(徐範洙),최기상(崔基相),49,4,53,1
28111,서범수(徐範洙),최승재(崔承宰),76,73,149,0
28112,서범수(徐範洙),최연숙(崔姸淑),33,37,70,0
28113,서범수(徐範洙),최영희(崔英姬),29,42,71,0
28114,서범수(徐範洙),최인호(崔仁昊),52,7,59,1
28115,서범수(徐範洙),최재형(崔在亨),28,13,41,0
28116,서범수(徐範洙),최종윤(崔鍾允),50,9,59,1
28117,서범수(徐範洙),최춘식(崔春植),79,125,204,0
28118,서범수(徐範洙),최형두(崔炯斗),91,130,221,0
28119,서범수(徐範洙),최혜영(崔惠英),50,6,56,1
28120,서범수(徐範洙),추경호(秋慶鎬),88,88,176,0
28121,서범수(徐範洙),태영호(太永浩),88,113,201,0
28122,서범수(徐範洙),하영제(河榮帝),79,112,191,1
28123,서범수(徐範洙),하태경(河泰慶),64,46,110,0
28124,서범수(徐範洙),한기호(韓起鎬),64,61,125,0
28125,서범수(徐範洙),한무경(韓茂景),81,101,182,0
28126,서범수(徐範洙),한병도(韓秉道),50,12,62,1
28127,서범수(徐範洙),한정애(韓貞愛),54,6,60,1
28128,서범수(徐範洙),한준호(韓俊鎬),50,5,55,1
28129,서범수(徐範洙),허숙정(許淑湞),0,0,0,1
28130,서범수(徐範洙),허영(許榮),52,12,64,1
28131,서범수(徐範洙),허은아(許垠娥),73,60,133,0
28132,서범수(徐範洙),허종식(許琮植),54,8,62,1
28133,서범수(徐範洙),홍기원(洪起元),50,6,56,1
28134,서범수(徐範洙),홍문표(洪文杓),73,69,142,0
28135,서범수(徐範洙),홍석준(洪碩晙),68,71,139,0
28136,서범수(徐範洙),홍성국(洪性國),53,7,60,1
28137,서범수(徐範洙),홍영표(洪永杓),53,5,58,1
28138,서범수(徐範洙),홍익표(洪翼杓),50,4,54,1
28139,서범수(徐範洙),홍정민(洪貞敏),52,7,59,1
28140,서범수(徐範洙),황보승희(皇甫承希),85,136,221,1
28141,서범수(徐範洙),황운하(黃雲夏),52,10,62,1
28142,서범수(徐範洙),황희(黃熙),49,5,54,1
28143,서병수(徐秉洙),서삼석(徐參錫),49,4,53,1
28144,서병수(徐秉洙),서영교(徐瑛敎),51,4,55,1
28145,서병수(徐秉洙),서영석(徐暎錫),49,6,55,1
28146,서병수(徐秉洙),서일준(徐一俊),109,156,265,0
28147,서병수(徐秉洙),서정숙(徐正淑),78,73,151,0
28148,서병수(徐秉洙),설훈(薛勳),52,5,57,1
28149,서병수(徐秉洙),성일종(成一鍾),97,131,228,0
28150,서병수(徐秉洙),소병철(蘇秉哲),50,5,55,1
28151,서병수(徐秉洙),소병훈(蘇秉勳),50,4,54,1
28152,서병수(徐秉洙),송갑석(宋甲錫),50,5,55,1
28153,서병수(徐秉洙),송기헌(宋基憲),50,6,56,1
28154,서병수(徐秉洙),송석준(宋錫俊),87,61,148,0
28155,서병수(徐秉洙),송언석(宋彦錫),77,75,152,0
28156,서병수(徐秉洙),송옥주(宋玉珠),50,4,54,1
28157,서병수(徐秉洙),송재호(宋在祜),51,6,57,1
28158,서병수(徐秉洙),신동근(申東根),50,4,54,1
28159,서병수(徐秉洙),신영대(申榮大),50,4,54,1
28160,서병수(徐秉洙),신원식(申源湜),74,76,150,0
28161,서병수(徐秉洙),신정훈(辛正勳),51,5,56,1
28162,서병수(徐秉洙),신현영(申賢榮),49,4,53,1
28163,서병수(徐秉洙),심상정(沈相奵),6,4,10,1
28164,서병수(徐秉洙),안규백(安圭伯),53,8,61,1
28165,서병수(徐秉洙),안민석(安敏錫),51,5,56,1
28166,서병수(徐秉洙),안병길(安炳吉),91,165,256,0
28167,서병수(徐秉洙),안철수(安哲秀),27,45,72,0
28168,서병수(徐秉洙),안호영(安浩永),50,4,54,1
28169,서병수(徐秉洙),양경숙(梁敬淑),50,5,55,1
28170,서병수(徐秉洙),양금희(梁琴喜),109,179,288,0
28171,서병수(徐秉洙),양기대(梁基大),50,6,56,1
28172,서병수(徐秉洙),양이원영(梁李媛瑛),45,4,49,1
28173,서병수(徐秉洙),양정숙(梁貞淑),3,8,11,1
28174,서병수(徐秉洙),양향자(梁香子),25,4,29,1
28175,서병수(徐秉洙),어기구(魚基龜),50,4,54,1
28176,서병수(徐秉洙),엄태영(嚴泰永),80,95,175,0
28177,서병수(徐秉洙),오기형(吳奇炯),49,5,54,1
28178,서병수(徐秉洙),오영환(吳永煥),51,5,56,1
28179,서병수(徐秉洙),용혜인(龍慧仁),1,1,2,1
28180,서병수(徐秉洙),우상호(禹相虎),50,5,55,1
28181,서병수(徐秉洙),우원식(禹元植),49,5,54,1
28182,서병수(徐秉洙),위성곤(魏聖坤),50,5,55,1
28183,서병수(徐秉洙),유경준(兪京濬),81,89,170,0
28184,서병수(徐秉洙),유기홍(柳基洪),50,4,54,1
28185,서병수(徐秉洙),유동수(柳東秀),50,5,55,1
28186,서병수(徐秉洙),유상범(劉相凡),70,74,144,0
28187,서병수(徐秉洙),유의동(兪義東),74,69,143,0
28188,서병수(徐秉洙),유정주(兪訂炷),50,5,55,1
28189,서병수(徐秉洙),윤건영(尹建永),49,3,52,1
28190,서병수(徐秉洙),윤관석(尹官石),41,1,42,1
28191,서병수(徐秉洙),윤두현(尹斗鉉),88,130,218,0
28192,서병수(徐秉洙),윤미향(尹美香),20,2,22,1
28193,서병수(徐秉洙),윤상현(尹相現),41,43,84,0
28194,서병수(徐秉洙),윤영덕(尹永德),49,4,53,1
28195,서병수(徐秉洙),윤영석(尹永碩),74,85,159,0
28196,서병수(徐秉洙),윤영찬(尹永燦),50,5,55,1
28197,서병수(徐秉洙),윤재갑(尹才鉀),53,17,70,1
28198,서병수(徐秉洙),윤재옥(尹在玉),69,62,131,0
28199,서병수(徐秉洙),윤주경(尹柱卿),76,95,171,0
28200,서병수(徐秉洙),윤준병(尹準炳),50,5,55,1
28201,서병수(徐秉洙),윤창현(尹暢賢),107,129,236,0
28202,서병수(徐秉洙),윤한홍(尹漢洪),76,65,141,0
28203,서병수(徐秉洙),윤호중(尹昊重),50,4,54,1
28204,서병수(徐秉洙),윤후덕(尹厚德),51,5,56,1
28205,서병수(徐秉洙),이개호(李介昊),50,5,55,1
28206,서병수(徐秉洙),이달곤(李達坤),68,85,153,0
28207,서병수(徐秉洙),이동주(李東洲),49,5,54,1
28208,서병수(徐秉洙),이만희(李晩熙),76,48,124,0
28209,서병수(徐秉洙),이명수(李明洙),93,130,223,0
28210,서병수(徐秉洙),이병훈(李炳勳),54,7,61,1
28211,서병수(徐秉洙),이상민(李相珉),50,4,54,1
28212,서병수(徐秉洙),이상헌(李相憲),51,5,56,1
28213,서병수(徐秉洙),이성만(李成萬),41,2,43,1
28214,서병수(徐秉洙),이소영(李素永),51,4,55,1
28215,서병수(徐秉洙),이수진(李壽珍),50,5,55,1
28216,서병수(徐秉洙),이수진(李秀眞),50,6,56,1
28217,서병수(徐秉洙),이양수(李亮壽),86,71,157,0
28218,서병수(徐秉洙),이용(李鏞),75,100,175,0
28219,서병수(徐秉洙),이용빈(李龍彬),53,8,61,1
28220,서병수(徐秉洙),이용선(李庸瑄),50,6,56,1
28221,서병수(徐秉洙),이용우(李龍雨),49,6,55,1
28222,서병수(徐秉洙),이용호(李容鎬),33,22,55,0
28223,서병수(徐秉洙),이원욱(李元旭),52,4,56,1
28224,서병수(徐秉洙),이원택(李源澤),50,5,55,1
28225,서병수(徐秉洙),이은주(李恩周),6,6,12,1
28226,서병수(徐秉洙),이인선(李仁善),32,40,72,0
28227,서병수(徐秉洙),이인영(李仁榮),50,4,54,1
28228,서병수(徐秉洙),이장섭(李將燮),50,4,54,1
28229,서병수(徐秉洙),이재명(李在明),25,4,29,1
28230,서병수(徐秉洙),이재정(李在汀),50,4,54,1
28231,서병수(徐秉洙),이정문(李楨文),50,4,54,1
28232,서병수(徐秉洙),이종배(李鍾培),90,117,207,0
28233,서병수(徐秉洙),이종성(李鍾成),89,154,243,0
28234,서병수(徐秉洙),이주환(李周桓),122,202,324,0
28235,서병수(徐秉洙),이채익(李埰益),87,111,198,0
28236,서병수(徐秉洙),이철규(李喆圭),75,60,135,0
28237,서병수(徐秉洙),이탄희(李誕熙),50,4,54,1
28238,서병수(徐秉洙),이태규(李泰珪),52,81,133,0
28239,서병수(徐秉洙),이학영(李學永),49,5,54,1
28240,서병수(徐秉洙),이해식(李海植),50,5,55,1
28241,서병수(徐秉洙),이헌승(李憲昇),102,204,306,0
28242,서병수(徐秉洙),이형석(李炯錫),49,5,54,1
28243,서병수(徐秉洙),인재근(印在謹),49,6,55,1
28244,서병수(徐秉洙),임병헌(林炳憲),33,47,80,0
28245,서병수(徐秉洙),임오경(林五卿),50,4,54,1
28246,서병수(徐秉洙),임이자(林利子),92,101,193,0
28247,서병수(徐秉洙),임종성(林鍾聲),50,5,55,1
28248,서병수(徐秉洙),임호선(林昊宣),51,5,56,1
28249,서병수(徐秉洙),장경태(張耿態),50,6,56,1
28250,서병수(徐秉洙),장동혁(張東赫),28,34,62,0
28251,서병수(徐秉洙),장제원(張濟元),78,68,146,0
28252,서병수(徐秉洙),장철민(張喆敏),50,5,55,1
28253,서병수(徐秉洙),장혜영(張惠英),8,6,14,1
28254,서병수(徐秉洙),전봉민(田奉珉),83,175,258,0
28255,서병수(徐秉洙),전용기(田溶冀),51,4,55,1
28256,서병수(徐秉洙),전재수(田載秀),51,7,58,1
28257,서병수(徐秉洙),전주혜(全珠惠),84,98,182,0
28258,서병수(徐秉洙),전해철(全海澈),52,4,56,1
28259,서병수(徐秉洙),전혜숙(全惠淑),50,5,55,1
28260,서병수(徐秉洙),정경희(丁慶姬),84,79,163,0
28261,서병수(徐秉洙),정동만(鄭東萬),92,148,240,0
28262,서병수(徐秉洙),정성호(鄭成湖),55,6,61,1
28263,서병수(徐秉洙),정우택(鄭宇澤),38,60,98,0
28264,서병수(徐秉洙),정운천(鄭雲天),72,113,185,0
28265,서병수(徐秉洙),정일영(鄭日永),49,7,56,1
28266,서병수(徐秉洙),정점식(鄭点植),74,58,132,0
28267,서병수(徐秉洙),정진석(鄭鎭碩),97,119,216,0
28268,서병수(徐秉洙),정청래(鄭淸來),50,5,55,1
28269,서병수(徐秉洙),정춘숙(鄭春淑),50,4,54,1
28270,서병수(徐秉洙),정태호(鄭泰浩),50,5,55,1
28271,서병수(徐秉洙),정필모(鄭必模),50,4,54,1
28272,서병수(徐秉洙),정희용(鄭熙溶),82,94,176,0
28273,서병수(徐秉洙),조경태(趙慶泰),96,134,230,0
28274,서병수(徐秉洙),조명희(曺明姬),97,123,220,0
28275,서병수(徐秉洙),조수진(趙修眞),90,123,213,0
28276,서병수(徐秉洙),조승래(趙承來),51,3,54,1
28277,서병수(徐秉洙),조오섭(曺五燮),53,7,60,1
28278,서병수(徐秉洙),조은희(趙恩禧),33,28,61,0
28279,서병수(徐秉洙),조응천(趙應天),50,4,54,1
28280,서병수(徐秉洙),조정식(趙正湜),49,3,52,1
28281,서병수(徐秉洙),조정훈(趙廷訓),1,8,9,1
28282,서병수(徐秉洙),조해진(曺海珍),72,43,115,0
28283,서병수(徐秉洙),주철현(朱哲鉉),50,5,55,1
28284,서병수(徐秉洙),주호영(朱豪英),69,56,125,0
28285,서병수(徐秉洙),지성호(池成浩),100,133,233,0
28286,서병수(徐秉洙),진선미(陳善美),50,4,54,1
28287,서병수(徐秉洙),진성준(陳聲準),50,5,55,1
28288,서병수(徐秉洙),천준호(千俊鎬),49,3,52,1
28289,서병수(徐秉洙),최기상(崔基相),49,4,53,1
28290,서병수(徐秉洙),최승재(崔承宰),74,103,177,0
28291,서병수(徐秉洙),최연숙(崔姸淑),50,57,107,0
28292,서병수(徐秉洙),최영희(崔英姬),29,51,80,0
28293,서병수(徐秉洙),최인호(崔仁昊),52,7,59,1
28294,서병수(徐秉洙),최재형(崔在亨),28,19,47,0
28295,서병수(徐秉洙),최종윤(崔鍾允),50,5,55,1
28296,서병수(徐秉洙),최춘식(崔春植),79,129,208,0
28297,서병수(徐秉洙),최형두(崔炯斗),99,95,194,0
28298,서병수(徐秉洙),최혜영(崔惠英),50,5,55,1
28299,서병수(徐秉洙),추경호(秋慶鎬),80,115,195,0
28300,서병수(徐秉洙),태영호(太永浩),93,144,237,0
28301,서병수(徐秉洙),하영제(河榮帝),96,113,209,1
28302,서병수(徐秉洙),하태경(河泰慶),79,69,148,0
28303,서병수(徐秉洙),한기호(韓起鎬),68,61,129,0
28304,서병수(徐秉洙),한무경(韓茂景),92,129,221,0
28305,서병수(徐秉洙),한병도(韓秉道),49,5,54,1
28306,서병수(徐秉洙),한정애(韓貞愛),50,6,56,1
28307,서병수(徐秉洙),한준호(韓俊鎬),51,5,56,1
28308,서병수(徐秉洙),허숙정(許淑湞),0,0,0,1
28309,서병수(徐秉洙),허영(許榮),51,5,56,1
28310,서병수(徐秉洙),허은아(許垠娥),78,65,143,0
28311,서병수(徐秉洙),허종식(許琮植),51,7,58,1
28312,서병수(徐秉洙),홍기원(洪起元),50,4,54,1
28313,서병수(徐秉洙),홍문표(洪文杓),67,118,185,0
28314,서병수(徐秉洙),홍석준(洪碩晙),76,72,148,0
28315,서병수(徐秉洙),홍성국(洪性國),50,5,55,1
28316,서병수(徐秉洙),홍영표(洪永杓),50,6,56,1
28317,서병수(徐秉洙),홍익표(洪翼杓),50,4,54,1
28318,서병수(徐秉洙),홍정민(洪貞敏),50,5,55,1
28319,서병수(徐秉洙),황보승희(皇甫承希),95,124,219,1
28320,서병수(徐秉洙),황운하(黃雲夏),50,5,55,1
28321,서병수(徐秉洙),황희(黃熙),49,5,54,1
28322,서삼석(徐參錫),서영교(徐瑛敎),121,112,233,0
28323,서삼석(徐參錫),서영석(徐暎錫),93,76,169,0
28324,서삼석(徐參錫),서일준(徐一俊),51,9,60,1
28325,서삼석(徐參錫),서정숙(徐正淑),49,5,54,1
28326,서삼석(徐參錫),설훈(薛勳),93,58,151,0
28327,서삼석(徐參錫),성일종(成一鍾),50,5,55,1
28328,서삼석(徐參錫),소병철(蘇秉哲),116,94,210,0
28329,서삼석(徐參錫),소병훈(蘇秉勳),105,98,203,0
28330,서삼석(徐參錫),송갑석(宋甲錫),160,260,420,0
28331,서삼석(徐參錫),송기헌(宋基憲),90,59,149,0
28332,서삼석(徐參錫),송석준(宋錫俊),51,6,57,1
28333,서삼석(徐參錫),송언석(宋彦錫),48,12,60,1
28334,서삼석(徐參錫),송옥주(宋玉珠),130,169,299,0
28335,서삼석(徐參錫),송재호(宋在祜),109,115,224,0
28336,서삼석(徐參錫),신동근(申東根),96,69,165,0
28337,서삼석(徐參錫),신영대(申榮大),113,96,209,0
28338,서삼석(徐參錫),신원식(申源湜),50,4,54,1
28339,서삼석(徐參錫),신정훈(辛正勳),172,255,427,0
28340,서삼석(徐參錫),신현영(申賢榮),92,57,149,0
28341,서삼석(徐參錫),심상정(沈相奵),16,19,35,1
28342,서삼석(徐參錫),안규백(安圭伯),95,72,167,0
28343,서삼석(徐參錫),안민석(安敏錫),97,61,158,0
28344,서삼석(徐參錫),안병길(安炳吉),55,10,65,1
28345,서삼석(徐參錫),안철수(安哲秀),25,4,29,1
28346,서삼석(徐參錫),안호영(安浩永),118,139,257,0
28347,서삼석(徐參錫),양경숙(梁敬淑),94,75,169,0
28348,서삼석(徐參錫),양금희(梁琴喜),49,5,54,1
28349,서삼석(徐參錫),양기대(梁基大),99,74,173,0
28350,서삼석(徐參錫),양이원영(梁李媛瑛),87,78,165,0
28351,서삼석(徐參錫),양정숙(梁貞淑),57,120,177,1
28352,서삼석(徐參錫),양향자(梁香子),65,68,133,1
28353,서삼석(徐參錫),어기구(魚基龜),110,113,223,0
28354,서삼석(徐參錫),엄태영(嚴泰永),51,6,57,1
28355,서삼석(徐參錫),오기형(吳奇炯),81,40,121,0
28356,서삼석(徐參錫),오영환(吳永煥),145,197,342,0
28357,서삼석(徐參錫),용혜인(龍慧仁),15,14,29,1
28358,서삼석(徐參錫),우상호(禹相虎),81,41,122,0
28359,서삼석(徐參錫),우원식(禹元植),104,75,179,0
28360,서삼석(徐參錫),위성곤(魏聖坤),179,226,405,0
28361,서삼석(徐參錫),유경준(兪京濬),49,5,54,1
28362,서삼석(徐參錫),유기홍(柳基洪),82,55,137,0
28363,서삼석(徐參錫),유동수(柳東秀),131,141,272,0
28364,서삼석(徐參錫),유상범(劉相凡),50,5,55,1
28365,서삼석(徐參錫),유의동(兪義東),49,4,53,1
28366,서삼석(徐參錫),유정주(兪訂炷),113,103,216,0
28367,서삼석(徐參錫),윤건영(尹建永),87,60,147,0
28368,서삼석(徐參錫),윤관석(尹官石),79,53,132,1
28369,서삼석(徐參錫),윤두현(尹斗鉉),49,4,53,1
28370,서삼석(徐參錫),윤미향(尹美香),47,68,115,1
28371,서삼석(徐參錫),윤상현(尹相現),30,4,34,1
28372,서삼석(徐參錫),윤영덕(尹永德),125,115,240,0
28373,서삼석(徐參錫),윤영석(尹永碩),49,7,56,1
28374,서삼석(徐參錫),윤영찬(尹永燦),84,49,133,0
28375,서삼석(徐參錫),윤재갑(尹才鉀),183,211,394,0
28376,서삼석(徐參錫),윤재옥(尹在玉),49,5,54,1
28377,서삼석(徐參錫),윤주경(尹柱卿),49,5,54,1
28378,서삼석(徐參錫),윤준병(尹準炳),115,153,268,0
28379,서삼석(徐參錫),윤창현(尹暢賢),49,4,53,1
28380,서삼석(徐參錫),윤한홍(尹漢洪),51,5,56,1
28381,서삼석(徐參錫),윤호중(尹昊重),84,59,143,0
28382,서삼석(徐參錫),윤후덕(尹厚德),133,102,235,0
28383,서삼석(徐參錫),이개호(李介昊),179,218,397,0
28384,서삼석(徐參錫),이달곤(李達坤),55,7,62,1
28385,서삼석(徐參錫),이동주(李東洲),113,98,211,0
28386,서삼석(徐參錫),이만희(李晩熙),57,6,63,1
28387,서삼석(徐參錫),이명수(李明洙),50,10,60,1
28388,서삼석(徐參錫),이병훈(李炳勳),132,164,296,0
28389,서삼석(徐參錫),이상민(李相珉),76,38,114,0
28390,서삼석(徐參錫),이상헌(李相憲),105,101,206,0
28391,서삼석(徐參錫),이성만(李成萬),90,93,183,1
28392,서삼석(徐參錫),이소영(李素永),87,64,151,0
28393,서삼석(徐參錫),이수진(李壽珍),107,83,190,0
28394,서삼석(徐參錫),이수진(李秀眞),110,89,199,0
28395,서삼석(徐參錫),이양수(李亮壽),60,6,66,1
28396,서삼석(徐參錫),이용(李鏞),49,4,53,1
28397,서삼석(徐參錫),이용빈(李龍彬),127,138,265,0
28398,서삼석(徐參錫),이용선(李庸瑄),102,75,177,0
28399,서삼석(徐參錫),이용우(李龍雨),106,83,189,0
28400,서삼석(徐參錫),이용호(李容鎬),31,17,48,1
28401,서삼석(徐參錫),이원욱(李元旭),104,94,198,0
28402,서삼석(徐參錫),이원택(李源澤),115,109,224,0
28403,서삼석(徐參錫),이은주(李恩周),18,16,34,1
28404,서삼석(徐參錫),이인선(李仁善),25,5,30,1
28405,서삼석(徐參錫),이인영(李仁榮),80,47,127,0
28406,서삼석(徐參錫),이장섭(李將燮),112,95,207,0
28407,서삼석(徐參錫),이재명(李在明),40,20,60,0
28408,서삼석(徐參錫),이재정(李在汀),81,44,125,0
28409,서삼석(徐參錫),이정문(李楨文),107,65,172,0
28410,서삼석(徐參錫),이종배(李鍾培),51,6,57,1
28411,서삼석(徐參錫),이종성(李鍾成),49,5,54,1
28412,서삼석(徐參錫),이주환(李周桓),49,4,53,1
28413,서삼석(徐參錫),이채익(李埰益),50,6,56,1
28414,서삼석(徐參錫),이철규(李喆圭),54,8,62,1
28415,서삼석(徐參錫),이탄희(李誕熙),94,61,155,0
28416,서삼석(徐參錫),이태규(李泰珪),29,5,34,1
28417,서삼석(徐參錫),이학영(李學永),105,80,185,0
28418,서삼석(徐參錫),이해식(李海植),109,87,196,0
28419,서삼석(徐參錫),이헌승(李憲昇),53,5,58,1
28420,서삼석(徐參錫),이형석(李炯錫),120,89,209,0
28421,서삼석(徐參錫),인재근(印在謹),113,122,235,0
28422,서삼석(徐參錫),임병헌(林炳憲),25,4,29,1
28423,서삼석(徐參錫),임오경(林五卿),138,98,236,0
28424,서삼석(徐參錫),임이자(林利子),52,6,58,1
28425,서삼석(徐參錫),임종성(林鍾聲),145,185,330,0
28426,서삼석(徐參錫),임호선(林昊宣),139,155,294,0
28427,서삼석(徐參錫),장경태(張耿態),124,119,243,0
28428,서삼석(徐參錫),장동혁(張東赫),25,5,30,1
28429,서삼석(徐參錫),장제원(張濟元),49,5,54,1
28430,서삼석(徐參錫),장철민(張喆敏),98,67,165,0
28431,서삼석(徐參錫),장혜영(張惠英),16,9,25,1
28432,서삼석(徐參錫),전봉민(田奉珉),35,6,41,1
28433,서삼석(徐參錫),전용기(田溶冀),145,112,257,0
28434,서삼석(徐參錫),전재수(田載秀),97,78,175,0
28435,서삼석(徐參錫),전주혜(全珠惠),50,4,54,1
28436,서삼석(徐參錫),전해철(全海澈),82,57,139,0
28437,서삼석(徐參錫),전혜숙(全惠淑),92,68,160,0
28438,서삼석(徐參錫),정경희(丁慶姬),49,5,54,1
28439,서삼석(徐參錫),정동만(鄭東萬),49,4,53,1
28440,서삼석(徐參錫),정성호(鄭成湖),90,80,170,0
28441,서삼석(徐參錫),정우택(鄭宇澤),25,4,29,1
28442,서삼석(徐參錫),정운천(鄭雲天),59,11,70,1
28443,서삼석(徐參錫),정일영(鄭日永),97,84,181,0
28444,서삼석(徐參錫),정점식(鄭点植),51,7,58,1
28445,서삼석(徐參錫),정진석(鄭鎭碩),49,5,54,1
28446,서삼석(徐參錫),정청래(鄭淸來),106,64,170,0
28447,서삼석(徐參錫),정춘숙(鄭春淑),124,175,299,0
28448,서삼석(徐參錫),정태호(鄭泰浩),91,73,164,0
28449,서삼석(徐參錫),정필모(鄭必模),99,79,178,0
28450,서삼석(徐參錫),정희용(鄭熙溶),56,8,64,1
28451,서삼석(徐參錫),조경태(趙慶泰),51,4,55,1
28452,서삼석(徐參錫),조명희(曺明姬),50,7,57,1
28453,서삼석(徐參錫),조수진(趙修眞),54,4,58,1
28454,서삼석(徐參錫),조승래(趙承來),95,68,163,0
28455,서삼석(徐參錫),조오섭(曺五燮),134,185,319,0
28456,서삼석(徐參錫),조은희(趙恩禧),25,5,30,1
28457,서삼석(徐參錫),조응천(趙應天),81,37,118,0
28458,서삼석(徐參錫),조정식(趙正湜),80,44,124,0
28459,서삼석(徐參錫),조정훈(趙廷訓),6,3,9,1
28460,서삼석(徐參錫),조해진(曺海珍),51,5,56,1
28461,서삼석(徐參錫),주철현(朱哲鉉),149,193,342,0
28462,서삼석(徐參錫),주호영(朱豪英),51,4,55,1
28463,서삼석(徐參錫),지성호(池成浩),50,5,55,1
28464,서삼석(徐參錫),진선미(陳善美),80,46,126,0
28465,서삼석(徐參錫),진성준(陳聲準),109,95,204,0
28466,서삼석(徐參錫),천준호(千俊鎬),101,75,176,0
28467,서삼석(徐參錫),최기상(崔基相),92,57,149,0
28468,서삼석(徐參錫),최승재(崔承宰),51,9,60,1
28469,서삼석(徐參錫),최연숙(崔姸淑),33,13,46,1
28470,서삼석(徐參錫),최영희(崔英姬),25,5,30,1
28471,서삼석(徐參錫),최인호(崔仁昊),117,81,198,0
28472,서삼석(徐參錫),최재형(崔在亨),26,4,30,1
28473,서삼석(徐參錫),최종윤(崔鍾允),108,100,208,0
28474,서삼석(徐參錫),최춘식(崔春植),52,6,58,1
28475,서삼석(徐參錫),최형두(崔炯斗),50,11,61,1
28476,서삼석(徐參錫),최혜영(崔惠英),96,79,175,0
28477,서삼석(徐參錫),추경호(秋慶鎬),55,3,58,1
28478,서삼석(徐參錫),태영호(太永浩),50,4,54,1
28479,서삼석(徐參錫),하영제(河榮帝),41,5,46,1
28480,서삼석(徐參錫),하태경(河泰慶),53,5,58,1
28481,서삼석(徐參錫),한기호(韓起鎬),51,6,57,1
28482,서삼석(徐參錫),한무경(韓茂景),50,7,57,1
28483,서삼석(徐參錫),한병도(韓秉道),111,85,196,0
28484,서삼석(徐參錫),한정애(韓貞愛),78,50,128,0
28485,서삼석(徐參錫),한준호(韓俊鎬),100,92,192,0
28486,서삼석(徐參錫),허숙정(許淑湞),1,2,3,0
28487,서삼석(徐參錫),허영(許榮),153,149,302,0
28488,서삼석(徐參錫),허은아(許垠娥),49,4,53,1
28489,서삼석(徐參錫),허종식(許琮植),97,91,188,0
28490,서삼석(徐參錫),홍기원(洪起元),98,84,182,0
28491,서삼석(徐參錫),홍문표(洪文杓),64,28,92,1
28492,서삼석(徐參錫),홍석준(洪碩晙),49,4,53,1
28493,서삼석(徐參錫),홍성국(洪性國),117,115,232,0
28494,서삼석(徐參錫),홍영표(洪永杓),88,60,148,0
28495,서삼석(徐參錫),홍익표(洪翼杓),87,66,153,0
28496,서삼석(徐參錫),홍정민(洪貞敏),113,110,223,0
28497,서삼석(徐參錫),황보승희(皇甫承希),45,2,47,1
28498,서삼석(徐參錫),황운하(黃雲夏),111,100,211,0
28499,서삼석(徐參錫),황희(黃熙),90,53,143,0
28500,서영교(徐瑛敎),서영석(徐暎錫),121,200,321,0
28501,서영교(徐瑛敎),서일준(徐一俊),53,5,58,1
28502,서영교(徐瑛敎),서정숙(徐正淑),49,6,55,1
28503,서영교(徐瑛敎),설훈(薛勳),94,104,198,0
28504,서영교(徐瑛敎),성일종(成一鍾),51,10,61,1
28505,서영교(徐瑛敎),소병철(蘇秉哲),100,76,176,0
28506,서영교(徐瑛敎),소병훈(蘇秉勳),107,140,247,0
28507,서영교(徐瑛敎),송갑석(宋甲錫),114,134,248,0
28508,서영교(徐瑛敎),송기헌(宋基憲),95,68,163,0
28509,서영교(徐瑛敎),송석준(宋錫俊),50,6,56,1
28510,서영교(徐瑛敎),송언석(宋彦錫),47,5,52,1
28511,서영교(徐瑛敎),송옥주(宋玉珠),104,131,235,0
28512,서영교(徐瑛敎),송재호(宋在祜),122,140,262,0
28513,서영교(徐瑛敎),신동근(申東根),110,102,212,0
28514,서영교(徐瑛敎),신영대(申榮大),97,92,189,0
28515,서영교(徐瑛敎),신원식(申源湜),53,6,59,1
28516,서영교(徐瑛敎),신정훈(辛正勳),165,341,506,0
28517,서영교(徐瑛敎),신현영(申賢榮),87,84,171,0
28518,서영교(徐瑛敎),심상정(沈相奵),21,50,71,1
28519,서영교(徐瑛敎),안규백(安圭伯),112,126,238,0
28520,서영교(徐瑛敎),안민석(安敏錫),115,113,228,0
28521,서영교(徐瑛敎),안병길(安炳吉),52,4,56,1
28522,서영교(徐瑛敎),안철수(安哲秀),26,4,30,1
28523,서영교(徐瑛敎),안호영(安浩永),95,153,248,0
28524,서영교(徐瑛敎),양경숙(梁敬淑),111,204,315,0
28525,서영교(徐瑛敎),양금희(梁琴喜),52,7,59,1
28526,서영교(徐瑛敎),양기대(梁基大),133,177,310,0
28527,서영교(徐瑛敎),양이원영(梁李媛瑛),102,96,198,0
28528,서영교(徐瑛敎),양정숙(梁貞淑),103,351,454,1
28529,서영교(徐瑛敎),양향자(梁香子),54,60,114,1
28530,서영교(徐瑛敎),어기구(魚基龜),93,83,176,0
28531,서영교(徐瑛敎),엄태영(嚴泰永),52,7,59,1
28532,서영교(徐瑛敎),오기형(吳奇炯),92,48,140,0
28533,서영교(徐瑛敎),오영환(吳永煥),232,331,563,0
28534,서영교(徐瑛敎),용혜인(龍慧仁),20,50,70,1
28535,서영교(徐瑛敎),우상호(禹相虎),84,47,131,0
28536,서영교(徐瑛敎),우원식(禹元植),111,120,231,0
28537,서영교(徐瑛敎),위성곤(魏聖坤),122,207,329,0
28538,서영교(徐瑛敎),유경준(兪京濬),50,5,55,1
28539,서영교(徐瑛敎),유기홍(柳基洪),86,85,171,0
28540,서영교(徐瑛敎),유동수(柳東秀),90,60,150,0
28541,서영교(徐瑛敎),유상범(劉相凡),51,5,56,1
28542,서영교(徐瑛敎),유의동(兪義東),50,5,55,1
28543,서영교(徐瑛敎),유정주(兪訂炷),142,196,338,0
28544,서영교(徐瑛敎),윤건영(尹建永),91,81,172,0
28545,서영교(徐瑛敎),윤관석(尹官石),92,93,185,1
28546,서영교(徐瑛敎),윤두현(尹斗鉉),50,5,55,1
28547,서영교(徐瑛敎),윤미향(尹美香),56,102,158,1
28548,서영교(徐瑛敎),윤상현(尹相現),32,6,38,1
28549,서영교(徐瑛敎),윤영덕(尹永德),113,151,264,0
28550,서영교(徐瑛敎),윤영석(尹永碩),51,5,56,1
28551,서영교(徐瑛敎),윤영찬(尹永燦),86,85,171,0
28552,서영교(徐瑛敎),윤재갑(尹才鉀),127,156,283,0
28553,서영교(徐瑛敎),윤재옥(尹在玉),50,4,54,1
28554,서영교(徐瑛敎),윤주경(尹柱卿),49,6,55,1
28555,서영교(徐瑛敎),윤준병(尹準炳),150,339,489,0
28556,서영교(徐瑛敎),윤창현(尹暢賢),49,7,56,1
28557,서영교(徐瑛敎),윤한홍(尹漢洪),51,5,56,1
28558,서영교(徐瑛敎),윤호중(尹昊重),83,56,139,0
28559,서영교(徐瑛敎),윤후덕(尹厚德),98,110,208,0
28560,서영교(徐瑛敎),이개호(李介昊),115,151,266,0
28561,서영교(徐瑛敎),이달곤(李達坤),53,7,60,1
28562,서영교(徐瑛敎),이동주(李東洲),109,140,249,0
28563,서영교(徐瑛敎),이만희(李晩熙),51,4,55,1
28564,서영교(徐瑛敎),이명수(李明洙),55,18,73,1
28565,서영교(徐瑛敎),이병훈(李炳勳),139,224,363,0
28566,서영교(徐瑛敎),이상민(李相珉),80,47,127,0
28567,서영교(徐瑛敎),이상헌(李相憲),119,212,331,0
28568,서영교(徐瑛敎),이성만(李成萬),117,159,276,1
28569,서영교(徐瑛敎),이소영(李素永),102,62,164,0
28570,서영교(徐瑛敎),이수진(李壽珍),107,146,253,0
28571,서영교(徐瑛敎),이수진(李秀眞),144,146,290,0
28572,서영교(徐瑛敎),이양수(李亮壽),55,7,62,1
28573,서영교(徐瑛敎),이용(李鏞),51,5,56,1
28574,서영교(徐瑛敎),이용빈(李龍彬),152,278,430,0
28575,서영교(徐瑛敎),이용선(李庸瑄),111,143,254,0
28576,서영교(徐瑛敎),이용우(李龍雨),101,73,174,0
28577,서영교(徐瑛敎),이용호(李容鎬),39,26,65,1
28578,서영교(徐瑛敎),이원욱(李元旭),103,129,232,0
28579,서영교(徐瑛敎),이원택(李源澤),102,129,231,0
28580,서영교(徐瑛敎),이은주(李恩周),27,46,73,1
28581,서영교(徐瑛敎),이인선(李仁善),25,4,29,1
28582,서영교(徐瑛敎),이인영(李仁榮),77,64,141,0
28583,서영교(徐瑛敎),이장섭(李將燮),99,120,219,0
28584,서영교(徐瑛敎),이재명(李在明),41,25,66,0
28585,서영교(徐瑛敎),이재정(李在汀),93,61,154,0
28586,서영교(徐瑛敎),이정문(李楨文),127,133,260,0
28587,서영교(徐瑛敎),이종배(李鍾培),52,8,60,1
28588,서영교(徐瑛敎),이종성(李鍾成),51,6,57,1
28589,서영교(徐瑛敎),이주환(李周桓),50,7,57,1
28590,서영교(徐瑛敎),이채익(李埰益),52,8,60,1
28591,서영교(徐瑛敎),이철규(李喆圭),53,5,58,1
28592,서영교(徐瑛敎),이탄희(李誕熙),104,78,182,0
28593,서영교(徐瑛敎),이태규(李泰珪),30,8,38,1
28594,서영교(徐瑛敎),이학영(李學永),111,166,277,0
28595,서영교(徐瑛敎),이해식(李海植),152,159,311,0
28596,서영교(徐瑛敎),이헌승(李憲昇),50,4,54,1
28597,서영교(徐瑛敎),이형석(李炯錫),155,171,326,0
28598,서영교(徐瑛敎),인재근(印在謹),116,127,243,0
28599,서영교(徐瑛敎),임병헌(林炳憲),26,5,31,1
28600,서영교(徐瑛敎),임오경(林五卿),156,184,340,0
28601,서영교(徐瑛敎),임이자(林利子),50,4,54,1
28602,서영교(徐瑛敎),임종성(林鍾聲),102,122,224,0
28603,서영교(徐瑛敎),임호선(林昊宣),184,214,398,0
28604,서영교(徐瑛敎),장경태(張耿態),114,126,240,0
28605,서영교(徐瑛敎),장동혁(張東赫),25,4,29,1
28606,서영교(徐瑛敎),장제원(張濟元),49,4,53,1
28607,서영교(徐瑛敎),장철민(張喆敏),115,122,237,0
28608,서영교(徐瑛敎),장혜영(張惠英),16,24,40,1
28609,서영교(徐瑛敎),전봉민(田奉珉),35,5,40,1
28610,서영교(徐瑛敎),전용기(田溶冀),106,129,235,0
28611,서영교(徐瑛敎),전재수(田載秀),91,69,160,0
28612,서영교(徐瑛敎),전주혜(全珠惠),53,7,60,1
28613,서영교(徐瑛敎),전해철(全海澈),83,73,156,0
28614,서영교(徐瑛敎),전혜숙(全惠淑),118,132,250,0
28615,서영교(徐瑛敎),정경희(丁慶姬),51,4,55,1
28616,서영교(徐瑛敎),정동만(鄭東萬),49,4,53,1
28617,서영교(徐瑛敎),정성호(鄭成湖),87,89,176,0
28618,서영교(徐瑛敎),정우택(鄭宇澤),26,4,30,1
28619,서영교(徐瑛敎),정운천(鄭雲天),51,4,55,1
28620,서영교(徐瑛敎),정일영(鄭日永),98,99,197,0
28621,서영교(徐瑛敎),정점식(鄭点植),51,4,55,1
28622,서영교(徐瑛敎),정진석(鄭鎭碩),50,8,58,1
28623,서영교(徐瑛敎),정청래(鄭淸來),97,73,170,0
28624,서영교(徐瑛敎),정춘숙(鄭春淑),88,100,188,0
28625,서영교(徐瑛敎),정태호(鄭泰浩),94,136,230,0
28626,서영교(徐瑛敎),정필모(鄭必模),98,80,178,0
28627,서영교(徐瑛敎),정희용(鄭熙溶),51,8,59,1
28628,서영교(徐瑛敎),조경태(趙慶泰),52,4,56,1
28629,서영교(徐瑛敎),조명희(曺明姬),52,7,59,1
28630,서영교(徐瑛敎),조수진(趙修眞),50,5,55,1
28631,서영교(徐瑛敎),조승래(趙承來),105,94,199,0
28632,서영교(徐瑛敎),조오섭(曺五燮),129,256,385,0
28633,서영교(徐瑛敎),조은희(趙恩禧),27,5,32,1
28634,서영교(徐瑛敎),조응천(趙應天),74,40,114,0
28635,서영교(徐瑛敎),조정식(趙正湜),80,54,134,0
28636,서영교(徐瑛敎),조정훈(趙廷訓),5,21,26,1
28637,서영교(徐瑛敎),조해진(曺海珍),53,5,58,1
28638,서영교(徐瑛敎),주철현(朱哲鉉),116,140,256,0
28639,서영교(徐瑛敎),주호영(朱豪英),50,4,54,1
28640,서영교(徐瑛敎),지성호(池成浩),51,5,56,1
28641,서영교(徐瑛敎),진선미(陳善美),88,81,169,0
28642,서영교(徐瑛敎),진성준(陳聲準),108,105,213,0
28643,서영교(徐瑛敎),천준호(千俊鎬),95,81,176,0
28644,서영교(徐瑛敎),최기상(崔基相),89,102,191,0
28645,서영교(徐瑛敎),최승재(崔承宰),53,6,59,1
28646,서영교(徐瑛敎),최연숙(崔姸淑),33,13,46,1
28647,서영교(徐瑛敎),최영희(崔英姬),26,5,31,1
28648,서영교(徐瑛敎),최인호(崔仁昊),102,108,210,0
28649,서영교(徐瑛敎),최재형(崔在亨),25,4,29,1
28650,서영교(徐瑛敎),최종윤(崔鍾允),118,160,278,0
28651,서영교(徐瑛敎),최춘식(崔春植),53,8,61,1
28652,서영교(徐瑛敎),최형두(崔炯斗),55,17,72,1
28653,서영교(徐瑛敎),최혜영(崔惠英),113,177,290,0
28654,서영교(徐瑛敎),추경호(秋慶鎬),51,4,55,1
28655,서영교(徐瑛敎),태영호(太永浩),50,8,58,1
28656,서영교(徐瑛敎),하영제(河榮帝),44,3,47,1
28657,서영교(徐瑛敎),하태경(河泰慶),50,6,56,1
28658,서영교(徐瑛敎),한기호(韓起鎬),51,7,58,1
28659,서영교(徐瑛敎),한무경(韓茂景),50,6,56,1
28660,서영교(徐瑛敎),한병도(韓秉道),183,260,443,0
28661,서영교(徐瑛敎),한정애(韓貞愛),86,93,179,0
28662,서영교(徐瑛敎),한준호(韓俊鎬),114,130,244,0
28663,서영교(徐瑛敎),허숙정(許淑湞),1,1,2,0
28664,서영교(徐瑛敎),허영(許榮),124,156,280,0
28665,서영교(徐瑛敎),허은아(許垠娥),50,5,55,1
28666,서영교(徐瑛敎),허종식(許琮植),96,113,209,0
28667,서영교(徐瑛敎),홍기원(洪起元),102,103,205,0
28668,서영교(徐瑛敎),홍문표(洪文杓),54,13,67,1
28669,서영교(徐瑛敎),홍석준(洪碩晙),50,4,54,1
28670,서영교(徐瑛敎),홍성국(洪性國),108,173,281,0
28671,서영교(徐瑛敎),홍영표(洪永杓),94,99,193,0
28672,서영교(徐瑛敎),홍익표(洪翼杓),97,92,189,0
28673,서영교(徐瑛敎),홍정민(洪貞敏),117,141,258,0
28674,서영교(徐瑛敎),황보승희(皇甫承希),50,3,53,1
28675,서영교(徐瑛敎),황운하(黃雲夏),116,139,255,0
28676,서영교(徐瑛敎),황희(黃熙),83,53,136,0
28677,서영석(徐暎錫),서일준(徐一俊),52,10,62,1
28678,서영석(徐暎錫),서정숙(徐正淑),49,6,55,1
28679,서영석(徐暎錫),설훈(薛勳),99,110,209,0
28680,서영석(徐暎錫),성일종(成一鍾),49,8,57,1
28681,서영석(徐暎錫),소병철(蘇秉哲),94,79,173,0
28682,서영석(徐暎錫),소병훈(蘇秉勳),109,129,238,0
28683,서영석(徐暎錫),송갑석(宋甲錫),121,154,275,0
28684,서영석(徐暎錫),송기헌(宋基憲),84,58,142,0
28685,서영석(徐暎錫),송석준(宋錫俊),51,6,57,1
28686,서영석(徐暎錫),송언석(宋彦錫),46,4,50,1
28687,서영석(徐暎錫),송옥주(宋玉珠),112,116,228,0
28688,서영석(徐暎錫),송재호(宋在祜),113,134,247,0
28689,서영석(徐暎錫),신동근(申東根),100,101,201,0
28690,서영석(徐暎錫),신영대(申榮大),89,63,152,0
28691,서영석(徐暎錫),신원식(申源湜),49,4,53,1
28692,서영석(徐暎錫),신정훈(辛正勳),123,212,335,0
28693,서영석(徐暎錫),신현영(申賢榮),90,70,160,0
28694,서영석(徐暎錫),심상정(沈相奵),17,39,56,1
28695,서영석(徐暎錫),안규백(安圭伯),93,88,181,0
28696,서영석(徐暎錫),안민석(安敏錫),107,150,257,0
28697,서영석(徐暎錫),안병길(安炳吉),49,5,54,1
28698,서영석(徐暎錫),안철수(安哲秀),25,5,30,1
28699,서영석(徐暎錫),안호영(安浩永),86,75,161,0
28700,서영석(徐暎錫),양경숙(梁敬淑),108,102,210,0
28701,서영석(徐暎錫),양금희(梁琴喜),49,7,56,1
28702,서영석(徐暎錫),양기대(梁基大),101,96,197,0
28703,서영석(徐暎錫),양이원영(梁李媛瑛),99,116,215,0
28704,서영석(徐暎錫),양정숙(梁貞淑),57,174,231,1
28705,서영석(徐暎錫),양향자(梁香子),56,70,126,1
28706,서영석(徐暎錫),어기구(魚基龜),94,55,149,0
28707,서영석(徐暎錫),엄태영(嚴泰永),50,7,57,1
28708,서영석(徐暎錫),오기형(吳奇炯),90,64,154,0
28709,서영석(徐暎錫),오영환(吳永煥),166,246,412,0
28710,서영석(徐暎錫),용혜인(龍慧仁),17,49,66,1
28711,서영석(徐暎錫),우상호(禹相虎),80,48,128,0
28712,서영석(徐暎錫),우원식(禹元植),106,144,250,0
28713,서영석(徐暎錫),위성곤(魏聖坤),94,118,212,0
28714,서영석(徐暎錫),유경준(兪京濬),49,4,53,1
28715,서영석(徐暎錫),유기홍(柳基洪),84,60,144,0
28716,서영석(徐暎錫),유동수(柳東秀),90,65,155,0
28717,서영석(徐暎錫),유상범(劉相凡),49,4,53,1
28718,서영석(徐暎錫),유의동(兪義東),49,4,53,1
28719,서영석(徐暎錫),유정주(兪訂炷),115,146,261,0
28720,서영석(徐暎錫),윤건영(尹建永),84,84,168,0
28721,서영석(徐暎錫),윤관석(尹官石),79,71,150,1
28722,서영석(徐暎錫),윤두현(尹斗鉉),49,5,54,1
28723,서영석(徐暎錫),윤미향(尹美香),61,121,182,1
28724,서영석(徐暎錫),윤상현(尹相現),31,12,43,1
28725,서영석(徐暎錫),윤영덕(尹永德),106,137,243,0
28726,서영석(徐暎錫),윤영석(尹永碩),49,5,54,1
28727,서영석(徐暎錫),윤영찬(尹永燦),87,79,166,0
28728,서영석(徐暎錫),윤재갑(尹才鉀),123,121,244,0
28729,서영석(徐暎錫),윤재옥(尹在玉),49,4,53,1
28730,서영석(徐暎錫),윤주경(尹柱卿),49,5,54,1
28731,서영석(徐暎錫),윤준병(尹準炳),120,188,308,0
28732,서영석(徐暎錫),윤창현(尹暢賢),49,6,55,1
28733,서영석(徐暎錫),윤한홍(尹漢洪),49,6,55,1
28734,서영석(徐暎錫),윤호중(尹昊重),78,63,141,0
28735,서영석(徐暎錫),윤후덕(尹厚德),97,78,175,0
28736,서영석(徐暎錫),이개호(李介昊),82,60,142,0
28737,서영석(徐暎錫),이달곤(李達坤),50,7,57,1
28738,서영석(徐暎錫),이동주(李東洲),113,132,245,0
28739,서영석(徐暎錫),이만희(李晩熙),49,4,53,1
28740,서영석(徐暎錫),이명수(李明洙),50,15,65,1
28741,서영석(徐暎錫),이병훈(李炳勳),96,128,224,0
28742,서영석(徐暎錫),이상민(李相珉),75,39,114,0
28743,서영석(徐暎錫),이상헌(李相憲),105,108,213,0
28744,서영석(徐暎錫),이성만(李成萬),114,144,258,1
28745,서영석(徐暎錫),이소영(李素永),98,74,172,0
28746,서영석(徐暎錫),이수진(李壽珍),120,149,269,0
28747,서영석(徐暎錫),이수진(李秀眞),127,120,247,0
28748,서영석(徐暎錫),이양수(李亮壽),49,6,55,1
28749,서영석(徐暎錫),이용(李鏞),49,4,53,1
28750,서영석(徐暎錫),이용빈(李龍彬),161,312,473,0
28751,서영석(徐暎錫),이용선(李庸瑄),111,155,266,0
28752,서영석(徐暎錫),이용우(李龍雨),133,120,253,0
28753,서영석(徐暎錫),이용호(李容鎬),36,29,65,1
28754,서영석(徐暎錫),이원욱(李元旭),95,85,180,0
28755,서영석(徐暎錫),이원택(李源澤),86,77,163,0
28756,서영석(徐暎錫),이은주(李恩周),32,48,80,1
28757,서영석(徐暎錫),이인선(李仁善),25,5,30,1
28758,서영석(徐暎錫),이인영(李仁榮),76,61,137,0
28759,서영석(徐暎錫),이장섭(李將燮),99,79,178,0
28760,서영석(徐暎錫),이재명(李在明),40,20,60,0
28761,서영석(徐暎錫),이재정(李在汀),91,65,156,0
28762,서영석(徐暎錫),이정문(李楨文),154,217,371,0
28763,서영석(徐暎錫),이종배(李鍾培),50,5,55,1
28764,서영석(徐暎錫),이종성(李鍾成),50,8,58,1
28765,서영석(徐暎錫),이주환(李周桓),49,5,54,1
28766,서영석(徐暎錫),이채익(李埰益),50,8,58,1
28767,서영석(徐暎錫),이철규(李喆圭),50,5,55,1
28768,서영석(徐暎錫),이탄희(李誕熙),104,102,206,0
28769,서영석(徐暎錫),이태규(李泰珪),29,7,36,1
28770,서영석(徐暎錫),이학영(李學永),111,148,259,0
28771,서영석(徐暎錫),이해식(李海植),137,183,320,0
28772,서영석(徐暎錫),이헌승(李憲昇),50,6,56,1
28773,서영석(徐暎錫),이형석(李炯錫),125,127,252,0
28774,서영석(徐暎錫),인재근(印在謹),159,220,379,0
28775,서영석(徐暎錫),임병헌(林炳憲),25,4,29,1
28776,서영석(徐暎錫),임오경(林五卿),103,102,205,0
28777,서영석(徐暎錫),임이자(林利子),49,5,54,1
28778,서영석(徐暎錫),임종성(林鍾聲),115,153,268,0
28779,서영석(徐暎錫),임호선(林昊宣),132,186,318,0
28780,서영석(徐暎錫),장경태(張耿態),107,119,226,0
28781,서영석(徐暎錫),장동혁(張東赫),25,4,29,1
28782,서영석(徐暎錫),장제원(張濟元),49,4,53,1
28783,서영석(徐暎錫),장철민(張喆敏),95,102,197,0
28784,서영석(徐暎錫),장혜영(張惠英),16,35,51,1
28785,서영석(徐暎錫),전봉민(田奉珉),35,6,41,1
28786,서영석(徐暎錫),전용기(田溶冀),117,111,228,0
28787,서영석(徐暎錫),전재수(田載秀),84,47,131,0
28788,서영석(徐暎錫),전주혜(全珠惠),50,6,56,1
28789,서영석(徐暎錫),전해철(全海澈),74,52,126,0
28790,서영석(徐暎錫),전혜숙(全惠淑),105,93,198,0
28791,서영석(徐暎錫),정경희(丁慶姬),49,4,53,1
28792,서영석(徐暎錫),정동만(鄭東萬),49,4,53,1
28793,서영석(徐暎錫),정성호(鄭成湖),90,108,198,0
28794,서영석(徐暎錫),정우택(鄭宇澤),26,5,31,1
28795,서영석(徐暎錫),정운천(鄭雲天),53,7,60,1
28796,서영석(徐暎錫),정일영(鄭日永),99,121,220,0
28797,서영석(徐暎錫),정점식(鄭点植),49,4,53,1
28798,서영석(徐暎錫),정진석(鄭鎭碩),49,7,56,1
28799,서영석(徐暎錫),정청래(鄭淸來),90,63,153,0
28800,서영석(徐暎錫),정춘숙(鄭春淑),111,142,253,0
28801,서영석(徐暎錫),정태호(鄭泰浩),82,94,176,0
28802,서영석(徐暎錫),정필모(鄭必模),92,98,190,0
28803,서영석(徐暎錫),정희용(鄭熙溶),50,6,56,1
28804,서영석(徐暎錫),조경태(趙慶泰),49,5,54,1
28805,서영석(徐暎錫),조명희(曺明姬),49,9,58,1
28806,서영석(徐暎錫),조수진(趙修眞),49,6,55,1
28807,서영석(徐暎錫),조승래(趙承來),117,129,246,0
28808,서영석(徐暎錫),조오섭(曺五燮),138,208,346,0
28809,서영석(徐暎錫),조은희(趙恩禧),25,5,30,1
28810,서영석(徐暎錫),조응천(趙應天),74,44,118,0
28811,서영석(徐暎錫),조정식(趙正湜),78,57,135,0
28812,서영석(徐暎錫),조정훈(趙廷訓),4,8,12,1
28813,서영석(徐暎錫),조해진(曺海珍),50,6,56,1
28814,서영석(徐暎錫),주철현(朱哲鉉),98,103,201,0
28815,서영석(徐暎錫),주호영(朱豪英),49,4,53,1
28816,서영석(徐暎錫),지성호(池成浩),49,4,53,1
28817,서영석(徐暎錫),진선미(陳善美),79,51,130,0
28818,서영석(徐暎錫),진성준(陳聲準),132,138,270,0
28819,서영석(徐暎錫),천준호(千俊鎬),97,85,182,0
28820,서영석(徐暎錫),최기상(崔基相),84,76,160,0
28821,서영석(徐暎錫),최승재(崔承宰),49,7,56,1
28822,서영석(徐暎錫),최연숙(崔姸淑),38,22,60,1
28823,서영석(徐暎錫),최영희(崔英姬),25,5,30,1
28824,서영석(徐暎錫),최인호(崔仁昊),98,96,194,0
28825,서영석(徐暎錫),최재형(崔在亨),25,5,30,1
28826,서영석(徐暎錫),최종윤(崔鍾允),138,198,336,0
28827,서영석(徐暎錫),최춘식(崔春植),51,7,58,1
28828,서영석(徐暎錫),최형두(崔炯斗),50,7,57,1
28829,서영석(徐暎錫),최혜영(崔惠英),168,252,420,0
28830,서영석(徐暎錫),추경호(秋慶鎬),49,3,52,1
28831,서영석(徐暎錫),태영호(太永浩),49,6,55,1
28832,서영석(徐暎錫),하영제(河榮帝),43,6,49,1
28833,서영석(徐暎錫),하태경(河泰慶),53,8,61,1
28834,서영석(徐暎錫),한기호(韓起鎬),49,4,53,1
28835,서영석(徐暎錫),한무경(韓茂景),51,6,57,1
28836,서영석(徐暎錫),한병도(韓秉道),106,107,213,0
28837,서영석(徐暎錫),한정애(韓貞愛),85,76,161,0
28838,서영석(徐暎錫),한준호(韓俊鎬),112,150,262,0
28839,서영석(徐暎錫),허숙정(許淑湞),1,1,2,0
28840,서영석(徐暎錫),허영(許榮),128,150,278,0
28841,서영석(徐暎錫),허은아(許垠娥),49,7,56,1
28842,서영석(徐暎錫),허종식(許琮植),125,158,283,0
28843,서영석(徐暎錫),홍기원(洪起元),105,95,200,0
28844,서영석(徐暎錫),홍문표(洪文杓),52,9,61,1
28845,서영석(徐暎錫),홍석준(洪碩晙),49,4,53,1
28846,서영석(徐暎錫),홍성국(洪性國),133,219,352,0
28847,서영석(徐暎錫),홍영표(洪永杓),78,55,133,0
28848,서영석(徐暎錫),홍익표(洪翼杓),94,77,171,0
28849,서영석(徐暎錫),홍정민(洪貞敏),152,182,334,0
28850,서영석(徐暎錫),황보승희(皇甫承希),45,4,49,1
28851,서영석(徐暎錫),황운하(黃雲夏),125,140,265,0
28852,서영석(徐暎錫),황희(黃熙),81,60,141,0
28853,서일준(徐一俊),서정숙(徐正淑),92,103,195,0
28854,서일준(徐一俊),설훈(薛勳),50,9,59,1
28855,서일준(徐一俊),성일종(成一鍾),109,176,285,0
28856,서일준(徐一俊),소병철(蘇秉哲),52,5,57,1
28857,서일준(徐一俊),소병훈(蘇秉勳),51,5,56,1
28858,서일준(徐一俊),송갑석(宋甲錫),52,7,59,1
28859,서일준(徐一俊),송기헌(宋基憲),51,5,56,1
28860,서일준(徐一俊),송석준(宋錫俊),77,74,151,0
28861,서일준(徐一俊),송언석(宋彦錫),100,117,217,0
28862,서일준(徐一俊),송옥주(宋玉珠),50,5,55,1
28863,서일준(徐一俊),송재호(宋在祜),51,5,56,1
28864,서일준(徐一俊),신동근(申東根),50,4,54,1
28865,서일준(徐一俊),신영대(申榮大),50,5,55,1
28866,서일준(徐一俊),신원식(申源湜),87,111,198,0
28867,서일준(徐一俊),신정훈(辛正勳),53,6,59,1
28868,서일준(徐一俊),신현영(申賢榮),50,4,54,1
28869,서일준(徐一俊),심상정(沈相奵),5,5,10,1
28870,서일준(徐一俊),안규백(安圭伯),52,9,61,1
28871,서일준(徐一俊),안민석(安敏錫),51,4,55,1
28872,서일준(徐一俊),안병길(安炳吉),82,130,212,0
28873,서일준(徐一俊),안철수(安哲秀),28,24,52,0
28874,서일준(徐一俊),안호영(安浩永),51,7,58,1
28875,서일준(徐一俊),양경숙(梁敬淑),50,7,57,1
28876,서일준(徐一俊),양금희(梁琴喜),168,268,436,0
28877,서일준(徐一俊),양기대(梁基大),51,4,55,1
28878,서일준(徐一俊),양이원영(梁李媛瑛),45,7,52,1
28879,서일준(徐一俊),양정숙(梁貞淑),4,10,14,1
28880,서일준(徐一俊),양향자(梁香子),24,10,34,1
28881,서일준(徐一俊),어기구(魚基龜),50,7,57,1
28882,서일준(徐一俊),엄태영(嚴泰永),89,107,196,0
28883,서일준(徐一俊),오기형(吳奇炯),49,4,53,1
28884,서일준(徐一俊),오영환(吳永煥),51,9,60,1
28885,서일준(徐一俊),용혜인(龍慧仁),1,4,5,1
28886,서일준(徐一俊),우상호(禹相虎),51,4,55,1
28887,서일준(徐一俊),우원식(禹元植),50,4,54,1
28888,서일준(徐一俊),위성곤(魏聖坤),50,6,56,1
28889,서일준(徐一俊),유경준(兪京濬),109,172,281,0
28890,서일준(徐一俊),유기홍(柳基洪),50,5,55,1
28891,서일준(徐一俊),유동수(柳東秀),51,4,55,1
28892,서일준(徐一俊),유상범(劉相凡),78,84,162,0
28893,서일준(徐一俊),유의동(兪義東),82,74,156,0
28894,서일준(徐一俊),유정주(兪訂炷),49,6,55,1
28895,서일준(徐一俊),윤건영(尹建永),49,4,53,1
28896,서일준(徐一俊),윤관석(尹官石),41,4,45,1
28897,서일준(徐一俊),윤두현(尹斗鉉),112,175,287,0
28898,서일준(徐一俊),윤미향(尹美香),20,5,25,1
28899,서일준(徐一俊),윤상현(尹相現),37,42,79,0
28900,서일준(徐一俊),윤영덕(尹永德),50,10,60,1
28901,서일준(徐一俊),윤영석(尹永碩),82,80,162,0
28902,서일준(徐一俊),윤영찬(尹永燦),50,4,54,1
28903,서일준(徐一俊),윤재갑(尹才鉀),54,9,63,1
28904,서일준(徐一俊),윤재옥(尹在玉),77,66,143,0
28905,서일준(徐一俊),윤주경(尹柱卿),87,93,180,0
28906,서일준(徐一俊),윤준병(尹準炳),51,4,55,1
28907,서일준(徐一俊),윤창현(尹暢賢),140,176,316,0
28908,서일준(徐一俊),윤한홍(尹漢洪),110,142,252,0
28909,서일준(徐一俊),윤호중(尹昊重),51,4,55,1
28910,서일준(徐一俊),윤후덕(尹厚德),50,8,58,1
28911,서일준(徐一俊),이개호(李介昊),52,6,58,1
28912,서일준(徐一俊),이달곤(李達坤),79,111,190,0
28913,서일준(徐一俊),이동주(李東洲),49,4,53,1
28914,서일준(徐一俊),이만희(李晩熙),83,77,160,0
28915,서일준(徐一俊),이명수(李明洙),111,179,290,0
28916,서일준(徐一俊),이병훈(李炳勳),52,8,60,1
28917,서일준(徐一俊),이상민(李相珉),50,5,55,1
28918,서일준(徐一俊),이상헌(李相憲),53,6,59,1
28919,서일준(徐一俊),이성만(李成萬),41,2,43,1
28920,서일준(徐一俊),이소영(李素永),51,8,59,1
28921,서일준(徐一俊),이수진(李壽珍),50,6,56,1
28922,서일준(徐一俊),이수진(李秀眞),50,6,56,1
28923,서일준(徐一俊),이양수(李亮壽),95,111,206,0
28924,서일준(徐一俊),이용(李鏞),107,183,290,0
28925,서일준(徐一俊),이용빈(李龍彬),53,8,61,1
28926,서일준(徐一俊),이용선(李庸瑄),50,6,56,1
28927,서일준(徐一俊),이용우(李龍雨),49,10,59,1
28928,서일준(徐一俊),이용호(李容鎬),42,29,71,0
28929,서일준(徐一俊),이원욱(李元旭),52,6,58,1
28930,서일준(徐一俊),이원택(李源澤),50,5,55,1
28931,서일준(徐一俊),이은주(李恩周),6,4,10,1
28932,서일준(徐一俊),이인선(李仁善),42,40,82,0
28933,서일준(徐一俊),이인영(李仁榮),50,4,54,1
28934,서일준(徐一俊),이장섭(李將燮),50,6,56,1
28935,서일준(徐一俊),이재명(李在明),25,4,29,1
28936,서일준(徐一俊),이재정(李在汀),50,4,54,1
28937,서일준(徐一俊),이정문(李楨文),50,8,58,1
28938,서일준(徐一俊),이종배(李鍾培),113,164,277,0
28939,서일준(徐一俊),이종성(李鍾成),158,248,406,0
28940,서일준(徐一俊),이주환(李周桓),154,238,392,0
28941,서일준(徐一俊),이채익(李埰益),95,119,214,0
28942,서일준(徐一俊),이철규(李喆圭),111,115,226,0
28943,서일준(徐一俊),이탄희(李誕熙),50,6,56,1
28944,서일준(徐一俊),이태규(李泰珪),47,52,99,0
28945,서일준(徐一俊),이학영(李學永),49,4,53,1
28946,서일준(徐一俊),이해식(李海植),51,9,60,1
28947,서일준(徐一俊),이헌승(李憲昇),75,132,207,0
28948,서일준(徐一俊),이형석(李炯錫),50,5,55,1
28949,서일준(徐一俊),인재근(印在謹),51,8,59,1
28950,서일준(徐一俊),임병헌(林炳憲),46,33,79,0
28951,서일준(徐一俊),임오경(林五卿),50,5,55,1
28952,서일준(徐一俊),임이자(林利子),131,171,302,0
28953,서일준(徐一俊),임종성(林鍾聲),53,6,59,1
28954,서일준(徐一俊),임호선(林昊宣),53,6,59,1
28955,서일준(徐一俊),장경태(張耿態),51,7,58,1
28956,서일준(徐一俊),장동혁(張東赫),31,39,70,0
28957,서일준(徐一俊),장제원(張濟元),68,60,128,0
28958,서일준(徐一俊),장철민(張喆敏),51,5,56,1
28959,서일준(徐一俊),장혜영(張惠英),5,5,10,1
28960,서일준(徐一俊),전봉민(田奉珉),67,130,197,0
28961,서일준(徐一俊),전용기(田溶冀),50,5,55,1
28962,서일준(徐一俊),전재수(田載秀),50,6,56,1
28963,서일준(徐一俊),전주혜(全珠惠),87,129,216,0
28964,서일준(徐一俊),전해철(全海澈),50,6,56,1
28965,서일준(徐一俊),전혜숙(全惠淑),51,7,58,1
28966,서일준(徐一俊),정경희(丁慶姬),88,98,186,0
28967,서일준(徐一俊),정동만(鄭東萬),98,121,219,0
28968,서일준(徐一俊),정성호(鄭成湖),53,5,58,1
28969,서일준(徐一俊),정우택(鄭宇澤),48,71,119,0
28970,서일준(徐一俊),정운천(鄭雲天),124,163,287,0
28971,서일준(徐一俊),정일영(鄭日永),49,6,55,1
28972,서일준(徐一俊),정점식(鄭点植),99,91,190,0
28973,서일준(徐一俊),정진석(鄭鎭碩),101,114,215,0
28974,서일준(徐一俊),정청래(鄭淸來),51,4,55,1
28975,서일준(徐一俊),정춘숙(鄭春淑),50,5,55,1
28976,서일준(徐一俊),정태호(鄭泰浩),50,6,56,1
28977,서일준(徐一俊),정필모(鄭必模),50,6,56,1
28978,서일준(徐一俊),정희용(鄭熙溶),122,160,282,0
28979,서일준(徐一俊),조경태(趙慶泰),91,106,197,0
28980,서일준(徐一俊),조명희(曺明姬),139,296,435,0
28981,서일준(徐一俊),조수진(趙修眞),104,149,253,0
28982,서일준(徐一俊),조승래(趙承來),50,8,58,1
28983,서일준(徐一俊),조오섭(曺五燮),53,9,62,1
28984,서일준(徐一俊),조은희(趙恩禧),45,70,115,0
28985,서일준(徐一俊),조응천(趙應天),50,3,53,1
28986,서일준(徐一俊),조정식(趙正湜),49,3,52,1
28987,서일준(徐一俊),조정훈(趙廷訓),2,8,10,1
28988,서일준(徐一俊),조해진(曺海珍),70,58,128,0
28989,서일준(徐一俊),주철현(朱哲鉉),52,6,58,1
28990,서일준(徐一俊),주호영(朱豪英),71,57,128,0
28991,서일준(徐一俊),지성호(池成浩),130,191,321,0
28992,서일준(徐一俊),진선미(陳善美),50,6,56,1
28993,서일준(徐一俊),진성준(陳聲準),50,5,55,1
28994,서일준(徐一俊),천준호(千俊鎬),49,3,52,1
28995,서일준(徐一俊),최기상(崔基相),50,4,54,1
28996,서일준(徐一俊),최승재(崔承宰),103,121,224,0
28997,서일준(徐一俊),최연숙(崔姸淑),38,51,89,0
28998,서일준(徐一俊),최영희(崔英姬),41,62,103,0
28999,서일준(徐一俊),최인호(崔仁昊),53,9,62,1
29000,서일준(徐一俊),최재형(崔在亨),25,15,40,0
29001,서일준(徐一俊),최종윤(崔鍾允),52,7,59,1
29002,서일준(徐一俊),최춘식(崔春植),108,168,276,0
29003,서일준(徐一俊),최형두(崔炯斗),114,164,278,0
29004,서일준(徐一俊),최혜영(崔惠英),49,6,55,1
29005,서일준(徐一俊),추경호(秋慶鎬),161,198,359,0
29006,서일준(徐一俊),태영호(太永浩),121,210,331,0
29007,서일준(徐一俊),하영제(河榮帝),137,288,425,1
29008,서일준(徐一俊),하태경(河泰慶),71,56,127,0
29009,서일준(徐一俊),한기호(韓起鎬),81,69,150,0
29010,서일준(徐一俊),한무경(韓茂景),157,291,448,0
29011,서일준(徐一俊),한병도(韓秉道),50,6,56,1
29012,서일준(徐一俊),한정애(韓貞愛),50,5,55,1
29013,서일준(徐一俊),한준호(韓俊鎬),51,10,61,1
29014,서일준(徐一俊),허숙정(許淑湞),0,0,0,1
29015,서일준(徐一俊),허영(許榮),51,5,56,1
29016,서일준(徐一俊),허은아(許垠娥),106,148,254,0
29017,서일준(徐一俊),허종식(許琮植),51,8,59,1
29018,서일준(徐一俊),홍기원(洪起元),50,5,55,1
29019,서일준(徐一俊),홍문표(洪文杓),103,132,235,0
29020,서일준(徐一俊),홍석준(洪碩晙),84,129,213,0
29021,서일준(徐一俊),홍성국(洪性國),50,11,61,1
29022,서일준(徐一俊),홍영표(洪永杓),50,5,55,1
29023,서일준(徐一俊),홍익표(洪翼杓),51,7,58,1
29024,서일준(徐一俊),홍정민(洪貞敏),51,4,55,1
29025,서일준(徐一俊),황보승희(皇甫承希),103,121,224,1
29026,서일준(徐一俊),황운하(黃雲夏),50,12,62,1
29027,서일준(徐一俊),황희(黃熙),49,6,55,1
29028,서정숙(徐正淑),설훈(薛勳),50,5,55,1
29029,서정숙(徐正淑),성일종(成一鍾),83,113,196,0
29030,서정숙(徐正淑),소병철(蘇秉哲),50,5,55,1
29031,서정숙(徐正淑),소병훈(蘇秉勳),49,5,54,1
29032,서정숙(徐正淑),송갑석(宋甲錫),49,4,53,1
29033,서정숙(徐正淑),송기헌(宋基憲),52,7,59,1
29034,서정숙(徐正淑),송석준(宋錫俊),70,84,154,0
29035,서정숙(徐正淑),송언석(宋彦錫),68,51,119,0
29036,서정숙(徐正淑),송옥주(宋玉珠),49,4,53,1
29037,서정숙(徐正淑),송재호(宋在祜),50,8,58,1
29038,서정숙(徐正淑),신동근(申東根),49,6,55,1
29039,서정숙(徐正淑),신영대(申榮大),49,4,53,1
29040,서정숙(徐正淑),신원식(申源湜),87,111,198,0
29041,서정숙(徐正淑),신정훈(辛正勳),51,5,56,1
29042,서정숙(徐正淑),신현영(申賢榮),49,5,54,1
29043,서정숙(徐正淑),심상정(沈相奵),4,6,10,1
29044,서정숙(徐正淑),안규백(安圭伯),51,6,57,1
29045,서정숙(徐正淑),안민석(安敏錫),50,3,53,1
29046,서정숙(徐正淑),안병길(安炳吉),71,70,141,0
29047,서정숙(徐正淑),안철수(安哲秀),28,22,50,0
29048,서정숙(徐正淑),안호영(安浩永),49,6,55,1
29049,서정숙(徐正淑),양경숙(梁敬淑),49,6,55,1
29050,서정숙(徐正淑),양금희(梁琴喜),87,112,199,0
29051,서정숙(徐正淑),양기대(梁基大),49,4,53,1
29052,서정숙(徐正淑),양이원영(梁李媛瑛),45,5,50,1
29053,서정숙(徐正淑),양정숙(梁貞淑),2,12,14,1
29054,서정숙(徐正淑),양향자(梁香子),24,8,32,1
29055,서정숙(徐正淑),어기구(魚基龜),49,5,54,1
29056,서정숙(徐正淑),엄태영(嚴泰永),73,76,149,0
29057,서정숙(徐正淑),오기형(吳奇炯),49,13,62,1
29058,서정숙(徐正淑),오영환(吳永煥),49,6,55,1
29059,서정숙(徐正淑),용혜인(龍慧仁),1,11,12,1
29060,서정숙(徐正淑),우상호(禹相虎),49,4,53,1
29061,서정숙(徐正淑),우원식(禹元植),49,5,54,1
29062,서정숙(徐正淑),위성곤(魏聖坤),49,7,56,1
29063,서정숙(徐正淑),유경준(兪京濬),84,76,160,0
29064,서정숙(徐正淑),유기홍(柳基洪),49,4,53,1
29065,서정숙(徐正淑),유동수(柳東秀),49,5,54,1
29066,서정숙(徐正淑),유상범(劉相凡),78,77,155,0
29067,서정숙(徐正淑),유의동(兪義東),70,70,140,0
29068,서정숙(徐正淑),유정주(兪訂炷),49,6,55,1
29069,서정숙(徐正淑),윤건영(尹建永),49,4,53,1
29070,서정숙(徐正淑),윤관석(尹官石),40,0,40,1
29071,서정숙(徐正淑),윤두현(尹斗鉉),85,104,189,0
29072,서정숙(徐正淑),윤미향(尹美香),20,2,22,1
29073,서정숙(徐正淑),윤상현(尹相現),38,40,78,0
29074,서정숙(徐正淑),윤영덕(尹永德),49,10,59,1
29075,서정숙(徐正淑),윤영석(尹永碩),63,53,116,0
29076,서정숙(徐正淑),윤영찬(尹永燦),49,6,55,1
29077,서정숙(徐正淑),윤재갑(尹才鉀),50,7,57,1
29078,서정숙(徐正淑),윤재옥(尹在玉),71,56,127,0
29079,서정숙(徐正淑),윤주경(尹柱卿),81,95,176,0
29080,서정숙(徐正淑),윤준병(尹準炳),49,4,53,1
29081,서정숙(徐正淑),윤창현(尹暢賢),78,108,186,0
29082,서정숙(徐正淑),윤한홍(尹漢洪),65,90,155,0
29083,서정숙(徐正淑),윤호중(尹昊重),49,5,54,1
29084,서정숙(徐正淑),윤후덕(尹厚德),49,5,54,1
29085,서정숙(徐正淑),이개호(李介昊),49,7,56,1
29086,서정숙(徐正淑),이달곤(李達坤),64,54,118,0
29087,서정숙(徐正淑),이동주(李東洲),49,5,54,1
29088,서정숙(徐正淑),이만희(李晩熙),76,63,139,0
29089,서정숙(徐正淑),이명수(李明洙),86,107,193,0
29090,서정숙(徐正淑),이병훈(李炳勳),52,11,63,1
29091,서정숙(徐正淑),이상민(李相珉),49,4,53,1
29092,서정숙(徐正淑),이상헌(李相憲),50,13,63,1
29093,서정숙(徐正淑),이성만(李成萬),40,2,42,1
29094,서정숙(徐正淑),이소영(李素永),49,7,56,1
29095,서정숙(徐正淑),이수진(李壽珍),49,8,57,1
29096,서정숙(徐正淑),이수진(李秀眞),49,7,56,1
29097,서정숙(徐正淑),이양수(李亮壽),76,80,156,0
29098,서정숙(徐正淑),이용(李鏞),84,87,171,0
29099,서정숙(徐正淑),이용빈(李龍彬),51,7,58,1
29100,서정숙(徐正淑),이용선(李庸瑄),49,6,55,1
29101,서정숙(徐正淑),이용우(李龍雨),49,10,59,1
29102,서정숙(徐正淑),이용호(李容鎬),34,21,55,0
29103,서정숙(徐正淑),이원욱(李元旭),50,6,56,1
29104,서정숙(徐正淑),이원택(李源澤),49,4,53,1
29105,서정숙(徐正淑),이은주(李恩周),4,4,8,1
29106,서정숙(徐正淑),이인선(李仁善),33,41,74,0
29107,서정숙(徐正淑),이인영(李仁榮),49,4,53,1
29108,서정숙(徐正淑),이장섭(李將燮),49,6,55,1
29109,서정숙(徐正淑),이재명(李在明),25,4,29,1
29110,서정숙(徐正淑),이재정(李在汀),49,4,53,1
29111,서정숙(徐正淑),이정문(李楨文),49,5,54,1
29112,서정숙(徐正淑),이종배(李鍾培),82,79,161,0
29113,서정숙(徐正淑),이종성(李鍾成),102,167,269,0
29114,서정숙(徐正淑),이주환(李周桓),80,80,160,0
29115,서정숙(徐正淑),이채익(李埰益),73,88,161,0
29116,서정숙(徐正淑),이철규(李喆圭),82,85,167,0
29117,서정숙(徐正淑),이탄희(李誕熙),49,6,55,1
29118,서정숙(徐正淑),이태규(李泰珪),46,48,94,0
29119,서정숙(徐正淑),이학영(李學永),49,5,54,1
29120,서정숙(徐正淑),이해식(李海植),49,5,54,1
29121,서정숙(徐正淑),이헌승(李憲昇),64,48,112,0
29122,서정숙(徐正淑),이형석(李炯錫),49,5,54,1
29123,서정숙(徐正淑),인재근(印在謹),50,8,58,1
29124,서정숙(徐正淑),임병헌(林炳憲),32,48,80,0
29125,서정숙(徐正淑),임오경(林五卿),49,9,58,1
29126,서정숙(徐正淑),임이자(林利子),78,72,150,0
29127,서정숙(徐正淑),임종성(林鍾聲),51,6,57,1
29128,서정숙(徐正淑),임호선(林昊宣),49,7,56,1
29129,서정숙(徐正淑),장경태(張耿態),49,8,57,1
29130,서정숙(徐正淑),장동혁(張東赫),30,37,67,0
29131,서정숙(徐正淑),장제원(張濟元),71,46,117,0
29132,서정숙(徐正淑),장철민(張喆敏),49,7,56,1
29133,서정숙(徐正淑),장혜영(張惠英),4,8,12,1
29134,서정숙(徐正淑),전봉민(田奉珉),58,50,108,0
29135,서정숙(徐正淑),전용기(田溶冀),49,6,55,1
29136,서정숙(徐正淑),전재수(田載秀),49,5,54,1
29137,서정숙(徐正淑),전주혜(全珠惠),83,133,216,0
29138,서정숙(徐正淑),전해철(全海澈),50,4,54,1
29139,서정숙(徐正淑),전혜숙(全惠淑),49,10,59,1
29140,서정숙(徐正淑),정경희(丁慶姬),80,100,180,0
29141,서정숙(徐正淑),정동만(鄭東萬),76,56,132,0
29142,서정숙(徐正淑),정성호(鄭成湖),52,5,57,1
29143,서정숙(徐正淑),정우택(鄭宇澤),35,47,82,0
29144,서정숙(徐正淑),정운천(鄭雲天),87,103,190,0
29145,서정숙(徐正淑),정일영(鄭日永),49,8,57,1
29146,서정숙(徐正淑),정점식(鄭点植),68,50,118,0
29147,서정숙(徐正淑),정진석(鄭鎭碩),73,75,148,0
29148,서정숙(徐正淑),정청래(鄭淸來),51,5,56,1
29149,서정숙(徐正淑),정춘숙(鄭春淑),49,6,55,1
29150,서정숙(徐正淑),정태호(鄭泰浩),49,10,59,1
29151,서정숙(徐正淑),정필모(鄭必模),49,6,55,1
29152,서정숙(徐正淑),정희용(鄭熙溶),79,75,154,0
29153,서정숙(徐正淑),조경태(趙慶泰),79,55,134,0
29154,서정숙(徐正淑),조명희(曺明姬),92,163,255,0
29155,서정숙(徐正淑),조수진(趙修眞),79,101,180,0
29156,서정숙(徐正淑),조승래(趙承來),49,7,56,1
29157,서정숙(徐正淑),조오섭(曺五燮),51,10,61,1
29158,서정숙(徐正淑),조은희(趙恩禧),35,38,73,0
29159,서정숙(徐正淑),조응천(趙應天),49,4,53,1
29160,서정숙(徐正淑),조정식(趙正湜),49,4,53,1
29161,서정숙(徐正淑),조정훈(趙廷訓),3,19,22,1
29162,서정숙(徐正淑),조해진(曺海珍),65,45,110,0
29163,서정숙(徐正淑),주철현(朱哲鉉),50,7,57,1
29164,서정숙(徐正淑),주호영(朱豪英),73,42,115,0
29165,서정숙(徐正淑),지성호(池成浩),82,136,218,0
29166,서정숙(徐正淑),진선미(陳善美),49,5,54,1
29167,서정숙(徐正淑),진성준(陳聲準),49,4,53,1
29168,서정숙(徐正淑),천준호(千俊鎬),49,4,53,1
29169,서정숙(徐正淑),최기상(崔基相),49,5,54,1
29170,서정숙(徐正淑),최승재(崔承宰),81,128,209,0
29171,서정숙(徐正淑),최연숙(崔姸淑),55,77,132,0
29172,서정숙(徐正淑),최영희(崔英姬),33,41,74,0
29173,서정숙(徐正淑),최인호(崔仁昊),50,5,55,1
29174,서정숙(徐正淑),최재형(崔在亨),28,26,54,0
29175,서정숙(徐正淑),최종윤(崔鍾允),49,5,54,1
29176,서정숙(徐正淑),최춘식(崔春植),72,88,160,0
29177,서정숙(徐正淑),최형두(崔炯斗),79,73,152,0
29178,서정숙(徐正淑),최혜영(崔惠英),49,13,62,1
29179,서정숙(徐正淑),추경호(秋慶鎬),87,86,173,0
29180,서정숙(徐正淑),태영호(太永浩),87,124,211,0
29181,서정숙(徐正淑),하영제(河榮帝),82,99,181,1
29182,서정숙(徐正淑),하태경(河泰慶),70,59,129,0
29183,서정숙(徐正淑),한기호(韓起鎬),69,74,143,0
29184,서정숙(徐正淑),한무경(韓茂景),81,114,195,0
29185,서정숙(徐正淑),한병도(韓秉道),50,5,55,1
29186,서정숙(徐正淑),한정애(韓貞愛),49,4,53,1
29187,서정숙(徐正淑),한준호(韓俊鎬),49,6,55,1
29188,서정숙(徐正淑),허숙정(許淑湞),0,0,0,1
29189,서정숙(徐正淑),허영(許榮),50,8,58,1
29190,서정숙(徐正淑),허은아(許垠娥),74,83,157,0
29191,서정숙(徐正淑),허종식(許琮植),49,7,56,1
29192,서정숙(徐正淑),홍기원(洪起元),49,6,55,1
29193,서정숙(徐正淑),홍문표(洪文杓),66,68,134,0
29194,서정숙(徐正淑),홍석준(洪碩晙),68,71,139,0
29195,서정숙(徐正淑),홍성국(洪性國),49,6,55,1
29196,서정숙(徐正淑),홍영표(洪永杓),49,5,54,1
29197,서정숙(徐正淑),홍익표(洪翼杓),49,6,55,1
29198,서정숙(徐正淑),홍정민(洪貞敏),49,8,57,1
29199,서정숙(徐正淑),황보승희(皇甫承希),75,115,190,1
29200,서정숙(徐正淑),황운하(黃雲夏),49,7,56,1
29201,서정숙(徐正淑),황희(黃熙),49,12,61,1
29202,설훈(薛勳),성일종(成一鍾),51,8,59,1
29203,설훈(薛勳),소병철(蘇秉哲),85,72,157,0
29204,설훈(薛勳),소병훈(蘇秉勳),84,75,159,0
29205,설훈(薛勳),송갑석(宋甲錫),90,84,174,0
29206,설훈(薛勳),송기헌(宋基憲),81,46,127,0
29207,설훈(薛勳),송석준(宋錫俊),51,5,56,1
29208,설훈(薛勳),송언석(宋彦錫),46,5,51,1
29209,설훈(薛勳),송옥주(宋玉珠),79,83,162,0
29210,설훈(薛勳),송재호(宋在祜),83,68,151,0
29211,설훈(薛勳),신동근(申東根),82,68,150,0
29212,설훈(薛勳),신영대(申榮大),83,58,141,0
29213,설훈(薛勳),신원식(申源湜),50,7,57,1
29214,설훈(薛勳),신정훈(辛正勳),99,108,207,0
29215,설훈(薛勳),신현영(申賢榮),82,47,129,0
29216,설훈(薛勳),심상정(沈相奵),16,20,36,1
29217,설훈(薛勳),안규백(安圭伯),87,76,163,0
29218,설훈(薛勳),안민석(安敏錫),83,77,160,0
29219,설훈(薛勳),안병길(安炳吉),50,6,56,1
29220,설훈(薛勳),안철수(安哲秀),26,4,30,1
29221,설훈(薛勳),안호영(安浩永),80,54,134,0
29222,설훈(薛勳),양경숙(梁敬淑),85,102,187,0
29223,설훈(薛勳),양금희(梁琴喜),51,9,60,1
29224,설훈(薛勳),양기대(梁基大),84,108,192,0
29225,설훈(薛勳),양이원영(梁李媛瑛),77,63,140,0
29226,설훈(薛勳),양정숙(梁貞淑),28,80,108,1
29227,설훈(薛勳),양향자(梁香子),38,46,84,1
29228,설훈(薛勳),어기구(魚基龜),82,61,143,0
29229,설훈(薛勳),엄태영(嚴泰永),51,5,56,1
29230,설훈(薛勳),오기형(吳奇炯),76,42,118,0
29231,설훈(薛勳),오영환(吳永煥),97,131,228,0
29232,설훈(薛勳),용혜인(龍慧仁),11,23,34,1
29233,설훈(薛勳),우상호(禹相虎),79,42,121,0
29234,설훈(薛勳),우원식(禹元植),82,67,149,0
29235,설훈(薛勳),위성곤(魏聖坤),97,73,170,0
29236,설훈(薛勳),유경준(兪京濬),49,5,54,1
29237,설훈(薛勳),유기홍(柳基洪),79,57,136,0
29238,설훈(薛勳),유동수(柳東秀),81,50,131,0
29239,설훈(薛勳),유상범(劉相凡),49,4,53,1
29240,설훈(薛勳),유의동(兪義東),50,6,56,1
29241,설훈(薛勳),유정주(兪訂炷),88,66,154,0
29242,설훈(薛勳),윤건영(尹建永),79,51,130,0
29243,설훈(薛勳),윤관석(尹官石),66,47,113,1
29244,설훈(薛勳),윤두현(尹斗鉉),50,8,58,1
29245,설훈(薛勳),윤미향(尹美香),37,53,90,1
29246,설훈(薛勳),윤상현(尹相現),31,5,36,1
29247,설훈(薛勳),윤영덕(尹永德),90,101,191,0
29248,설훈(薛勳),윤영석(尹永碩),51,5,56,1
29249,설훈(薛勳),윤영찬(尹永燦),83,79,162,0
29250,설훈(薛勳),윤재갑(尹才鉀),100,104,204,0
29251,설훈(薛勳),윤재옥(尹在玉),51,4,55,1
29252,설훈(薛勳),윤주경(尹柱卿),50,7,57,1
29253,설훈(薛勳),윤준병(尹準炳),93,121,214,0
29254,설훈(薛勳),윤창현(尹暢賢),50,7,57,1
29255,설훈(薛勳),윤한홍(尹漢洪),51,6,57,1
29256,설훈(薛勳),윤호중(尹昊重),81,53,134,0
29257,설훈(薛勳),윤후덕(尹厚德),80,84,164,0
29258,설훈(薛勳),이개호(李介昊),94,75,169,0
29259,설훈(薛勳),이달곤(李達坤),52,6,58,1
29260,설훈(薛勳),이동주(李東洲),83,68,151,0
29261,설훈(薛勳),이만희(李晩熙),50,6,56,1
29262,설훈(薛勳),이명수(李明洙),53,13,66,1
29263,설훈(薛勳),이병훈(李炳勳),93,110,203,0
29264,설훈(薛勳),이상민(李相珉),76,35,111,0
29265,설훈(薛勳),이상헌(李相憲),81,56,137,0
29266,설훈(薛勳),이성만(李成萬),70,53,123,1
29267,설훈(薛勳),이소영(李素永),81,47,128,0
29268,설훈(薛勳),이수진(李壽珍),86,76,162,0
29269,설훈(薛勳),이수진(李秀眞),90,64,154,0
29270,설훈(薛勳),이양수(李亮壽),52,6,58,1
29271,설훈(薛勳),이용(李鏞),49,5,54,1
29272,설훈(薛勳),이용빈(李龍彬),95,110,205,0
29273,설훈(薛勳),이용선(李庸瑄),87,63,150,0
29274,설훈(薛勳),이용우(李龍雨),85,62,147,0
29275,설훈(薛勳),이용호(李容鎬),32,12,44,1
29276,설훈(薛勳),이원욱(李元旭),87,73,160,0
29277,설훈(薛勳),이원택(李源澤),78,56,134,0
29278,설훈(薛勳),이은주(李恩周),14,21,35,1
29279,설훈(薛勳),이인선(李仁善),25,5,30,1
29280,설훈(薛勳),이인영(李仁榮),73,52,125,0
29281,설훈(薛勳),이장섭(李將燮),86,78,164,0
29282,설훈(薛勳),이재명(李在明),39,23,62,0
29283,설훈(薛勳),이재정(李在汀),81,47,128,0
29284,설훈(薛勳),이정문(李楨文),91,89,180,0
29285,설훈(薛勳),이종배(李鍾培),51,9,60,1
29286,설훈(薛勳),이종성(李鍾成),50,8,58,1
29287,설훈(薛勳),이주환(李周桓),50,5,55,1
29288,설훈(薛勳),이채익(李埰益),51,6,57,1
29289,설훈(薛勳),이철규(李喆圭),51,5,56,1
29290,설훈(薛勳),이탄희(李誕熙),86,54,140,0
29291,설훈(薛勳),이태규(李泰珪),29,6,35,1
29292,설훈(薛勳),이학영(李學永),88,69,157,0
29293,설훈(薛勳),이해식(李海植),86,72,158,0
29294,설훈(薛勳),이헌승(李憲昇),51,5,56,1
29295,설훈(薛勳),이형석(李炯錫),89,70,159,0
29296,설훈(薛勳),인재근(印在謹),87,73,160,0
29297,설훈(薛勳),임병헌(林炳憲),26,5,31,1
29298,설훈(薛勳),임오경(林五卿),80,54,134,0
29299,설훈(薛勳),임이자(林利子),50,4,54,1
29300,설훈(薛勳),임종성(林鍾聲),90,75,165,0
29301,설훈(薛勳),임호선(林昊宣),91,102,193,0
29302,설훈(薛勳),장경태(張耿態),85,72,157,0
29303,설훈(薛勳),장동혁(張東赫),25,5,30,1
29304,설훈(薛勳),장제원(張濟元),49,4,53,1
29305,설훈(薛勳),장철민(張喆敏),83,64,147,0
29306,설훈(薛勳),장혜영(張惠英),12,12,24,1
29307,설훈(薛勳),전봉민(田奉珉),36,5,41,1
29308,설훈(薛勳),전용기(田溶冀),89,70,159,0
29309,설훈(薛勳),전재수(田載秀),79,46,125,0
29310,설훈(薛勳),전주혜(全珠惠),51,8,59,1
29311,설훈(薛勳),전해철(全海澈),81,42,123,0
29312,설훈(薛勳),전혜숙(全惠淑),92,96,188,0
29313,설훈(薛勳),정경희(丁慶姬),50,5,55,1
29314,설훈(薛勳),정동만(鄭東萬),49,5,54,1
29315,설훈(薛勳),정성호(鄭成湖),78,72,150,0
29316,설훈(薛勳),정우택(鄭宇澤),25,5,30,1
29317,설훈(薛勳),정운천(鄭雲天),49,7,56,1
29318,설훈(薛勳),정일영(鄭日永),79,59,138,0
29319,설훈(薛勳),정점식(鄭点植),51,6,57,1
29320,설훈(薛勳),정진석(鄭鎭碩),50,9,59,1
29321,설훈(薛勳),정청래(鄭淸來),82,49,131,0
29322,설훈(薛勳),정춘숙(鄭春淑),85,63,148,0
29323,설훈(薛勳),정태호(鄭泰浩),89,106,195,0
29324,설훈(薛勳),정필모(鄭必模),85,61,146,0
29325,설훈(薛勳),정희용(鄭熙溶),51,7,58,1
29326,설훈(薛勳),조경태(趙慶泰),51,8,59,1
29327,설훈(薛勳),조명희(曺明姬),50,8,58,1
29328,설훈(薛勳),조수진(趙修眞),49,5,54,1
29329,설훈(薛勳),조승래(趙承來),90,69,159,0
29330,설훈(薛勳),조오섭(曺五燮),87,85,172,0
29331,설훈(薛勳),조은희(趙恩禧),25,9,34,1
29332,설훈(薛勳),조응천(趙應天),71,31,102,0
29333,설훈(薛勳),조정식(趙正湜),80,41,121,0
29334,설훈(薛勳),조정훈(趙廷訓),5,4,9,1
29335,설훈(薛勳),조해진(曺海珍),53,5,58,1
29336,설훈(薛勳),주철현(朱哲鉉),78,69,147,0
29337,설훈(薛勳),주호영(朱豪英),49,4,53,1
29338,설훈(薛勳),지성호(池成浩),49,6,55,1
29339,설훈(薛勳),진선미(陳善美),81,42,123,0
29340,설훈(薛勳),진성준(陳聲準),84,71,155,0
29341,설훈(薛勳),천준호(千俊鎬),79,47,126,0
29342,설훈(薛勳),최기상(崔基相),80,46,126,0
29343,설훈(薛勳),최승재(崔承宰),49,7,56,1
29344,설훈(薛勳),최연숙(崔姸淑),33,18,51,1
29345,설훈(薛勳),최영희(崔英姬),26,5,31,1
29346,설훈(薛勳),최인호(崔仁昊),81,81,162,0
29347,설훈(薛勳),최재형(崔在亨),25,4,29,1
29348,설훈(薛勳),최종윤(崔鍾允),88,84,172,0
29349,설훈(薛勳),최춘식(崔春植),49,6,55,1
29350,설훈(薛勳),최형두(崔炯斗),52,10,62,1
29351,설훈(薛勳),최혜영(崔惠英),83,61,144,0
29352,설훈(薛勳),추경호(秋慶鎬),49,5,54,1
29353,설훈(薛勳),태영호(太永浩),49,6,55,1
29354,설훈(薛勳),하영제(河榮帝),42,3,45,1
29355,설훈(薛勳),하태경(河泰慶),50,4,54,1
29356,설훈(薛勳),한기호(韓起鎬),50,6,56,1
29357,설훈(薛勳),한무경(韓茂景),49,5,54,1
29358,설훈(薛勳),한병도(韓秉道),90,62,152,0
29359,설훈(薛勳),한정애(韓貞愛),76,53,129,0
29360,설훈(薛勳),한준호(韓俊鎬),87,73,160,0
29361,설훈(薛勳),허숙정(許淑湞),1,1,2,0
29362,설훈(薛勳),허영(許榮),86,88,174,0
29363,설훈(薛勳),허은아(許垠娥),50,6,56,1
29364,설훈(薛勳),허종식(許琮植),82,81,163,0
29365,설훈(薛勳),홍기원(洪起元),87,76,163,0
29366,설훈(薛勳),홍문표(洪文杓),57,18,75,1
29367,설훈(薛勳),홍석준(洪碩晙),50,5,55,1
29368,설훈(薛勳),홍성국(洪性國),97,98,195,0
29369,설훈(薛勳),홍영표(洪永杓),92,65,157,0
29370,설훈(薛勳),홍익표(洪翼杓),86,68,154,0
29371,설훈(薛勳),홍정민(洪貞敏),98,85,183,0
29372,설훈(薛勳),황보승희(皇甫承希),47,4,51,1
29373,설훈(薛勳),황운하(黃雲夏),84,72,156,0
29374,설훈(薛勳),황희(黃熙),80,43,123,0
29375,성일종(成一鍾),소병철(蘇秉哲),50,6,56,1
29376,성일종(成一鍾),소병훈(蘇秉勳),53,6,59,1
29377,성일종(成一鍾),송갑석(宋甲錫),52,8,60,1
29378,성일종(成一鍾),송기헌(宋基憲),52,6,58,1
29379,성일종(成一鍾),송석준(宋錫俊),92,129,221,0
29380,성일종(成一鍾),송언석(宋彦錫),90,120,210,0
29381,성일종(成一鍾),송옥주(宋玉珠),50,3,53,1
29382,성일종(成一鍾),송재호(宋在祜),51,8,59,1
29383,성일종(成一鍾),신동근(申東根),50,7,57,1
29384,성일종(成一鍾),신영대(申榮大),50,5,55,1
29385,성일종(成一鍾),신원식(申源湜),91,110,201,0
29386,성일종(成一鍾),신정훈(辛正勳),53,11,64,1
29387,성일종(成一鍾),신현영(申賢榮),49,4,53,1
29388,성일종(成一鍾),심상정(沈相奵),5,10,15,1
29389,성일종(成一鍾),안규백(安圭伯),54,12,66,1
29390,성일종(成一鍾),안민석(安敏錫),51,5,56,1
29391,성일종(成一鍾),안병길(安炳吉),96,145,241,0
29392,성일종(成一鍾),안철수(安哲秀),30,31,61,0
29393,성일종(成一鍾),안호영(安浩永),50,5,55,1
29394,성일종(成一鍾),양경숙(梁敬淑),50,5,55,1
29395,성일종(成一鍾),양금희(梁琴喜),101,177,278,0
29396,성일종(成一鍾),양기대(梁基大),52,7,59,1
29397,성일종(成一鍾),양이원영(梁李媛瑛),45,6,51,1
29398,성일종(成一鍾),양정숙(梁貞淑),4,15,19,1
29399,성일종(成一鍾),양향자(梁香子),27,24,51,1
29400,성일종(成一鍾),어기구(魚基龜),51,10,61,1
29401,성일종(成一鍾),엄태영(嚴泰永),104,147,251,0
29402,성일종(成一鍾),오기형(吳奇炯),49,5,54,1
29403,성일종(成一鍾),오영환(吳永煥),51,8,59,1
29404,성일종(成一鍾),용혜인(龍慧仁),1,10,11,1
29405,성일종(成一鍾),우상호(禹相虎),50,5,55,1
29406,성일종(成一鍾),우원식(禹元植),49,6,55,1
29407,성일종(成一鍾),위성곤(魏聖坤),51,8,59,1
29408,성일종(成一鍾),유경준(兪京濬),100,127,227,0
29409,성일종(成一鍾),유기홍(柳基洪),50,7,57,1
29410,성일종(成一鍾),유동수(柳東秀),53,12,65,1
29411,성일종(成一鍾),유상범(劉相凡),73,81,154,0
29412,성일종(成一鍾),유의동(兪義東),76,76,152,0
29413,성일종(成一鍾),유정주(兪訂炷),49,6,55,1
29414,성일종(成一鍾),윤건영(尹建永),49,5,54,1
29415,성일종(成一鍾),윤관석(尹官石),42,1,43,1
29416,성일종(成一鍾),윤두현(尹斗鉉),86,144,230,0
29417,성일종(成一鍾),윤미향(尹美香),21,3,24,1
29418,성일종(成一鍾),윤상현(尹相現),46,74,120,0
29419,성일종(成一鍾),윤영덕(尹永德),49,7,56,1
29420,성일종(成一鍾),윤영석(尹永碩),76,84,160,0
29421,성일종(成一鍾),윤영찬(尹永燦),50,8,58,1
29422,성일종(成一鍾),윤재갑(尹才鉀),57,18,75,1
29423,성일종(成一鍾),윤재옥(尹在玉),82,73,155,0
29424,성일종(成一鍾),윤주경(尹柱卿),77,97,174,0
29425,성일종(成一鍾),윤준병(尹準炳),50,6,56,1
29426,성일종(成一鍾),윤창현(尹暢賢),130,187,317,0
29427,성일종(成一鍾),윤한홍(尹漢洪),77,75,152,0
29428,성일종(成一鍾),윤호중(尹昊重),50,4,54,1
29429,성일종(成一鍾),윤후덕(尹厚德),52,8,60,1
29430,성일종(成一鍾),이개호(李介昊),51,5,56,1
29431,성일종(成一鍾),이달곤(李達坤),71,75,146,0
29432,성일종(成一鍾),이동주(李東洲),49,7,56,1
29433,성일종(成一鍾),이만희(李晩熙),84,80,164,0
29434,성일종(成一鍾),이명수(李明洙),150,316,466,0
29435,성일종(成一鍾),이병훈(李炳勳),54,11,65,1
29436,성일종(成一鍾),이상민(李相珉),50,4,54,1
29437,성일종(成一鍾),이상헌(李相憲),52,20,72,1
29438,성일종(成一鍾),이성만(李成萬),42,2,44,1
29439,성일종(成一鍾),이소영(李素永),50,5,55,1
29440,성일종(成一鍾),이수진(李壽珍),51,7,58,1
29441,성일종(成一鍾),이수진(李秀眞),51,7,58,1
29442,성일종(成一鍾),이양수(李亮壽),89,98,187,0
29443,성일종(成一鍾),이용(李鏞),95,115,210,0
29444,성일종(成一鍾),이용빈(李龍彬),52,11,63,1
29445,성일종(成一鍾),이용선(李庸瑄),51,11,62,1
29446,성일종(成一鍾),이용우(李龍雨),50,5,55,1
29447,성일종(成一鍾),이용호(李容鎬),35,47,82,0
29448,성일종(成一鍾),이원욱(李元旭),51,6,57,1
29449,성일종(成一鍾),이원택(李源澤),50,7,57,1
29450,성일종(成一鍾),이은주(李恩周),7,6,13,1
29451,성일종(成一鍾),이인선(李仁善),37,49,86,0
29452,성일종(成一鍾),이인영(李仁榮),50,4,54,1
29453,성일종(成一鍾),이장섭(李將燮),50,4,54,1
29454,성일종(成一鍾),이재명(李在明),25,4,29,1
29455,성일종(成一鍾),이재정(李在汀),50,4,54,1
29456,성일종(成一鍾),이정문(李楨文),51,8,59,1
29457,성일종(成一鍾),이종배(李鍾培),158,294,452,0
29458,성일종(成一鍾),이종성(李鍾成),112,236,348,0
29459,성일종(成一鍾),이주환(李周桓),119,175,294,0
29460,성일종(成一鍾),이채익(李埰益),94,161,255,0
29461,성일종(成一鍾),이철규(李喆圭),79,114,193,0
29462,성일종(成一鍾),이탄희(李誕熙),50,5,55,1
29463,성일종(成一鍾),이태규(李泰珪),64,96,160,0
29464,성일종(成一鍾),이학영(李學永),49,7,56,1
29465,성일종(成一鍾),이해식(李海植),50,6,56,1
29466,성일종(成一鍾),이헌승(李憲昇),84,140,224,0
29467,성일종(成一鍾),이형석(李炯錫),49,4,53,1
29468,성일종(成一鍾),인재근(印在謹),50,6,56,1
29469,성일종(成一鍾),임병헌(林炳憲),33,73,106,0
29470,성일종(成一鍾),임오경(林五卿),50,8,58,1
29471,성일종(成一鍾),임이자(林利子),113,131,244,0
29472,성일종(成一鍾),임종성(林鍾聲),51,8,59,1
29473,성일종(成一鍾),임호선(林昊宣),50,6,56,1
29474,성일종(成一鍾),장경태(張耿態),50,11,61,1
29475,성일종(成一鍾),장동혁(張東赫),32,72,104,0
29476,성일종(成一鍾),장제원(張濟元),72,64,136,0
29477,성일종(成一鍾),장철민(張喆敏),50,5,55,1
29478,성일종(成一鍾),장혜영(張惠英),6,5,11,1
29479,성일종(成一鍾),전봉민(田奉珉),53,79,132,0
29480,성일종(成一鍾),전용기(田溶冀),50,5,55,1
29481,성일종(成一鍾),전재수(田載秀),50,4,54,1
29482,성일종(成一鍾),전주혜(全珠惠),88,106,194,0
29483,성일종(成一鍾),전해철(全海澈),51,4,55,1
29484,성일종(成一鍾),전혜숙(全惠淑),51,18,69,1
29485,성일종(成一鍾),정경희(丁慶姬),91,96,187,0
29486,성일종(成一鍾),정동만(鄭東萬),82,83,165,0
29487,성일종(成一鍾),정성호(鄭成湖),56,16,72,1
29488,성일종(成一鍾),정우택(鄭宇澤),41,92,133,0
29489,성일종(成一鍾),정운천(鄭雲天),112,164,276,0
29490,성일종(成一鍾),정일영(鄭日永),50,8,58,1
29491,성일종(成一鍾),정점식(鄭点植),78,69,147,0
29492,성일종(成一鍾),정진석(鄭鎭碩),96,120,216,0
29493,성일종(成一鍾),정청래(鄭淸來),49,4,53,1
29494,성일종(成一鍾),정춘숙(鄭春淑),50,6,56,1
29495,성일종(成一鍾),정태호(鄭泰浩),50,5,55,1
29496,성일종(成一鍾),정필모(鄭必模),50,5,55,1
29497,성일종(成一鍾),정희용(鄭熙溶),94,113,207,0
29498,성일종(成一鍾),조경태(趙慶泰),103,111,214,0
29499,성일종(成一鍾),조명희(曺明姬),121,263,384,0
29500,성일종(成一鍾),조수진(趙修眞),96,145,241,0
29501,성일종(成一鍾),조승래(趙承來),51,7,58,1
29502,성일종(成一鍾),조오섭(曺五燮),51,8,59,1
29503,성일종(成一鍾),조은희(趙恩禧),41,56,97,0
29504,성일종(成一鍾),조응천(趙應天),52,6,58,1
29505,성일종(成一鍾),조정식(趙正湜),49,3,52,1
29506,성일종(成一鍾),조정훈(趙廷訓),2,20,22,1
29507,성일종(成一鍾),조해진(曺海珍),75,74,149,0
29508,성일종(成一鍾),주철현(朱哲鉉),51,5,56,1
29509,성일종(成一鍾),주호영(朱豪英),72,80,152,0
29510,성일종(成一鍾),지성호(池成浩),105,133,238,0
29511,성일종(成一鍾),진선미(陳善美),50,5,55,1
29512,성일종(成一鍾),진성준(陳聲準),50,5,55,1
29513,성일종(成一鍾),천준호(千俊鎬),49,3,52,1
29514,성일종(成一鍾),최기상(崔基相),49,6,55,1
29515,성일종(成一鍾),최승재(崔承宰),111,139,250,0
29516,성일종(成一鍾),최연숙(崔姸淑),50,61,111,0
29517,성일종(成一鍾),최영희(崔英姬),30,56,86,0
29518,성일종(成一鍾),최인호(崔仁昊),51,4,55,1
29519,성일종(成一鍾),최재형(崔在亨),28,22,50,0
29520,성일종(成一鍾),최종윤(崔鍾允),50,5,55,1
29521,성일종(成一鍾),최춘식(崔春植),101,170,271,0
29522,성일종(成一鍾),최형두(崔炯斗),89,114,203,0
29523,성일종(成一鍾),최혜영(崔惠英),51,6,57,1
29524,성일종(成一鍾),추경호(秋慶鎬),156,254,410,0
29525,성일종(成一鍾),태영호(太永浩),127,279,406,0
29526,성일종(成一鍾),하영제(河榮帝),84,160,244,1
29527,성일종(成一鍾),하태경(河泰慶),72,80,152,0
29528,성일종(成一鍾),한기호(韓起鎬),71,104,175,0
29529,성일종(成一鍾),한무경(韓茂景),99,134,233,0
29530,성일종(成一鍾),한병도(韓秉道),49,4,53,1
29531,성일종(成一鍾),한정애(韓貞愛),50,5,55,1
29532,성일종(成一鍾),한준호(韓俊鎬),50,8,58,1
29533,성일종(成一鍾),허숙정(許淑湞),0,0,0,1
29534,성일종(成一鍾),허영(許榮),52,6,58,1
29535,성일종(成一鍾),허은아(許垠娥),98,88,186,0
29536,성일종(成一鍾),허종식(許琮植),50,15,65,1
29537,성일종(成一鍾),홍기원(洪起元),50,6,56,1
29538,성일종(成一鍾),홍문표(洪文杓),120,224,344,0
29539,성일종(成一鍾),홍석준(洪碩晙),75,78,153,0
29540,성일종(成一鍾),홍성국(洪性國),52,9,61,1
29541,성일종(成一鍾),홍영표(洪永杓),50,6,56,1
29542,성일종(成一鍾),홍익표(洪翼杓),50,9,59,1
29543,성일종(成一鍾),홍정민(洪貞敏),50,9,59,1
29544,성일종(成一鍾),황보승희(皇甫承希),93,151,244,1
29545,성일종(成一鍾),황운하(黃雲夏),51,7,58,1
29546,성일종(成一鍾),황희(黃熙),49,5,54,1
29547,소병철(蘇秉哲),소병훈(蘇秉勳),88,56,144,0
29548,소병철(蘇秉哲),송갑석(宋甲錫),98,91,189,0
29549,소병철(蘇秉哲),송기헌(宋基憲),111,86,197,0
29550,소병철(蘇秉哲),송석준(宋錫俊),50,6,56,1
29551,소병철(蘇秉哲),송언석(宋彦錫),46,4,50,1
29552,소병철(蘇秉哲),송옥주(宋玉珠),90,66,156,0
29553,소병철(蘇秉哲),송재호(宋在祜),99,82,181,0
29554,소병철(蘇秉哲),신동근(申東根),104,53,157,0
29555,소병철(蘇秉哲),신영대(申榮大),93,62,155,0
29556,소병철(蘇秉哲),신원식(申源湜),52,5,57,1
29557,소병철(蘇秉哲),신정훈(辛正勳),115,137,252,0
29558,소병철(蘇秉哲),신현영(申賢榮),87,55,142,0
29559,소병철(蘇秉哲),심상정(沈相奵),14,23,37,1
29560,소병철(蘇秉哲),안규백(安圭伯),99,76,175,0
29561,소병철(蘇秉哲),안민석(安敏錫),87,52,139,0
29562,소병철(蘇秉哲),안병길(安炳吉),50,4,54,1
29563,소병철(蘇秉哲),안철수(安哲秀),27,4,31,1
29564,소병철(蘇秉哲),안호영(安浩永),84,77,161,0
29565,소병철(蘇秉哲),양경숙(梁敬淑),82,60,142,0
29566,소병철(蘇秉哲),양금희(梁琴喜),52,6,58,1
29567,소병철(蘇秉哲),양기대(梁基大),90,55,145,0
29568,소병철(蘇秉哲),양이원영(梁李媛瑛),85,59,144,0
29569,소병철(蘇秉哲),양정숙(梁貞淑),42,74,116,1
29570,소병철(蘇秉哲),양향자(梁香子),55,48,103,1
29571,소병철(蘇秉哲),어기구(魚基龜),82,64,146,0
29572,소병철(蘇秉哲),엄태영(嚴泰永),52,6,58,1
29573,소병철(蘇秉哲),오기형(吳奇炯),85,50,135,0
29574,소병철(蘇秉哲),오영환(吳永煥),116,180,296,0
29575,소병철(蘇秉哲),용혜인(龍慧仁),14,18,32,1
29576,소병철(蘇秉哲),우상호(禹相虎),80,39,119,0
29577,소병철(蘇秉哲),우원식(禹元植),86,68,154,0
29578,소병철(蘇秉哲),위성곤(魏聖坤),111,141,252,0
29579,소병철(蘇秉哲),유경준(兪京濬),50,4,54,1
29580,소병철(蘇秉哲),유기홍(柳基洪),83,51,134,0
29581,소병철(蘇秉哲),유동수(柳東秀),89,51,140,0
29582,소병철(蘇秉哲),유상범(劉相凡),52,4,56,1
29583,소병철(蘇秉哲),유의동(兪義東),50,4,54,1
29584,소병철(蘇秉哲),유정주(兪訂炷),99,83,182,0
29585,소병철(蘇秉哲),윤건영(尹建永),84,93,177,0
29586,소병철(蘇秉哲),윤관석(尹官石),71,44,115,1
29587,소병철(蘇秉哲),윤두현(尹斗鉉),51,5,56,1
29588,소병철(蘇秉哲),윤미향(尹美香),42,32,74,1
29589,소병철(蘇秉哲),윤상현(尹相現),32,5,37,1
29590,소병철(蘇秉哲),윤영덕(尹永德),102,91,193,0
29591,소병철(蘇秉哲),윤영석(尹永碩),50,5,55,1
29592,소병철(蘇秉哲),윤영찬(尹永燦),84,65,149,0
29593,소병철(蘇秉哲),윤재갑(尹才鉀),112,128,240,0
29594,소병철(蘇秉哲),윤재옥(尹在玉),50,5,55,1
29595,소병철(蘇秉哲),윤주경(尹柱卿),50,6,56,1
29596,소병철(蘇秉哲),윤준병(尹準炳),98,109,207,0
29597,소병철(蘇秉哲),윤창현(尹暢賢),50,7,57,1
29598,소병철(蘇秉哲),윤한홍(尹漢洪),50,5,55,1
29599,소병철(蘇秉哲),윤호중(尹昊重),80,51,131,0
29600,소병철(蘇秉哲),윤후덕(尹厚德),85,68,153,0
29601,소병철(蘇秉哲),이개호(李介昊),116,101,217,0
29602,소병철(蘇秉哲),이달곤(李達坤),51,7,58,1
29603,소병철(蘇秉哲),이동주(李東洲),84,67,151,0
29604,소병철(蘇秉哲),이만희(李晩熙),52,4,56,1
29605,소병철(蘇秉哲),이명수(李明洙),51,14,65,1
29606,소병철(蘇秉哲),이병훈(李炳勳),97,112,209,0
29607,소병철(蘇秉哲),이상민(李相珉),78,35,113,0
29608,소병철(蘇秉哲),이상헌(李相憲),91,63,154,0
29609,소병철(蘇秉哲),이성만(李成萬),75,53,128,1
29610,소병철(蘇秉哲),이소영(李素永),88,49,137,0
29611,소병철(蘇秉哲),이수진(李壽珍),97,90,187,0
29612,소병철(蘇秉哲),이수진(李秀眞),99,104,203,0
29613,소병철(蘇秉哲),이양수(李亮壽),54,4,58,1
29614,소병철(蘇秉哲),이용(李鏞),51,4,55,1
29615,소병철(蘇秉哲),이용빈(李龍彬),105,109,214,0
29616,소병철(蘇秉哲),이용선(李庸瑄),89,64,153,0
29617,소병철(蘇秉哲),이용우(李龍雨),98,83,181,0
29618,소병철(蘇秉哲),이용호(李容鎬),28,10,38,1
29619,소병철(蘇秉哲),이원욱(李元旭),96,73,169,0
29620,소병철(蘇秉哲),이원택(李源澤),88,67,155,0
29621,소병철(蘇秉哲),이은주(李恩周),17,18,35,1
29622,소병철(蘇秉哲),이인선(李仁善),26,6,32,1
29623,소병철(蘇秉哲),이인영(李仁榮),76,44,120,0
29624,소병철(蘇秉哲),이장섭(李將燮),90,75,165,0
29625,소병철(蘇秉哲),이재명(李在明),40,23,63,0
29626,소병철(蘇秉哲),이재정(李在汀),85,47,132,0
29627,소병철(蘇秉哲),이정문(李楨文),91,70,161,0
29628,소병철(蘇秉哲),이종배(李鍾培),51,7,58,1
29629,소병철(蘇秉哲),이종성(李鍾成),51,5,56,1
29630,소병철(蘇秉哲),이주환(李周桓),50,4,54,1
29631,소병철(蘇秉哲),이채익(李埰益),52,7,59,1
29632,소병철(蘇秉哲),이철규(李喆圭),53,5,58,1
29633,소병철(蘇秉哲),이탄희(李誕熙),90,61,151,0
29634,소병철(蘇秉哲),이태규(李泰珪),28,5,33,1
29635,소병철(蘇秉哲),이학영(李學永),94,77,171,0
29636,소병철(蘇秉哲),이해식(李海植),91,67,158,0
29637,소병철(蘇秉哲),이헌승(李憲昇),50,5,55,1
29638,소병철(蘇秉哲),이형석(李炯錫),99,91,190,0
29639,소병철(蘇秉哲),인재근(印在謹),85,61,146,0
29640,소병철(蘇秉哲),임병헌(林炳憲),26,5,31,1
29641,소병철(蘇秉哲),임오경(林五卿),88,69,157,0
29642,소병철(蘇秉哲),임이자(林利子),50,5,55,1
29643,소병철(蘇秉哲),임종성(林鍾聲),88,77,165,0
29644,소병철(蘇秉哲),임호선(林昊宣),114,166,280,0
29645,소병철(蘇秉哲),장경태(張耿態),102,96,198,0
29646,소병철(蘇秉哲),장동혁(張東赫),26,4,30,1
29647,소병철(蘇秉哲),장제원(張濟元),49,4,53,1
29648,소병철(蘇秉哲),장철민(張喆敏),91,102,193,0
29649,소병철(蘇秉哲),장혜영(張惠英),12,13,25,1
29650,소병철(蘇秉哲),전봉민(田奉珉),35,6,41,1
29651,소병철(蘇秉哲),전용기(田溶冀),107,78,185,0
29652,소병철(蘇秉哲),전재수(田載秀),82,51,133,0
29653,소병철(蘇秉哲),전주혜(全珠惠),53,5,58,1
29654,소병철(蘇秉哲),전해철(全海澈),77,59,136,0
29655,소병철(蘇秉哲),전혜숙(全惠淑),88,73,161,0
29656,소병철(蘇秉哲),정경희(丁慶姬),50,5,55,1
29657,소병철(蘇秉哲),정동만(鄭東萬),49,6,55,1
29658,소병철(蘇秉哲),정성호(鄭成湖),84,70,154,0
29659,소병철(蘇秉哲),정우택(鄭宇澤),26,5,31,1
29660,소병철(蘇秉哲),정운천(鄭雲天),51,7,58,1
29661,소병철(蘇秉哲),정일영(鄭日永),98,121,219,0
29662,소병철(蘇秉哲),정점식(鄭点植),50,5,55,1
29663,소병철(蘇秉哲),정진석(鄭鎭碩),50,5,55,1
29664,소병철(蘇秉哲),정청래(鄭淸來),87,56,143,0
29665,소병철(蘇秉哲),정춘숙(鄭春淑),86,72,158,0
29666,소병철(蘇秉哲),정태호(鄭泰浩),83,72,155,0
29667,소병철(蘇秉哲),정필모(鄭必模),87,72,159,0
29668,소병철(蘇秉哲),정희용(鄭熙溶),51,6,57,1
29669,소병철(蘇秉哲),조경태(趙慶泰),51,5,56,1
29670,소병철(蘇秉哲),조명희(曺明姬),51,6,57,1
29671,소병철(蘇秉哲),조수진(趙修眞),51,4,55,1
29672,소병철(蘇秉哲),조승래(趙承來),101,53,154,0
29673,소병철(蘇秉哲),조오섭(曺五燮),92,91,183,0
29674,소병철(蘇秉哲),조은희(趙恩禧),27,4,31,1
29675,소병철(蘇秉哲),조응천(趙應天),77,33,110,0
29676,소병철(蘇秉哲),조정식(趙正湜),76,31,107,0
29677,소병철(蘇秉哲),조정훈(趙廷訓),4,7,11,1
29678,소병철(蘇秉哲),조해진(曺海珍),53,6,59,1
29679,소병철(蘇秉哲),주철현(朱哲鉉),107,111,218,0
29680,소병철(蘇秉哲),주호영(朱豪英),51,4,55,1
29681,소병철(蘇秉哲),지성호(池成浩),51,4,55,1
29682,소병철(蘇秉哲),진선미(陳善美),82,46,128,0
29683,소병철(蘇秉哲),진성준(陳聲準),105,94,199,0
29684,소병철(蘇秉哲),천준호(千俊鎬),89,55,144,0
29685,소병철(蘇秉哲),최기상(崔基相),106,79,185,0
29686,소병철(蘇秉哲),최승재(崔承宰),51,5,56,1
29687,소병철(蘇秉哲),최연숙(崔姸淑),32,14,46,1
29688,소병철(蘇秉哲),최영희(崔英姬),26,5,31,1
29689,소병철(蘇秉哲),최인호(崔仁昊),96,65,161,0
29690,소병철(蘇秉哲),최재형(崔在亨),26,5,31,1
29691,소병철(蘇秉哲),최종윤(崔鍾允),101,91,192,0
29692,소병철(蘇秉哲),최춘식(崔春植),50,6,56,1
29693,소병철(蘇秉哲),최형두(崔炯斗),51,9,60,1
29694,소병철(蘇秉哲),최혜영(崔惠英),93,63,156,0
29695,소병철(蘇秉哲),추경호(秋慶鎬),50,4,54,1
29696,소병철(蘇秉哲),태영호(太永浩),50,4,54,1
29697,소병철(蘇秉哲),하영제(河榮帝),43,2,45,1
29698,소병철(蘇秉哲),하태경(河泰慶),50,4,54,1
29699,소병철(蘇秉哲),한기호(韓起鎬),52,5,57,1
29700,소병철(蘇秉哲),한무경(韓茂景),51,5,56,1
29701,소병철(蘇秉哲),한병도(韓秉道),90,57,147,0
29702,소병철(蘇秉哲),한정애(韓貞愛),76,49,125,0
29703,소병철(蘇秉哲),한준호(韓俊鎬),96,100,196,0
29704,소병철(蘇秉哲),허숙정(許淑湞),1,2,3,0
29705,소병철(蘇秉哲),허영(許榮),101,97,198,0
29706,소병철(蘇秉哲),허은아(許垠娥),51,4,55,1
29707,소병철(蘇秉哲),허종식(許琮植),94,85,179,0
29708,소병철(蘇秉哲),홍기원(洪起元),98,76,174,0
29709,소병철(蘇秉哲),홍문표(洪文杓),54,12,66,1
29710,소병철(蘇秉哲),홍석준(洪碩晙),51,4,55,1
29711,소병철(蘇秉哲),홍성국(洪性國),104,80,184,0
29712,소병철(蘇秉哲),홍영표(洪永杓),84,58,142,0
29713,소병철(蘇秉哲),홍익표(洪翼杓),88,61,149,0
29714,소병철(蘇秉哲),홍정민(洪貞敏),107,109,216,0
29715,소병철(蘇秉哲),황보승희(皇甫承希),47,2,49,1
29716,소병철(蘇秉哲),황운하(黃雲夏),109,98,207,0
29717,소병철(蘇秉哲),황희(黃熙),77,45,122,0
29718,소병훈(蘇秉勳),송갑석(宋甲錫),119,187,306,0
29719,소병훈(蘇秉勳),송기헌(宋基憲),85,65,150,0
29720,소병훈(蘇秉勳),송석준(宋錫俊),56,15,71,1
29721,소병훈(蘇秉勳),송언석(宋彦錫),46,6,52,1
29722,소병훈(蘇秉勳),송옥주(宋玉珠),103,119,222,0
29723,소병훈(蘇秉勳),송재호(宋在祜),108,128,236,0
29724,소병훈(蘇秉勳),신동근(申東根),93,79,172,0
29725,소병훈(蘇秉勳),신영대(申榮大),86,79,165,0
29726,소병훈(蘇秉勳),신원식(申源湜),50,4,54,1
29727,소병훈(蘇秉勳),신정훈(辛正勳),123,229,352,0
29728,소병훈(蘇秉勳),신현영(申賢榮),82,51,133,0
29729,소병훈(蘇秉勳),심상정(沈相奵),15,31,46,1
29730,소병훈(蘇秉勳),안규백(安圭伯),106,109,215,0
29731,소병훈(蘇秉勳),안민석(安敏錫),90,74,164,0
29732,소병훈(蘇秉勳),안병길(安炳吉),51,5,56,1
29733,소병훈(蘇秉勳),안철수(安哲秀),26,4,30,1
29734,소병훈(蘇秉勳),안호영(安浩永),101,143,244,0
29735,소병훈(蘇秉勳),양경숙(梁敬淑),97,139,236,0
29736,소병훈(蘇秉勳),양금희(梁琴喜),51,6,57,1
29737,소병훈(蘇秉勳),양기대(梁基大),90,80,170,0
29738,소병훈(蘇秉勳),양이원영(梁李媛瑛),99,89,188,0
29739,소병훈(蘇秉勳),양정숙(梁貞淑),57,193,250,1
29740,소병훈(蘇秉勳),양향자(梁香子),44,52,96,1
29741,소병훈(蘇秉勳),어기구(魚基龜),94,140,234,0
29742,소병훈(蘇秉勳),엄태영(嚴泰永),51,5,56,1
29743,소병훈(蘇秉勳),오기형(吳奇炯),79,40,119,0
29744,소병훈(蘇秉勳),오영환(吳永煥),117,184,301,0
29745,소병훈(蘇秉勳),용혜인(龍慧仁),18,49,67,1
29746,소병훈(蘇秉勳),우상호(禹相虎),82,46,128,0
29747,소병훈(蘇秉勳),우원식(禹元植),98,99,197,0
29748,소병훈(蘇秉勳),위성곤(魏聖坤),114,195,309,0
29749,소병훈(蘇秉勳),유경준(兪京濬),51,6,57,1
29750,소병훈(蘇秉勳),유기홍(柳基洪),82,63,145,0
29751,소병훈(蘇秉勳),유동수(柳東秀),85,70,155,0
29752,소병훈(蘇秉勳),유상범(劉相凡),52,4,56,1
29753,소병훈(蘇秉勳),유의동(兪義東),49,7,56,1
29754,소병훈(蘇秉勳),유정주(兪訂炷),103,94,197,0
29755,소병훈(蘇秉勳),윤건영(尹建永),87,82,169,0
29756,소병훈(蘇秉勳),윤관석(尹官石),83,71,154,1
29757,소병훈(蘇秉勳),윤두현(尹斗鉉),50,4,54,1
29758,소병훈(蘇秉勳),윤미향(尹美香),54,103,157,1
29759,소병훈(蘇秉勳),윤상현(尹相現),32,5,37,1
29760,소병훈(蘇秉勳),윤영덕(尹永德),102,104,206,0
29761,소병훈(蘇秉勳),윤영석(尹永碩),51,5,56,1
29762,소병훈(蘇秉勳),윤영찬(尹永燦),82,51,133,0
29763,소병훈(蘇秉勳),윤재갑(尹才鉀),111,126,237,0
29764,소병훈(蘇秉勳),윤재옥(尹在玉),49,4,53,1
29765,소병훈(蘇秉勳),윤주경(尹柱卿),49,5,54,1
29766,소병훈(蘇秉勳),윤준병(尹準炳),127,214,341,0
29767,소병훈(蘇秉勳),윤창현(尹暢賢),49,6,55,1
29768,소병훈(蘇秉勳),윤한홍(尹漢洪),50,4,54,1
29769,소병훈(蘇秉勳),윤호중(尹昊重),82,63,145,0
29770,소병훈(蘇秉勳),윤후덕(尹厚德),96,88,184,0
29771,소병훈(蘇秉勳),이개호(李介昊),101,143,244,0
29772,소병훈(蘇秉勳),이달곤(李達坤),54,6,60,1
29773,소병훈(蘇秉勳),이동주(李東洲),89,99,188,0
29774,소병훈(蘇秉勳),이만희(李晩熙),50,5,55,1
29775,소병훈(蘇秉勳),이명수(李明洙),50,14,64,1
29776,소병훈(蘇秉勳),이병훈(李炳勳),106,104,210,0
29777,소병훈(蘇秉勳),이상민(李相珉),77,37,114,0
29778,소병훈(蘇秉勳),이상헌(李相憲),97,104,201,0
29779,소병훈(蘇秉勳),이성만(李成萬),89,130,219,1
29780,소병훈(蘇秉勳),이소영(李素永),85,65,150,0
29781,소병훈(蘇秉勳),이수진(李壽珍),103,125,228,0
29782,소병훈(蘇秉勳),이수진(李秀眞),99,69,168,0
29783,소병훈(蘇秉勳),이양수(李亮壽),54,4,58,1
29784,소병훈(蘇秉勳),이용(李鏞),50,7,57,1
29785,소병훈(蘇秉勳),이용빈(李龍彬),110,139,249,0
29786,소병훈(蘇秉勳),이용선(李庸瑄),99,80,179,0
29787,소병훈(蘇秉勳),이용우(李龍雨),92,75,167,0
29788,소병훈(蘇秉勳),이용호(李容鎬),42,30,72,1
29789,소병훈(蘇秉勳),이원욱(李元旭),98,82,180,0
29790,소병훈(蘇秉勳),이원택(李源澤),97,137,234,0
29791,소병훈(蘇秉勳),이은주(李恩周),12,28,40,1
29792,소병훈(蘇秉勳),이인선(李仁善),25,4,29,1
29793,소병훈(蘇秉勳),이인영(李仁榮),78,66,144,0
29794,소병훈(蘇秉勳),이장섭(李將燮),94,76,170,0
29795,소병훈(蘇秉勳),이재명(李在明),40,22,62,0
29796,소병훈(蘇秉勳),이재정(李在汀),84,66,150,0
29797,소병훈(蘇秉勳),이정문(李楨文),93,97,190,0
29798,소병훈(蘇秉勳),이종배(李鍾培),53,6,59,1
29799,소병훈(蘇秉勳),이종성(李鍾成),50,4,54,1
29800,소병훈(蘇秉勳),이주환(李周桓),50,6,56,1
29801,소병훈(蘇秉勳),이채익(李埰益),53,8,61,1
29802,소병훈(蘇秉勳),이철규(李喆圭),54,6,60,1
29803,소병훈(蘇秉勳),이탄희(李誕熙),83,81,164,0
29804,소병훈(蘇秉勳),이태규(李泰珪),28,5,33,1
29805,소병훈(蘇秉勳),이학영(李學永),103,99,202,0
29806,소병훈(蘇秉勳),이해식(李海植),113,103,216,0
29807,소병훈(蘇秉勳),이헌승(李憲昇),51,5,56,1
29808,소병훈(蘇秉勳),이형석(李炯錫),98,98,196,0
29809,소병훈(蘇秉勳),인재근(印在謹),135,199,334,0
29810,소병훈(蘇秉勳),임병헌(林炳憲),25,4,29,1
29811,소병훈(蘇秉勳),임오경(林五卿),91,62,153,0
29812,소병훈(蘇秉勳),임이자(林利子),49,4,53,1
29813,소병훈(蘇秉勳),임종성(林鍾聲),128,182,310,0
29814,소병훈(蘇秉勳),임호선(林昊宣),99,129,228,0
29815,소병훈(蘇秉勳),장경태(張耿態),107,100,207,0
29816,소병훈(蘇秉勳),장동혁(張東赫),25,4,29,1
29817,소병훈(蘇秉勳),장제원(張濟元),49,4,53,1
29818,소병훈(蘇秉勳),장철민(張喆敏),91,76,167,0
29819,소병훈(蘇秉勳),장혜영(張惠英),11,17,28,1
29820,소병훈(蘇秉勳),전봉민(田奉珉),35,5,40,1
29821,소병훈(蘇秉勳),전용기(田溶冀),86,85,171,0
29822,소병훈(蘇秉勳),전재수(田載秀),84,67,151,0
29823,소병훈(蘇秉勳),전주혜(全珠惠),52,5,57,1
29824,소병훈(蘇秉勳),전해철(全海澈),76,67,143,0
29825,소병훈(蘇秉勳),전혜숙(全惠淑),97,102,199,0
29826,소병훈(蘇秉勳),정경희(丁慶姬),50,4,54,1
29827,소병훈(蘇秉勳),정동만(鄭東萬),49,4,53,1
29828,소병훈(蘇秉勳),정성호(鄭成湖),94,92,186,0
29829,소병훈(蘇秉勳),정우택(鄭宇澤),27,4,31,1
29830,소병훈(蘇秉勳),정운천(鄭雲天),50,8,58,1
29831,소병훈(蘇秉勳),정일영(鄭日永),92,77,169,0
29832,소병훈(蘇秉勳),정점식(鄭点植),50,5,55,1
29833,소병훈(蘇秉勳),정진석(鄭鎭碩),50,6,56,1
29834,소병훈(蘇秉勳),정청래(鄭淸來),92,60,152,0
29835,소병훈(蘇秉勳),정춘숙(鄭春淑),99,92,191,0
29836,소병훈(蘇秉勳),정태호(鄭泰浩),84,88,172,0
29837,소병훈(蘇秉勳),정필모(鄭必模),91,85,176,0
29838,소병훈(蘇秉勳),정희용(鄭熙溶),50,7,57,1
29839,소병훈(蘇秉勳),조경태(趙慶泰),50,6,56,1
29840,소병훈(蘇秉勳),조명희(曺明姬),50,7,57,1
29841,소병훈(蘇秉勳),조수진(趙修眞),50,6,56,1
29842,소병훈(蘇秉勳),조승래(趙承來),90,57,147,0
29843,소병훈(蘇秉勳),조오섭(曺五燮),117,203,320,0
29844,소병훈(蘇秉勳),조은희(趙恩禧),26,4,30,1
29845,소병훈(蘇秉勳),조응천(趙應天),89,48,137,0
29846,소병훈(蘇秉勳),조정식(趙正湜),77,63,140,0
29847,소병훈(蘇秉勳),조정훈(趙廷訓),1,9,10,1
29848,소병훈(蘇秉勳),조해진(曺海珍),52,5,57,1
29849,소병훈(蘇秉勳),주철현(朱哲鉉),106,178,284,0
29850,소병훈(蘇秉勳),주호영(朱豪英),49,5,54,1
29851,소병훈(蘇秉勳),지성호(池成浩),50,4,54,1
29852,소병훈(蘇秉勳),진선미(陳善美),93,56,149,0
29853,소병훈(蘇秉勳),진성준(陳聲準),105,91,196,0
29854,소병훈(蘇秉勳),천준호(千俊鎬),103,75,178,0
29855,소병훈(蘇秉勳),최기상(崔基相),87,67,154,0
29856,소병훈(蘇秉勳),최승재(崔承宰),52,5,57,1
29857,소병훈(蘇秉勳),최연숙(崔姸淑),38,22,60,1
29858,소병훈(蘇秉勳),최영희(崔英姬),25,4,29,1
29859,소병훈(蘇秉勳),최인호(崔仁昊),86,76,162,0
29860,소병훈(蘇秉勳),최재형(崔在亨),25,4,29,1
29861,소병훈(蘇秉勳),최종윤(崔鍾允),138,176,314,0
29862,소병훈(蘇秉勳),최춘식(崔春植),50,8,58,1
29863,소병훈(蘇秉勳),최형두(崔炯斗),50,6,56,1
29864,소병훈(蘇秉勳),최혜영(崔惠英),114,118,232,0
29865,소병훈(蘇秉勳),추경호(秋慶鎬),49,5,54,1
29866,소병훈(蘇秉勳),태영호(太永浩),49,9,58,1
29867,소병훈(蘇秉勳),하영제(河榮帝),42,3,45,1
29868,소병훈(蘇秉勳),하태경(河泰慶),49,4,53,1
29869,소병훈(蘇秉勳),한기호(韓起鎬),51,5,56,1
29870,소병훈(蘇秉勳),한무경(韓茂景),50,5,55,1
29871,소병훈(蘇秉勳),한병도(韓秉道),101,87,188,0
29872,소병훈(蘇秉勳),한정애(韓貞愛),77,61,138,0
29873,소병훈(蘇秉勳),한준호(韓俊鎬),96,82,178,0
29874,소병훈(蘇秉勳),허숙정(許淑湞),1,2,3,0
29875,소병훈(蘇秉勳),허영(許榮),137,161,298,0
29876,소병훈(蘇秉勳),허은아(許垠娥),49,5,54,1
29877,소병훈(蘇秉勳),허종식(許琮植),99,99,198,0
29878,소병훈(蘇秉勳),홍기원(洪起元),102,80,182,0
29879,소병훈(蘇秉勳),홍문표(洪文杓),51,10,61,1
29880,소병훈(蘇秉勳),홍석준(洪碩晙),50,4,54,1
29881,소병훈(蘇秉勳),홍성국(洪性國),110,116,226,0
29882,소병훈(蘇秉勳),홍영표(洪永杓),81,60,141,0
29883,소병훈(蘇秉勳),홍익표(洪翼杓),90,87,177,0
29884,소병훈(蘇秉勳),홍정민(洪貞敏),99,110,209,0
29885,소병훈(蘇秉勳),황보승희(皇甫承希),48,2,50,1
29886,소병훈(蘇秉勳),황운하(黃雲夏),89,116,205,0
29887,소병훈(蘇秉勳),황희(黃熙),78,50,128,0
29888,송갑석(宋甲錫),송기헌(宋基憲),83,51,134,0
29889,송갑석(宋甲錫),송석준(宋錫俊),51,8,59,1
29890,송갑석(宋甲錫),송언석(宋彦錫),45,4,49,1
29891,송갑석(宋甲錫),송옥주(宋玉珠),121,170,291,0
29892,송갑석(宋甲錫),송재호(宋在祜),106,128,234,0
29893,송갑석(宋甲錫),신동근(申東根),92,107,199,0
29894,송갑석(宋甲錫),신영대(申榮大),115,104,219,0
29895,송갑석(宋甲錫),신원식(申源湜),50,5,55,1
29896,송갑석(宋甲錫),신정훈(辛正勳),168,276,444,0
29897,송갑석(宋甲錫),신현영(申賢榮),91,80,171,0
29898,송갑석(宋甲錫),심상정(沈相奵),15,23,38,1
29899,송갑석(宋甲錫),안규백(安圭伯),102,110,212,0
29900,송갑석(宋甲錫),안민석(安敏錫),120,145,265,0
29901,송갑석(宋甲錫),안병길(安炳吉),53,6,59,1
29902,송갑석(宋甲錫),안철수(安哲秀),26,4,30,1
29903,송갑석(宋甲錫),안호영(安浩永),99,163,262,0
29904,송갑석(宋甲錫),양경숙(梁敬淑),104,168,272,0
29905,송갑석(宋甲錫),양금희(梁琴喜),51,5,56,1
29906,송갑석(宋甲錫),양기대(梁基大),93,84,177,0
29907,송갑석(宋甲錫),양이원영(梁李媛瑛),109,137,246,0
29908,송갑석(宋甲錫),양정숙(梁貞淑),70,223,293,1
29909,송갑석(宋甲錫),양향자(梁香子),96,131,227,1
29910,송갑석(宋甲錫),어기구(魚基龜),105,128,233,0
29911,송갑석(宋甲錫),엄태영(嚴泰永),50,6,56,1
29912,송갑석(宋甲錫),오기형(吳奇炯),79,53,132,0
29913,송갑석(宋甲錫),오영환(吳永煥),144,271,415,0
29914,송갑석(宋甲錫),용혜인(龍慧仁),13,33,46,1
29915,송갑석(宋甲錫),우상호(禹相虎),86,46,132,0
29916,송갑석(宋甲錫),우원식(禹元植),100,117,217,0
29917,송갑석(宋甲錫),위성곤(魏聖坤),120,212,332,0
29918,송갑석(宋甲錫),유경준(兪京濬),49,6,55,1
29919,송갑석(宋甲錫),유기홍(柳基洪),80,67,147,0
29920,송갑석(宋甲錫),유동수(柳東秀),121,131,252,0
29921,송갑석(宋甲錫),유상범(劉相凡),51,4,55,1
29922,송갑석(宋甲錫),유의동(兪義東),52,5,57,1
29923,송갑석(宋甲錫),유정주(兪訂炷),113,164,277,0
29924,송갑석(宋甲錫),윤건영(尹建永),86,97,183,0
29925,송갑석(宋甲錫),윤관석(尹官石),80,61,141,1
29926,송갑석(宋甲錫),윤두현(尹斗鉉),50,4,54,1
29927,송갑석(宋甲錫),윤미향(尹美香),61,96,157,1
29928,송갑석(宋甲錫),윤상현(尹相現),31,6,37,1
29929,송갑석(宋甲錫),윤영덕(尹永德),169,292,461,0
29930,송갑석(宋甲錫),윤영석(尹永碩),50,6,56,1
29931,송갑석(宋甲錫),윤영찬(尹永燦),90,113,203,0
29932,송갑석(宋甲錫),윤재갑(尹才鉀),153,200,353,0
29933,송갑석(宋甲錫),윤재옥(尹在玉),52,5,57,1
29934,송갑석(宋甲錫),윤주경(尹柱卿),49,5,54,1
29935,송갑석(宋甲錫),윤준병(尹準炳),113,186,299,0
29936,송갑석(宋甲錫),윤창현(尹暢賢),49,5,54,1
29937,송갑석(宋甲錫),윤한홍(尹漢洪),50,6,56,1
29938,송갑석(宋甲錫),윤호중(尹昊重),82,80,162,0
29939,송갑석(宋甲錫),윤후덕(尹厚德),122,161,283,0
29940,송갑석(宋甲錫),이개호(李介昊),148,182,330,0
29941,송갑석(宋甲錫),이달곤(李達坤),52,7,59,1
29942,송갑석(宋甲錫),이동주(李東洲),125,235,360,0
29943,송갑석(宋甲錫),이만희(李晩熙),51,4,55,1
29944,송갑석(宋甲錫),이명수(李明洙),51,15,66,1
29945,송갑석(宋甲錫),이병훈(李炳勳),157,273,430,0
29946,송갑석(宋甲錫),이상민(李相珉),79,43,122,0
29947,송갑석(宋甲錫),이상헌(李相憲),115,123,238,0
29948,송갑석(宋甲錫),이성만(李成萬),124,174,298,1
29949,송갑석(宋甲錫),이소영(李素永),88,123,211,0
29950,송갑석(宋甲錫),이수진(李壽珍),125,171,296,0
29951,송갑석(宋甲錫),이수진(李秀眞),125,171,296,0
29952,송갑석(宋甲錫),이양수(李亮壽),52,4,56,1
29953,송갑석(宋甲錫),이용(李鏞),50,5,55,1
29954,송갑석(宋甲錫),이용빈(李龍彬),168,343,511,0
29955,송갑석(宋甲錫),이용선(李庸瑄),100,106,206,0
29956,송갑석(宋甲錫),이용우(李龍雨),99,118,217,0
29957,송갑석(宋甲錫),이용호(李容鎬),31,25,56,1
29958,송갑석(宋甲錫),이원욱(李元旭),108,136,244,0
29959,송갑석(宋甲錫),이원택(李源澤),106,123,229,0
29960,송갑석(宋甲錫),이은주(李恩周),15,21,36,1
29961,송갑석(宋甲錫),이인선(李仁善),25,4,29,1
29962,송갑석(宋甲錫),이인영(李仁榮),81,64,145,0
29963,송갑석(宋甲錫),이장섭(李將燮),142,207,349,0
29964,송갑석(宋甲錫),이재명(李在明),40,26,66,0
29965,송갑석(宋甲錫),이재정(李在汀),77,65,142,0
29966,송갑석(宋甲錫),이정문(李楨文),128,189,317,0
29967,송갑석(宋甲錫),이종배(李鍾培),51,6,57,1
29968,송갑석(宋甲錫),이종성(李鍾成),50,5,55,1
29969,송갑석(宋甲錫),이주환(李周桓),50,4,54,1
29970,송갑석(宋甲錫),이채익(李埰益),51,9,60,1
29971,송갑석(宋甲錫),이철규(李喆圭),53,4,57,1
29972,송갑석(宋甲錫),이탄희(李誕熙),97,116,213,0
29973,송갑석(宋甲錫),이태규(李泰珪),29,4,33,1
29974,송갑석(宋甲錫),이학영(李學永),115,150,265,0
29975,송갑석(宋甲錫),이해식(李海植),118,121,239,0
29976,송갑석(宋甲錫),이헌승(李憲昇),51,7,58,1
29977,송갑석(宋甲錫),이형석(李炯錫),177,264,441,0
29978,송갑석(宋甲錫),인재근(印在謹),166,217,383,0
29979,송갑석(宋甲錫),임병헌(林炳憲),25,5,30,1
29980,송갑석(宋甲錫),임오경(林五卿),113,143,256,0
29981,송갑석(宋甲錫),임이자(林利子),49,4,53,1
29982,송갑석(宋甲錫),임종성(林鍾聲),139,201,340,0
29983,송갑석(宋甲錫),임호선(林昊宣),124,241,365,0
29984,송갑석(宋甲錫),장경태(張耿態),114,182,296,0
29985,송갑석(宋甲錫),장동혁(張東赫),25,4,29,1
29986,송갑석(宋甲錫),장제원(張濟元),49,5,54,1
29987,송갑석(宋甲錫),장철민(張喆敏),113,134,247,0
29988,송갑석(宋甲錫),장혜영(張惠英),11,17,28,1
29989,송갑석(宋甲錫),전봉민(田奉珉),35,5,40,1
29990,송갑석(宋甲錫),전용기(田溶冀),142,234,376,0
29991,송갑석(宋甲錫),전재수(田載秀),92,69,161,0
29992,송갑석(宋甲錫),전주혜(全珠惠),52,5,57,1
29993,송갑석(宋甲錫),전해철(全海澈),77,59,136,0
29994,송갑석(宋甲錫),전혜숙(全惠淑),106,146,252,0
29995,송갑석(宋甲錫),정경희(丁慶姬),50,4,54,1
29996,송갑석(宋甲錫),정동만(鄭東萬),50,5,55,1
29997,송갑석(宋甲錫),정성호(鄭成湖),92,115,207,0
29998,송갑석(宋甲錫),정우택(鄭宇澤),26,4,30,1
29999,송갑석(宋甲錫),정운천(鄭雲天),51,8,59,1
30000,송갑석(宋甲錫),정일영(鄭日永),100,89,189,0
30001,송갑석(宋甲錫),정점식(鄭点植),50,4,54,1
30002,송갑석(宋甲錫),정진석(鄭鎭碩),52,5,57,1
30003,송갑석(宋甲錫),정청래(鄭淸來),106,141,247,0
30004,송갑석(宋甲錫),정춘숙(鄭春淑),124,181,305,0
30005,송갑석(宋甲錫),정태호(鄭泰浩),97,115,212,0
30006,송갑석(宋甲錫),정필모(鄭必模),99,123,222,0
30007,송갑석(宋甲錫),정희용(鄭熙溶),50,5,55,1
30008,송갑석(宋甲錫),조경태(趙慶泰),50,5,55,1
30009,송갑석(宋甲錫),조명희(曺明姬),50,6,56,1
30010,송갑석(宋甲錫),조수진(趙修眞),52,4,56,1
30011,송갑석(宋甲錫),조승래(趙承來),96,72,168,0
30012,송갑석(宋甲錫),조오섭(曺五燮),203,437,640,0
30013,송갑석(宋甲錫),조은희(趙恩禧),26,4,30,1
30014,송갑석(宋甲錫),조응천(趙應天),83,51,134,0
30015,송갑석(宋甲錫),조정식(趙正湜),90,80,170,0
30016,송갑석(宋甲錫),조정훈(趙廷訓),4,9,13,1
30017,송갑석(宋甲錫),조해진(曺海珍),51,7,58,1
30018,송갑석(宋甲錫),주철현(朱哲鉉),135,202,337,0
30019,송갑석(宋甲錫),주호영(朱豪英),50,4,54,1
30020,송갑석(宋甲錫),지성호(池成浩),50,4,54,1
30021,송갑석(宋甲錫),진선미(陳善美),88,92,180,0
30022,송갑석(宋甲錫),진성준(陳聲準),100,117,217,0
30023,송갑석(宋甲錫),천준호(千俊鎬),87,65,152,0
30024,송갑석(宋甲錫),최기상(崔基相),95,105,200,0
30025,송갑석(宋甲錫),최승재(崔承宰),52,10,62,1
30026,송갑석(宋甲錫),최연숙(崔姸淑),33,13,46,1
30027,송갑석(宋甲錫),최영희(崔英姬),25,5,30,1
30028,송갑석(宋甲錫),최인호(崔仁昊),90,102,192,0
30029,송갑석(宋甲錫),최재형(崔在亨),25,4,29,1
30030,송갑석(宋甲錫),최종윤(崔鍾允),117,171,288,0
30031,송갑석(宋甲錫),최춘식(崔春植),49,6,55,1
30032,송갑석(宋甲錫),최형두(崔炯斗),51,7,58,1
30033,송갑석(宋甲錫),최혜영(崔惠英),120,152,272,0
30034,송갑석(宋甲錫),추경호(秋慶鎬),50,6,56,1
30035,송갑석(宋甲錫),태영호(太永浩),49,4,53,1
30036,송갑석(宋甲錫),하영제(河榮帝),42,7,49,1
30037,송갑석(宋甲錫),하태경(河泰慶),51,5,56,1
30038,송갑석(宋甲錫),한기호(韓起鎬),53,7,60,1
30039,송갑석(宋甲錫),한무경(韓茂景),49,5,54,1
30040,송갑석(宋甲錫),한병도(韓秉道),114,135,249,0
30041,송갑석(宋甲錫),한정애(韓貞愛),82,55,137,0
30042,송갑석(宋甲錫),한준호(韓俊鎬),105,147,252,0
30043,송갑석(宋甲錫),허숙정(許淑湞),1,1,2,0
30044,송갑석(宋甲錫),허영(許榮),128,172,300,0
30045,송갑석(宋甲錫),허은아(許垠娥),49,5,54,1
30046,송갑석(宋甲錫),허종식(許琮植),105,122,227,0
30047,송갑석(宋甲錫),홍기원(洪起元),98,139,237,0
30048,송갑석(宋甲錫),홍문표(洪文杓),50,15,65,1
30049,송갑석(宋甲錫),홍석준(洪碩晙),50,5,55,1
30050,송갑석(宋甲錫),홍성국(洪性國),140,168,308,0
30051,송갑석(宋甲錫),홍영표(洪永杓),86,78,164,0
30052,송갑석(宋甲錫),홍익표(洪翼杓),105,120,225,0
30053,송갑석(宋甲錫),홍정민(洪貞敏),108,135,243,0
30054,송갑석(宋甲錫),황보승희(皇甫承希),50,3,53,1
30055,송갑석(宋甲錫),황운하(黃雲夏),140,220,360,0
30056,송갑석(宋甲錫),황희(黃熙),82,66,148,0
30057,송기헌(宋基憲),송석준(宋錫俊),50,5,55,1
30058,송기헌(宋基憲),송언석(宋彦錫),50,19,69,1
30059,송기헌(宋基憲),송옥주(宋玉珠),87,54,141,0
30060,송기헌(宋基憲),송재호(宋在祜),92,82,174,0
30061,송기헌(宋基憲),신동근(申東根),104,50,154,0
30062,송기헌(宋基憲),신영대(申榮大),88,60,148,0
30063,송기헌(宋基憲),신원식(申源湜),51,18,69,1
30064,송기헌(宋基憲),신정훈(辛正勳),94,87,181,0
30065,송기헌(宋基憲),신현영(申賢榮),82,44,126,0
30066,송기헌(宋基憲),심상정(沈相奵),12,10,22,1
30067,송기헌(宋基憲),안규백(安圭伯),85,56,141,0
30068,송기헌(宋基憲),안민석(安敏錫),80,44,124,0
30069,송기헌(宋基憲),안병길(安炳吉),50,4,54,1
30070,송기헌(宋基憲),안철수(安哲秀),26,4,30,1
30071,송기헌(宋基憲),안호영(安浩永),84,60,144,0
30072,송기헌(宋基憲),양경숙(梁敬淑),85,50,135,0
30073,송기헌(宋基憲),양금희(梁琴喜),51,5,56,1
30074,송기헌(宋基憲),양기대(梁基大),87,53,140,0
30075,송기헌(宋基憲),양이원영(梁李媛瑛),81,50,131,0
30076,송기헌(宋基憲),양정숙(梁貞淑),31,57,88,1
30077,송기헌(宋基憲),양향자(梁香子),40,30,70,1
30078,송기헌(宋基憲),어기구(魚基龜),81,41,122,0
30079,송기헌(宋基憲),엄태영(嚴泰永),52,5,57,1
30080,송기헌(宋基憲),오기형(吳奇炯),77,44,121,0
30081,송기헌(宋基憲),오영환(吳永煥),93,107,200,0
30082,송기헌(宋基憲),용혜인(龍慧仁),11,17,28,1
30083,송기헌(宋基憲),우상호(禹相虎),79,40,119,0
30084,송기헌(宋基憲),우원식(禹元植),88,57,145,0
30085,송기헌(宋基憲),위성곤(魏聖坤),94,103,197,0
30086,송기헌(宋基憲),유경준(兪京濬),49,4,53,1
30087,송기헌(宋基憲),유기홍(柳基洪),75,38,113,0
30088,송기헌(宋基憲),유동수(柳東秀),80,49,129,0
30089,송기헌(宋基憲),유상범(劉相凡),56,13,69,1
30090,송기헌(宋基憲),유의동(兪義東),50,9,59,1
30091,송기헌(宋基憲),유정주(兪訂炷),89,73,162,0
30092,송기헌(宋基憲),윤건영(尹建永),79,52,131,0
30093,송기헌(宋基憲),윤관석(尹官石),73,42,115,1
30094,송기헌(宋基憲),윤두현(尹斗鉉),51,6,57,1
30095,송기헌(宋基憲),윤미향(尹美香),39,24,63,1
30096,송기헌(宋基憲),윤상현(尹相現),32,5,37,1
30097,송기헌(宋基憲),윤영덕(尹永德),81,49,130,0
30098,송기헌(宋基憲),윤영석(尹永碩),50,5,55,1
30099,송기헌(宋基憲),윤영찬(尹永燦),79,47,126,0
30100,송기헌(宋基憲),윤재갑(尹才鉀),91,73,164,0
30101,송기헌(宋基憲),윤재옥(尹在玉),49,4,53,1
30102,송기헌(宋基憲),윤주경(尹柱卿),50,5,55,1
30103,송기헌(宋基憲),윤준병(尹準炳),90,72,162,0
30104,송기헌(宋基憲),윤창현(尹暢賢),52,5,57,1
30105,송기헌(宋基憲),윤한홍(尹漢洪),50,6,56,1
30106,송기헌(宋基憲),윤호중(尹昊重),81,41,122,0
30107,송기헌(宋基憲),윤후덕(尹厚德),78,53,131,0
30108,송기헌(宋基憲),이개호(李介昊),79,47,126,0
30109,송기헌(宋基憲),이달곤(李達坤),53,6,59,1
30110,송기헌(宋基憲),이동주(李東洲),83,48,131,0
30111,송기헌(宋基憲),이만희(李晩熙),51,5,56,1
30112,송기헌(宋基憲),이명수(李明洙),53,10,63,1
30113,송기헌(宋基憲),이병훈(李炳勳),96,66,162,0
30114,송기헌(宋基憲),이상민(李相珉),73,36,109,0
30115,송기헌(宋基憲),이상헌(李相憲),90,71,161,0
30116,송기헌(宋基憲),이성만(李成萬),83,70,153,1
30117,송기헌(宋基憲),이소영(李素永),80,51,131,0
30118,송기헌(宋基憲),이수진(李壽珍),86,55,141,0
30119,송기헌(宋基憲),이수진(李秀眞),86,67,153,0
30120,송기헌(宋基憲),이양수(李亮壽),58,11,69,1
30121,송기헌(宋基憲),이용(李鏞),50,4,54,1
30122,송기헌(宋基憲),이용빈(李龍彬),92,63,155,0
30123,송기헌(宋基憲),이용선(李庸瑄),85,51,136,0
30124,송기헌(宋基憲),이용우(李龍雨),83,54,137,0
30125,송기헌(宋基憲),이용호(李容鎬),32,12,44,1
30126,송기헌(宋基憲),이원욱(李元旭),85,52,137,0
30127,송기헌(宋基憲),이원택(李源澤),82,50,132,0
30128,송기헌(宋基憲),이은주(李恩周),13,14,27,1
30129,송기헌(宋基憲),이인선(李仁善),25,4,29,1
30130,송기헌(宋基憲),이인영(李仁榮),72,37,109,0
30131,송기헌(宋基憲),이장섭(李將燮),82,50,132,0
30132,송기헌(宋基憲),이재명(李在明),39,18,57,0
30133,송기헌(宋基憲),이재정(李在汀),80,43,123,0
30134,송기헌(宋基憲),이정문(李楨文),80,56,136,0
30135,송기헌(宋基憲),이종배(李鍾培),51,6,57,1
30136,송기헌(宋基憲),이종성(李鍾成),51,5,56,1
30137,송기헌(宋基憲),이주환(李周桓),50,6,56,1
30138,송기헌(宋基憲),이채익(李埰益),51,7,58,1
30139,송기헌(宋基憲),이철규(李喆圭),60,18,78,1
30140,송기헌(宋基憲),이탄희(李誕熙),91,51,142,0
30141,송기헌(宋基憲),이태규(李泰珪),28,6,34,1
30142,송기헌(宋基憲),이학영(李學永),84,50,134,0
30143,송기헌(宋基憲),이해식(李海植),89,56,145,0
30144,송기헌(宋基憲),이헌승(李憲昇),51,4,55,1
30145,송기헌(宋基憲),이형석(李炯錫),84,54,138,0
30146,송기헌(宋基憲),인재근(印在謹),81,63,144,0
30147,송기헌(宋基憲),임병헌(林炳憲),25,4,29,1
30148,송기헌(宋基憲),임오경(林五卿),82,41,123,0
30149,송기헌(宋基憲),임이자(林利子),49,9,58,1
30150,송기헌(宋基憲),임종성(林鍾聲),91,55,146,0
30151,송기헌(宋基憲),임호선(林昊宣),100,119,219,0
30152,송기헌(宋基憲),장경태(張耿態),84,57,141,0
30153,송기헌(宋基憲),장동혁(張東赫),25,4,29,1
30154,송기헌(宋基憲),장제원(張濟元),49,4,53,1
30155,송기헌(宋基憲),장철민(張喆敏),90,91,181,0
30156,송기헌(宋基憲),장혜영(張惠英),11,9,20,1
30157,송기헌(宋基憲),전봉민(田奉珉),35,5,40,1
30158,송기헌(宋基憲),전용기(田溶冀),82,59,141,0
30159,송기헌(宋基憲),전재수(田載秀),89,73,162,0
30160,송기헌(宋基憲),전주혜(全珠惠),52,6,58,1
30161,송기헌(宋基憲),전해철(全海澈),78,34,112,0
30162,송기헌(宋基憲),전혜숙(全惠淑),81,54,135,0
30163,송기헌(宋基憲),정경희(丁慶姬),51,4,55,1
30164,송기헌(宋基憲),정동만(鄭東萬),49,4,53,1
30165,송기헌(宋基憲),정성호(鄭成湖),79,70,149,0
30166,송기헌(宋基憲),정우택(鄭宇澤),26,4,30,1
30167,송기헌(宋基憲),정운천(鄭雲天),50,6,56,1
30168,송기헌(宋基憲),정일영(鄭日永),94,101,195,0
30169,송기헌(宋基憲),정점식(鄭点植),51,4,55,1
30170,송기헌(宋基憲),정진석(鄭鎭碩),50,7,57,1
30171,송기헌(宋基憲),정청래(鄭淸來),82,38,120,0
30172,송기헌(宋基憲),정춘숙(鄭春淑),86,44,130,0
30173,송기헌(宋基憲),정태호(鄭泰浩),88,51,139,0
30174,송기헌(宋基憲),정필모(鄭必模),79,50,129,0
30175,송기헌(宋基憲),정희용(鄭熙溶),50,6,56,1
30176,송기헌(宋基憲),조경태(趙慶泰),50,5,55,1
30177,송기헌(宋基憲),조명희(曺明姬),50,8,58,1
30178,송기헌(宋基憲),조수진(趙修眞),51,5,56,1
30179,송기헌(宋基憲),조승래(趙承來),104,82,186,0
30180,송기헌(宋基憲),조오섭(曺五燮),85,64,149,0
30181,송기헌(宋基憲),조은희(趙恩禧),27,6,33,1
30182,송기헌(宋基憲),조응천(趙應天),77,39,116,0
30183,송기헌(宋基憲),조정식(趙正湜),74,33,107,0
30184,송기헌(宋基憲),조정훈(趙廷訓),3,6,9,1
30185,송기헌(宋基憲),조해진(曺海珍),51,6,57,1
30186,송기헌(宋基憲),주철현(朱哲鉉),92,65,157,0
30187,송기헌(宋基憲),주호영(朱豪英),50,4,54,1
30188,송기헌(宋基憲),지성호(池成浩),51,5,56,1
30189,송기헌(宋基憲),진선미(陳善美),76,40,116,0
30190,송기헌(宋基憲),진성준(陳聲準),82,66,148,0
30191,송기헌(宋基憲),천준호(千俊鎬),83,43,126,0
30192,송기헌(宋基憲),최기상(崔基相),106,48,154,0
30193,송기헌(宋基憲),최승재(崔承宰),51,7,58,1
30194,송기헌(宋基憲),최연숙(崔姸淑),32,8,40,1
30195,송기헌(宋基憲),최영희(崔英姬),25,4,29,1
30196,송기헌(宋基憲),최인호(崔仁昊),88,69,157,0
30197,송기헌(宋基憲),최재형(崔在亨),25,4,29,1
30198,송기헌(宋基憲),최종윤(崔鍾允),89,82,171,0
30199,송기헌(宋基憲),최춘식(崔春植),49,11,60,1
30200,송기헌(宋基憲),최형두(崔炯斗),50,6,56,1
30201,송기헌(宋基憲),최혜영(崔惠英),82,55,137,0
30202,송기헌(宋基憲),추경호(秋慶鎬),51,5,56,1
30203,송기헌(宋基憲),태영호(太永浩),52,6,58,1
30204,송기헌(宋基憲),하영제(河榮帝),42,2,44,1
30205,송기헌(宋基憲),하태경(河泰慶),49,4,53,1
30206,송기헌(宋基憲),한기호(韓起鎬),56,16,72,1
30207,송기헌(宋基憲),한무경(韓茂景),49,5,54,1
30208,송기헌(宋基憲),한병도(韓秉道),86,63,149,0
30209,송기헌(宋基憲),한정애(韓貞愛),77,34,111,0
30210,송기헌(宋基憲),한준호(韓俊鎬),87,68,155,0
30211,송기헌(宋基憲),허숙정(許淑湞),1,1,2,0
30212,송기헌(宋基憲),허영(許榮),107,109,216,0
30213,송기헌(宋基憲),허은아(許垠娥),49,7,56,1
30214,송기헌(宋基憲),허종식(許琮植),84,54,138,0
30215,송기헌(宋基憲),홍기원(洪起元),85,50,135,0
30216,송기헌(宋基憲),홍문표(洪文杓),51,6,57,1
30217,송기헌(宋基憲),홍석준(洪碩晙),50,5,55,1
30218,송기헌(宋基憲),홍성국(洪性國),95,82,177,0
30219,송기헌(宋基憲),홍영표(洪永杓),79,52,131,0
30220,송기헌(宋基憲),홍익표(洪翼杓),86,57,143,0
30221,송기헌(宋基憲),홍정민(洪貞敏),93,64,157,0
30222,송기헌(宋基憲),황보승희(皇甫承希),46,3,49,1
30223,송기헌(宋基憲),황운하(黃雲夏),83,79,162,0
30224,송기헌(宋基憲),황희(黃熙),73,36,109,0
30225,송석준(宋錫俊),송언석(宋彦錫),72,60,132,0
30226,송석준(宋錫俊),송옥주(宋玉珠),52,4,56,1
30227,송석준(宋錫俊),송재호(宋在祜),51,6,57,1
30228,송석준(宋錫俊),신동근(申東根),49,3,52,1
30229,송석준(宋錫俊),신영대(申榮大),49,4,53,1
30230,송석준(宋錫俊),신원식(申源湜),70,70,140,0
30231,송석준(宋錫俊),신정훈(辛正勳),50,6,56,1
30232,송석준(宋錫俊),신현영(申賢榮),49,4,53,1
30233,송석준(宋錫俊),심상정(沈相奵),7,3,10,1
30234,송석준(宋錫俊),안규백(安圭伯),54,5,59,1
30235,송석준(宋錫俊),안민석(安敏錫),51,7,58,1
30236,송석준(宋錫俊),안병길(安炳吉),69,63,132,0
30237,송석준(宋錫俊),안철수(安哲秀),28,23,51,0
30238,송석준(宋錫俊),안호영(安浩永),50,4,54,1
30239,송석준(宋錫俊),양경숙(梁敬淑),51,5,56,1
30240,송석준(宋錫俊),양금희(梁琴喜),88,88,176,0
30241,송석준(宋錫俊),양기대(梁基大),49,4,53,1
30242,송석준(宋錫俊),양이원영(梁李媛瑛),45,4,49,1
30243,송석준(宋錫俊),양정숙(梁貞淑),3,7,10,1
30244,송석준(宋錫俊),양향자(梁香子),22,6,28,1
30245,송석준(宋錫俊),어기구(魚基龜),50,7,57,1
30246,송석준(宋錫俊),엄태영(嚴泰永),81,89,170,0
30247,송석준(宋錫俊),오기형(吳奇炯),49,4,53,1
30248,송석준(宋錫俊),오영환(吳永煥),52,8,60,1
30249,송석준(宋錫俊),용혜인(龍慧仁),1,3,4,1
30250,송석준(宋錫俊),우상호(禹相虎),50,5,55,1
30251,송석준(宋錫俊),우원식(禹元植),51,4,55,1
30252,송석준(宋錫俊),위성곤(魏聖坤),52,12,64,1
30253,송석준(宋錫俊),유경준(兪京濬),98,92,190,0
30254,송석준(宋錫俊),유기홍(柳基洪),49,4,53,1
30255,송석준(宋錫俊),유동수(柳東秀),58,12,70,1
30256,송석준(宋錫俊),유상범(劉相凡),69,85,154,0
30257,송석준(宋錫俊),유의동(兪義東),65,49,114,0
30258,송석준(宋錫俊),유정주(兪訂炷),49,4,53,1
30259,송석준(宋錫俊),윤건영(尹建永),49,5,54,1
30260,송석준(宋錫俊),윤관석(尹官石),43,3,46,1
30261,송석준(宋錫俊),윤두현(尹斗鉉),71,85,156,0
30262,송석준(宋錫俊),윤미향(尹美香),20,1,21,1
30263,송석준(宋錫俊),윤상현(尹相現),38,35,73,0
30264,송석준(宋錫俊),윤영덕(尹永德),50,5,55,1
30265,송석준(宋錫俊),윤영석(尹永碩),61,51,112,0
30266,송석준(宋錫俊),윤영찬(尹永燦),49,4,53,1
30267,송석준(宋錫俊),윤재갑(尹才鉀),51,12,63,1
30268,송석준(宋錫俊),윤재옥(尹在玉),65,48,113,0
30269,송석준(宋錫俊),윤주경(尹柱卿),71,67,138,0
30270,송석준(宋錫俊),윤준병(尹準炳),50,6,56,1
30271,송석준(宋錫俊),윤창현(尹暢賢),80,101,181,0
30272,송석준(宋錫俊),윤한홍(尹漢洪),66,77,143,0
30273,송석준(宋錫俊),윤호중(尹昊重),51,8,59,1
30274,송석준(宋錫俊),윤후덕(尹厚德),52,7,59,1
30275,송석준(宋錫俊),이개호(李介昊),54,10,64,1
30276,송석준(宋錫俊),이달곤(李達坤),64,60,124,0
30277,송석준(宋錫俊),이동주(李東洲),49,4,53,1
30278,송석준(宋錫俊),이만희(李晩熙),73,68,141,0
30279,송석준(宋錫俊),이명수(李明洙),84,84,168,0
30280,송석준(宋錫俊),이병훈(李炳勳),52,10,62,1
30281,송석준(宋錫俊),이상민(李相珉),51,5,56,1
30282,송석준(宋錫俊),이상헌(李相憲),52,7,59,1
30283,송석준(宋錫俊),이성만(李成萬),40,2,42,1
30284,송석준(宋錫俊),이소영(李素永),50,4,54,1
30285,송석준(宋錫俊),이수진(李壽珍),50,4,54,1
30286,송석준(宋錫俊),이수진(李秀眞),49,6,55,1
30287,송석준(宋錫俊),이양수(李亮壽),84,70,154,0
30288,송석준(宋錫俊),이용(李鏞),73,83,156,0
30289,송석준(宋錫俊),이용빈(李龍彬),50,8,58,1
30290,송석준(宋錫俊),이용선(李庸瑄),49,5,54,1
30291,송석준(宋錫俊),이용우(李龍雨),52,6,58,1
30292,송석준(宋錫俊),이용호(李容鎬),34,30,64,0
30293,송석준(宋錫俊),이원욱(李元旭),53,7,60,1
30294,송석준(宋錫俊),이원택(李源澤),50,5,55,1
30295,송석준(宋錫俊),이은주(李恩周),5,3,8,1
30296,송석준(宋錫俊),이인선(李仁善),30,33,63,0
30297,송석준(宋錫俊),이인영(李仁榮),49,5,54,1
30298,송석준(宋錫俊),이장섭(李將燮),49,4,53,1
30299,송석준(宋錫俊),이재명(李在明),25,4,29,1
30300,송석준(宋錫俊),이재정(李在汀),50,4,54,1
30301,송석준(宋錫俊),이정문(李楨文),50,4,54,1
30302,송석준(宋錫俊),이종배(李鍾培),99,127,226,0
30303,송석준(宋錫俊),이종성(李鍾成),73,110,183,0
30304,송석준(宋錫俊),이주환(李周桓),76,84,160,0
30305,송석준(宋錫俊),이채익(李埰益),71,81,152,0
30306,송석준(宋錫俊),이철규(李喆圭),74,61,135,0
30307,송석준(宋錫俊),이탄희(李誕熙),50,6,56,1
30308,송석준(宋錫俊),이태규(李泰珪),40,39,79,0
30309,송석준(宋錫俊),이학영(李學永),49,4,53,1
30310,송석준(宋錫俊),이해식(李海植),51,4,55,1
30311,송석준(宋錫俊),이헌승(李憲昇),78,82,160,0
30312,송석준(宋錫俊),이형석(李炯錫),50,4,54,1
30313,송석준(宋錫俊),인재근(印在謹),51,15,66,1
30314,송석준(宋錫俊),임병헌(林炳憲),33,35,68,0
30315,송석준(宋錫俊),임오경(林五卿),50,4,54,1
30316,송석준(宋錫俊),임이자(林利子),82,75,157,0
30317,송석준(宋錫俊),임종성(林鍾聲),56,17,73,1
30318,송석준(宋錫俊),임호선(林昊宣),49,5,54,1
30319,송석준(宋錫俊),장경태(張耿態),49,5,54,1
30320,송석준(宋錫俊),장동혁(張東赫),28,24,52,0
30321,송석준(宋錫俊),장제원(張濟元),64,45,109,0
30322,송석준(宋錫俊),장철민(張喆敏),50,4,54,1
30323,송석준(宋錫俊),장혜영(張惠英),5,3,8,1
30324,송석준(宋錫俊),전봉민(田奉珉),45,36,81,0
30325,송석준(宋錫俊),전용기(田溶冀),51,7,58,1
30326,송석준(宋錫俊),전재수(田載秀),49,4,53,1
30327,송석준(宋錫俊),전주혜(全珠惠),70,69,139,0
30328,송석준(宋錫俊),전해철(全海澈),51,5,56,1
30329,송석준(宋錫俊),전혜숙(全惠淑),49,4,53,1
30330,송석준(宋錫俊),정경희(丁慶姬),70,82,152,0
30331,송석준(宋錫俊),정동만(鄭東萬),68,60,128,0
30332,송석준(宋錫俊),정성호(鄭成湖),55,6,61,1
30333,송석준(宋錫俊),정우택(鄭宇澤),43,76,119,0
30334,송석준(宋錫俊),정운천(鄭雲天),76,65,141,0
30335,송석준(宋錫俊),정일영(鄭日永),50,7,57,1
30336,송석준(宋錫俊),정점식(鄭点植),69,51,120,0
30337,송석준(宋錫俊),정진석(鄭鎭碩),66,59,125,0
30338,송석준(宋錫俊),정청래(鄭淸來),49,4,53,1
30339,송석준(宋錫俊),정춘숙(鄭春淑),52,9,61,1
30340,송석준(宋錫俊),정태호(鄭泰浩),49,6,55,1
30341,송석준(宋錫俊),정필모(鄭必模),49,5,54,1
30342,송석준(宋錫俊),정희용(鄭熙溶),73,84,157,0
30343,송석준(宋錫俊),조경태(趙慶泰),77,69,146,0
30344,송석준(宋錫俊),조명희(曺明姬),78,85,163,0
30345,송석준(宋錫俊),조수진(趙修眞),72,93,165,0
30346,송석준(宋錫俊),조승래(趙承來),49,5,54,1
30347,송석준(宋錫俊),조오섭(曺五燮),52,7,59,1
30348,송석준(宋錫俊),조은희(趙恩禧),33,36,69,0
30349,송석준(宋錫俊),조응천(趙應天),52,4,56,1
30350,송석준(宋錫俊),조정식(趙正湜),50,6,56,1
30351,송석준(宋錫俊),조정훈(趙廷訓),0,10,10,1
30352,송석준(宋錫俊),조해진(曺海珍),66,42,108,0
30353,송석준(宋錫俊),주철현(朱哲鉉),51,6,57,1
30354,송석준(宋錫俊),주호영(朱豪英),66,46,112,0
30355,송석준(宋錫俊),지성호(池成浩),79,101,180,0
30356,송석준(宋錫俊),진선미(陳善美),50,4,54,1
30357,송석준(宋錫俊),진성준(陳聲準),50,5,55,1
30358,송석준(宋錫俊),천준호(千俊鎬),51,4,55,1
30359,송석준(宋錫俊),최기상(崔基相),49,4,53,1
30360,송석준(宋錫俊),최승재(崔承宰),82,86,168,0
30361,송석준(宋錫俊),최연숙(崔姸淑),37,31,68,0
30362,송석준(宋錫俊),최영희(崔英姬),30,44,74,0
30363,송석준(宋錫俊),최인호(崔仁昊),49,4,53,1
30364,송석준(宋錫俊),최재형(崔在亨),29,16,45,0
30365,송석준(宋錫俊),최종윤(崔鍾允),51,6,57,1
30366,송석준(宋錫俊),최춘식(崔春植),72,80,152,0
30367,송석준(宋錫俊),최형두(崔炯斗),81,57,138,0
30368,송석준(宋錫俊),최혜영(崔惠英),50,9,59,1
30369,송석준(宋錫俊),추경호(秋慶鎬),88,96,184,0
30370,송석준(宋錫俊),태영호(太永浩),99,129,228,0
30371,송석준(宋錫俊),하영제(河榮帝),77,93,170,1
30372,송석준(宋錫俊),하태경(河泰慶),66,47,113,0
30373,송석준(宋錫俊),한기호(韓起鎬),65,47,112,0
30374,송석준(宋錫俊),한무경(韓茂景),77,108,185,0
30375,송석준(宋錫俊),한병도(韓秉道),49,4,53,1
30376,송석준(宋錫俊),한정애(韓貞愛),50,8,58,1
30377,송석준(宋錫俊),한준호(韓俊鎬),51,4,55,1
30378,송석준(宋錫俊),허숙정(許淑湞),0,0,0,1
30379,송석준(宋錫俊),허영(許榮),53,5,58,1
30380,송석준(宋錫俊),허은아(許垠娥),75,63,138,0
30381,송석준(宋錫俊),허종식(許琮植),53,17,70,1
30382,송석준(宋錫俊),홍기원(洪起元),49,5,54,1
30383,송석준(宋錫俊),홍문표(洪文杓),68,73,141,0
30384,송석준(宋錫俊),홍석준(洪碩晙),70,56,126,0
30385,송석준(宋錫俊),홍성국(洪性國),51,9,60,1
30386,송석준(宋錫俊),홍영표(洪永杓),50,6,56,1
30387,송석준(宋錫俊),홍익표(洪翼杓),49,4,53,1
30388,송석준(宋錫俊),홍정민(洪貞敏),50,4,54,1
30389,송석준(宋錫俊),황보승희(皇甫承希),76,98,174,1
30390,송석준(宋錫俊),황운하(黃雲夏),49,8,57,1
30391,송석준(宋錫俊),황희(黃熙),49,6,55,1
30392,송언석(宋彦錫),송옥주(宋玉珠),45,3,48,1
30393,송언석(宋彦錫),송재호(宋在祜),49,16,65,1
30394,송언석(宋彦錫),신동근(申東根),45,3,48,1
30395,송언석(宋彦錫),신영대(申榮大),45,4,49,1
30396,송언석(宋彦錫),신원식(申源湜),71,76,147,0
30397,송언석(宋彦錫),신정훈(辛正勳),50,19,69,1
30398,송언석(宋彦錫),신현영(申賢榮),46,5,51,1
30399,송언석(宋彦錫),심상정(沈相奵),4,0,4,1
30400,송언석(宋彦錫),안규백(安圭伯),47,5,52,1
30401,송언석(宋彦錫),안민석(安敏錫),45,3,48,1
30402,송언석(宋彦錫),안병길(安炳吉),73,82,155,0
30403,송언석(宋彦錫),안철수(安哲秀),27,15,42,0
30404,송언석(宋彦錫),안호영(安浩永),48,17,65,1
30405,송언석(宋彦錫),양경숙(梁敬淑),45,4,49,1
30406,송언석(宋彦錫),양금희(梁琴喜),106,140,246,0
30407,송언석(宋彦錫),양기대(梁基大),45,4,49,1
30408,송언석(宋彦錫),양이원영(梁李媛瑛),43,5,48,1
30409,송언석(宋彦錫),양정숙(梁貞淑),4,7,11,1
30410,송언석(宋彦錫),양향자(梁香子),17,2,19,1
30411,송언석(宋彦錫),어기구(魚基龜),45,5,50,1
30412,송언석(宋彦錫),엄태영(嚴泰永),79,82,161,0
30413,송언석(宋彦錫),오기형(吳奇炯),45,4,49,1
30414,송언석(宋彦錫),오영환(吳永煥),45,7,52,1
30415,송언석(宋彦錫),용혜인(龍慧仁),0,0,0,1
30416,송언석(宋彦錫),우상호(禹相虎),45,4,49,1
30417,송언석(宋彦錫),우원식(禹元植),47,7,54,1
30418,송언석(宋彦錫),위성곤(魏聖坤),49,18,67,1
30419,송언석(宋彦錫),유경준(兪京濬),81,79,160,0
30420,송언석(宋彦錫),유기홍(柳基洪),45,4,49,1
30421,송언석(宋彦錫),유동수(柳東秀),46,6,52,1
30422,송언석(宋彦錫),유상범(劉相凡),77,80,157,0
30423,송언석(宋彦錫),유의동(兪義東),67,57,124,0
30424,송언석(宋彦錫),유정주(兪訂炷),46,4,50,1
30425,송언석(宋彦錫),윤건영(尹建永),45,3,48,1
30426,송언석(宋彦錫),윤관석(尹官石),36,0,36,1
30427,송언석(宋彦錫),윤두현(尹斗鉉),94,125,219,0
30428,송언석(宋彦錫),윤미향(尹美香),16,0,16,1
30429,송언석(宋彦錫),윤상현(尹相現),36,28,64,0
30430,송언석(宋彦錫),윤영덕(尹永德),45,4,49,1
30431,송언석(宋彦錫),윤영석(尹永碩),72,62,134,0
30432,송언석(宋彦錫),윤영찬(尹永燦),45,4,49,1
30433,송언석(宋彦錫),윤재갑(尹才鉀),51,16,67,1
30434,송언석(宋彦錫),윤재옥(尹在玉),78,62,140,0
30435,송언석(宋彦錫),윤주경(尹柱卿),62,62,124,0
30436,송언석(宋彦錫),윤준병(尹準炳),47,6,53,1
30437,송언석(宋彦錫),윤창현(尹暢賢),94,99,193,0
30438,송언석(宋彦錫),윤한홍(尹漢洪),59,66,125,0
30439,송언석(宋彦錫),윤호중(尹昊重),45,4,49,1
30440,송언석(宋彦錫),윤후덕(尹厚德),45,5,50,1
30441,송언석(宋彦錫),이개호(李介昊),45,4,49,1
30442,송언석(宋彦錫),이달곤(李達坤),56,57,113,0
30443,송언석(宋彦錫),이동주(李東洲),45,4,49,1
30444,송언석(宋彦錫),이만희(李晩熙),87,99,186,0
30445,송언석(宋彦錫),이명수(李明洙),95,102,197,0
30446,송언석(宋彦錫),이병훈(李炳勳),50,6,56,1
30447,송언석(宋彦錫),이상민(李相珉),45,4,49,1
30448,송언석(宋彦錫),이상헌(李相憲),48,7,55,1
30449,송언석(宋彦錫),이성만(李成萬),36,0,36,1
30450,송언석(宋彦錫),이소영(李素永),46,4,50,1
30451,송언석(宋彦錫),이수진(李壽珍),45,4,49,1
30452,송언석(宋彦錫),이수진(李秀眞),45,4,49,1
30453,송언석(宋彦錫),이양수(李亮壽),74,70,144,0
30454,송언석(宋彦錫),이용(李鏞),79,89,168,0
30455,송언석(宋彦錫),이용빈(李龍彬),48,4,52,1
30456,송언석(宋彦錫),이용선(李庸瑄),47,5,52,1
30457,송언석(宋彦錫),이용우(李龍雨),45,4,49,1
30458,송언석(宋彦錫),이용호(李容鎬),30,19,49,0
30459,송언석(宋彦錫),이원욱(李元旭),46,4,50,1
30460,송언석(宋彦錫),이원택(李源澤),47,7,54,1
30461,송언석(宋彦錫),이은주(李恩周),3,0,3,1
30462,송언석(宋彦錫),이인선(李仁善),28,17,45,0
30463,송언석(宋彦錫),이인영(李仁榮),45,4,49,1
30464,송언석(宋彦錫),이장섭(李將燮),47,7,54,1
30465,송언석(宋彦錫),이재명(李在明),25,4,29,1
30466,송언석(宋彦錫),이재정(李在汀),45,4,49,1
30467,송언석(宋彦錫),이정문(李楨文),45,4,49,1
30468,송언석(宋彦錫),이종배(李鍾培),88,106,194,0
30469,송언석(宋彦錫),이종성(李鍾成),117,134,251,0
30470,송언석(宋彦錫),이주환(李周桓),84,100,184,0
30471,송언석(宋彦錫),이채익(李埰益),66,77,143,0
30472,송언석(宋彦錫),이철규(李喆圭),71,61,132,0
30473,송언석(宋彦錫),이탄희(李誕熙),45,4,49,1
30474,송언석(宋彦錫),이태규(李泰珪),46,51,97,0
30475,송언석(宋彦錫),이학영(李學永),45,4,49,1
30476,송언석(宋彦錫),이해식(李海植),47,7,54,1
30477,송언석(宋彦錫),이헌승(李憲昇),65,64,129,0
30478,송언석(宋彦錫),이형석(李炯錫),45,4,49,1
30479,송언석(宋彦錫),인재근(印在謹),45,4,49,1
30480,송언석(宋彦錫),임병헌(林炳憲),34,19,53,0
30481,송언석(宋彦錫),임오경(林五卿),45,4,49,1
30482,송언석(宋彦錫),임이자(林利子),135,160,295,0
30483,송언석(宋彦錫),임종성(林鍾聲),45,4,49,1
30484,송언석(宋彦錫),임호선(林昊宣),51,20,71,1
30485,송언석(宋彦錫),장경태(張耿態),45,4,49,1
30486,송언석(宋彦錫),장동혁(張東赫),29,18,47,0
30487,송언석(宋彦錫),장제원(張濟元),60,45,105,0
30488,송언석(宋彦錫),장철민(張喆敏),45,4,49,1
30489,송언석(宋彦錫),장혜영(張惠英),5,2,7,1
30490,송언석(宋彦錫),전봉민(田奉珉),57,61,118,0
30491,송언석(宋彦錫),전용기(田溶冀),45,4,49,1
30492,송언석(宋彦錫),전재수(田載秀),47,5,52,1
30493,송언석(宋彦錫),전주혜(全珠惠),65,75,140,0
30494,송언석(宋彦錫),전해철(全海澈),46,4,50,1
30495,송언석(宋彦錫),전혜숙(全惠淑),45,5,50,1
30496,송언석(宋彦錫),정경희(丁慶姬),71,63,134,0
30497,송언석(宋彦錫),정동만(鄭東萬),60,56,116,0
30498,송언석(宋彦錫),정성호(鄭成湖),46,4,50,1
30499,송언석(宋彦錫),정우택(鄭宇澤),37,31,68,0
30500,송언석(宋彦錫),정운천(鄭雲天),77,82,159,0
30501,송언석(宋彦錫),정일영(鄭日永),45,4,49,1
30502,송언석(宋彦錫),정점식(鄭点植),69,48,117,0
30503,송언석(宋彦錫),정진석(鄭鎭碩),106,152,258,0
30504,송언석(宋彦錫),정청래(鄭淸來),46,4,50,1
30505,송언석(宋彦錫),정춘숙(鄭春淑),47,5,52,1
30506,송언석(宋彦錫),정태호(鄭泰浩),47,5,52,1
30507,송언석(宋彦錫),정필모(鄭必模),45,4,49,1
30508,송언석(宋彦錫),정희용(鄭熙溶),136,197,333,0
30509,송언석(宋彦錫),조경태(趙慶泰),75,66,141,0
30510,송언석(宋彦錫),조명희(曺明姬),79,104,183,0
30511,송언석(宋彦錫),조수진(趙修眞),74,92,166,0
30512,송언석(宋彦錫),조승래(趙承來),47,5,52,1
30513,송언석(宋彦錫),조오섭(曺五燮),45,4,49,1
30514,송언석(宋彦錫),조은희(趙恩禧),35,34,69,0
30515,송언석(宋彦錫),조응천(趙應天),45,3,48,1
30516,송언석(宋彦錫),조정식(趙正湜),45,3,48,1
30517,송언석(宋彦錫),조정훈(趙廷訓),2,4,6,1
30518,송언석(宋彦錫),조해진(曺海珍),60,36,96,0
30519,송언석(宋彦錫),주철현(朱哲鉉),49,7,56,1
30520,송언석(宋彦錫),주호영(朱豪英),65,48,113,0
30521,송언석(宋彦錫),지성호(池成浩),93,95,188,0
30522,송언석(宋彦錫),진선미(陳善美),45,4,49,1
30523,송언석(宋彦錫),진성준(陳聲準),47,4,51,1
30524,송언석(宋彦錫),천준호(千俊鎬),45,3,48,1
30525,송언석(宋彦錫),최기상(崔基相),45,4,49,1
30526,송언석(宋彦錫),최승재(崔承宰),64,74,138,0
30527,송언석(宋彦錫),최연숙(崔姸淑),40,44,84,0
30528,송언석(宋彦錫),최영희(崔英姬),32,24,56,0
30529,송언석(宋彦錫),최인호(崔仁昊),46,4,50,1
30530,송언석(宋彦錫),최재형(崔在亨),27,18,45,0
30531,송언석(宋彦錫),최종윤(崔鍾允),45,4,49,1
30532,송언석(宋彦錫),최춘식(崔春植),103,119,222,0
30533,송언석(宋彦錫),최형두(崔炯斗),98,105,203,0
30534,송언석(宋彦錫),최혜영(崔惠英),46,4,50,1
30535,송언석(宋彦錫),추경호(秋慶鎬),132,169,301,0
30536,송언석(宋彦錫),태영호(太永浩),105,200,305,0
30537,송언석(宋彦錫),하영제(河榮帝),72,69,141,1
30538,송언석(宋彦錫),하태경(河泰慶),59,46,105,0
30539,송언석(宋彦錫),한기호(韓起鎬),66,53,119,0
30540,송언석(宋彦錫),한무경(韓茂景),104,123,227,0
30541,송언석(宋彦錫),한병도(韓秉道),45,4,49,1
30542,송언석(宋彦錫),한정애(韓貞愛),47,5,52,1
30543,송언석(宋彦錫),한준호(韓俊鎬),48,7,55,1
30544,송언석(宋彦錫),허숙정(許淑湞),0,0,0,1
30545,송언석(宋彦錫),허영(許榮),48,6,54,1
30546,송언석(宋彦錫),허은아(許垠娥),81,89,170,0
30547,송언석(宋彦錫),허종식(許琮植),45,4,49,1
30548,송언석(宋彦錫),홍기원(洪起元),45,4,49,1
30549,송언석(宋彦錫),홍문표(洪文杓),74,61,135,0
30550,송언석(宋彦錫),홍석준(洪碩晙),70,75,145,0
30551,송언석(宋彦錫),홍성국(洪性國),48,10,58,1
30552,송언석(宋彦錫),홍영표(洪永杓),45,4,49,1
30553,송언석(宋彦錫),홍익표(洪翼杓),47,5,52,1
30554,송언석(宋彦錫),홍정민(洪貞敏),45,4,49,1
30555,송언석(宋彦錫),황보승희(皇甫承希),71,88,159,1
30556,송언석(宋彦錫),황운하(黃雲夏),46,6,52,1
30557,송언석(宋彦錫),황희(黃熙),45,4,49,1
30558,송옥주(宋玉珠),송재호(宋在祜),102,91,193,0
30559,송옥주(宋玉珠),신동근(申東根),92,84,176,0
30560,송옥주(宋玉珠),신영대(申榮大),87,60,147,0
30561,송옥주(宋玉珠),신원식(申源湜),49,4,53,1
30562,송옥주(宋玉珠),신정훈(辛正勳),116,153,269,0
30563,송옥주(宋玉珠),신현영(申賢榮),77,58,135,0
30564,송옥주(宋玉珠),심상정(沈相奵),20,55,75,1
30565,송옥주(宋玉珠),안규백(安圭伯),99,77,176,0
30566,송옥주(宋玉珠),안민석(安敏錫),89,74,163,0
30567,송옥주(宋玉珠),안병길(安炳吉),53,4,57,1
30568,송옥주(宋玉珠),안철수(安哲秀),25,3,28,1
30569,송옥주(宋玉珠),안호영(安浩永),185,237,422,0
30570,송옥주(宋玉珠),양경숙(梁敬淑),92,93,185,0
30571,송옥주(宋玉珠),양금희(梁琴喜),50,4,54,1
30572,송옥주(宋玉珠),양기대(梁基大),103,83,186,0
30573,송옥주(宋玉珠),양이원영(梁李媛瑛),137,104,241,0
30574,송옥주(宋玉珠),양정숙(梁貞淑),64,195,259,1
30575,송옥주(宋玉珠),양향자(梁香子),45,62,107,1
30576,송옥주(宋玉珠),어기구(魚基龜),94,88,182,0
30577,송옥주(宋玉珠),엄태영(嚴泰永),51,4,55,1
30578,송옥주(宋玉珠),오기형(吳奇炯),83,41,124,0
30579,송옥주(宋玉珠),오영환(吳永煥),129,181,310,0
30580,송옥주(宋玉珠),용혜인(龍慧仁),28,105,133,1
30581,송옥주(宋玉珠),우상호(禹相虎),81,49,130,0
30582,송옥주(宋玉珠),우원식(禹元植),95,113,208,0
30583,송옥주(宋玉珠),위성곤(魏聖坤),101,124,225,0
30584,송옥주(宋玉珠),유경준(兪京濬),49,4,53,1
30585,송옥주(宋玉珠),유기홍(柳基洪),87,61,148,0
30586,송옥주(宋玉珠),유동수(柳東秀),133,189,322,0
30587,송옥주(宋玉珠),유상범(劉相凡),49,3,52,1
30588,송옥주(宋玉珠),유의동(兪義東),52,4,56,1
30589,송옥주(宋玉珠),유정주(兪訂炷),107,145,252,0
30590,송옥주(宋玉珠),윤건영(尹建永),89,78,167,0
30591,송옥주(宋玉珠),윤관석(尹官石),93,72,165,1
30592,송옥주(宋玉珠),윤두현(尹斗鉉),49,3,52,1
30593,송옥주(宋玉珠),윤미향(尹美香),132,239,371,1
30594,송옥주(宋玉珠),윤상현(尹相現),30,4,34,1
30595,송옥주(宋玉珠),윤영덕(尹永德),92,104,196,0
30596,송옥주(宋玉珠),윤영석(尹永碩),50,4,54,1
30597,송옥주(宋玉珠),윤영찬(尹永燦),85,59,144,0
30598,송옥주(宋玉珠),윤재갑(尹才鉀),106,112,218,0
30599,송옥주(宋玉珠),윤재옥(尹在玉),52,4,56,1
30600,송옥주(宋玉珠),윤주경(尹柱卿),49,3,52,1
30601,송옥주(宋玉珠),윤준병(尹準炳),164,226,390,0
30602,송옥주(宋玉珠),윤창현(尹暢賢),49,3,52,1
30603,송옥주(宋玉珠),윤한홍(尹漢洪),50,5,55,1
30604,송옥주(宋玉珠),윤호중(尹昊重),79,43,122,0
30605,송옥주(宋玉珠),윤후덕(尹厚德),104,137,241,0
30606,송옥주(宋玉珠),이개호(李介昊),87,66,153,0
30607,송옥주(宋玉珠),이달곤(李達坤),52,5,57,1
30608,송옥주(宋玉珠),이동주(李東洲),99,133,232,0
30609,송옥주(宋玉珠),이만희(李晩熙),49,3,52,1
30610,송옥주(宋玉珠),이명수(李明洙),50,9,59,1
30611,송옥주(宋玉珠),이병훈(李炳勳),116,153,269,0
30612,송옥주(宋玉珠),이상민(李相珉),76,36,112,0
30613,송옥주(宋玉珠),이상헌(李相憲),92,91,183,0
30614,송옥주(宋玉珠),이성만(李成萬),117,203,320,1
30615,송옥주(宋玉珠),이소영(李素永),97,102,199,0
30616,송옥주(宋玉珠),이수진(李壽珍),180,277,457,0
30617,송옥주(宋玉珠),이수진(李秀眞),102,100,202,0
30618,송옥주(宋玉珠),이양수(李亮壽),50,4,54,1
30619,송옥주(宋玉珠),이용(李鏞),49,3,52,1
30620,송옥주(宋玉珠),이용빈(李龍彬),127,162,289,0
30621,송옥주(宋玉珠),이용선(李庸瑄),91,88,179,0
30622,송옥주(宋玉珠),이용우(李龍雨),101,76,177,0
30623,송옥주(宋玉珠),이용호(李容鎬),39,25,64,1
30624,송옥주(宋玉珠),이원욱(李元旭),124,145,269,0
30625,송옥주(宋玉珠),이원택(李源澤),91,74,165,0
30626,송옥주(宋玉珠),이은주(李恩周),24,40,64,1
30627,송옥주(宋玉珠),이인선(李仁善),25,3,28,1
30628,송옥주(宋玉珠),이인영(李仁榮),78,55,133,0
30629,송옥주(宋玉珠),이장섭(李將燮),105,99,204,0
30630,송옥주(宋玉珠),이재명(李在明),39,21,60,0
30631,송옥주(宋玉珠),이재정(李在汀),78,49,127,0
30632,송옥주(宋玉珠),이정문(李楨文),99,97,196,0
30633,송옥주(宋玉珠),이종배(李鍾培),50,6,56,1
30634,송옥주(宋玉珠),이종성(李鍾成),49,4,53,1
30635,송옥주(宋玉珠),이주환(李周桓),49,3,52,1
30636,송옥주(宋玉珠),이채익(李埰益),52,8,60,1
30637,송옥주(宋玉珠),이철규(李喆圭),50,3,53,1
30638,송옥주(宋玉珠),이탄희(李誕熙),108,89,197,0
30639,송옥주(宋玉珠),이태규(李泰珪),30,3,33,1
30640,송옥주(宋玉珠),이학영(李學永),140,183,323,0
30641,송옥주(宋玉珠),이해식(李海植),104,82,186,0
30642,송옥주(宋玉珠),이헌승(李憲昇),51,5,56,1
30643,송옥주(宋玉珠),이형석(李炯錫),107,111,218,0
30644,송옥주(宋玉珠),인재근(印在謹),103,130,233,0
30645,송옥주(宋玉珠),임병헌(林炳憲),25,5,30,1
30646,송옥주(宋玉珠),임오경(林五卿),105,90,195,0
30647,송옥주(宋玉珠),임이자(林利子),49,3,52,1
30648,송옥주(宋玉珠),임종성(林鍾聲),188,328,516,0
30649,송옥주(宋玉珠),임호선(林昊宣),122,140,262,0
30650,송옥주(宋玉珠),장경태(張耿態),108,97,205,0
30651,송옥주(宋玉珠),장동혁(張東赫),25,3,28,1
30652,송옥주(宋玉珠),장제원(張濟元),49,4,53,1
30653,송옥주(宋玉珠),장철민(張喆敏),144,149,293,0
30654,송옥주(宋玉珠),장혜영(張惠英),17,26,43,1
30655,송옥주(宋玉珠),전봉민(田奉珉),35,4,39,1
30656,송옥주(宋玉珠),전용기(田溶冀),109,138,247,0
30657,송옥주(宋玉珠),전재수(田載秀),119,66,185,0
30658,송옥주(宋玉珠),전주혜(全珠惠),51,3,54,1
30659,송옥주(宋玉珠),전해철(全海澈),80,62,142,0
30660,송옥주(宋玉珠),전혜숙(全惠淑),110,102,212,0
30661,송옥주(宋玉珠),정경희(丁慶姬),49,3,52,1
30662,송옥주(宋玉珠),정동만(鄭東萬),49,3,52,1
30663,송옥주(宋玉珠),정성호(鄭成湖),99,144,243,0
30664,송옥주(宋玉珠),정우택(鄭宇澤),25,3,28,1
30665,송옥주(宋玉珠),정운천(鄭雲天),49,5,54,1
30666,송옥주(宋玉珠),정일영(鄭日永),95,116,211,0
30667,송옥주(宋玉珠),정점식(鄭点植),50,3,53,1
30668,송옥주(宋玉珠),정진석(鄭鎭碩),52,6,58,1
30669,송옥주(宋玉珠),정청래(鄭淸來),81,59,140,0
30670,송옥주(宋玉珠),정춘숙(鄭春淑),144,239,383,0
30671,송옥주(宋玉珠),정태호(鄭泰浩),87,103,190,0
30672,송옥주(宋玉珠),정필모(鄭必模),114,86,200,0
30673,송옥주(宋玉珠),정희용(鄭熙溶),50,4,54,1
30674,송옥주(宋玉珠),조경태(趙慶泰),49,3,52,1
30675,송옥주(宋玉珠),조명희(曺明姬),49,4,53,1
30676,송옥주(宋玉珠),조수진(趙修眞),51,3,54,1
30677,송옥주(宋玉珠),조승래(趙承來),99,84,183,0
30678,송옥주(宋玉珠),조오섭(曺五燮),94,149,243,0
30679,송옥주(宋玉珠),조은희(趙恩禧),25,4,29,1
30680,송옥주(宋玉珠),조응천(趙應天),92,37,129,0
30681,송옥주(宋玉珠),조정식(趙正湜),79,40,119,0
30682,송옥주(宋玉珠),조정훈(趙廷訓),6,7,13,1
30683,송옥주(宋玉珠),조해진(曺海珍),51,5,56,1
30684,송옥주(宋玉珠),주철현(朱哲鉉),95,97,192,0
30685,송옥주(宋玉珠),주호영(朱豪英),49,3,52,1
30686,송옥주(宋玉珠),지성호(池成浩),49,3,52,1
30687,송옥주(宋玉珠),진선미(陳善美),87,62,149,0
30688,송옥주(宋玉珠),진성준(陳聲準),113,103,216,0
30689,송옥주(宋玉珠),천준호(千俊鎬),98,72,170,0
30690,송옥주(宋玉珠),최기상(崔基相),85,69,154,0
30691,송옥주(宋玉珠),최승재(崔承宰),51,4,55,1
30692,송옥주(宋玉珠),최연숙(崔姸淑),31,12,43,1
30693,송옥주(宋玉珠),최영희(崔英姬),25,3,28,1
30694,송옥주(宋玉珠),최인호(崔仁昊),134,119,253,0
30695,송옥주(宋玉珠),최재형(崔在亨),25,3,28,1
30696,송옥주(宋玉珠),최종윤(崔鍾允),126,165,291,0
30697,송옥주(宋玉珠),최춘식(崔春植),49,4,53,1
30698,송옥주(宋玉珠),최형두(崔炯斗),51,5,56,1
30699,송옥주(宋玉珠),최혜영(崔惠英),92,115,207,0
30700,송옥주(宋玉珠),추경호(秋慶鎬),49,3,52,1
30701,송옥주(宋玉珠),태영호(太永浩),49,4,53,1
30702,송옥주(宋玉珠),하영제(河榮帝),41,2,43,1
30703,송옥주(宋玉珠),하태경(河泰慶),49,4,53,1
30704,송옥주(宋玉珠),한기호(韓起鎬),50,3,53,1
30705,송옥주(宋玉珠),한무경(韓茂景),50,5,55,1
30706,송옥주(宋玉珠),한병도(韓秉道),107,92,199,0
30707,송옥주(宋玉珠),한정애(韓貞愛),96,121,217,0
30708,송옥주(宋玉珠),한준호(韓俊鎬),101,98,199,0
30709,송옥주(宋玉珠),허숙정(許淑湞),1,2,3,0
30710,송옥주(宋玉珠),허영(許榮),118,114,232,0
30711,송옥주(宋玉珠),허은아(許垠娥),49,4,53,1
30712,송옥주(宋玉珠),허종식(許琮植),107,137,244,0
30713,송옥주(宋玉珠),홍기원(洪起元),101,106,207,0
30714,송옥주(宋玉珠),홍문표(洪文杓),50,4,54,1
30715,송옥주(宋玉珠),홍석준(洪碩晙),50,4,54,1
30716,송옥주(宋玉珠),홍성국(洪性國),122,140,262,0
30717,송옥주(宋玉珠),홍영표(洪永杓),92,63,155,0
30718,송옥주(宋玉珠),홍익표(洪翼杓),90,75,165,0
30719,송옥주(宋玉珠),홍정민(洪貞敏),102,115,217,0
30720,송옥주(宋玉珠),황보승희(皇甫承希),49,3,52,1
30721,송옥주(宋玉珠),황운하(黃雲夏),108,117,225,0
30722,송옥주(宋玉珠),황희(黃熙),79,58,137,0
30723,송재호(宋在祜),신동근(申東根),91,74,165,0
30724,송재호(宋在祜),신영대(申榮大),93,76,169,0
30725,송재호(宋在祜),신원식(申源湜),51,5,56,1
30726,송재호(宋在祜),신정훈(辛正勳),133,256,389,0
30727,송재호(宋在祜),신현영(申賢榮),89,69,158,0
30728,송재호(宋在祜),심상정(沈相奵),15,32,47,1
30729,송재호(宋在祜),안규백(安圭伯),102,90,192,0
30730,송재호(宋在祜),안민석(安敏錫),95,78,173,0
30731,송재호(宋在祜),안병길(安炳吉),51,5,56,1
30732,송재호(宋在祜),안철수(安哲秀),26,5,31,1
30733,송재호(宋在祜),안호영(安浩永),99,120,219,0
30734,송재호(宋在祜),양경숙(梁敬淑),99,147,246,0
30735,송재호(宋在祜),양금희(梁琴喜),51,8,59,1
30736,송재호(宋在祜),양기대(梁基大),105,97,202,0
30737,송재호(宋在祜),양이원영(梁李媛瑛),102,112,214,0
30738,송재호(宋在祜),양정숙(梁貞淑),85,240,325,1
30739,송재호(宋在祜),양향자(梁香子),52,57,109,1
30740,송재호(宋在祜),어기구(魚基龜),88,85,173,0
30741,송재호(宋在祜),엄태영(嚴泰永),50,4,54,1
30742,송재호(宋在祜),오기형(吳奇炯),96,75,171,0
30743,송재호(宋在祜),오영환(吳永煥),169,265,434,0
30744,송재호(宋在祜),용혜인(龍慧仁),22,54,76,1
30745,송재호(宋在祜),우상호(禹相虎),82,39,121,0
30746,송재호(宋在祜),우원식(禹元植),101,95,196,0
30747,송재호(宋在祜),위성곤(魏聖坤),128,230,358,0
30748,송재호(宋在祜),유경준(兪京濬),49,4,53,1
30749,송재호(宋在祜),유기홍(柳基洪),88,64,152,0
30750,송재호(宋在祜),유동수(柳東秀),93,67,160,0
30751,송재호(宋在祜),유상범(劉相凡),51,5,56,1
30752,송재호(宋在祜),유의동(兪義東),49,6,55,1
30753,송재호(宋在祜),유정주(兪訂炷),126,143,269,0
30754,송재호(宋在祜),윤건영(尹建永),100,91,191,0
30755,송재호(宋在祜),윤관석(尹官石),88,70,158,1
30756,송재호(宋在祜),윤두현(尹斗鉉),50,4,54,1
30757,송재호(宋在祜),윤미향(尹美香),67,81,148,1
30758,송재호(宋在祜),윤상현(尹相現),31,6,37,1
30759,송재호(宋在祜),윤영덕(尹永德),106,165,271,0
30760,송재호(宋在祜),윤영석(尹永碩),50,7,57,1
30761,송재호(宋在祜),윤영찬(尹永燦),89,61,150,0
30762,송재호(宋在祜),윤재갑(尹才鉀),131,184,315,0
30763,송재호(宋在祜),윤재옥(尹在玉),49,4,53,1
30764,송재호(宋在祜),윤주경(尹柱卿),50,5,55,1
30765,송재호(宋在祜),윤준병(尹準炳),129,192,321,0
30766,송재호(宋在祜),윤창현(尹暢賢),50,6,56,1
30767,송재호(宋在祜),윤한홍(尹漢洪),50,4,54,1
30768,송재호(宋在祜),윤호중(尹昊重),81,60,141,0
30769,송재호(宋在祜),윤후덕(尹厚德),90,71,161,0
30770,송재호(宋在祜),이개호(李介昊),108,119,227,0
30771,송재호(宋在祜),이달곤(李達坤),51,5,56,1
30772,송재호(宋在祜),이동주(李東洲),91,128,219,0
30773,송재호(宋在祜),이만희(李晩熙),50,6,56,1
30774,송재호(宋在祜),이명수(李明洙),56,16,72,1
30775,송재호(宋在祜),이병훈(李炳勳),116,167,283,0
30776,송재호(宋在祜),이상민(李相珉),86,46,132,0
30777,송재호(宋在祜),이상헌(李相憲),122,117,239,0
30778,송재호(宋在祜),이성만(李成萬),140,190,330,1
30779,송재호(宋在祜),이소영(李素永),96,69,165,0
30780,송재호(宋在祜),이수진(李壽珍),138,170,308,0
30781,송재호(宋在祜),이수진(李秀眞),106,120,226,0
30782,송재호(宋在祜),이양수(李亮壽),53,6,59,1
30783,송재호(宋在祜),이용(李鏞),50,7,57,1
30784,송재호(宋在祜),이용빈(李龍彬),152,202,354,0
30785,송재호(宋在祜),이용선(李庸瑄),104,85,189,0
30786,송재호(宋在祜),이용우(李龍雨),117,124,241,0
30787,송재호(宋在祜),이용호(李容鎬),34,29,63,1
30788,송재호(宋在祜),이원욱(李元旭),107,82,189,0
30789,송재호(宋在祜),이원택(李源澤),116,126,242,0
30790,송재호(宋在祜),이은주(李恩周),22,38,60,1
30791,송재호(宋在祜),이인선(李仁善),25,4,29,1
30792,송재호(宋在祜),이인영(李仁榮),75,51,126,0
30793,송재호(宋在祜),이장섭(李將燮),99,103,202,0
30794,송재호(宋在祜),이재명(李在明),41,23,64,0
30795,송재호(宋在祜),이재정(李在汀),88,54,142,0
30796,송재호(宋在祜),이정문(李楨文),103,125,228,0
30797,송재호(宋在祜),이종배(李鍾培),51,6,57,1
30798,송재호(宋在祜),이종성(李鍾成),50,6,56,1
30799,송재호(宋在祜),이주환(李周桓),50,6,56,1
30800,송재호(宋在祜),이채익(李埰益),56,9,65,1
30801,송재호(宋在祜),이철규(李喆圭),53,6,59,1
30802,송재호(宋在祜),이탄희(李誕熙),96,93,189,0
30803,송재호(宋在祜),이태규(李泰珪),30,6,36,1
30804,송재호(宋在祜),이학영(李學永),105,97,202,0
30805,송재호(宋在祜),이해식(李海植),115,142,257,0
30806,송재호(宋在祜),이헌승(李憲昇),50,4,54,1
30807,송재호(宋在祜),이형석(李炯錫),125,123,248,0
30808,송재호(宋在祜),인재근(印在謹),115,111,226,0
30809,송재호(宋在祜),임병헌(林炳憲),25,4,29,1
30810,송재호(宋在祜),임오경(林五卿),104,94,198,0
30811,송재호(宋在祜),임이자(林利子),49,4,53,1
30812,송재호(宋在祜),임종성(林鍾聲),119,131,250,0
30813,송재호(宋在祜),임호선(林昊宣),146,211,357,0
30814,송재호(宋在祜),장경태(張耿態),118,133,251,0
30815,송재호(宋在祜),장동혁(張東赫),25,4,29,1
30816,송재호(宋在祜),장제원(張濟元),50,4,54,1
30817,송재호(宋在祜),장철민(張喆敏),94,92,186,0
30818,송재호(宋在祜),장혜영(張惠英),13,25,38,1
30819,송재호(宋在祜),전봉민(田奉珉),35,5,40,1
30820,송재호(宋在祜),전용기(田溶冀),94,105,199,0
30821,송재호(宋在祜),전재수(田載秀),89,81,170,0
30822,송재호(宋在祜),전주혜(全珠惠),52,6,58,1
30823,송재호(宋在祜),전해철(全海澈),78,56,134,0
30824,송재호(宋在祜),전혜숙(全惠淑),99,84,183,0
30825,송재호(宋在祜),정경희(丁慶姬),50,4,54,1
30826,송재호(宋在祜),정동만(鄭東萬),50,4,54,1
30827,송재호(宋在祜),정성호(鄭成湖),96,93,189,0
30828,송재호(宋在祜),정우택(鄭宇澤),26,5,31,1
30829,송재호(宋在祜),정운천(鄭雲天),50,5,55,1
30830,송재호(宋在祜),정일영(鄭日永),101,133,234,0
30831,송재호(宋在祜),정점식(鄭点植),50,6,56,1
30832,송재호(宋在祜),정진석(鄭鎭碩),50,9,59,1
30833,송재호(宋在祜),정청래(鄭淸來),94,57,151,0
30834,송재호(宋在祜),정춘숙(鄭春淑),105,90,195,0
30835,송재호(宋在祜),정태호(鄭泰浩),98,102,200,0
30836,송재호(宋在祜),정필모(鄭必模),103,125,228,0
30837,송재호(宋在祜),정희용(鄭熙溶),51,9,60,1
30838,송재호(宋在祜),조경태(趙慶泰),50,5,55,1
30839,송재호(宋在祜),조명희(曺明姬),50,8,58,1
30840,송재호(宋在祜),조수진(趙修眞),50,4,54,1
30841,송재호(宋在祜),조승래(趙承來),107,76,183,0
30842,송재호(宋在祜),조오섭(曺五燮),115,187,302,0
30843,송재호(宋在祜),조은희(趙恩禧),26,5,31,1
30844,송재호(宋在祜),조응천(趙應天),79,48,127,0
30845,송재호(宋在祜),조정식(趙正湜),82,67,149,0
30846,송재호(宋在祜),조정훈(趙廷訓),4,26,30,1
30847,송재호(宋在祜),조해진(曺海珍),52,5,57,1
30848,송재호(宋在祜),주철현(朱哲鉉),117,179,296,0
30849,송재호(宋在祜),주호영(朱豪英),50,5,55,1
30850,송재호(宋在祜),지성호(池成浩),50,4,54,1
30851,송재호(宋在祜),진선미(陳善美),85,56,141,0
30852,송재호(宋在祜),진성준(陳聲準),98,122,220,0
30853,송재호(宋在祜),천준호(千俊鎬),96,76,172,0
30854,송재호(宋在祜),최기상(崔基相),93,104,197,0
30855,송재호(宋在祜),최승재(崔承宰),50,6,56,1
30856,송재호(宋在祜),최연숙(崔姸淑),32,15,47,1
30857,송재호(宋在祜),최영희(崔英姬),25,6,31,1
30858,송재호(宋在祜),최인호(崔仁昊),93,75,168,0
30859,송재호(宋在祜),최재형(崔在亨),25,5,30,1
30860,송재호(宋在祜),최종윤(崔鍾允),119,165,284,0
30861,송재호(宋在祜),최춘식(崔春植),50,11,61,1
30862,송재호(宋在祜),최형두(崔炯斗),50,6,56,1
30863,송재호(宋在祜),최혜영(崔惠英),105,94,199,0
30864,송재호(宋在祜),추경호(秋慶鎬),49,4,53,1
30865,송재호(宋在祜),태영호(太永浩),49,6,55,1
30866,송재호(宋在祜),하영제(河榮帝),42,4,46,1
30867,송재호(宋在祜),하태경(河泰慶),50,5,55,1
30868,송재호(宋在祜),한기호(韓起鎬),51,5,56,1
30869,송재호(宋在祜),한무경(韓茂景),49,7,56,1
30870,송재호(宋在祜),한병도(韓秉道),113,118,231,0
30871,송재호(宋在祜),한정애(韓貞愛),87,74,161,0
30872,송재호(宋在祜),한준호(韓俊鎬),112,127,239,0
30873,송재호(宋在祜),허숙정(許淑湞),1,2,3,0
30874,송재호(宋在祜),허영(許榮),130,173,303,0
30875,송재호(宋在祜),허은아(許垠娥),49,5,54,1
30876,송재호(宋在祜),허종식(許琮植),119,136,255,0
30877,송재호(宋在祜),홍기원(洪起元),96,109,205,0
30878,송재호(宋在祜),홍문표(洪文杓),53,23,76,1
30879,송재호(宋在祜),홍석준(洪碩晙),50,4,54,1
30880,송재호(宋在祜),홍성국(洪性國),149,218,367,0
30881,송재호(宋在祜),홍영표(洪永杓),84,70,154,0
30882,송재호(宋在祜),홍익표(洪翼杓),110,82,192,0
30883,송재호(宋在祜),홍정민(洪貞敏),120,143,263,0
30884,송재호(宋在祜),황보승희(皇甫承希),47,4,51,1
30885,송재호(宋在祜),황운하(黃雲夏),116,152,268,0
30886,송재호(宋在祜),황희(黃熙),81,47,128,0
30887,신동근(申東根),신영대(申榮大),82,57,139,0
30888,신동근(申東根),신원식(申源湜),49,3,52,1
30889,신동근(申東根),신정훈(辛正勳),94,105,199,0
30890,신동근(申東根),신현영(申賢榮),79,45,124,0
30891,신동근(申東根),심상정(沈相奵),15,21,36,1
30892,신동근(申東根),안규백(安圭伯),93,71,164,0
30893,신동근(申東根),안민석(安敏錫),113,101,214,0
30894,신동근(申東根),안병길(安炳吉),50,3,53,1
30895,신동근(申東根),안철수(安哲秀),25,3,28,1
30896,신동근(申東根),안호영(安浩永),89,63,152,0
30897,신동근(申東根),양경숙(梁敬淑),87,67,154,0
30898,신동근(申東根),양금희(梁琴喜),50,4,54,1
30899,신동근(申東根),양기대(梁基大),88,84,172,0
30900,신동근(申東根),양이원영(梁李媛瑛),82,65,147,0
30901,신동근(申東根),양정숙(梁貞淑),34,79,113,1
30902,신동근(申東根),양향자(梁香子),48,43,91,1
30903,신동근(申東根),어기구(魚基龜),95,63,158,0
30904,신동근(申東根),엄태영(嚴泰永),50,6,56,1
30905,신동근(申東根),오기형(吳奇炯),77,49,126,0
30906,신동근(申東根),오영환(吳永煥),114,146,260,0
30907,신동근(申東根),용혜인(龍慧仁),12,18,30,1
30908,신동근(申東根),우상호(禹相虎),79,44,123,0
30909,신동근(申東根),우원식(禹元植),88,69,157,0
30910,신동근(申東根),위성곤(魏聖坤),90,93,183,0
30911,신동근(申東根),유경준(兪京濬),49,6,55,1
30912,신동근(申東根),유기홍(柳基洪),78,49,127,0
30913,신동근(申東根),유동수(柳東秀),110,114,224,0
30914,신동근(申東根),유상범(劉相凡),49,3,52,1
30915,신동근(申東根),유의동(兪義東),49,3,52,1
30916,신동근(申東根),유정주(兪訂炷),112,172,284,0
30917,신동근(申東根),윤건영(尹建永),80,49,129,0
30918,신동근(申東根),윤관석(尹官石),102,111,213,1
30919,신동근(申東根),윤두현(尹斗鉉),49,3,52,1
30920,신동근(申東根),윤미향(尹美香),43,48,91,1
30921,신동근(申東根),윤상현(尹相現),31,10,41,1
30922,신동근(申東根),윤영덕(尹永德),86,76,162,0
30923,신동근(申東根),윤영석(尹永碩),50,3,53,1
30924,신동근(申東根),윤영찬(尹永燦),79,51,130,0
30925,신동근(申東根),윤재갑(尹才鉀),103,67,170,0
30926,신동근(申東根),윤재옥(尹在玉),49,3,52,1
30927,신동근(申東根),윤주경(尹柱卿),49,4,53,1
30928,신동근(申東根),윤준병(尹準炳),100,119,219,0
30929,신동근(申東根),윤창현(尹暢賢),49,4,53,1
30930,신동근(申東根),윤한홍(尹漢洪),50,3,53,1
30931,신동근(申東根),윤호중(尹昊重),83,69,152,0
30932,신동근(申東根),윤후덕(尹厚德),99,71,170,0
30933,신동근(申東根),이개호(李介昊),88,63,151,0
30934,신동근(申東根),이달곤(李達坤),51,4,55,1
30935,신동근(申東根),이동주(李東洲),103,105,208,0
30936,신동근(申東根),이만희(李晩熙),49,3,52,1
30937,신동근(申東根),이명수(李明洙),50,7,57,1
30938,신동근(申東根),이병훈(李炳勳),96,116,212,0
30939,신동근(申東根),이상민(李相珉),77,36,113,0
30940,신동근(申東根),이상헌(李相憲),121,147,268,0
30941,신동근(申東根),이성만(李成萬),108,120,228,1
30942,신동근(申東根),이소영(李素永),83,52,135,0
30943,신동근(申東根),이수진(李壽珍),95,99,194,0
30944,신동근(申東根),이수진(李秀眞),108,114,222,0
30945,신동근(申東根),이양수(李亮壽),51,3,54,1
30946,신동근(申東根),이용(李鏞),49,3,52,1
30947,신동근(申東根),이용빈(李龍彬),111,139,250,0
30948,신동근(申東根),이용선(李庸瑄),100,68,168,0
30949,신동근(申東根),이용우(李龍雨),91,64,155,0
30950,신동근(申東根),이용호(李容鎬),35,29,64,1
30951,신동근(申東根),이원욱(李元旭),84,88,172,0
30952,신동근(申東根),이원택(李源澤),84,57,141,0
30953,신동근(申東根),이은주(李恩周),18,22,40,1
30954,신동근(申東根),이인선(李仁善),25,3,28,1
30955,신동근(申東根),이인영(李仁榮),75,57,132,0
30956,신동근(申東根),이장섭(李將燮),85,73,158,0
30957,신동근(申東根),이재명(李在明),39,19,58,0
30958,신동근(申東根),이재정(李在汀),78,39,117,0
30959,신동근(申東根),이정문(李楨文),134,159,293,0
30960,신동근(申東根),이종배(李鍾培),50,5,55,1
30961,신동근(申東根),이종성(李鍾成),49,4,53,1
30962,신동근(申東根),이주환(李周桓),49,3,52,1
30963,신동근(申東根),이채익(李埰益),51,5,56,1
30964,신동근(申東根),이철규(李喆圭),50,8,58,1
30965,신동근(申東根),이탄희(李誕熙),105,64,169,0
30966,신동근(申東根),이태규(李泰珪),28,3,31,1
30967,신동근(申東根),이학영(李學永),96,96,192,0
30968,신동근(申東根),이해식(李海植),92,72,164,0
30969,신동근(申東根),이헌승(李憲昇),50,3,53,1
30970,신동근(申東根),이형석(李炯錫),87,72,159,0
30971,신동근(申東根),인재근(印在謹),96,72,168,0
30972,신동근(申東根),임병헌(林炳憲),25,3,28,1
30973,신동근(申東根),임오경(林五卿),99,108,207,0
30974,신동근(申東根),임이자(林利子),49,3,52,1
30975,신동근(申東根),임종성(林鍾聲),99,99,198,0
30976,신동근(申東根),임호선(林昊宣),106,121,227,0
30977,신동근(申東根),장경태(張耿態),102,135,237,0
30978,신동근(申東根),장동혁(張東赫),25,3,28,1
30979,신동근(申東根),장제원(張濟元),49,3,52,1
30980,신동근(申東根),장철민(張喆敏),93,102,195,0
30981,신동근(申東根),장혜영(張惠英),16,15,31,1
30982,신동근(申東根),전봉민(田奉珉),35,4,39,1
30983,신동근(申東根),전용기(田溶冀),96,107,203,0
30984,신동근(申東根),전재수(田載秀),85,71,156,0
30985,신동근(申東根),전주혜(全珠惠),51,4,55,1
30986,신동근(申東根),전해철(全海澈),82,48,130,0
30987,신동근(申東根),전혜숙(全惠淑),89,70,159,0
30988,신동근(申東根),정경희(丁慶姬),49,4,53,1
30989,신동근(申東根),정동만(鄭東萬),49,3,52,1
30990,신동근(申東根),정성호(鄭成湖),85,86,171,0
30991,신동근(申東根),정우택(鄭宇澤),25,3,28,1
30992,신동근(申東根),정운천(鄭雲天),50,3,53,1
30993,신동근(申東根),정일영(鄭日永),125,128,253,0
30994,신동근(申東根),정점식(鄭点植),50,3,53,1
30995,신동근(申東根),정진석(鄭鎭碩),50,3,53,1
30996,신동근(申東根),정청래(鄭淸來),95,56,151,0
30997,신동근(申東根),정춘숙(鄭春淑),98,98,196,0
30998,신동근(申東根),정태호(鄭泰浩),84,84,168,0
30999,신동근(申東根),정필모(鄭必模),89,78,167,0
31000,신동근(申東根),정희용(鄭熙溶),50,4,54,1
31001,신동근(申東根),조경태(趙慶泰),49,5,54,1
31002,신동근(申東根),조명희(曺明姬),50,4,54,1
31003,신동근(申東根),조수진(趙修眞),50,3,53,1
31004,신동근(申東根),조승래(趙承來),110,95,205,0
31005,신동근(申東根),조오섭(曺五燮),88,107,195,0
31006,신동근(申東根),조은희(趙恩禧),25,3,28,1
31007,신동근(申東根),조응천(趙應天),86,51,137,0
31008,신동근(申東根),조정식(趙正湜),83,56,139,0
31009,신동근(申東根),조정훈(趙廷訓),2,12,14,1
31010,신동근(申東根),조해진(曺海珍),52,5,57,1
31011,신동근(申東根),주철현(朱哲鉉),88,53,141,0
31012,신동근(申東根),주호영(朱豪英),49,3,52,1
31013,신동근(申東根),지성호(池成浩),49,3,52,1
31014,신동근(申東根),진선미(陳善美),86,42,128,0
31015,신동근(申東根),진성준(陳聲準),95,89,184,0
31016,신동근(申東根),천준호(千俊鎬),86,60,146,0
31017,신동근(申東根),최기상(崔基相),104,64,168,0
31018,신동근(申東根),최승재(崔承宰),49,4,53,1
31019,신동근(申東根),최연숙(崔姸淑),30,10,40,1
31020,신동근(申東根),최영희(崔英姬),25,4,29,1
31021,신동근(申東根),최인호(崔仁昊),98,95,193,0
31022,신동근(申東根),최재형(崔在亨),25,3,28,1
31023,신동근(申東根),최종윤(崔鍾允),105,87,192,0
31024,신동근(申東根),최춘식(崔春植),49,6,55,1
31025,신동근(申東根),최형두(崔炯斗),50,3,53,1
31026,신동근(申東根),최혜영(崔惠英),95,95,190,0
31027,신동근(申東根),추경호(秋慶鎬),49,3,52,1
31028,신동근(申東根),태영호(太永浩),49,4,53,1
31029,신동근(申東根),하영제(河榮帝),41,0,41,1
31030,신동근(申東根),하태경(河泰慶),49,3,52,1
31031,신동근(申東根),한기호(韓起鎬),50,7,57,1
31032,신동근(申東根),한무경(韓茂景),49,3,52,1
31033,신동근(申東根),한병도(韓秉道),98,91,189,0
31034,신동근(申東根),한정애(韓貞愛),79,44,123,0
31035,신동근(申東根),한준호(韓俊鎬),87,92,179,0
31036,신동근(申東根),허숙정(許淑湞),1,1,2,0
31037,신동근(申東根),허영(許榮),106,121,227,0
31038,신동근(申東根),허은아(許垠娥),49,3,52,1
31039,신동근(申東根),허종식(許琮植),126,132,258,0
31040,신동근(申東根),홍기원(洪起元),93,80,173,0
31041,신동근(申東根),홍문표(洪文杓),52,5,57,1
31042,신동근(申東根),홍석준(洪碩晙),50,3,53,1
31043,신동근(申東根),홍성국(洪性國),102,128,230,0
31044,신동근(申東根),홍영표(洪永杓),96,103,199,0
31045,신동근(申東根),홍익표(洪翼杓),86,68,154,0
31046,신동근(申東根),홍정민(洪貞敏),101,90,191,0
31047,신동근(申東根),황보승희(皇甫承希),46,0,46,1
31048,신동근(申東根),황운하(黃雲夏),91,78,169,0
31049,신동근(申東根),황희(黃熙),78,38,116,0
31050,신영대(申榮大),신원식(申源湜),49,4,53,1
31051,신영대(申榮大),신정훈(辛正勳),126,110,236,0
31052,신영대(申榮大),신현영(申賢榮),77,43,120,0
31053,신영대(申榮大),심상정(沈相奵),13,17,30,1
31054,신영대(申榮大),안규백(安圭伯),86,79,165,0
31055,신영대(申榮大),안민석(安敏錫),80,47,127,0
31056,신영대(申榮大),안병길(安炳吉),50,4,54,1
31057,신영대(申榮大),안철수(安哲秀),25,4,29,1
31058,신영대(申榮大),안호영(安浩永),98,118,216,0
31059,신영대(申榮大),양경숙(梁敬淑),87,74,161,0
31060,신영대(申榮大),양금희(梁琴喜),50,5,55,1
31061,신영대(申榮大),양기대(梁基大),82,71,153,0
31062,신영대(申榮大),양이원영(梁李媛瑛),83,66,149,0
31063,신영대(申榮大),양정숙(梁貞淑),44,112,156,1
31064,신영대(申榮大),양향자(梁香子),39,30,69,1
31065,신영대(申榮大),어기구(魚基龜),87,78,165,0
31066,신영대(申榮大),엄태영(嚴泰永),51,4,55,1
31067,신영대(申榮大),오기형(吳奇炯),76,37,113,0
31068,신영대(申榮大),오영환(吳永煥),115,105,220,0
31069,신영대(申榮大),용혜인(龍慧仁),12,19,31,1
31070,신영대(申榮大),우상호(禹相虎),78,41,119,0
31071,신영대(申榮大),우원식(禹元植),83,65,148,0
31072,신영대(申榮大),위성곤(魏聖坤),100,118,218,0
31073,신영대(申榮大),유경준(兪京濬),49,4,53,1
31074,신영대(申榮大),유기홍(柳基洪),77,55,132,0
31075,신영대(申榮大),유동수(柳東秀),82,51,133,0
31076,신영대(申榮大),유상범(劉相凡),49,4,53,1
31077,신영대(申榮大),유의동(兪義東),49,4,53,1
31078,신영대(申榮大),유정주(兪訂炷),126,117,243,0
31079,신영대(申榮大),윤건영(尹建永),84,46,130,0
31080,신영대(申榮大),윤관석(尹官石),79,48,127,1
31081,신영대(申榮大),윤두현(尹斗鉉),49,4,53,1
31082,신영대(申榮大),윤미향(尹美香),37,43,80,1
31083,신영대(申榮大),윤상현(尹相現),30,4,34,1
31084,신영대(申榮大),윤영덕(尹永德),97,60,157,0
31085,신영대(申榮大),윤영석(尹永碩),50,6,56,1
31086,신영대(申榮大),윤영찬(尹永燦),87,56,143,0
31087,신영대(申榮大),윤재갑(尹才鉀),97,86,183,0
31088,신영대(申榮大),윤재옥(尹在玉),49,4,53,1
31089,신영대(申榮大),윤주경(尹柱卿),49,11,60,1
31090,신영대(申榮大),윤준병(尹準炳),116,144,260,0
31091,신영대(申榮大),윤창현(尹暢賢),49,4,53,1
31092,신영대(申榮大),윤한홍(尹漢洪),50,4,54,1
31093,신영대(申榮大),윤호중(尹昊重),78,50,128,0
31094,신영대(申榮大),윤후덕(尹厚德),92,64,156,0
31095,신영대(申榮大),이개호(李介昊),101,88,189,0
31096,신영대(申榮大),이달곤(李達坤),51,5,56,1
31097,신영대(申榮大),이동주(李東洲),98,105,203,0
31098,신영대(申榮大),이만희(李晩熙),49,4,53,1
31099,신영대(申榮大),이명수(李明洙),50,7,57,1
31100,신영대(申榮大),이병훈(李炳勳),116,111,227,0
31101,신영대(申榮大),이상민(李相珉),74,35,109,0
31102,신영대(申榮大),이상헌(李相憲),109,66,175,0
31103,신영대(申榮大),이성만(李成萬),82,67,149,1
31104,신영대(申榮大),이소영(李素永),86,48,134,0
31105,신영대(申榮大),이수진(李壽珍),87,75,162,0
31106,신영대(申榮大),이수진(李秀眞),90,58,148,0
31107,신영대(申榮大),이양수(李亮壽),50,4,54,1
31108,신영대(申榮大),이용(李鏞),49,6,55,1
31109,신영대(申榮大),이용빈(李龍彬),124,132,256,0
31110,신영대(申榮大),이용선(李庸瑄),94,79,173,0
31111,신영대(申榮大),이용우(李龍雨),85,46,131,0
31112,신영대(申榮大),이용호(李容鎬),39,28,67,1
31113,신영대(申榮大),이원욱(李元旭),84,78,162,0
31114,신영대(申榮大),이원택(李源澤),100,106,206,0
31115,신영대(申榮大),이은주(李恩周),12,27,39,1
31116,신영대(申榮大),이인선(李仁善),25,4,29,1
31117,신영대(申榮大),이인영(李仁榮),73,44,117,0
31118,신영대(申榮大),이장섭(李將燮),111,114,225,0
31119,신영대(申榮大),이재명(李在明),41,19,60,0
31120,신영대(申榮大),이재정(李在汀),76,58,134,0
31121,신영대(申榮大),이정문(李楨文),89,79,168,0
31122,신영대(申榮大),이종배(李鍾培),50,5,55,1
31123,신영대(申榮大),이종성(李鍾成),49,6,55,1
31124,신영대(申榮大),이주환(李周桓),49,4,53,1
31125,신영대(申榮大),이채익(李埰益),51,5,56,1
31126,신영대(申榮大),이철규(李喆圭),53,7,60,1
31127,신영대(申榮大),이탄희(李誕熙),87,53,140,0
31128,신영대(申榮大),이태규(李泰珪),28,4,32,1
31129,신영대(申榮大),이학영(李學永),111,121,232,0
31130,신영대(申榮大),이해식(李海植),93,67,160,0
31131,신영대(申榮大),이헌승(李憲昇),50,4,54,1
31132,신영대(申榮大),이형석(李炯錫),97,75,172,0
31133,신영대(申榮大),인재근(印在謹),88,82,170,0
31134,신영대(申榮大),임병헌(林炳憲),25,4,29,1
31135,신영대(申榮大),임오경(林五卿),88,55,143,0
31136,신영대(申榮大),임이자(林利子),49,4,53,1
31137,신영대(申榮大),임종성(林鍾聲),89,86,175,0
31138,신영대(申榮大),임호선(林昊宣),100,122,222,0
31139,신영대(申榮大),장경태(張耿態),90,85,175,0
31140,신영대(申榮大),장동혁(張東赫),25,4,29,1
31141,신영대(申榮大),장제원(張濟元),49,4,53,1
31142,신영대(申榮大),장철민(張喆敏),81,57,138,0
31143,신영대(申榮大),장혜영(張惠英),11,11,22,1
31144,신영대(申榮大),전봉민(田奉珉),35,5,40,1
31145,신영대(申榮大),전용기(田溶冀),108,103,211,0
31146,신영대(申榮大),전재수(田載秀),95,102,197,0
31147,신영대(申榮大),전주혜(全珠惠),51,5,56,1
31148,신영대(申榮大),전해철(全海澈),75,71,146,0
31149,신영대(申榮大),전혜숙(全惠淑),87,51,138,0
31150,신영대(申榮大),정경희(丁慶姬),49,4,53,1
31151,신영대(申榮大),정동만(鄭東萬),49,4,53,1
31152,신영대(申榮大),정성호(鄭成湖),80,52,132,0
31153,신영대(申榮大),정우택(鄭宇澤),25,4,29,1
31154,신영대(申榮大),정운천(鄭雲天),49,7,56,1
31155,신영대(申榮大),정일영(鄭日永),99,97,196,0
31156,신영대(申榮大),정점식(鄭点植),50,4,54,1
31157,신영대(申榮大),정진석(鄭鎭碩),50,9,59,1
31158,신영대(申榮大),정청래(鄭淸來),80,45,125,0
31159,신영대(申榮大),정춘숙(鄭春淑),92,65,157,0
31160,신영대(申榮大),정태호(鄭泰浩),88,87,175,0
31161,신영대(申榮大),정필모(鄭必模),92,60,152,0
31162,신영대(申榮大),정희용(鄭熙溶),50,5,55,1
31163,신영대(申榮大),조경태(趙慶泰),49,4,53,1
31164,신영대(申榮大),조명희(曺明姬),49,5,54,1
31165,신영대(申榮大),조수진(趙修眞),50,6,56,1
31166,신영대(申榮大),조승래(趙承來),93,59,152,0
31167,신영대(申榮大),조오섭(曺五燮),89,94,183,0
31168,신영대(申榮大),조은희(趙恩禧),25,4,29,1
31169,신영대(申榮大),조응천(趙應天),74,36,110,0
31170,신영대(申榮大),조정식(趙正湜),77,45,122,0
31171,신영대(申榮大),조정훈(趙廷訓),1,7,8,1
31172,신영대(申榮大),조해진(曺海珍),51,5,56,1
31173,신영대(申榮大),주철현(朱哲鉉),107,80,187,0
31174,신영대(申榮大),주호영(朱豪英),49,4,53,1
31175,신영대(申榮大),지성호(池成浩),49,4,53,1
31176,신영대(申榮大),진선미(陳善美),76,42,118,0
31177,신영대(申榮大),진성준(陳聲準),85,56,141,0
31178,신영대(申榮大),천준호(千俊鎬),86,59,145,0
31179,신영대(申榮大),최기상(崔基相),83,50,133,0
31180,신영대(申榮大),최승재(崔承宰),49,6,55,1
31181,신영대(申榮大),최연숙(崔姸淑),29,11,40,1
31182,신영대(申榮大),최영희(崔英姬),25,4,29,1
31183,신영대(申榮大),최인호(崔仁昊),87,107,194,0
31184,신영대(申榮大),최재형(崔在亨),25,4,29,1
31185,신영대(申榮大),최종윤(崔鍾允),95,87,182,0
31186,신영대(申榮大),최춘식(崔春植),49,5,54,1
31187,신영대(申榮大),최형두(崔炯斗),50,5,55,1
31188,신영대(申榮大),최혜영(崔惠英),87,81,168,0
31189,신영대(申榮大),추경호(秋慶鎬),49,5,54,1
31190,신영대(申榮大),태영호(太永浩),50,7,57,1
31191,신영대(申榮大),하영제(河榮帝),41,1,42,1
31192,신영대(申榮大),하태경(河泰慶),49,5,54,1
31193,신영대(申榮大),한기호(韓起鎬),50,5,55,1
31194,신영대(申榮大),한무경(韓茂景),50,4,54,1
31195,신영대(申榮大),한병도(韓秉道),117,135,252,0
31196,신영대(申榮大),한정애(韓貞愛),76,45,121,0
31197,신영대(申榮大),한준호(韓俊鎬),99,84,183,0
31198,신영대(申榮大),허숙정(許淑湞),1,1,2,0
31199,신영대(申榮大),허영(許榮),127,108,235,0
31200,신영대(申榮大),허은아(許垠娥),49,4,53,1
31201,신영대(申榮大),허종식(許琮植),89,78,167,0
31202,신영대(申榮大),홍기원(洪起元),84,76,160,0
31203,신영대(申榮大),홍문표(洪文杓),50,5,55,1
31204,신영대(申榮大),홍석준(洪碩晙),50,6,56,1
31205,신영대(申榮大),홍성국(洪性國),96,86,182,0
31206,신영대(申榮大),홍영표(洪永杓),77,49,126,0
31207,신영대(申榮大),홍익표(洪翼杓),87,62,149,0
31208,신영대(申榮大),홍정민(洪貞敏),101,75,176,0
31209,신영대(申榮大),황보승희(皇甫承希),46,3,49,1
31210,신영대(申榮大),황운하(黃雲夏),91,63,154,0
31211,신영대(申榮大),황희(黃熙),85,68,153,0
31212,신원식(申源湜),신정훈(辛正勳),52,4,56,1
31213,신원식(申源湜),신현영(申賢榮),50,4,54,1
31214,신원식(申源湜),심상정(沈相奵),5,2,7,1
31215,신원식(申源湜),안규백(安圭伯),58,16,74,1
31216,신원식(申源湜),안민석(安敏錫),50,3,53,1
31217,신원식(申源湜),안병길(安炳吉),74,91,165,0
31218,신원식(申源湜),안철수(安哲秀),29,16,45,0
31219,신원식(申源湜),안호영(安浩永),49,4,53,1
31220,신원식(申源湜),양경숙(梁敬淑),50,7,57,1
31221,신원식(申源湜),양금희(梁琴喜),97,133,230,0
31222,신원식(申源湜),양기대(梁基大),50,4,54,1
31223,신원식(申源湜),양이원영(梁李媛瑛),45,4,49,1
31224,신원식(申源湜),양정숙(梁貞淑),4,6,10,1
31225,신원식(申源湜),양향자(梁香子),20,2,22,1
31226,신원식(申源湜),어기구(魚基龜),49,4,53,1
31227,신원식(申源湜),엄태영(嚴泰永),73,76,149,0
31228,신원식(申源湜),오기형(吳奇炯),50,9,59,1
31229,신원식(申源湜),오영환(吳永煥),52,8,60,1
31230,신원식(申源湜),용혜인(龍慧仁),1,1,2,1
31231,신원식(申源湜),우상호(禹相虎),50,4,54,1
31232,신원식(申源湜),우원식(禹元植),50,4,54,1
31233,신원식(申源湜),위성곤(魏聖坤),49,4,53,1
31234,신원식(申源湜),유경준(兪京濬),81,106,187,0
31235,신원식(申源湜),유기홍(柳基洪),49,4,53,1
31236,신원식(申源湜),유동수(柳東秀),50,5,55,1
31237,신원식(申源湜),유상범(劉相凡),76,73,149,0
31238,신원식(申源湜),유의동(兪義東),71,122,193,0
31239,신원식(申源湜),유정주(兪訂炷),49,4,53,1
31240,신원식(申源湜),윤건영(尹建永),49,3,52,1
31241,신원식(申源湜),윤관석(尹官石),40,0,40,1
31242,신원식(申源湜),윤두현(尹斗鉉),88,138,226,0
31243,신원식(申源湜),윤미향(尹美香),20,1,21,1
31244,신원식(申源湜),윤상현(尹相現),37,25,62,0
31245,신원식(申源湜),윤영덕(尹永德),50,5,55,1
31246,신원식(申源湜),윤영석(尹永碩),66,46,112,0
31247,신원식(申源湜),윤영찬(尹永燦),49,6,55,1
31248,신원식(申源湜),윤재갑(尹才鉀),50,5,55,1
31249,신원식(申源湜),윤재옥(尹在玉),69,66,135,0
31250,신원식(申源湜),윤주경(尹柱卿),77,95,172,0
31251,신원식(申源湜),윤준병(尹準炳),49,4,53,1
31252,신원식(申源湜),윤창현(尹暢賢),84,100,184,0
31253,신원식(申源湜),윤한홍(尹漢洪),73,71,144,0
31254,신원식(申源湜),윤호중(尹昊重),50,4,54,1
31255,신원식(申源湜),윤후덕(尹厚德),50,6,56,1
31256,신원식(申源湜),이개호(李介昊),50,5,55,1
31257,신원식(申源湜),이달곤(李達坤),62,76,138,0
31258,신원식(申源湜),이동주(李東洲),49,4,53,1
31259,신원식(申源湜),이만희(李晩熙),82,88,170,0
31260,신원식(申源湜),이명수(李明洙),80,87,167,0
31261,신원식(申源湜),이병훈(李炳勳),54,6,60,1
31262,신원식(申源湜),이상민(李相珉),50,5,55,1
31263,신원식(申源湜),이상헌(李相憲),51,12,63,1
31264,신원식(申源湜),이성만(李成萬),41,0,41,1
31265,신원식(申源湜),이소영(李素永),51,5,56,1
31266,신원식(申源湜),이수진(李壽珍),49,4,53,1
31267,신원식(申源湜),이수진(李秀眞),49,5,54,1
31268,신원식(申源湜),이양수(李亮壽),78,90,168,0
31269,신원식(申源湜),이용(李鏞),94,97,191,0
31270,신원식(申源湜),이용빈(李龍彬),51,5,56,1
31271,신원식(申源湜),이용선(李庸瑄),49,5,54,1
31272,신원식(申源湜),이용우(李龍雨),50,10,60,1
31273,신원식(申源湜),이용호(李容鎬),30,18,48,0
31274,신원식(申源湜),이원욱(李元旭),51,4,55,1
31275,신원식(申源湜),이원택(李源澤),50,5,55,1
31276,신원식(申源湜),이은주(李恩周),4,2,6,1
31277,신원식(申源湜),이인선(李仁善),30,54,84,0
31278,신원식(申源湜),이인영(李仁榮),49,4,53,1
31279,신원식(申源湜),이장섭(李將燮),49,5,54,1
31280,신원식(申源湜),이재명(李在明),25,4,29,1
31281,신원식(申源湜),이재정(李在汀),49,4,53,1
31282,신원식(申源湜),이정문(李楨文),49,4,53,1
31283,신원식(申源湜),이종배(李鍾培),70,65,135,0
31284,신원식(申源湜),이종성(李鍾成),87,125,212,0
31285,신원식(申源湜),이주환(李周桓),79,77,156,0
31286,신원식(申源湜),이채익(李埰益),75,83,158,0
31287,신원식(申源湜),이철규(李喆圭),75,83,158,0
31288,신원식(申源湜),이탄희(李誕熙),49,4,53,1
31289,신원식(申源湜),이태규(李泰珪),40,49,89,0
31290,신원식(申源湜),이학영(李學永),49,4,53,1
31291,신원식(申源湜),이해식(李海植),50,4,54,1
31292,신원식(申源湜),이헌승(李憲昇),69,78,147,0
31293,신원식(申源湜),이형석(李炯錫),50,4,54,1
31294,신원식(申源湜),인재근(印在謹),50,4,54,1
31295,신원식(申源湜),임병헌(林炳憲),37,40,77,0
31296,신원식(申源湜),임오경(林五卿),49,4,53,1
31297,신원식(申源湜),임이자(林利子),78,80,158,0
31298,신원식(申源湜),임종성(林鍾聲),52,5,57,1
31299,신원식(申源湜),임호선(林昊宣),51,6,57,1
31300,신원식(申源湜),장경태(張耿態),49,5,54,1
31301,신원식(申源湜),장동혁(張東赫),30,22,52,0
31302,신원식(申源湜),장제원(張濟元),69,41,110,0
31303,신원식(申源湜),장철민(張喆敏),50,5,55,1
31304,신원식(申源湜),장혜영(張惠英),7,3,10,1
31305,신원식(申源湜),전봉민(田奉珉),50,59,109,0
31306,신원식(申源湜),전용기(田溶冀),49,4,53,1
31307,신원식(申源湜),전재수(田載秀),50,13,63,1
31308,신원식(申源湜),전주혜(全珠惠),86,108,194,0
31309,신원식(申源湜),전해철(全海澈),50,4,54,1
31310,신원식(申源湜),전혜숙(全惠淑),49,8,57,1
31311,신원식(申源湜),정경희(丁慶姬),82,113,195,0
31312,신원식(申源湜),정동만(鄭東萬),72,85,157,0
31313,신원식(申源湜),정성호(鄭成湖),54,6,60,1
31314,신원식(申源湜),정우택(鄭宇澤),31,37,68,0
31315,신원식(申源湜),정운천(鄭雲天),69,58,127,0
31316,신원식(申源湜),정일영(鄭日永),50,5,55,1
31317,신원식(申源湜),정점식(鄭点植),67,47,114,0
31318,신원식(申源湜),정진석(鄭鎭碩),71,84,155,0
31319,신원식(申源湜),정청래(鄭淸來),50,4,54,1
31320,신원식(申源湜),정춘숙(鄭春淑),49,4,53,1
31321,신원식(申源湜),정태호(鄭泰浩),49,5,54,1
31322,신원식(申源湜),정필모(鄭必模),49,4,53,1
31323,신원식(申源湜),정희용(鄭熙溶),82,108,190,0
31324,신원식(申源湜),조경태(趙慶泰),74,58,132,0
31325,신원식(申源湜),조명희(曺明姬),85,150,235,0
31326,신원식(申源湜),조수진(趙修眞),95,130,225,0
31327,신원식(申源湜),조승래(趙承來),49,13,62,1
31328,신원식(申源湜),조오섭(曺五燮),50,4,54,1
31329,신원식(申源湜),조은희(趙恩禧),34,41,75,0
31330,신원식(申源湜),조응천(趙應天),51,4,55,1
31331,신원식(申源湜),조정식(趙正湜),49,3,52,1
31332,신원식(申源湜),조정훈(趙廷訓),0,2,2,1
31333,신원식(申源湜),조해진(曺海珍),66,43,109,0
31334,신원식(申源湜),주철현(朱哲鉉),51,4,55,1
31335,신원식(申源湜),주호영(朱豪英),73,50,123,0
31336,신원식(申源湜),지성호(池成浩),81,109,190,0
31337,신원식(申源湜),진선미(陳善美),49,4,53,1
31338,신원식(申源湜),진성준(陳聲準),49,4,53,1
31339,신원식(申源湜),천준호(千俊鎬),49,3,52,1
31340,신원식(申源湜),최기상(崔基相),50,4,54,1
31341,신원식(申源湜),최승재(崔承宰),78,97,175,0
31342,신원식(申源湜),최연숙(崔姸淑),35,39,74,0
31343,신원식(申源湜),최영희(崔英姬),32,33,65,0
31344,신원식(申源湜),최인호(崔仁昊),51,12,63,1
31345,신원식(申源湜),최재형(崔在亨),27,15,42,0
31346,신원식(申源湜),최종윤(崔鍾允),50,4,54,1
31347,신원식(申源湜),최춘식(崔春植),76,90,166,0
31348,신원식(申源湜),최형두(崔炯斗),72,71,143,0
31349,신원식(申源湜),최혜영(崔惠英),50,4,54,1
31350,신원식(申源湜),추경호(秋慶鎬),87,87,174,0
31351,신원식(申源湜),태영호(太永浩),93,112,205,0
31352,신원식(申源湜),하영제(河榮帝),76,107,183,1
31353,신원식(申源湜),하태경(河泰慶),69,83,152,0
31354,신원식(申源湜),한기호(韓起鎬),76,89,165,0
31355,신원식(申源湜),한무경(韓茂景),77,110,187,0
31356,신원식(申源湜),한병도(韓秉道),51,4,55,1
31357,신원식(申源湜),한정애(韓貞愛),49,5,54,1
31358,신원식(申源湜),한준호(韓俊鎬),50,4,54,1
31359,신원식(申源湜),허숙정(許淑湞),0,0,0,1
31360,신원식(申源湜),허영(許榮),52,9,61,1
31361,신원식(申源湜),허은아(許垠娥),73,83,156,0
31362,신원식(申源湜),허종식(許琮植),50,4,54,1
31363,신원식(申源湜),홍기원(洪起元),49,4,53,1
31364,신원식(申源湜),홍문표(洪文杓),75,63,138,0
31365,신원식(申源湜),홍석준(洪碩晙),67,80,147,0
31366,신원식(申源湜),홍성국(洪性國),49,4,53,1
31367,신원식(申源湜),홍영표(洪永杓),49,4,53,1
31368,신원식(申源湜),홍익표(洪翼杓),50,4,54,1
31369,신원식(申源湜),홍정민(洪貞敏),50,6,56,1
31370,신원식(申源湜),황보승희(皇甫承希),82,122,204,1
31371,신원식(申源湜),황운하(黃雲夏),50,4,54,1
31372,신원식(申源湜),황희(黃熙),49,12,61,1
31373,신정훈(辛正勳),신현영(申賢榮),108,91,199,0
31374,신정훈(辛正勳),심상정(沈相奵),25,50,75,1
31375,신정훈(辛正勳),안규백(安圭伯),132,136,268,0
31376,신정훈(辛正勳),안민석(安敏錫),108,110,218,0
31377,신정훈(辛正勳),안병길(安炳吉),51,5,56,1
31378,신정훈(辛正勳),안철수(安哲秀),26,4,30,1
31379,신정훈(辛正勳),안호영(安浩永),107,202,309,0
31380,신정훈(辛正勳),양경숙(梁敬淑),124,238,362,0
31381,신정훈(辛正勳),양금희(梁琴喜),51,5,56,1
31382,신정훈(辛正勳),양기대(梁基大),118,178,296,0
31383,신정훈(辛正勳),양이원영(梁李媛瑛),142,158,300,0
31384,신정훈(辛正勳),양정숙(梁貞淑),146,385,531,1
31385,신정훈(辛正勳),양향자(梁香子),63,84,147,1
31386,신정훈(辛正勳),어기구(魚基龜),121,186,307,0
31387,신정훈(辛正勳),엄태영(嚴泰永),51,7,58,1
31388,신정훈(辛正勳),오기형(吳奇炯),84,69,153,0
31389,신정훈(辛正勳),오영환(吳永煥),202,411,613,0
31390,신정훈(辛正勳),용혜인(龍慧仁),29,70,99,1
31391,신정훈(辛正勳),우상호(禹相虎),81,53,134,0
31392,신정훈(辛正勳),우원식(禹元植),113,128,241,0
31393,신정훈(辛正勳),위성곤(魏聖坤),186,356,542,0
31394,신정훈(辛正勳),유경준(兪京濬),49,5,54,1
31395,신정훈(辛正勳),유기홍(柳基洪),89,84,173,0
31396,신정훈(辛正勳),유동수(柳東秀),104,85,189,0
31397,신정훈(辛正勳),유상범(劉相凡),53,4,57,1
31398,신정훈(辛正勳),유의동(兪義東),50,4,54,1
31399,신정훈(辛正勳),유정주(兪訂炷),170,265,435,0
31400,신정훈(辛正勳),윤건영(尹建永),107,120,227,0
31401,신정훈(辛正勳),윤관석(尹官石),94,95,189,1
31402,신정훈(辛正勳),윤두현(尹斗鉉),52,4,56,1
31403,신정훈(辛正勳),윤미향(尹美香),82,183,265,1
31404,신정훈(辛正勳),윤상현(尹相現),32,4,36,1
31405,신정훈(辛正勳),윤영덕(尹永德),135,235,370,0
31406,신정훈(辛正勳),윤영석(尹永碩),50,4,54,1
31407,신정훈(辛正勳),윤영찬(尹永燦),89,81,170,0
31408,신정훈(辛正勳),윤재갑(尹才鉀),213,363,576,0
31409,신정훈(辛正勳),윤재옥(尹在玉),51,4,55,1
31410,신정훈(辛正勳),윤주경(尹柱卿),50,5,55,1
31411,신정훈(辛正勳),윤준병(尹準炳),200,423,623,0
31412,신정훈(辛正勳),윤창현(尹暢賢),50,8,58,1
31413,신정훈(辛正勳),윤한홍(尹漢洪),50,4,54,1
31414,신정훈(辛正勳),윤호중(尹昊重),80,76,156,0
31415,신정훈(辛正勳),윤후덕(尹厚德),116,121,237,0
31416,신정훈(辛正勳),이개호(李介昊),150,252,402,0
31417,신정훈(辛正勳),이달곤(李達坤),54,7,61,1
31418,신정훈(辛正勳),이동주(李東洲),137,236,373,0
31419,신정훈(辛正勳),이만희(李晩熙),54,4,58,1
31420,신정훈(辛正勳),이명수(李明洙),60,22,82,1
31421,신정훈(辛正勳),이병훈(李炳勳),169,287,456,0
31422,신정훈(辛正勳),이상민(李相珉),81,51,132,0
31423,신정훈(辛正勳),이상헌(李相憲),137,243,380,0
31424,신정훈(辛正勳),이성만(李成萬),143,239,382,1
31425,신정훈(辛正勳),이소영(李素永),109,111,220,0
31426,신정훈(辛正勳),이수진(李壽珍),154,248,402,0
31427,신정훈(辛正勳),이수진(李秀眞),145,213,358,0
31428,신정훈(辛正勳),이양수(李亮壽),54,7,61,1
31429,신정훈(辛正勳),이용(李鏞),51,4,55,1
31430,신정훈(辛正勳),이용빈(李龍彬),198,382,580,0
31431,신정훈(辛正勳),이용선(李庸瑄),126,180,306,0
31432,신정훈(辛正勳),이용우(李龍雨),130,156,286,0
31433,신정훈(辛正勳),이용호(李容鎬),43,35,78,1
31434,신정훈(辛正勳),이원욱(李元旭),111,148,259,0
31435,신정훈(辛正勳),이원택(李源澤),151,241,392,0
31436,신정훈(辛正勳),이은주(李恩周),32,46,78,1
31437,신정훈(辛正勳),이인선(李仁善),25,4,29,1
31438,신정훈(辛正勳),이인영(李仁榮),76,68,144,0
31439,신정훈(辛正勳),이장섭(李將燮),149,157,306,0
31440,신정훈(辛正勳),이재명(李在明),41,23,64,0
31441,신정훈(辛正勳),이재정(李在汀),91,72,163,0
31442,신정훈(辛正勳),이정문(李楨文),107,154,261,0
31443,신정훈(辛正勳),이종배(李鍾培),51,7,58,1
31444,신정훈(辛正勳),이종성(李鍾成),52,6,58,1
31445,신정훈(辛正勳),이주환(李周桓),51,5,56,1
31446,신정훈(辛正勳),이채익(李埰益),51,8,59,1
31447,신정훈(辛正勳),이철규(李喆圭),54,5,59,1
31448,신정훈(辛正勳),이탄희(李誕熙),101,109,210,0
31449,신정훈(辛正勳),이태규(李泰珪),30,5,35,1
31450,신정훈(辛正勳),이학영(李學永),140,195,335,0
31451,신정훈(辛正勳),이해식(李海植),150,190,340,0
31452,신정훈(辛正勳),이헌승(李憲昇),51,6,57,1
31453,신정훈(辛正勳),이형석(李炯錫),133,197,330,0
31454,신정훈(辛正勳),인재근(印在謹),122,168,290,0
31455,신정훈(辛正勳),임병헌(林炳憲),25,4,29,1
31456,신정훈(辛正勳),임오경(林五卿),129,173,302,0
31457,신정훈(辛正勳),임이자(林利子),49,6,55,1
31458,신정훈(辛正勳),임종성(林鍾聲),136,168,304,0
31459,신정훈(辛正勳),임호선(林昊宣),186,331,517,0
31460,신정훈(辛正勳),장경태(張耿態),142,217,359,0
31461,신정훈(辛正勳),장동혁(張東赫),25,4,29,1
31462,신정훈(辛正勳),장제원(張濟元),50,4,54,1
31463,신정훈(辛正勳),장철민(張喆敏),108,138,246,0
31464,신정훈(辛正勳),장혜영(張惠英),21,26,47,1
31465,신정훈(辛正勳),전봉민(田奉珉),36,5,41,1
31466,신정훈(辛正勳),전용기(田溶冀),161,228,389,0
31467,신정훈(辛正勳),전재수(田載秀),110,133,243,0
31468,신정훈(辛正勳),전주혜(全珠惠),53,6,59,1
31469,신정훈(辛正勳),전해철(全海澈),83,75,158,0
31470,신정훈(辛正勳),전혜숙(全惠淑),119,155,274,0
31471,신정훈(辛正勳),정경희(丁慶姬),52,4,56,1
31472,신정훈(辛正勳),정동만(鄭東萬),50,5,55,1
31473,신정훈(辛正勳),정성호(鄭成湖),96,135,231,0
31474,신정훈(辛正勳),정우택(鄭宇澤),26,4,30,1
31475,신정훈(辛正勳),정운천(鄭雲天),51,8,59,1
31476,신정훈(辛正勳),정일영(鄭日永),100,172,272,0
31477,신정훈(辛正勳),정점식(鄭点植),52,4,56,1
31478,신정훈(辛正勳),정진석(鄭鎭碩),51,7,58,1
31479,신정훈(辛正勳),정청래(鄭淸來),102,105,207,0
31480,신정훈(辛正勳),정춘숙(鄭春淑),109,149,258,0
31481,신정훈(辛正勳),정태호(鄭泰浩),105,157,262,0
31482,신정훈(辛正勳),정필모(鄭必模),123,179,302,0
31483,신정훈(辛正勳),정희용(鄭熙溶),52,6,58,1
31484,신정훈(辛正勳),조경태(趙慶泰),55,11,66,1
31485,신정훈(辛正勳),조명희(曺明姬),51,6,57,1
31486,신정훈(辛正勳),조수진(趙修眞),50,4,54,1
31487,신정훈(辛正勳),조승래(趙承來),105,90,195,0
31488,신정훈(辛正勳),조오섭(曺五燮),151,356,507,0
31489,신정훈(辛正勳),조은희(趙恩禧),26,4,30,1
31490,신정훈(辛正勳),조응천(趙應天),81,62,143,0
31491,신정훈(辛正勳),조정식(趙正湜),84,83,167,0
31492,신정훈(辛正勳),조정훈(趙廷訓),10,36,46,1
31493,신정훈(辛正勳),조해진(曺海珍),51,6,57,1
31494,신정훈(辛正勳),주철현(朱哲鉉),172,340,512,0
31495,신정훈(辛正勳),주호영(朱豪英),50,4,54,1
31496,신정훈(辛正勳),지성호(池成浩),50,4,54,1
31497,신정훈(辛正勳),진선미(陳善美),97,84,181,0
31498,신정훈(辛正勳),진성준(陳聲準),123,183,306,0
31499,신정훈(辛正勳),천준호(千俊鎬),109,103,212,0
31500,신정훈(辛正勳),최기상(崔基相),107,145,252,0
31501,신정훈(辛正勳),최승재(崔承宰),55,11,66,1
31502,신정훈(辛正勳),최연숙(崔姸淑),34,15,49,1
31503,신정훈(辛正勳),최영희(崔英姬),25,4,29,1
31504,신정훈(辛正勳),최인호(崔仁昊),120,156,276,0
31505,신정훈(辛正勳),최재형(崔在亨),25,4,29,1
31506,신정훈(辛正勳),최종윤(崔鍾允),121,208,329,0
31507,신정훈(辛正勳),최춘식(崔春植),50,4,54,1
31508,신정훈(辛正勳),최형두(崔炯斗),53,19,72,1
31509,신정훈(辛正勳),최혜영(崔惠英),135,235,370,0
31510,신정훈(辛正勳),추경호(秋慶鎬),51,6,57,1
31511,신정훈(辛正勳),태영호(太永浩),51,7,58,1
31512,신정훈(辛正勳),하영제(河榮帝),43,3,46,1
31513,신정훈(辛正勳),하태경(河泰慶),53,4,57,1
31514,신정훈(辛正勳),한기호(韓起鎬),53,7,60,1
31515,신정훈(辛正勳),한무경(韓茂景),52,7,59,1
31516,신정훈(辛正勳),한병도(韓秉道),160,307,467,0
31517,신정훈(辛正勳),한정애(韓貞愛),94,91,185,0
31518,신정훈(辛正勳),한준호(韓俊鎬),121,172,293,0
31519,신정훈(辛正勳),허숙정(許淑湞),1,2,3,0
31520,신정훈(辛正勳),허영(許榮),177,261,438,0
31521,신정훈(辛正勳),허은아(許垠娥),50,6,56,1
31522,신정훈(辛正勳),허종식(許琮植),131,199,330,0
31523,신정훈(辛正勳),홍기원(洪起元),121,157,278,0
31524,신정훈(辛正勳),홍문표(洪文杓),62,41,103,1
31525,신정훈(辛正勳),홍석준(洪碩晙),51,4,55,1
31526,신정훈(辛正勳),홍성국(洪性國),186,260,446,0
31527,신정훈(辛正勳),홍영표(洪永杓),93,84,177,0
31528,신정훈(辛正勳),홍익표(洪翼杓),114,127,241,0
31529,신정훈(辛正勳),홍정민(洪貞敏),150,233,383,0
31530,신정훈(辛正勳),황보승희(皇甫承希),49,3,52,1
31531,신정훈(辛正勳),황운하(黃雲夏),168,264,432,0
31532,신정훈(辛正勳),황희(黃熙),88,59,147,0
31533,신현영(申賢榮),심상정(沈相奵),20,15,35,1
31534,신현영(申賢榮),안규백(安圭伯),84,53,137,0
31535,신현영(申賢榮),안민석(安敏錫),84,52,136,0
31536,신현영(申賢榮),안병길(安炳吉),49,4,53,1
31537,신현영(申賢榮),안철수(安哲秀),26,4,30,1
31538,신현영(申賢榮),안호영(安浩永),78,54,132,0
31539,신현영(申賢榮),양경숙(梁敬淑),85,69,154,0
31540,신현영(申賢榮),양금희(梁琴喜),50,5,55,1
31541,신현영(申賢榮),양기대(梁基大),78,62,140,0
31542,신현영(申賢榮),양이원영(梁李媛瑛),81,63,144,0
31543,신현영(申賢榮),양정숙(梁貞淑),26,65,91,1
31544,신현영(申賢榮),양향자(梁香子),30,18,48,1
31545,신현영(申賢榮),어기구(魚基龜),86,51,137,0
31546,신현영(申賢榮),엄태영(嚴泰永),49,4,53,1
31547,신현영(申賢榮),오기형(吳奇炯),89,47,136,0
31548,신현영(申賢榮),오영환(吳永煥),148,164,312,0
31549,신현영(申賢榮),용혜인(龍慧仁),13,27,40,1
31550,신현영(申賢榮),우상호(禹相虎),76,34,110,0
31551,신현영(申賢榮),우원식(禹元植),86,55,141,0
31552,신현영(申賢榮),위성곤(魏聖坤),97,80,177,0
31553,신현영(申賢榮),유경준(兪京濬),49,4,53,1
31554,신현영(申賢榮),유기홍(柳基洪),75,42,117,0
31555,신현영(申賢榮),유동수(柳東秀),81,47,128,0
31556,신현영(申賢榮),유상범(劉相凡),51,4,55,1
31557,신현영(申賢榮),유의동(兪義東),50,4,54,1
31558,신현영(申賢榮),유정주(兪訂炷),108,110,218,0
31559,신현영(申賢榮),윤건영(尹建永),93,71,164,0
31560,신현영(申賢榮),윤관석(尹官石),67,36,103,1
31561,신현영(申賢榮),윤두현(尹斗鉉),50,4,54,1
31562,신현영(申賢榮),윤미향(尹美香),37,37,74,1
31563,신현영(申賢榮),윤상현(尹相現),31,4,35,1
31564,신현영(申賢榮),윤영덕(尹永德),98,107,205,0
31565,신현영(申賢榮),윤영석(尹永碩),49,5,54,1
31566,신현영(申賢榮),윤영찬(尹永燦),82,56,138,0
31567,신현영(申賢榮),윤재갑(尹才鉀),91,70,161,0
31568,신현영(申賢榮),윤재옥(尹在玉),50,4,54,1
31569,신현영(申賢榮),윤주경(尹柱卿),49,4,53,1
31570,신현영(申賢榮),윤준병(尹準炳),87,84,171,0
31571,신현영(申賢榮),윤창현(尹暢賢),49,5,54,1
31572,신현영(申賢榮),윤한홍(尹漢洪),49,4,53,1
31573,신현영(申賢榮),윤호중(尹昊重),80,47,127,0
31574,신현영(申賢榮),윤후덕(尹厚德),104,58,162,0
31575,신현영(申賢榮),이개호(李介昊),82,56,138,0
31576,신현영(申賢榮),이달곤(李達坤),50,6,56,1
31577,신현영(申賢榮),이동주(李東洲),83,65,148,0
31578,신현영(申賢榮),이만희(李晩熙),51,4,55,1
31579,신현영(申賢榮),이명수(李明洙),51,10,61,1
31580,신현영(申賢榮),이병훈(李炳勳),88,66,154,0
31581,신현영(申賢榮),이상민(李相珉),73,36,109,0
31582,신현영(申賢榮),이상헌(李相憲),82,49,131,0
31583,신현영(申賢榮),이성만(李成萬),93,93,186,1
31584,신현영(申賢榮),이소영(李素永),82,62,144,0
31585,신현영(申賢榮),이수진(李壽珍),94,84,178,0
31586,신현영(申賢榮),이수진(李秀眞),130,120,250,0
31587,신현영(申賢榮),이양수(李亮壽),52,4,56,1
31588,신현영(申賢榮),이용(李鏞),50,4,54,1
31589,신현영(申賢榮),이용빈(李龍彬),96,102,198,0
31590,신현영(申賢榮),이용선(李庸瑄),89,72,161,0
31591,신현영(申賢榮),이용우(李龍雨),136,117,253,0
31592,신현영(申賢榮),이용호(李容鎬),29,6,35,1
31593,신현영(申賢榮),이원욱(李元旭),86,62,148,0
31594,신현영(申賢榮),이원택(李源澤),125,95,220,0
31595,신현영(申賢榮),이은주(李恩周),15,9,24,1
31596,신현영(申賢榮),이인선(李仁善),25,4,29,1
31597,신현영(申賢榮),이인영(李仁榮),74,42,116,0
31598,신현영(申賢榮),이장섭(李將燮),78,57,135,0
31599,신현영(申賢榮),이재명(李在明),39,17,56,0
31600,신현영(申賢榮),이재정(李在汀),77,41,118,0
31601,신현영(申賢榮),이정문(李楨文),83,50,133,0
31602,신현영(申賢榮),이종배(李鍾培),51,5,56,1
31603,신현영(申賢榮),이종성(李鍾成),50,5,55,1
31604,신현영(申賢榮),이주환(李周桓),50,4,54,1
31605,신현영(申賢榮),이채익(李埰益),50,7,57,1
31606,신현영(申賢榮),이철규(李喆圭),52,4,56,1
31607,신현영(申賢榮),이탄희(李誕熙),94,70,164,0
31608,신현영(申賢榮),이태규(李泰珪),29,4,33,1
31609,신현영(申賢榮),이학영(李學永),87,71,158,0
31610,신현영(申賢榮),이해식(李海植),86,56,142,0
31611,신현영(申賢榮),이헌승(李憲昇),49,4,53,1
31612,신현영(申賢榮),이형석(李炯錫),91,62,153,0
31613,신현영(申賢榮),인재근(印在謹),83,63,146,0
31614,신현영(申賢榮),임병헌(林炳憲),25,4,29,1
31615,신현영(申賢榮),임오경(林五卿),121,101,222,0
31616,신현영(申賢榮),임이자(林利子),49,4,53,1
31617,신현영(申賢榮),임종성(林鍾聲),104,83,187,0
31618,신현영(申賢榮),임호선(林昊宣),139,157,296,0
31619,신현영(申賢榮),장경태(張耿態),120,121,241,0
31620,신현영(申賢榮),장동혁(張東赫),25,4,29,1
31621,신현영(申賢榮),장제원(張濟元),49,4,53,1
31622,신현영(申賢榮),장철민(張喆敏),112,95,207,0
31623,신현영(申賢榮),장혜영(張惠英),14,11,25,1
31624,신현영(申賢榮),전봉민(田奉珉),35,5,40,1
31625,신현영(申賢榮),전용기(田溶冀),94,84,178,0
31626,신현영(申賢榮),전재수(田載秀),83,43,126,0
31627,신현영(申賢榮),전주혜(全珠惠),51,4,55,1
31628,신현영(申賢榮),전해철(全海澈),74,43,117,0
31629,신현영(申賢榮),전혜숙(全惠淑),90,64,154,0
31630,신현영(申賢榮),정경희(丁慶姬),50,4,54,1
31631,신현영(申賢榮),정동만(鄭東萬),49,4,53,1
31632,신현영(申賢榮),정성호(鄭成湖),84,66,150,0
31633,신현영(申賢榮),정우택(鄭宇澤),26,4,30,1
31634,신현영(申賢榮),정운천(鄭雲天),51,4,55,1
31635,신현영(申賢榮),정일영(鄭日永),93,89,182,0
31636,신현영(申賢榮),정점식(鄭点植),49,4,53,1
31637,신현영(申賢榮),정진석(鄭鎭碩),49,5,54,1
31638,신현영(申賢榮),정청래(鄭淸來),120,94,214,0
31639,신현영(申賢榮),정춘숙(鄭春淑),95,78,173,0
31640,신현영(申賢榮),정태호(鄭泰浩),79,65,144,0
31641,신현영(申賢榮),정필모(鄭必模),87,61,148,0
31642,신현영(申賢榮),정희용(鄭熙溶),50,5,55,1
31643,신현영(申賢榮),조경태(趙慶泰),50,4,54,1
31644,신현영(申賢榮),조명희(曺明姬),50,6,56,1
31645,신현영(申賢榮),조수진(趙修眞),50,4,54,1
31646,신현영(申賢榮),조승래(趙承來),86,51,137,0
31647,신현영(申賢榮),조오섭(曺五燮),81,98,179,0
31648,신현영(申賢榮),조은희(趙恩禧),26,4,30,1
31649,신현영(申賢榮),조응천(趙應天),73,32,105,0
31650,신현영(申賢榮),조정식(趙正湜),75,38,113,0
31651,신현영(申賢榮),조정훈(趙廷訓),1,2,3,1
31652,신현영(申賢榮),조해진(曺海珍),51,5,56,1
31653,신현영(申賢榮),주철현(朱哲鉉),120,122,242,0
31654,신현영(申賢榮),주호영(朱豪英),50,4,54,1
31655,신현영(申賢榮),지성호(池成浩),50,4,54,1
31656,신현영(申賢榮),진선미(陳善美),80,47,127,0
31657,신현영(申賢榮),진성준(陳聲準),82,73,155,0
31658,신현영(申賢榮),천준호(千俊鎬),87,58,145,0
31659,신현영(申賢榮),최기상(崔基相),82,59,141,0
31660,신현영(申賢榮),최승재(崔承宰),50,4,54,1
31661,신현영(申賢榮),최연숙(崔姸淑),31,7,38,1
31662,신현영(申賢榮),최영희(崔英姬),25,4,29,1
31663,신현영(申賢榮),최인호(崔仁昊),86,69,155,0
31664,신현영(申賢榮),최재형(崔在亨),25,4,29,1
31665,신현영(申賢榮),최종윤(崔鍾允),93,76,169,0
31666,신현영(申賢榮),최춘식(崔春植),49,4,53,1
31667,신현영(申賢榮),최형두(崔炯斗),49,5,54,1
31668,신현영(申賢榮),최혜영(崔惠英),137,134,271,0
31669,신현영(申賢榮),추경호(秋慶鎬),49,3,52,1
31670,신현영(申賢榮),태영호(太永浩),49,4,53,1
31671,신현영(申賢榮),하영제(河榮帝),41,2,43,1
31672,신현영(申賢榮),하태경(河泰慶),50,4,54,1
31673,신현영(申賢榮),한기호(韓起鎬),50,4,54,1
31674,신현영(申賢榮),한무경(韓茂景),49,4,53,1
31675,신현영(申賢榮),한병도(韓秉道),85,51,136,0
31676,신현영(申賢榮),한정애(韓貞愛),80,44,124,0
31677,신현영(申賢榮),한준호(韓俊鎬),123,115,238,0
31678,신현영(申賢榮),허숙정(許淑湞),1,1,2,0
31679,신현영(申賢榮),허영(許榮),107,89,196,0
31680,신현영(申賢榮),허은아(許垠娥),49,4,53,1
31681,신현영(申賢榮),허종식(許琮植),113,91,204,0
31682,신현영(申賢榮),홍기원(洪起元),94,70,164,0
31683,신현영(申賢榮),홍문표(洪文杓),49,4,53,1
31684,신현영(申賢榮),홍석준(洪碩晙),49,4,53,1
31685,신현영(申賢榮),홍성국(洪性國),127,142,269,0
31686,신현영(申賢榮),홍영표(洪永杓),80,61,141,0
31687,신현영(申賢榮),홍익표(洪翼杓),80,59,139,0
31688,신현영(申賢榮),홍정민(洪貞敏),107,112,219,0
31689,신현영(申賢榮),황보승희(皇甫承希),46,1,47,1
31690,신현영(申賢榮),황운하(黃雲夏),93,81,174,0
31691,신현영(申賢榮),황희(黃熙),74,39,113,0
31692,심상정(沈相奵),안규백(安圭伯),14,20,34,1
31693,심상정(沈相奵),안민석(安敏錫),15,20,35,1
31694,심상정(沈相奵),안병길(安炳吉),6,3,9,1
31695,심상정(沈相奵),안철수(安哲秀),0,0,0,1
31696,심상정(沈相奵),안호영(安浩永),18,65,83,1
31697,심상정(沈相奵),양경숙(梁敬淑),17,46,63,1
31698,심상정(沈相奵),양금희(梁琴喜),6,5,11,1
31699,심상정(沈相奵),양기대(梁基大),17,8,25,1
31700,심상정(沈相奵),양이원영(梁李媛瑛),14,56,70,1
31701,심상정(沈相奵),양정숙(梁貞淑),48,202,250,1
31702,심상정(沈相奵),양향자(梁香子),11,14,25,1
31703,심상정(沈相奵),어기구(魚基龜),18,18,36,1
31704,심상정(沈相奵),엄태영(嚴泰永),6,4,10,1
31705,심상정(沈相奵),오기형(吳奇炯),12,10,22,1
31706,심상정(沈相奵),오영환(吳永煥),27,69,96,1
31707,심상정(沈相奵),용혜인(龍慧仁),38,164,202,1
31708,심상정(沈相奵),우상호(禹相虎),13,14,27,1
31709,심상정(沈相奵),우원식(禹元植),15,32,47,1
31710,심상정(沈相奵),위성곤(魏聖坤),16,56,72,1
31711,심상정(沈相奵),유경준(兪京濬),5,3,8,1
31712,심상정(沈相奵),유기홍(柳基洪),13,20,33,1
31713,심상정(沈相奵),유동수(柳東秀),14,21,35,1
31714,심상정(沈相奵),유상범(劉相凡),6,2,8,1
31715,심상정(沈相奵),유의동(兪義東),5,3,8,1
31716,심상정(沈相奵),유정주(兪訂炷),24,76,100,1
31717,심상정(沈相奵),윤건영(尹建永),13,19,32,1
31718,심상정(沈相奵),윤관석(尹官石),12,13,25,1
31719,심상정(沈相奵),윤두현(尹斗鉉),5,5,10,1
31720,심상정(沈相奵),윤미향(尹美香),27,126,153,1
31721,심상정(沈相奵),윤상현(尹相現),2,3,5,1
31722,심상정(沈相奵),윤영덕(尹永德),25,76,101,1
31723,심상정(沈相奵),윤영석(尹永碩),5,3,8,1
31724,심상정(沈相奵),윤영찬(尹永燦),11,15,26,1
31725,심상정(沈相奵),윤재갑(尹才鉀),27,44,71,1
31726,심상정(沈相奵),윤재옥(尹在玉),5,2,7,1
31727,심상정(沈相奵),윤주경(尹柱卿),4,6,10,1
31728,심상정(沈相奵),윤준병(尹準炳),22,74,96,1
31729,심상정(沈相奵),윤창현(尹暢賢),4,3,7,1
31730,심상정(沈相奵),윤한홍(尹漢洪),5,2,7,1
31731,심상정(沈相奵),윤호중(尹昊重),11,20,31,1
31732,심상정(沈相奵),윤후덕(尹厚德),22,41,63,1
31733,심상정(沈相奵),이개호(李介昊),14,21,35,1
31734,심상정(沈相奵),이달곤(李達坤),7,4,11,1
31735,심상정(沈相奵),이동주(李東洲),20,37,57,1
31736,심상정(沈相奵),이만희(李晩熙),5,2,7,1
31737,심상정(沈相奵),이명수(李明洙),6,22,28,1
31738,심상정(沈相奵),이병훈(李炳勳),16,29,45,1
31739,심상정(沈相奵),이상민(李相珉),12,16,28,1
31740,심상정(沈相奵),이상헌(李相憲),19,50,69,1
31741,심상정(沈相奵),이성만(李成萬),14,42,56,1
31742,심상정(沈相奵),이소영(李素永),19,25,44,1
31743,심상정(沈相奵),이수진(李壽珍),42,201,243,1
31744,심상정(沈相奵),이수진(李秀眞),23,42,65,1
31745,심상정(沈相奵),이양수(李亮壽),6,4,10,1
31746,심상정(沈相奵),이용(李鏞),5,3,8,1
31747,심상정(沈相奵),이용빈(李龍彬),31,113,144,1
31748,심상정(沈相奵),이용선(李庸瑄),17,69,86,1
31749,심상정(沈相奵),이용우(李龍雨),26,25,51,1
31750,심상정(沈相奵),이용호(李容鎬),6,12,18,1
31751,심상정(沈相奵),이원욱(李元旭),11,18,29,1
31752,심상정(沈相奵),이원택(李源澤),10,15,25,1
31753,심상정(沈相奵),이은주(李恩周),87,347,434,0
31754,심상정(沈相奵),이인선(李仁善),0,0,0,1
31755,심상정(沈相奵),이인영(李仁榮),10,10,20,1
31756,심상정(沈相奵),이장섭(李將燮),12,21,33,1
31757,심상정(沈相奵),이재명(李在明),5,9,14,1
31758,심상정(沈相奵),이재정(李在汀),13,13,26,1
31759,심상정(沈相奵),이정문(李楨文),12,18,30,1
31760,심상정(沈相奵),이종배(李鍾培),5,5,10,1
31761,심상정(沈相奵),이종성(李鍾成),5,3,8,1
31762,심상정(沈相奵),이주환(李周桓),4,3,7,1
31763,심상정(沈相奵),이채익(李埰益),7,6,13,1
31764,심상정(沈相奵),이철규(李喆圭),5,4,9,1
31765,심상정(沈相奵),이탄희(李誕熙),21,65,86,1
31766,심상정(沈相奵),이태규(李泰珪),5,6,11,1
31767,심상정(沈相奵),이학영(李學永),14,25,39,1
31768,심상정(沈相奵),이해식(李海植),16,24,40,1
31769,심상정(沈相奵),이헌승(李憲昇),7,3,10,1
31770,심상정(沈相奵),이형석(李炯錫),15,30,45,1
31771,심상정(沈相奵),인재근(印在謹),14,34,48,1
31772,심상정(沈相奵),임병헌(林炳憲),1,1,2,1
31773,심상정(沈相奵),임오경(林五卿),16,25,41,1
31774,심상정(沈相奵),임이자(林利子),4,3,7,1
31775,심상정(沈相奵),임종성(林鍾聲),26,53,79,1
31776,심상정(沈相奵),임호선(林昊宣),17,47,64,1
31777,심상정(沈相奵),장경태(張耿態),24,70,94,1
31778,심상정(沈相奵),장동혁(張東赫),0,0,0,1
31779,심상정(沈相奵),장제원(張濟元),4,2,6,1
31780,심상정(沈相奵),장철민(張喆敏),14,34,48,1
31781,심상정(沈相奵),장혜영(張惠英),84,341,425,0
31782,심상정(沈相奵),전봉민(田奉珉),1,1,2,1
31783,심상정(沈相奵),전용기(田溶冀),14,36,50,1
31784,심상정(沈相奵),전재수(田載秀),12,16,28,1
31785,심상정(沈相奵),전주혜(全珠惠),6,3,9,1
31786,심상정(沈相奵),전해철(全海澈),10,17,27,1
31787,심상정(沈相奵),전혜숙(全惠淑),15,33,48,1
31788,심상정(沈相奵),정경희(丁慶姬),5,2,7,1
31789,심상정(沈相奵),정동만(鄭東萬),5,3,8,1
31790,심상정(沈相奵),정성호(鄭成湖),21,49,70,1
31791,심상정(沈相奵),정우택(鄭宇澤),1,0,1,1
31792,심상정(沈相奵),정운천(鄭雲天),4,2,6,1
31793,심상정(沈相奵),정일영(鄭日永),11,27,38,1
31794,심상정(沈相奵),정점식(鄭点植),5,2,7,1
31795,심상정(沈相奵),정진석(鄭鎭碩),6,3,9,1
31796,심상정(沈相奵),정청래(鄭淸來),13,22,35,1
31797,심상정(沈相奵),정춘숙(鄭春淑),16,46,62,1
31798,심상정(沈相奵),정태호(鄭泰浩),15,34,49,1
31799,심상정(沈相奵),정필모(鄭必模),17,21,38,1
31800,심상정(沈相奵),정희용(鄭熙溶),6,4,10,1
31801,심상정(沈相奵),조경태(趙慶泰),4,2,6,1
31802,심상정(沈相奵),조명희(曺明姬),4,4,8,1
31803,심상정(沈相奵),조수진(趙修眞),5,3,8,1
31804,심상정(沈相奵),조승래(趙承來),13,11,24,1
31805,심상정(沈相奵),조오섭(曺五燮),33,88,121,1
31806,심상정(沈相奵),조은희(趙恩禧),3,1,4,1
31807,심상정(沈相奵),조응천(趙應天),10,8,18,1
31808,심상정(沈相奵),조정식(趙正湜),9,6,15,1
31809,심상정(沈相奵),조정훈(趙廷訓),7,52,59,1
31810,심상정(沈相奵),조해진(曺海珍),6,5,11,1
31811,심상정(沈相奵),주철현(朱哲鉉),14,25,39,1
31812,심상정(沈相奵),주호영(朱豪英),5,3,8,1
31813,심상정(沈相奵),지성호(池成浩),5,3,8,1
31814,심상정(沈相奵),진선미(陳善美),16,25,41,1
31815,심상정(沈相奵),진성준(陳聲準),17,35,52,1
31816,심상정(沈相奵),천준호(千俊鎬),15,31,46,1
31817,심상정(沈相奵),최기상(崔基相),12,13,25,1
31818,심상정(沈相奵),최승재(崔承宰),6,11,17,1
31819,심상정(沈相奵),최연숙(崔姸淑),8,22,30,1
31820,심상정(沈相奵),최영희(崔英姬),0,1,1,1
31821,심상정(沈相奵),최인호(崔仁昊),11,15,26,1
31822,심상정(沈相奵),최재형(崔在亨),0,0,0,1
31823,심상정(沈相奵),최종윤(崔鍾允),16,28,44,1
31824,심상정(沈相奵),최춘식(崔春植),7,13,20,1
31825,심상정(沈相奵),최형두(崔炯斗),8,7,15,1
31826,심상정(沈相奵),최혜영(崔惠英),30,66,96,1
31827,심상정(沈相奵),추경호(秋慶鎬),5,3,8,1
31828,심상정(沈相奵),태영호(太永浩),4,5,9,1
31829,심상정(沈相奵),하영제(河榮帝),5,3,8,1
31830,심상정(沈相奵),하태경(河泰慶),5,5,10,1
31831,심상정(沈相奵),한기호(韓起鎬),5,2,7,1
31832,심상정(沈相奵),한무경(韓茂景),5,5,10,1
31833,심상정(沈相奵),한병도(韓秉道),15,48,63,1
31834,심상정(沈相奵),한정애(韓貞愛),10,15,25,1
31835,심상정(沈相奵),한준호(韓俊鎬),20,29,49,1
31836,심상정(沈相奵),허숙정(許淑湞),1,1,2,1
31837,심상정(沈相奵),허영(許榮),26,27,53,1
31838,심상정(沈相奵),허은아(許垠娥),4,3,7,1
31839,심상정(沈相奵),허종식(許琮植),29,56,85,1
31840,심상정(沈相奵),홍기원(洪起元),19,31,50,1
31841,심상정(沈相奵),홍문표(洪文杓),5,3,8,1
31842,심상정(沈相奵),홍석준(洪碩晙),5,4,9,1
31843,심상정(沈相奵),홍성국(洪性國),16,40,56,1
31844,심상정(沈相奵),홍영표(洪永杓),15,21,36,1
31845,심상정(沈相奵),홍익표(洪翼杓),14,27,41,1
31846,심상정(沈相奵),홍정민(洪貞敏),20,32,52,1
31847,심상정(沈相奵),황보승희(皇甫承希),7,7,14,1
31848,심상정(沈相奵),황운하(黃雲夏),20,39,59,1
31849,심상정(沈相奵),황희(黃熙),10,14,24,1
31850,안규백(安圭伯),안민석(安敏錫),96,85,181,0
31851,안규백(安圭伯),안병길(安炳吉),51,4,55,1
31852,안규백(安圭伯),안철수(安哲秀),28,6,34,1
31853,안규백(安圭伯),안호영(安浩永),82,76,158,0
31854,안규백(安圭伯),양경숙(梁敬淑),102,131,233,0
31855,안규백(安圭伯),양금희(梁琴喜),54,9,63,1
31856,안규백(安圭伯),양기대(梁基大),99,92,191,0
31857,안규백(安圭伯),양이원영(梁李媛瑛),114,101,215,0
31858,안규백(安圭伯),양정숙(梁貞淑),97,152,249,1
31859,안규백(安圭伯),양향자(梁香子),42,47,89,1
31860,안규백(安圭伯),어기구(魚基龜),83,53,136,0
31861,안규백(安圭伯),엄태영(嚴泰永),52,8,60,1
31862,안규백(安圭伯),오기형(吳奇炯),77,41,118,0
31863,안규백(安圭伯),오영환(吳永煥),123,150,273,0
31864,안규백(安圭伯),용혜인(龍慧仁),24,27,51,1
31865,안규백(安圭伯),우상호(禹相虎),80,39,119,0
31866,안규백(安圭伯),우원식(禹元植),84,80,164,0
31867,안규백(安圭伯),위성곤(魏聖坤),94,80,174,0
31868,안규백(安圭伯),유경준(兪京濬),50,10,60,1
31869,안규백(安圭伯),유기홍(柳基洪),78,46,124,0
31870,안규백(安圭伯),유동수(柳東秀),96,66,162,0
31871,안규백(安圭伯),유상범(劉相凡),52,10,62,1
31872,안규백(安圭伯),유의동(兪義東),53,15,68,1
31873,안규백(安圭伯),유정주(兪訂炷),98,96,194,0
31874,안규백(安圭伯),윤건영(尹建永),91,64,155,0
31875,안규백(安圭伯),윤관석(尹官石),95,85,180,1
31876,안규백(安圭伯),윤두현(尹斗鉉),52,6,58,1
31877,안규백(安圭伯),윤미향(尹美香),61,75,136,1
31878,안규백(安圭伯),윤상현(尹相現),34,5,39,1
31879,안규백(安圭伯),윤영덕(尹永德),93,75,168,0
31880,안규백(安圭伯),윤영석(尹永碩),50,7,57,1
31881,안규백(安圭伯),윤영찬(尹永燦),85,58,143,0
31882,안규백(安圭伯),윤재갑(尹才鉀),113,105,218,0
31883,안규백(安圭伯),윤재옥(尹在玉),52,6,58,1
31884,안규백(安圭伯),윤주경(尹柱卿),55,13,68,1
31885,안규백(安圭伯),윤준병(尹準炳),122,155,277,0
31886,안규백(安圭伯),윤창현(尹暢賢),53,5,58,1
31887,안규백(安圭伯),윤한홍(尹漢洪),53,5,58,1
31888,안규백(安圭伯),윤호중(尹昊重),78,55,133,0
31889,안규백(安圭伯),윤후덕(尹厚德),102,112,214,0
31890,안규백(安圭伯),이개호(李介昊),90,76,166,0
31891,안규백(安圭伯),이달곤(李達坤),52,6,58,1
31892,안규백(安圭伯),이동주(李東洲),91,89,180,0
31893,안규백(安圭伯),이만희(李晩熙),52,4,56,1
31894,안규백(安圭伯),이명수(李明洙),69,24,93,1
31895,안규백(安圭伯),이병훈(李炳勳),111,120,231,0
31896,안규백(安圭伯),이상민(李相珉),84,39,123,0
31897,안규백(安圭伯),이상헌(李相憲),111,123,234,0
31898,안규백(安圭伯),이성만(李成萬),103,106,209,1
31899,안규백(安圭伯),이소영(李素永),82,62,144,0
31900,안규백(安圭伯),이수진(李壽珍),111,108,219,0
31901,안규백(安圭伯),이수진(李秀眞),98,89,187,0
31902,안규백(安圭伯),이양수(李亮壽),57,11,68,1
31903,안규백(安圭伯),이용(李鏞),52,4,56,1
31904,안규백(安圭伯),이용빈(李龍彬),114,143,257,0
31905,안규백(安圭伯),이용선(李庸瑄),99,83,182,0
31906,안규백(安圭伯),이용우(李龍雨),93,58,151,0
31907,안규백(安圭伯),이용호(李容鎬),38,22,60,1
31908,안규백(安圭伯),이원욱(李元旭),92,71,163,0
31909,안규백(安圭伯),이원택(李源澤),96,85,181,0
31910,안규백(安圭伯),이은주(李恩周),23,22,45,1
31911,안규백(安圭伯),이인선(李仁善),26,5,31,1
31912,안규백(安圭伯),이인영(李仁榮),83,54,137,0
31913,안규백(安圭伯),이장섭(李將燮),90,64,154,0
31914,안규백(安圭伯),이재명(李在明),40,19,59,0
31915,안규백(安圭伯),이재정(李在汀),91,59,150,0
31916,안규백(安圭伯),이정문(李楨文),101,114,215,0
31917,안규백(安圭伯),이종배(李鍾培),53,7,60,1
31918,안규백(安圭伯),이종성(李鍾成),52,8,60,1
31919,안규백(安圭伯),이주환(李周桓),52,8,60,1
31920,안규백(安圭伯),이채익(李埰益),55,11,66,1
31921,안규백(安圭伯),이철규(李喆圭),55,11,66,1
31922,안규백(安圭伯),이탄희(李誕熙),103,62,165,0
31923,안규백(安圭伯),이태규(李泰珪),28,10,38,1
31924,안규백(安圭伯),이학영(李學永),90,70,160,0
31925,안규백(安圭伯),이해식(李海植),107,90,197,0
31926,안규백(安圭伯),이헌승(李憲昇),53,10,63,1
31927,안규백(安圭伯),이형석(李炯錫),122,99,221,0
31928,안규백(安圭伯),인재근(印在謹),99,99,198,0
31929,안규백(安圭伯),임병헌(林炳憲),30,8,38,1
31930,안규백(安圭伯),임오경(林五卿),85,60,145,0
31931,안규백(安圭伯),임이자(林利子),53,12,65,1
31932,안규백(安圭伯),임종성(林鍾聲),115,116,231,0
31933,안규백(安圭伯),임호선(林昊宣),110,111,221,0
31934,안규백(安圭伯),장경태(張耿態),101,90,191,0
31935,안규백(安圭伯),장동혁(張東赫),26,6,32,1
31936,안규백(安圭伯),장제원(張濟元),50,5,55,1
31937,안규백(安圭伯),장철민(張喆敏),95,59,154,0
31938,안규백(安圭伯),장혜영(張惠英),14,9,23,1
31939,안규백(安圭伯),전봉민(田奉珉),37,6,43,1
31940,안규백(安圭伯),전용기(田溶冀),109,94,203,0
31941,안규백(安圭伯),전재수(田載秀),87,70,157,0
31942,안규백(安圭伯),전주혜(全珠惠),55,5,60,1
31943,안규백(安圭伯),전해철(全海澈),79,75,154,0
31944,안규백(安圭伯),전혜숙(全惠淑),120,130,250,0
31945,안규백(安圭伯),정경희(丁慶姬),51,6,57,1
31946,안규백(安圭伯),정동만(鄭東萬),50,5,55,1
31947,안규백(安圭伯),정성호(鄭成湖),103,103,206,0
31948,안규백(安圭伯),정우택(鄭宇澤),26,5,31,1
31949,안규백(安圭伯),정운천(鄭雲天),52,8,60,1
31950,안규백(安圭伯),정일영(鄭日永),111,133,244,0
31951,안규백(安圭伯),정점식(鄭点植),51,5,56,1
31952,안규백(安圭伯),정진석(鄭鎭碩),50,6,56,1
31953,안규백(安圭伯),정청래(鄭淸來),99,71,170,0
31954,안규백(安圭伯),정춘숙(鄭春淑),93,61,154,0
31955,안규백(安圭伯),정태호(鄭泰浩),82,76,158,0
31956,안규백(安圭伯),정필모(鄭必模),94,74,168,0
31957,안규백(安圭伯),정희용(鄭熙溶),52,7,59,1
31958,안규백(安圭伯),조경태(趙慶泰),52,6,58,1
31959,안규백(安圭伯),조명희(曺明姬),55,13,68,1
31960,안규백(安圭伯),조수진(趙修眞),54,9,63,1
31961,안규백(安圭伯),조승래(趙承來),97,87,184,0
31962,안규백(安圭伯),조오섭(曺五燮),110,133,243,0
31963,안규백(安圭伯),조은희(趙恩禧),28,4,32,1
31964,안규백(安圭伯),조응천(趙應天),84,42,126,0
31965,안규백(安圭伯),조정식(趙正湜),88,61,149,0
31966,안규백(安圭伯),조정훈(趙廷訓),2,13,15,1
31967,안규백(安圭伯),조해진(曺海珍),53,8,61,1
31968,안규백(安圭伯),주철현(朱哲鉉),104,88,192,0
31969,안규백(安圭伯),주호영(朱豪英),51,5,56,1
31970,안규백(安圭伯),지성호(池成浩),53,6,59,1
31971,안규백(安圭伯),진선미(陳善美),92,54,146,0
31972,안규백(安圭伯),진성준(陳聲準),100,75,175,0
31973,안규백(安圭伯),천준호(千俊鎬),94,58,152,0
31974,안규백(安圭伯),최기상(崔基相),94,69,163,0
31975,안규백(安圭伯),최승재(崔承宰),52,7,59,1
31976,안규백(安圭伯),최연숙(崔姸淑),31,14,45,1
31977,안규백(安圭伯),최영희(崔英姬),27,5,32,1
31978,안규백(安圭伯),최인호(崔仁昊),102,86,188,0
31979,안규백(安圭伯),최재형(崔在亨),27,5,32,1
31980,안규백(安圭伯),최종윤(崔鍾允),120,145,265,0
31981,안규백(安圭伯),최춘식(崔春植),52,12,64,1
31982,안규백(安圭伯),최형두(崔炯斗),53,11,64,1
31983,안규백(安圭伯),최혜영(崔惠英),100,74,174,0
31984,안규백(安圭伯),추경호(秋慶鎬),50,9,59,1
31985,안규백(安圭伯),태영호(太永浩),53,6,59,1
31986,안규백(安圭伯),하영제(河榮帝),43,4,47,1
31987,안규백(安圭伯),하태경(河泰慶),51,8,59,1
31988,안규백(安圭伯),한기호(韓起鎬),64,21,85,1
31989,안규백(安圭伯),한무경(韓茂景),51,6,57,1
31990,안규백(安圭伯),한병도(韓秉道),126,99,225,0
31991,안규백(安圭伯),한정애(韓貞愛),87,70,157,0
31992,안규백(安圭伯),한준호(韓俊鎬),98,118,216,0
31993,안규백(安圭伯),허숙정(許淑湞),1,1,2,0
31994,안규백(安圭伯),허영(許榮),119,109,228,0
31995,안규백(安圭伯),허은아(許垠娥),51,6,57,1
31996,안규백(安圭伯),허종식(許琮植),88,98,186,0
31997,안규백(安圭伯),홍기원(洪起元),91,66,157,0
31998,안규백(安圭伯),홍문표(洪文杓),50,6,56,1
31999,안규백(安圭伯),홍석준(洪碩晙),51,6,57,1
32000,안규백(安圭伯),홍성국(洪性國),113,124,237,0
32001,안규백(安圭伯),홍영표(洪永杓),102,75,177,0
32002,안규백(安圭伯),홍익표(洪翼杓),99,86,185,0
32003,안규백(安圭伯),홍정민(洪貞敏),100,93,193,0
32004,안규백(安圭伯),황보승희(皇甫承希),48,6,54,1
32005,안규백(安圭伯),황운하(黃雲夏),114,144,258,0
32006,안규백(安圭伯),황희(黃熙),83,55,138,0
32007,안민석(安敏錫),안병길(安炳吉),52,4,56,1
32008,안민석(安敏錫),안철수(安哲秀),26,4,30,1
32009,안민석(安敏錫),안호영(安浩永),81,61,142,0
32010,안민석(安敏錫),양경숙(梁敬淑),93,129,222,0
32011,안민석(安敏錫),양금희(梁琴喜),50,3,53,1
32012,안민석(安敏錫),양기대(梁基大),86,55,141,0
32013,안민석(安敏錫),양이원영(梁李媛瑛),90,73,163,0
32014,안민석(安敏錫),양정숙(梁貞淑),44,104,148,1
32015,안민석(安敏錫),양향자(梁香子),41,42,83,1
32016,안민석(安敏錫),어기구(魚基龜),78,48,126,0
32017,안민석(安敏錫),엄태영(嚴泰永),52,3,55,1
32018,안민석(安敏錫),오기형(吳奇炯),77,40,117,0
32019,안민석(安敏錫),오영환(吳永煥),107,127,234,0
32020,안민석(安敏錫),용혜인(龍慧仁),15,35,50,1
32021,안민석(安敏錫),우상호(禹相虎),79,45,124,0
32022,안민석(安敏錫),우원식(禹元植),81,66,147,0
32023,안민석(安敏錫),위성곤(魏聖坤),86,68,154,0
32024,안민석(安敏錫),유경준(兪京濬),50,3,53,1
32025,안민석(安敏錫),유기홍(柳基洪),102,93,195,0
32026,안민석(安敏錫),유동수(柳東秀),92,57,149,0
32027,안민석(安敏錫),유상범(劉相凡),50,3,53,1
32028,안민석(安敏錫),유의동(兪義東),50,4,54,1
32029,안민석(安敏錫),유정주(兪訂炷),120,129,249,0
32030,안민석(安敏錫),윤건영(尹建永),84,51,135,0
32031,안민석(安敏錫),윤관석(尹官石),82,57,139,1
32032,안민석(安敏錫),윤두현(尹斗鉉),50,4,54,1
32033,안민석(安敏錫),윤미향(尹美香),38,48,86,1
32034,안민석(安敏錫),윤상현(尹相現),31,4,35,1
32035,안민석(安敏錫),윤영덕(尹永德),100,123,223,0
32036,안민석(安敏錫),윤영석(尹永碩),50,3,53,1
32037,안민석(安敏錫),윤영찬(尹永燦),80,48,128,0
32038,안민석(安敏錫),윤재갑(尹才鉀),101,89,190,0
32039,안민석(安敏錫),윤재옥(尹在玉),51,3,54,1
32040,안민석(安敏錫),윤주경(尹柱卿),49,4,53,1
32041,안민석(安敏錫),윤준병(尹準炳),89,114,203,0
32042,안민석(安敏錫),윤창현(尹暢賢),49,3,52,1
32043,안민석(安敏錫),윤한홍(尹漢洪),50,3,53,1
32044,안민석(安敏錫),윤호중(尹昊重),83,57,140,0
32045,안민석(安敏錫),윤후덕(尹厚德),94,75,169,0
32046,안민석(安敏錫),이개호(李介昊),98,59,157,0
32047,안민석(安敏錫),이달곤(李達坤),52,6,58,1
32048,안민석(安敏錫),이동주(李東洲),108,154,262,0
32049,안민석(安敏錫),이만희(李晩熙),50,3,53,1
32050,안민석(安敏錫),이명수(李明洙),51,10,61,1
32051,안민석(安敏錫),이병훈(李炳勳),123,101,224,0
32052,안민석(安敏錫),이상민(李相珉),85,46,131,0
32053,안민석(安敏錫),이상헌(李相憲),126,109,235,0
32054,안민석(安敏錫),이성만(李成萬),88,100,188,1
32055,안민석(安敏錫),이소영(李素永),84,61,145,0
32056,안민석(安敏錫),이수진(李壽珍),95,95,190,0
32057,안민석(安敏錫),이수진(李秀眞),100,75,175,0
32058,안민석(安敏錫),이양수(李亮壽),52,3,55,1
32059,안민석(安敏錫),이용(李鏞),50,3,53,1
32060,안민석(安敏錫),이용빈(李龍彬),120,173,293,0
32061,안민석(安敏錫),이용선(李庸瑄),103,76,179,0
32062,안민석(安敏錫),이용우(李龍雨),86,52,138,0
32063,안민석(安敏錫),이용호(李容鎬),33,16,49,1
32064,안민석(安敏錫),이원욱(李元旭),98,84,182,0
32065,안민석(安敏錫),이원택(李源澤),88,62,150,0
32066,안민석(安敏錫),이은주(李恩周),13,16,29,1
32067,안민석(安敏錫),이인선(李仁善),25,3,28,1
32068,안민석(安敏錫),이인영(李仁榮),79,43,122,0
32069,안민석(安敏錫),이장섭(李將燮),98,75,173,0
32070,안민석(安敏錫),이재명(李在明),40,20,60,0
32071,안민석(安敏錫),이재정(李在汀),93,69,162,0
32072,안민석(安敏錫),이정문(李楨文),150,210,360,0
32073,안민석(安敏錫),이종배(李鍾培),50,5,55,1
32074,안민석(安敏錫),이종성(李鍾成),51,4,55,1
32075,안민석(安敏錫),이주환(李周桓),50,4,54,1
32076,안민석(安敏錫),이채익(李埰益),51,4,55,1
32077,안민석(安敏錫),이철규(李喆圭),52,3,55,1
32078,안민석(安敏錫),이탄희(李誕熙),86,86,172,0
32079,안민석(安敏錫),이태규(李泰珪),29,5,34,1
32080,안민석(安敏錫),이학영(李學永),105,78,183,0
32081,안민석(安敏錫),이해식(李海植),94,57,151,0
32082,안민석(安敏錫),이헌승(李憲昇),51,5,56,1
32083,안민석(安敏錫),이형석(李炯錫),95,72,167,0
32084,안민석(安敏錫),인재근(印在謹),118,122,240,0
32085,안민석(安敏錫),임병헌(林炳憲),25,4,29,1
32086,안민석(安敏錫),임오경(林五卿),100,83,183,0
32087,안민석(安敏錫),임이자(林利子),49,3,52,1
32088,안민석(安敏錫),임종성(林鍾聲),97,81,178,0
32089,안민석(安敏錫),임호선(林昊宣),120,166,286,0
32090,안민석(安敏錫),장경태(張耿態),93,78,171,0
32091,안민석(安敏錫),장동혁(張東赫),25,3,28,1
32092,안민석(安敏錫),장제원(張濟元),50,3,53,1
32093,안민석(安敏錫),장철민(張喆敏),85,66,151,0
32094,안민석(安敏錫),장혜영(張惠英),12,15,27,1
32095,안민석(安敏錫),전봉민(田奉珉),36,5,41,1
32096,안민석(安敏錫),전용기(田溶冀),110,92,202,0
32097,안민석(安敏錫),전재수(田載秀),90,57,147,0
32098,안민석(安敏錫),전주혜(全珠惠),52,4,56,1
32099,안민석(安敏錫),전해철(全海澈),80,56,136,0
32100,안민석(安敏錫),전혜숙(全惠淑),95,93,188,0
32101,안민석(安敏錫),정경희(丁慶姬),50,4,54,1
32102,안민석(安敏錫),정동만(鄭東萬),50,3,53,1
32103,안민석(安敏錫),정성호(鄭成湖),82,60,142,0
32104,안민석(安敏錫),정우택(鄭宇澤),25,4,29,1
32105,안민석(安敏錫),정운천(鄭雲天),50,3,53,1
32106,안민석(安敏錫),정일영(鄭日永),81,66,147,0
32107,안민석(安敏錫),정점식(鄭点植),51,3,54,1
32108,안민석(安敏錫),정진석(鄭鎭碩),51,3,54,1
32109,안민석(安敏錫),정청래(鄭淸來),83,49,132,0
32110,안민석(安敏錫),정춘숙(鄭春淑),99,79,178,0
32111,안민석(安敏錫),정태호(鄭泰浩),81,74,155,0
32112,안민석(安敏錫),정필모(鄭必模),93,67,160,0
32113,안민석(安敏錫),정희용(鄭熙溶),50,4,54,1
32114,안민석(安敏錫),조경태(趙慶泰),50,5,55,1
32115,안민석(安敏錫),조명희(曺明姬),50,4,54,1
32116,안민석(安敏錫),조수진(趙修眞),49,3,52,1
32117,안민석(安敏錫),조승래(趙承來),116,109,225,0
32118,안민석(安敏錫),조오섭(曺五燮),125,169,294,0
32119,안민석(安敏錫),조은희(趙恩禧),25,3,28,1
32120,안민석(安敏錫),조응천(趙應天),78,36,114,0
32121,안민석(安敏錫),조정식(趙正湜),82,64,146,0
32122,안민석(安敏錫),조정훈(趙廷訓),4,10,14,1
32123,안민석(安敏錫),조해진(曺海珍),52,5,57,1
32124,안민석(安敏錫),주철현(朱哲鉉),84,69,153,0
32125,안민석(安敏錫),주호영(朱豪英),49,3,52,1
32126,안민석(安敏錫),지성호(池成浩),49,3,52,1
32127,안민석(安敏錫),진선미(陳善美),78,45,123,0
32128,안민석(安敏錫),진성준(陳聲準),92,61,153,0
32129,안민석(安敏錫),천준호(千俊鎬),86,59,145,0
32130,안민석(安敏錫),최기상(崔基相),83,54,137,0
32131,안민석(安敏錫),최승재(崔承宰),50,5,55,1
32132,안민석(安敏錫),최연숙(崔姸淑),32,12,44,1
32133,안민석(安敏錫),최영희(崔英姬),25,5,30,1
32134,안민석(安敏錫),최인호(崔仁昊),88,70,158,0
32135,안민석(安敏錫),최재형(崔在亨),25,4,29,1
32136,안민석(安敏錫),최종윤(崔鍾允),89,109,198,0
32137,안민석(安敏錫),최춘식(崔春植),50,5,55,1
32138,안민석(安敏錫),최형두(崔炯斗),51,3,54,1
32139,안민석(安敏錫),최혜영(崔惠英),86,88,174,0
32140,안민석(安敏錫),추경호(秋慶鎬),49,3,52,1
32141,안민석(安敏錫),태영호(太永浩),49,4,53,1
32142,안민석(安敏錫),하영제(河榮帝),43,0,43,1
32143,안민석(安敏錫),하태경(河泰慶),51,4,55,1
32144,안민석(安敏錫),한기호(韓起鎬),50,3,53,1
32145,안민석(安敏錫),한무경(韓茂景),50,4,54,1
32146,안민석(安敏錫),한병도(韓秉道),100,87,187,0
32147,안민석(安敏錫),한정애(韓貞愛),80,49,129,0
32148,안민석(安敏錫),한준호(韓俊鎬),103,111,214,0
32149,안민석(安敏錫),허숙정(許淑湞),1,1,2,0
32150,안민석(安敏錫),허영(許榮),102,62,164,0
32151,안민석(安敏錫),허은아(許垠娥),50,3,53,1
32152,안민석(安敏錫),허종식(許琮植),86,69,155,0
32153,안민석(安敏錫),홍기원(洪起元),91,64,155,0
32154,안민석(安敏錫),홍문표(洪文杓),50,5,55,1
32155,안민석(安敏錫),홍석준(洪碩晙),50,3,53,1
32156,안민석(安敏錫),홍성국(洪性國),99,94,193,0
32157,안민석(安敏錫),홍영표(洪永杓),82,58,140,0
32158,안민석(安敏錫),홍익표(洪翼杓),88,62,150,0
32159,안민석(安敏錫),홍정민(洪貞敏),115,87,202,0
32160,안민석(安敏錫),황보승희(皇甫承希),47,1,48,1
32161,안민석(安敏錫),황운하(黃雲夏),105,118,223,0
32162,안민석(安敏錫),황희(黃熙),83,46,129,0
32163,안병길(安炳吉),안철수(安哲秀),26,19,45,0
32164,안병길(安炳吉),안호영(安浩永),51,4,55,1
32165,안병길(安炳吉),양경숙(梁敬淑),51,4,55,1
32166,안병길(安炳吉),양금희(梁琴喜),93,134,227,0
32167,안병길(安炳吉),양기대(梁基大),50,4,54,1
32168,안병길(安炳吉),양이원영(梁李媛瑛),45,4,49,1
32169,안병길(安炳吉),양정숙(梁貞淑),5,2,7,1
32170,안병길(安炳吉),양향자(梁香子),22,11,33,1
32171,안병길(安炳吉),어기구(魚基龜),50,6,56,1
32172,안병길(安炳吉),엄태영(嚴泰永),70,89,159,0
32173,안병길(安炳吉),오기형(吳奇炯),49,4,53,1
32174,안병길(安炳吉),오영환(吳永煥),52,7,59,1
32175,안병길(安炳吉),용혜인(龍慧仁),1,2,3,1
32176,안병길(安炳吉),우상호(禹相虎),50,4,54,1
32177,안병길(安炳吉),우원식(禹元植),49,4,53,1
32178,안병길(安炳吉),위성곤(魏聖坤),53,10,63,1
32179,안병길(安炳吉),유경준(兪京濬),77,87,164,0
32180,안병길(安炳吉),유기홍(柳基洪),50,4,54,1
32181,안병길(安炳吉),유동수(柳東秀),51,4,55,1
32182,안병길(安炳吉),유상범(劉相凡),68,79,147,0
32183,안병길(安炳吉),유의동(兪義東),92,112,204,0
32184,안병길(安炳吉),유정주(兪訂炷),52,5,57,1
32185,안병길(安炳吉),윤건영(尹建永),49,5,54,1
32186,안병길(安炳吉),윤관석(尹官石),41,0,41,1
32187,안병길(安炳吉),윤두현(尹斗鉉),79,136,215,0
32188,안병길(安炳吉),윤미향(尹美香),20,1,21,1
32189,안병길(安炳吉),윤상현(尹相現),44,59,103,0
32190,안병길(安炳吉),윤영덕(尹永德),49,6,55,1
32191,안병길(安炳吉),윤영석(尹永碩),75,85,160,0
32192,안병길(安炳吉),윤영찬(尹永燦),50,4,54,1
32193,안병길(安炳吉),윤재갑(尹才鉀),57,13,70,1
32194,안병길(安炳吉),윤재옥(尹在玉),85,66,151,0
32195,안병길(安炳吉),윤주경(尹柱卿),75,68,143,0
32196,안병길(安炳吉),윤준병(尹準炳),51,6,57,1
32197,안병길(安炳吉),윤창현(尹暢賢),87,151,238,0
32198,안병길(安炳吉),윤한홍(尹漢洪),72,62,134,0
32199,안병길(安炳吉),윤호중(尹昊重),50,4,54,1
32200,안병길(安炳吉),윤후덕(尹厚德),51,4,55,1
32201,안병길(安炳吉),이개호(李介昊),55,7,62,1
32202,안병길(安炳吉),이달곤(李達坤),67,71,138,0
32203,안병길(安炳吉),이동주(李東洲),50,4,54,1
32204,안병길(安炳吉),이만희(李晩熙),86,68,154,0
32205,안병길(安炳吉),이명수(李明洙),89,121,210,0
32206,안병길(安炳吉),이병훈(李炳勳),52,7,59,1
32207,안병길(安炳吉),이상민(李相珉),50,4,54,1
32208,안병길(安炳吉),이상헌(李相憲),52,6,58,1
32209,안병길(安炳吉),이성만(李成萬),41,0,41,1
32210,안병길(安炳吉),이소영(李素永),51,4,55,1
32211,안병길(安炳吉),이수진(李壽珍),50,4,54,1
32212,안병길(安炳吉),이수진(李秀眞),50,5,55,1
32213,안병길(安炳吉),이양수(李亮壽),95,92,187,0
32214,안병길(安炳吉),이용(李鏞),79,139,218,0
32215,안병길(安炳吉),이용빈(李龍彬),51,4,55,1
32216,안병길(安炳吉),이용선(李庸瑄),51,4,55,1
32217,안병길(安炳吉),이용우(李龍雨),49,5,54,1
32218,안병길(安炳吉),이용호(李容鎬),28,28,56,0
32219,안병길(安炳吉),이원욱(李元旭),53,5,58,1
32220,안병길(安炳吉),이원택(李源澤),52,4,56,1
32221,안병길(安炳吉),이은주(李恩周),5,3,8,1
32222,안병길(安炳吉),이인선(李仁善),32,48,80,0
32223,안병길(安炳吉),이인영(李仁榮),50,4,54,1
32224,안병길(安炳吉),이장섭(李將燮),51,4,55,1
32225,안병길(安炳吉),이재명(李在明),25,4,29,1
32226,안병길(安炳吉),이재정(李在汀),50,4,54,1
32227,안병길(安炳吉),이정문(李楨文),50,4,54,1
32228,안병길(安炳吉),이종배(李鍾培),92,118,210,0
32229,안병길(安炳吉),이종성(李鍾成),102,207,309,0
32230,안병길(安炳吉),이주환(李周桓),110,259,369,0
32231,안병길(安炳吉),이채익(李埰益),73,78,151,0
32232,안병길(安炳吉),이철규(李喆圭),81,91,172,0
32233,안병길(安炳吉),이탄희(李誕熙),50,4,54,1
32234,안병길(安炳吉),이태규(李泰珪),39,50,89,0
32235,안병길(安炳吉),이학영(李學永),49,4,53,1
32236,안병길(安炳吉),이해식(李海植),50,4,54,1
32237,안병길(安炳吉),이헌승(李憲昇),91,208,299,0
32238,안병길(安炳吉),이형석(李炯錫),52,5,57,1
32239,안병길(安炳吉),인재근(印在謹),49,5,54,1
32240,안병길(安炳吉),임병헌(林炳憲),35,44,79,0
32241,안병길(安炳吉),임오경(林五卿),50,4,54,1
32242,안병길(安炳吉),임이자(林利子),82,92,174,0
32243,안병길(安炳吉),임종성(林鍾聲),53,7,60,1
32244,안병길(安炳吉),임호선(林昊宣),52,6,58,1
32245,안병길(安炳吉),장경태(張耿態),50,4,54,1
32246,안병길(安炳吉),장동혁(張東赫),29,58,87,0
32247,안병길(安炳吉),장제원(張濟元),67,62,129,0
32248,안병길(安炳吉),장철민(張喆敏),53,5,58,1
32249,안병길(安炳吉),장혜영(張惠英),6,4,10,1
32250,안병길(安炳吉),전봉민(田奉珉),85,230,315,0
32251,안병길(安炳吉),전용기(田溶冀),50,5,55,1
32252,안병길(安炳吉),전재수(田載秀),51,7,58,1
32253,안병길(安炳吉),전주혜(全珠惠),76,80,156,0
32254,안병길(安炳吉),전해철(全海澈),50,4,54,1
32255,안병길(安炳吉),전혜숙(全惠淑),53,5,58,1
32256,안병길(安炳吉),정경희(丁慶姬),77,82,159,0
32257,안병길(安炳吉),정동만(鄭東萬),91,170,261,0
32258,안병길(安炳吉),정성호(鄭成湖),50,5,55,1
32259,안병길(安炳吉),정우택(鄭宇澤),31,47,78,0
32260,안병길(安炳吉),정운천(鄭雲天),92,148,240,0
32261,안병길(安炳吉),정일영(鄭日永),49,4,53,1
32262,안병길(安炳吉),정점식(鄭点植),77,73,150,0
32263,안병길(安炳吉),정진석(鄭鎭碩),89,79,168,0
32264,안병길(安炳吉),정청래(鄭淸來),49,4,53,1
32265,안병길(安炳吉),정춘숙(鄭春淑),50,4,54,1
32266,안병길(安炳吉),정태호(鄭泰浩),50,4,54,1
32267,안병길(安炳吉),정필모(鄭必模),50,4,54,1
32268,안병길(安炳吉),정희용(鄭熙溶),94,114,208,0
32269,안병길(安炳吉),조경태(趙慶泰),83,121,204,0
32270,안병길(安炳吉),조명희(曺明姬),87,127,214,0
32271,안병길(安炳吉),조수진(趙修眞),87,112,199,0
32272,안병길(安炳吉),조승래(趙承來),53,6,59,1
32273,안병길(安炳吉),조오섭(曺五燮),50,4,54,1
32274,안병길(安炳吉),조은희(趙恩禧),39,62,101,0
32275,안병길(安炳吉),조응천(趙應天),50,3,53,1
32276,안병길(安炳吉),조정식(趙正湜),49,3,52,1
32277,안병길(安炳吉),조정훈(趙廷訓),1,1,2,1
32278,안병길(安炳吉),조해진(曺海珍),65,46,111,0
32279,안병길(安炳吉),주철현(朱哲鉉),56,6,62,1
32280,안병길(安炳吉),주호영(朱豪英),70,100,170,0
32281,안병길(安炳吉),지성호(池成浩),77,119,196,0
32282,안병길(安炳吉),진선미(陳善美),51,4,55,1
32283,안병길(安炳吉),진성준(陳聲準),50,5,55,1
32284,안병길(安炳吉),천준호(千俊鎬),49,3,52,1
32285,안병길(安炳吉),최기상(崔基相),49,4,53,1
32286,안병길(安炳吉),최승재(崔承宰),72,74,146,0
32287,안병길(安炳吉),최연숙(崔姸淑),31,37,68,0
32288,안병길(安炳吉),최영희(崔英姬),33,67,100,0
32289,안병길(安炳吉),최인호(崔仁昊),53,8,61,1
32290,안병길(安炳吉),최재형(崔在亨),26,15,41,0
32291,안병길(安炳吉),최종윤(崔鍾允),50,4,54,1
32292,안병길(安炳吉),최춘식(崔春植),87,148,235,0
32293,안병길(安炳吉),최형두(崔炯斗),81,71,152,0
32294,안병길(安炳吉),최혜영(崔惠英),49,6,55,1
32295,안병길(安炳吉),추경호(秋慶鎬),91,102,193,0
32296,안병길(安炳吉),태영호(太永浩),85,121,206,0
32297,안병길(安炳吉),하영제(河榮帝),74,94,168,1
32298,안병길(安炳吉),하태경(河泰慶),69,70,139,0
32299,안병길(安炳吉),한기호(韓起鎬),70,58,128,0
32300,안병길(安炳吉),한무경(韓茂景),74,129,203,0
32301,안병길(安炳吉),한병도(韓秉道),49,4,53,1
32302,안병길(安炳吉),한정애(韓貞愛),53,8,61,1
32303,안병길(安炳吉),한준호(韓俊鎬),51,4,55,1
32304,안병길(安炳吉),허숙정(許淑湞),0,0,0,1
32305,안병길(安炳吉),허영(許榮),52,4,56,1
32306,안병길(安炳吉),허은아(許垠娥),67,55,122,0
32307,안병길(安炳吉),허종식(許琮植),52,7,59,1
32308,안병길(安炳吉),홍기원(洪起元),50,6,56,1
32309,안병길(安炳吉),홍문표(洪文杓),86,78,164,0
32310,안병길(安炳吉),홍석준(洪碩晙),72,90,162,0
32311,안병길(安炳吉),홍성국(洪性國),51,6,57,1
32312,안병길(安炳吉),홍영표(洪永杓),52,5,57,1
32313,안병길(安炳吉),홍익표(洪翼杓),50,4,54,1
32314,안병길(安炳吉),홍정민(洪貞敏),52,5,57,1
32315,안병길(安炳吉),황보승희(皇甫承希),105,156,261,1
32316,안병길(安炳吉),황운하(黃雲夏),50,4,54,1
32317,안병길(安炳吉),황희(黃熙),49,6,55,1
32318,안철수(安哲秀),안호영(安浩永),25,5,30,1
32319,안철수(安哲秀),양경숙(梁敬淑),25,4,29,1
32320,안철수(安哲秀),양금희(梁琴喜),30,36,66,0
32321,안철수(安哲秀),양기대(梁基大),25,5,30,1
32322,안철수(安哲秀),양이원영(梁李媛瑛),25,4,29,1
32323,안철수(安哲秀),양정숙(梁貞淑),1,4,5,1
32324,안철수(安哲秀),양향자(梁香子),1,6,7,1
32325,안철수(安哲秀),어기구(魚基龜),25,4,29,1
32326,안철수(安哲秀),엄태영(嚴泰永),26,32,58,0
32327,안철수(安哲秀),오기형(吳奇炯),25,4,29,1
32328,안철수(安哲秀),오영환(吳永煥),26,6,32,1
32329,안철수(安哲秀),용혜인(龍慧仁),0,0,0,1
32330,안철수(安哲秀),우상호(禹相虎),26,4,30,1
32331,안철수(安哲秀),우원식(禹元植),26,5,31,1
32332,안철수(安哲秀),위성곤(魏聖坤),25,5,30,1
32333,안철수(安哲秀),유경준(兪京濬),27,41,68,0
32334,안철수(安哲秀),유기홍(柳基洪),26,4,30,1
32335,안철수(安哲秀),유동수(柳東秀),25,5,30,1
32336,안철수(安哲秀),유상범(劉相凡),27,15,42,0
32337,안철수(安哲秀),유의동(兪義東),26,25,51,0
32338,안철수(安哲秀),유정주(兪訂炷),25,4,29,1
32339,안철수(安哲秀),윤건영(尹建永),25,3,28,1
32340,안철수(安哲秀),윤관석(尹官石),16,0,16,1
32341,안철수(安哲秀),윤두현(尹斗鉉),29,17,46,0
32342,안철수(安哲秀),윤미향(尹美香),0,0,0,1
32343,안철수(安哲秀),윤상현(尹相現),29,36,65,0
32344,안철수(安哲秀),윤영덕(尹永德),25,5,30,1
32345,안철수(安哲秀),윤영석(尹永碩),26,17,43,0
32346,안철수(安哲秀),윤영찬(尹永燦),25,4,29,1
32347,안철수(安哲秀),윤재갑(尹才鉀),25,8,33,1
32348,안철수(安哲秀),윤재옥(尹在玉),27,22,49,0
32349,안철수(安哲秀),윤주경(尹柱卿),28,19,47,0
32350,안철수(安哲秀),윤준병(尹準炳),25,4,29,1
32351,안철수(安哲秀),윤창현(尹暢賢),29,18,47,0
32352,안철수(安哲秀),윤한홍(尹漢洪),25,12,37,0
32353,안철수(安哲秀),윤호중(尹昊重),26,5,31,1
32354,안철수(安哲秀),윤후덕(尹厚德),25,5,30,1
32355,안철수(安哲秀),이개호(李介昊),26,5,31,1
32356,안철수(安哲秀),이달곤(李達坤),25,12,37,0
32357,안철수(安哲秀),이동주(李東洲),25,4,29,1
32358,안철수(安哲秀),이만희(李晩熙),27,12,39,0
32359,안철수(安哲秀),이명수(李明洙),26,43,69,0
32360,안철수(安哲秀),이병훈(李炳勳),27,4,31,1
32361,안철수(安哲秀),이상민(李相珉),25,4,29,1
32362,안철수(安哲秀),이상헌(李相憲),25,5,30,1
32363,안철수(安哲秀),이성만(李成萬),16,1,17,1
32364,안철수(安哲秀),이소영(李素永),26,5,31,1
32365,안철수(安哲秀),이수진(李壽珍),25,4,29,1
32366,안철수(安哲秀),이수진(李秀眞),25,4,29,1
32367,안철수(安哲秀),이양수(李亮壽),28,13,41,0
32368,안철수(安哲秀),이용(李鏞),27,21,48,0
32369,안철수(安哲秀),이용빈(李龍彬),26,4,30,1
32370,안철수(安哲秀),이용선(李庸瑄),25,4,29,1
32371,안철수(安哲秀),이용우(李龍雨),25,4,29,1
32372,안철수(安哲秀),이용호(李容鎬),27,16,43,0
32373,안철수(安哲秀),이원욱(李元旭),27,5,32,1
32374,안철수(安哲秀),이원택(李源澤),25,4,29,1
32375,안철수(安哲秀),이은주(李恩周),0,0,0,1
32376,안철수(安哲秀),이인선(李仁善),28,34,62,0
32377,안철수(安哲秀),이인영(李仁榮),25,4,29,1
32378,안철수(安哲秀),이장섭(李將燮),25,5,30,1
32379,안철수(安哲秀),이재명(李在明),25,4,29,1
32380,안철수(安哲秀),이재정(李在汀),25,4,29,1
32381,안철수(安哲秀),이정문(李楨文),25,4,29,1
32382,안철수(安哲秀),이종배(李鍾培),28,34,62,0
32383,안철수(安哲秀),이종성(李鍾成),28,31,59,0
32384,안철수(安哲秀),이주환(李周桓),29,20,49,0
32385,안철수(安哲秀),이채익(李埰益),29,30,59,0
32386,안철수(安哲秀),이철규(李喆圭),27,9,36,0
32387,안철수(安哲秀),이탄희(李誕熙),25,4,29,1
32388,안철수(安哲秀),이태규(李泰珪),30,31,61,0
32389,안철수(安哲秀),이학영(李學永),25,4,29,1
32390,안철수(安哲秀),이해식(李海植),25,4,29,1
32391,안철수(安哲秀),이헌승(李憲昇),27,64,91,0
32392,안철수(安哲秀),이형석(李炯錫),26,5,31,1
32393,안철수(安哲秀),인재근(印在謹),26,5,31,1
32394,안철수(安哲秀),임병헌(林炳憲),29,17,46,0
32395,안철수(安哲秀),임오경(林五卿),25,5,30,1
32396,안철수(安哲秀),임이자(林利子),27,17,44,0
32397,안철수(安哲秀),임종성(林鍾聲),26,4,30,1
32398,안철수(安哲秀),임호선(林昊宣),26,5,31,1
32399,안철수(安哲秀),장경태(張耿態),25,4,29,1
32400,안철수(安哲秀),장동혁(張東赫),26,18,44,0
32401,안철수(安哲秀),장제원(張濟元),25,10,35,0
32402,안철수(安哲秀),장철민(張喆敏),26,5,31,1
32403,안철수(安哲秀),장혜영(張惠英),0,0,0,1
32404,안철수(安哲秀),전봉민(田奉珉),26,29,55,0
32405,안철수(安哲秀),전용기(田溶冀),25,4,29,1
32406,안철수(安哲秀),전재수(田載秀),25,4,29,1
32407,안철수(安哲秀),전주혜(全珠惠),28,16,44,0
32408,안철수(安哲秀),전해철(全海澈),26,4,30,1
32409,안철수(安哲秀),전혜숙(全惠淑),25,5,30,1
32410,안철수(安哲秀),정경희(丁慶姬),28,15,43,0
32411,안철수(安哲秀),정동만(鄭東萬),25,19,44,0
32412,안철수(安哲秀),정성호(鄭成湖),28,5,33,1
32413,안철수(安哲秀),정우택(鄭宇澤),27,46,73,0
32414,안철수(安哲秀),정운천(鄭雲天),28,18,46,0
32415,안철수(安哲秀),정일영(鄭日永),25,4,29,1
32416,안철수(安哲秀),정점식(鄭点植),25,13,38,0
32417,안철수(安哲秀),정진석(鄭鎭碩),25,14,39,0
32418,안철수(安哲秀),정청래(鄭淸來),25,4,29,1
32419,안철수(安哲秀),정춘숙(鄭春淑),25,4,29,1
32420,안철수(安哲秀),정태호(鄭泰浩),25,6,31,1
32421,안철수(安哲秀),정필모(鄭必模),25,4,29,1
32422,안철수(安哲秀),정희용(鄭熙溶),28,24,52,0
32423,안철수(安哲秀),조경태(趙慶泰),28,26,54,0
32424,안철수(安哲秀),조명희(曺明姬),31,35,66,0
32425,안철수(安哲秀),조수진(趙修眞),26,31,57,0
32426,안철수(安哲秀),조승래(趙承來),25,4,29,1
32427,안철수(安哲秀),조오섭(曺五燮),26,5,31,1
32428,안철수(安哲秀),조은희(趙恩禧),28,23,51,0
32429,안철수(安哲秀),조응천(趙應天),25,3,28,1
32430,안철수(安哲秀),조정식(趙正湜),25,4,29,1
32431,안철수(安哲秀),조정훈(趙廷訓),0,7,7,1
32432,안철수(安哲秀),조해진(曺海珍),28,17,45,0
32433,안철수(安哲秀),주철현(朱哲鉉),27,5,32,1
32434,안철수(安哲秀),주호영(朱豪英),27,14,41,0
32435,안철수(安哲秀),지성호(池成浩),29,39,68,0
32436,안철수(安哲秀),진선미(陳善美),25,4,29,1
32437,안철수(安哲秀),진성준(陳聲準),25,4,29,1
32438,안철수(安哲秀),천준호(千俊鎬),25,3,28,1
32439,안철수(安哲秀),최기상(崔基相),26,4,30,1
32440,안철수(安哲秀),최승재(崔承宰),29,26,55,0
32441,안철수(安哲秀),최연숙(崔姸淑),29,32,61,0
32442,안철수(安哲秀),최영희(崔英姬),27,37,64,0
32443,안철수(安哲秀),최인호(崔仁昊),26,5,31,1
32444,안철수(安哲秀),최재형(崔在亨),27,18,45,0
32445,안철수(安哲秀),최종윤(崔鍾允),26,5,31,1
32446,안철수(安哲秀),최춘식(崔春植),27,25,52,0
32447,안철수(安哲秀),최형두(崔炯斗),28,23,51,0
32448,안철수(安哲秀),최혜영(崔惠英),26,4,30,1
32449,안철수(安哲秀),추경호(秋慶鎬),25,8,33,0
32450,안철수(安哲秀),태영호(太永浩),26,50,76,0
32451,안철수(安哲秀),하영제(河榮帝),20,26,46,1
32452,안철수(安哲秀),하태경(河泰慶),26,27,53,0
32453,안철수(安哲秀),한기호(韓起鎬),27,14,41,0
32454,안철수(安哲秀),한무경(韓茂景),26,18,44,0
32455,안철수(安哲秀),한병도(韓秉道),26,5,31,1
32456,안철수(安哲秀),한정애(韓貞愛),25,5,30,1
32457,안철수(安哲秀),한준호(韓俊鎬),25,5,30,1
32458,안철수(安哲秀),허숙정(許淑湞),0,0,0,1
32459,안철수(安哲秀),허영(許榮),26,5,31,1
32460,안철수(安哲秀),허은아(許垠娥),27,13,40,0
32461,안철수(安哲秀),허종식(許琮植),25,5,30,1
32462,안철수(安哲秀),홍기원(洪起元),25,5,30,1
32463,안철수(安哲秀),홍문표(洪文杓),26,38,64,0
32464,안철수(安哲秀),홍석준(洪碩晙),27,17,44,0
32465,안철수(安哲秀),홍성국(洪性國),25,5,30,1
32466,안철수(安哲秀),홍영표(洪永杓),25,4,29,1
32467,안철수(安哲秀),홍익표(洪翼杓),26,4,30,1
32468,안철수(安哲秀),홍정민(洪貞敏),26,4,30,1
32469,안철수(安哲秀),황보승희(皇甫承希),22,8,30,1
32470,안철수(安哲秀),황운하(黃雲夏),25,4,29,1
32471,안철수(安哲秀),황희(黃熙),25,5,30,1
32472,안호영(安浩永),양경숙(梁敬淑),92,88,180,0
32473,안호영(安浩永),양금희(梁琴喜),50,6,56,1
32474,안호영(安浩永),양기대(梁基大),79,75,154,0
32475,안호영(安浩永),양이원영(梁李媛瑛),137,118,255,0
32476,안호영(安浩永),양정숙(梁貞淑),65,229,294,1
32477,안호영(安浩永),양향자(梁香子),38,43,81,1
32478,안호영(安浩永),어기구(魚基龜),96,128,224,0
32479,안호영(安浩永),엄태영(嚴泰永),51,4,55,1
32480,안호영(安浩永),오기형(吳奇炯),79,39,118,0
32481,안호영(安浩永),오영환(吳永煥),113,172,285,0
32482,안호영(安浩永),용혜인(龍慧仁),16,39,55,1
32483,안호영(安浩永),우상호(禹相虎),77,40,117,0
32484,안호영(安浩永),우원식(禹元植),88,99,187,0
32485,안호영(安浩永),위성곤(魏聖坤),112,216,328,0
32486,안호영(安浩永),유경준(兪京濬),50,4,54,1
32487,안호영(安浩永),유기홍(柳基洪),76,57,133,0
32488,안호영(安浩永),유동수(柳東秀),104,96,200,0
32489,안호영(安浩永),유상범(劉相凡),49,5,54,1
32490,안호영(安浩永),유의동(兪義東),50,6,56,1
32491,안호영(安浩永),유정주(兪訂炷),97,98,195,0
32492,안호영(安浩永),윤건영(尹建永),83,60,143,0
32493,안호영(安浩永),윤관석(尹官石),67,41,108,1
32494,안호영(安浩永),윤두현(尹斗鉉),49,4,53,1
32495,안호영(安浩永),윤미향(尹美香),120,161,281,1
32496,안호영(安浩永),윤상현(尹相現),30,7,37,1
32497,안호영(安浩永),윤영덕(尹永德),91,95,186,0
32498,안호영(安浩永),윤영석(尹永碩),50,8,58,1
32499,안호영(安浩永),윤영찬(尹永燦),81,51,132,0
32500,안호영(安浩永),윤재갑(尹才鉀),116,146,262,0
32501,안호영(安浩永),윤재옥(尹在玉),50,5,55,1
32502,안호영(安浩永),윤주경(尹柱卿),49,6,55,1
32503,안호영(安浩永),윤준병(尹準炳),184,336,520,0
32504,안호영(安浩永),윤창현(尹暢賢),49,5,54,1
32505,안호영(安浩永),윤한홍(尹漢洪),50,5,55,1
32506,안호영(安浩永),윤호중(尹昊重),77,45,122,0
32507,안호영(安浩永),윤후덕(尹厚德),82,80,162,0
32508,안호영(安浩永),이개호(李介昊),85,98,183,0
32509,안호영(安浩永),이달곤(李達坤),53,7,60,1
32510,안호영(安浩永),이동주(李東洲),92,94,186,0
32511,안호영(安浩永),이만희(李晩熙),51,4,55,1
32512,안호영(安浩永),이명수(李明洙),51,12,63,1
32513,안호영(安浩永),이병훈(李炳勳),95,100,195,0
32514,안호영(安浩永),이상민(李相珉),74,33,107,0
32515,안호영(安浩永),이상헌(李相憲),95,103,198,0
32516,안호영(安浩永),이성만(李成萬),87,105,192,1
32517,안호영(安浩永),이소영(李素永),88,62,150,0
32518,안호영(安浩永),이수진(李壽珍),167,199,366,0
32519,안호영(安浩永),이수진(李秀眞),92,78,170,0
32520,안호영(安浩永),이양수(李亮壽),52,4,56,1
32521,안호영(安浩永),이용(李鏞),49,6,55,1
32522,안호영(安浩永),이용빈(李龍彬),122,186,308,0
32523,안호영(安浩永),이용선(李庸瑄),87,90,177,0
32524,안호영(安浩永),이용우(李龍雨),88,62,150,0
32525,안호영(安浩永),이용호(李容鎬),51,56,107,1
32526,안호영(安浩永),이원욱(李元旭),99,91,190,0
32527,안호영(安浩永),이원택(李源澤),98,166,264,0
32528,안호영(安浩永),이은주(李恩周),17,38,55,1
32529,안호영(安浩永),이인선(李仁善),25,4,29,1
32530,안호영(安浩永),이인영(李仁榮),78,44,122,0
32531,안호영(安浩永),이장섭(李將燮),84,80,164,0
32532,안호영(安浩永),이재명(李在明),40,20,60,0
32533,안호영(安浩永),이재정(李在汀),77,43,120,0
32534,안호영(安浩永),이정문(李楨文),90,83,173,0
32535,안호영(安浩永),이종배(李鍾培),50,5,55,1
32536,안호영(安浩永),이종성(李鍾成),50,4,54,1
32537,안호영(安浩永),이주환(李周桓),49,7,56,1
32538,안호영(安浩永),이채익(李埰益),52,8,60,1
32539,안호영(安浩永),이철규(李喆圭),51,6,57,1
32540,안호영(安浩永),이탄희(李誕熙),90,71,161,0
32541,안호영(安浩永),이태규(李泰珪),28,5,33,1
32542,안호영(安浩永),이학영(李學永),93,103,196,0
32543,안호영(安浩永),이해식(李海植),99,93,192,0
32544,안호영(安浩永),이헌승(李憲昇),51,4,55,1
32545,안호영(安浩永),이형석(李炯錫),85,80,165,0
32546,안호영(安浩永),인재근(印在謹),93,119,212,0
32547,안호영(安浩永),임병헌(林炳憲),25,4,29,1
32548,안호영(安浩永),임오경(林五卿),100,95,195,0
32549,안호영(安浩永),임이자(林利子),50,5,55,1
32550,안호영(安浩永),임종성(林鍾聲),164,210,374,0
32551,안호영(安浩永),임호선(林昊宣),101,130,231,0
32552,안호영(安浩永),장경태(張耿態),95,114,209,0
32553,안호영(安浩永),장동혁(張東赫),25,4,29,1
32554,안호영(安浩永),장제원(張濟元),49,4,53,1
32555,안호영(安浩永),장철민(張喆敏),140,142,282,0
32556,안호영(安浩永),장혜영(張惠英),15,25,40,1
32557,안호영(安浩永),전봉민(田奉珉),35,5,40,1
32558,안호영(安浩永),전용기(田溶冀),85,79,164,0
32559,안호영(安浩永),전재수(田載秀),81,57,138,0
32560,안호영(安浩永),전주혜(全珠惠),51,7,58,1
32561,안호영(安浩永),전해철(全海澈),74,49,123,0
32562,안호영(安浩永),전혜숙(全惠淑),89,68,157,0
32563,안호영(安浩永),정경희(丁慶姬),49,4,53,1
32564,안호영(安浩永),정동만(鄭東萬),49,4,53,1
32565,안호영(安浩永),정성호(鄭成湖),88,88,176,0
32566,안호영(安浩永),정우택(鄭宇澤),25,5,30,1
32567,안호영(安浩永),정운천(鄭雲天),50,13,63,1
32568,안호영(安浩永),정일영(鄭日永),78,83,161,0
32569,안호영(安浩永),정점식(鄭点植),50,4,54,1
32570,안호영(安浩永),정진석(鄭鎭碩),50,9,59,1
32571,안호영(安浩永),정청래(鄭淸來),80,60,140,0
32572,안호영(安浩永),정춘숙(鄭春淑),119,137,256,0
32573,안호영(安浩永),정태호(鄭泰浩),84,69,153,0
32574,안호영(安浩永),정필모(鄭必模),93,57,150,0
32575,안호영(安浩永),정희용(鄭熙溶),51,6,57,1
32576,안호영(安浩永),조경태(趙慶泰),49,4,53,1
32577,안호영(安浩永),조명희(曺明姬),49,8,57,1
32578,안호영(安浩永),조수진(趙修眞),49,6,55,1
32579,안호영(安浩永),조승래(趙承來),87,54,141,0
32580,안호영(安浩永),조오섭(曺五燮),100,140,240,0
32581,안호영(安浩永),조은희(趙恩禧),25,4,29,1
32582,안호영(安浩永),조응천(趙應天),72,32,104,0
32583,안호영(安浩永),조정식(趙正湜),77,89,166,0
32584,안호영(安浩永),조정훈(趙廷訓),5,9,14,1
32585,안호영(安浩永),조해진(曺海珍),52,5,57,1
32586,안호영(安浩永),주철현(朱哲鉉),97,133,230,0
32587,안호영(安浩永),주호영(朱豪英),49,4,53,1
32588,안호영(安浩永),지성호(池成浩),49,4,53,1
32589,안호영(安浩永),진선미(陳善美),86,88,174,0
32590,안호영(安浩永),진성준(陳聲準),90,99,189,0
32591,안호영(安浩永),천준호(千俊鎬),91,59,150,0
32592,안호영(安浩永),최기상(崔基相),78,62,140,0
32593,안호영(安浩永),최승재(崔承宰),50,11,61,1
32594,안호영(安浩永),최연숙(崔姸淑),33,19,52,1
32595,안호영(安浩永),최영희(崔英姬),25,5,30,1
32596,안호영(安浩永),최인호(崔仁昊),87,77,164,0
32597,안호영(安浩永),최재형(崔在亨),25,5,30,1
32598,안호영(安浩永),최종윤(崔鍾允),114,119,233,0
32599,안호영(安浩永),최춘식(崔春植),50,4,54,1
32600,안호영(安浩永),최형두(崔炯斗),50,6,56,1
32601,안호영(安浩永),최혜영(崔惠英),83,84,167,0
32602,안호영(安浩永),추경호(秋慶鎬),51,6,57,1
32603,안호영(安浩永),태영호(太永浩),50,9,59,1
32604,안호영(安浩永),하영제(河榮帝),41,4,45,1
32605,안호영(安浩永),하태경(河泰慶),49,5,54,1
32606,안호영(安浩永),한기호(韓起鎬),50,5,55,1
32607,안호영(安浩永),한무경(韓茂景),49,5,54,1
32608,안호영(安浩永),한병도(韓秉道),116,176,292,0
32609,안호영(安浩永),한정애(韓貞愛),81,61,142,0
32610,안호영(安浩永),한준호(韓俊鎬),87,79,166,0
32611,안호영(安浩永),허숙정(許淑湞),1,2,3,0
32612,안호영(安浩永),허영(許榮),106,108,214,0
32613,안호영(安浩永),허은아(許垠娥),49,7,56,1
32614,안호영(安浩永),허종식(許琮植),85,80,165,0
32615,안호영(安浩永),홍기원(洪起元),85,68,153,0
32616,안호영(安浩永),홍문표(洪文杓),52,9,61,1
32617,안호영(安浩永),홍석준(洪碩晙),51,5,56,1
32618,안호영(安浩永),홍성국(洪性國),100,95,195,0
32619,안호영(安浩永),홍영표(洪永杓),82,61,143,0
32620,안호영(安浩永),홍익표(洪翼杓),87,77,164,0
32621,안호영(安浩永),홍정민(洪貞敏),90,90,180,0
32622,안호영(安浩永),황보승희(皇甫承希),46,5,51,1
32623,안호영(安浩永),황운하(黃雲夏),107,169,276,0
32624,안호영(安浩永),황희(黃熙),77,48,125,0
32625,양경숙(梁敬淑),양금희(梁琴喜),50,6,56,1
32626,양경숙(梁敬淑),양기대(梁基大),87,107,194,0
32627,양경숙(梁敬淑),양이원영(梁李媛瑛),96,105,201,0
32628,양경숙(梁敬淑),양정숙(梁貞淑),71,268,339,1
32629,양경숙(梁敬淑),양향자(梁香子),49,61,110,1
32630,양경숙(梁敬淑),어기구(魚基龜),90,67,157,0
32631,양경숙(梁敬淑),엄태영(嚴泰永),51,4,55,1
32632,양경숙(梁敬淑),오기형(吳奇炯),82,42,124,0
32633,양경숙(梁敬淑),오영환(吳永煥),127,230,357,0
32634,양경숙(梁敬淑),용혜인(龍慧仁),22,60,82,1
32635,양경숙(梁敬淑),우상호(禹相虎),79,51,130,0
32636,양경숙(梁敬淑),우원식(禹元植),108,75,183,0
32637,양경숙(梁敬淑),위성곤(魏聖坤),102,163,265,0
32638,양경숙(梁敬淑),유경준(兪京濬),49,4,53,1
32639,양경숙(梁敬淑),유기홍(柳基洪),78,61,139,0
32640,양경숙(梁敬淑),유동수(柳東秀),95,60,155,0
32641,양경숙(梁敬淑),유상범(劉相凡),50,4,54,1
32642,양경숙(梁敬淑),유의동(兪義東),50,4,54,1
32643,양경숙(梁敬淑),유정주(兪訂炷),105,129,234,0
32644,양경숙(梁敬淑),윤건영(尹建永),87,74,161,0
32645,양경숙(梁敬淑),윤관석(尹官石),86,72,158,1
32646,양경숙(梁敬淑),윤두현(尹斗鉉),49,4,53,1
32647,양경숙(梁敬淑),윤미향(尹美香),57,96,153,1
32648,양경숙(梁敬淑),윤상현(尹相現),30,5,35,1
32649,양경숙(梁敬淑),윤영덕(尹永德),97,140,237,0
32650,양경숙(梁敬淑),윤영석(尹永碩),51,5,56,1
32651,양경숙(梁敬淑),윤영찬(尹永燦),90,79,169,0
32652,양경숙(梁敬淑),윤재갑(尹才鉀),114,150,264,0
32653,양경숙(梁敬淑),윤재옥(尹在玉),50,4,54,1
32654,양경숙(梁敬淑),윤주경(尹柱卿),49,6,55,1
32655,양경숙(梁敬淑),윤준병(尹準炳),120,242,362,0
32656,양경숙(梁敬淑),윤창현(尹暢賢),49,5,54,1
32657,양경숙(梁敬淑),윤한홍(尹漢洪),50,4,54,1
32658,양경숙(梁敬淑),윤호중(尹昊重),78,61,139,0
32659,양경숙(梁敬淑),윤후덕(尹厚德),103,128,231,0
32660,양경숙(梁敬淑),이개호(李介昊),93,111,204,0
32661,양경숙(梁敬淑),이달곤(李達坤),52,5,57,1
32662,양경숙(梁敬淑),이동주(李東洲),95,147,242,0
32663,양경숙(梁敬淑),이만희(李晩熙),49,4,53,1
32664,양경숙(梁敬淑),이명수(李明洙),51,14,65,1
32665,양경숙(梁敬淑),이병훈(李炳勳),104,172,276,0
32666,양경숙(梁敬淑),이상민(李相珉),85,58,143,0
32667,양경숙(梁敬淑),이상헌(李相憲),100,168,268,0
32668,양경숙(梁敬淑),이성만(李成萬),103,151,254,1
32669,양경숙(梁敬淑),이소영(李素永),84,76,160,0
32670,양경숙(梁敬淑),이수진(李壽珍),125,184,309,0
32671,양경숙(梁敬淑),이수진(李秀眞),114,119,233,0
32672,양경숙(梁敬淑),이양수(李亮壽),51,4,55,1
32673,양경숙(梁敬淑),이용(李鏞),49,6,55,1
32674,양경숙(梁敬淑),이용빈(李龍彬),116,241,357,0
32675,양경숙(梁敬淑),이용선(李庸瑄),89,98,187,0
32676,양경숙(梁敬淑),이용우(李龍雨),96,116,212,0
32677,양경숙(梁敬淑),이용호(李容鎬),32,20,52,1
32678,양경숙(梁敬淑),이원욱(李元旭),94,97,191,0
32679,양경숙(梁敬淑),이원택(李源澤),100,104,204,0
32680,양경숙(梁敬淑),이은주(李恩周),19,32,51,1
32681,양경숙(梁敬淑),이인선(李仁善),25,4,29,1
32682,양경숙(梁敬淑),이인영(李仁榮),82,52,134,0
32683,양경숙(梁敬淑),이장섭(李將燮),100,93,193,0
32684,양경숙(梁敬淑),이재명(李在明),40,24,64,0
32685,양경숙(梁敬淑),이재정(李在汀),85,73,158,0
32686,양경숙(梁敬淑),이정문(李楨文),95,121,216,0
32687,양경숙(梁敬淑),이종배(李鍾培),50,6,56,1
32688,양경숙(梁敬淑),이종성(李鍾成),49,4,53,1
32689,양경숙(梁敬淑),이주환(李周桓),49,5,54,1
32690,양경숙(梁敬淑),이채익(李埰益),51,5,56,1
32691,양경숙(梁敬淑),이철규(李喆圭),52,5,57,1
32692,양경숙(梁敬淑),이탄희(李誕熙),101,94,195,0
32693,양경숙(梁敬淑),이태규(李泰珪),29,6,35,1
32694,양경숙(梁敬淑),이학영(李學永),95,95,190,0
32695,양경숙(梁敬淑),이해식(李海植),101,83,184,0
32696,양경숙(梁敬淑),이헌승(李憲昇),50,4,54,1
32697,양경숙(梁敬淑),이형석(李炯錫),108,91,199,0
32698,양경숙(梁敬淑),인재근(印在謹),108,111,219,0
32699,양경숙(梁敬淑),임병헌(林炳憲),25,4,29,1
32700,양경숙(梁敬淑),임오경(林五卿),89,96,185,0
32701,양경숙(梁敬淑),임이자(林利子),49,4,53,1
32702,양경숙(梁敬淑),임종성(林鍾聲),101,111,212,0
32703,양경숙(梁敬淑),임호선(林昊宣),112,188,300,0
32704,양경숙(梁敬淑),장경태(張耿態),98,116,214,0
32705,양경숙(梁敬淑),장동혁(張東赫),25,4,29,1
32706,양경숙(梁敬淑),장제원(張濟元),49,5,54,1
32707,양경숙(梁敬淑),장철민(張喆敏),101,91,192,0
32708,양경숙(梁敬淑),장혜영(張惠英),15,27,42,1
32709,양경숙(梁敬淑),전봉민(田奉珉),35,5,40,1
32710,양경숙(梁敬淑),전용기(田溶冀),99,115,214,0
32711,양경숙(梁敬淑),전재수(田載秀),94,89,183,0
32712,양경숙(梁敬淑),전주혜(全珠惠),51,5,56,1
32713,양경숙(梁敬淑),전해철(全海澈),78,61,139,0
32714,양경숙(梁敬淑),전혜숙(全惠淑),102,130,232,0
32715,양경숙(梁敬淑),정경희(丁慶姬),49,4,53,1
32716,양경숙(梁敬淑),정동만(鄭東萬),49,4,53,1
32717,양경숙(梁敬淑),정성호(鄭成湖),108,124,232,0
32718,양경숙(梁敬淑),정우택(鄭宇澤),25,4,29,1
32719,양경숙(梁敬淑),정운천(鄭雲天),49,5,54,1
32720,양경숙(梁敬淑),정일영(鄭日永),117,123,240,0
32721,양경숙(梁敬淑),정점식(鄭点植),50,4,54,1
32722,양경숙(梁敬淑),정진석(鄭鎭碩),50,7,57,1
32723,양경숙(梁敬淑),정청래(鄭淸來),92,84,176,0
32724,양경숙(梁敬淑),정춘숙(鄭春淑),100,104,204,0
32725,양경숙(梁敬淑),정태호(鄭泰浩),95,107,202,0
32726,양경숙(梁敬淑),정필모(鄭必模),88,85,173,0
32727,양경숙(梁敬淑),정희용(鄭熙溶),50,7,57,1
32728,양경숙(梁敬淑),조경태(趙慶泰),49,5,54,1
32729,양경숙(梁敬淑),조명희(曺明姬),50,7,57,1
32730,양경숙(梁敬淑),조수진(趙修眞),49,5,54,1
32731,양경숙(梁敬淑),조승래(趙承來),90,76,166,0
32732,양경숙(梁敬淑),조오섭(曺五燮),100,158,258,0
32733,양경숙(梁敬淑),조은희(趙恩禧),25,4,29,1
32734,양경숙(梁敬淑),조응천(趙應天),76,49,125,0
32735,양경숙(梁敬淑),조정식(趙正湜),85,67,152,0
32736,양경숙(梁敬淑),조정훈(趙廷訓),3,18,21,1
32737,양경숙(梁敬淑),조해진(曺海珍),51,5,56,1
32738,양경숙(梁敬淑),주철현(朱哲鉉),104,125,229,0
32739,양경숙(梁敬淑),주호영(朱豪英),50,4,54,1
32740,양경숙(梁敬淑),지성호(池成浩),49,4,53,1
32741,양경숙(梁敬淑),진선미(陳善美),86,65,151,0
32742,양경숙(梁敬淑),진성준(陳聲準),95,93,188,0
32743,양경숙(梁敬淑),천준호(千俊鎬),86,51,137,0
32744,양경숙(梁敬淑),최기상(崔基相),85,80,165,0
32745,양경숙(梁敬淑),최승재(崔承宰),50,10,60,1
32746,양경숙(梁敬淑),최연숙(崔姸淑),35,12,47,1
32747,양경숙(梁敬淑),최영희(崔英姬),25,4,29,1
32748,양경숙(梁敬淑),최인호(崔仁昊),86,75,161,0
32749,양경숙(梁敬淑),최재형(崔在亨),25,4,29,1
32750,양경숙(梁敬淑),최종윤(崔鍾允),125,190,315,0
32751,양경숙(梁敬淑),최춘식(崔春植),49,4,53,1
32752,양경숙(梁敬淑),최형두(崔炯斗),50,6,56,1
32753,양경숙(梁敬淑),최혜영(崔惠英),111,111,222,0
32754,양경숙(梁敬淑),추경호(秋慶鎬),49,3,52,1
32755,양경숙(梁敬淑),태영호(太永浩),49,5,54,1
32756,양경숙(梁敬淑),하영제(河榮帝),41,4,45,1
32757,양경숙(梁敬淑),하태경(河泰慶),50,5,55,1
32758,양경숙(梁敬淑),한기호(韓起鎬),50,4,54,1
32759,양경숙(梁敬淑),한무경(韓茂景),49,5,54,1
32760,양경숙(梁敬淑),한병도(韓秉道),106,150,256,0
32761,양경숙(梁敬淑),한정애(韓貞愛),85,63,148,0
32762,양경숙(梁敬淑),한준호(韓俊鎬),91,88,179,0
32763,양경숙(梁敬淑),허숙정(許淑湞),1,1,2,0
32764,양경숙(梁敬淑),허영(許榮),109,99,208,0
32765,양경숙(梁敬淑),허은아(許垠娥),49,5,54,1
32766,양경숙(梁敬淑),허종식(許琮植),108,106,214,0
32767,양경숙(梁敬淑),홍기원(洪起元),90,89,179,0
32768,양경숙(梁敬淑),홍문표(洪文杓),51,7,58,1
32769,양경숙(梁敬淑),홍석준(洪碩晙),50,5,55,1
32770,양경숙(梁敬淑),홍성국(洪性國),113,153,266,0
32771,양경숙(梁敬淑),홍영표(洪永杓),92,61,153,0
32772,양경숙(梁敬淑),홍익표(洪翼杓),85,86,171,0
32773,양경숙(梁敬淑),홍정민(洪貞敏),95,86,181,0
32774,양경숙(梁敬淑),황보승희(皇甫承希),47,3,50,1
32775,양경숙(梁敬淑),황운하(黃雲夏),109,172,281,0
32776,양경숙(梁敬淑),황희(黃熙),78,43,121,0
32777,양금희(梁琴喜),양기대(梁基大),50,5,55,1
32778,양금희(梁琴喜),양이원영(梁李媛瑛),45,6,51,1
32779,양금희(梁琴喜),양정숙(梁貞淑),2,6,8,1
32780,양금희(梁琴喜),양향자(梁香子),23,13,36,1
32781,양금희(梁琴喜),어기구(魚基龜),50,8,58,1
32782,양금희(梁琴喜),엄태영(嚴泰永),82,108,190,0
32783,양금희(梁琴喜),오기형(吳奇炯),49,10,59,1
32784,양금희(梁琴喜),오영환(吳永煥),50,7,57,1
32785,양금희(梁琴喜),용혜인(龍慧仁),1,8,9,1
32786,양금희(梁琴喜),우상호(禹相虎),51,4,55,1
32787,양금희(梁琴喜),우원식(禹元植),50,4,54,1
32788,양금희(梁琴喜),위성곤(魏聖坤),50,7,57,1
32789,양금희(梁琴喜),유경준(兪京濬),104,127,231,0
32790,양금희(梁琴喜),유기홍(柳基洪),50,4,54,1
32791,양금희(梁琴喜),유동수(柳東秀),51,6,57,1
32792,양금희(梁琴喜),유상범(劉相凡),76,115,191,0
32793,양금희(梁琴喜),유의동(兪義東),93,101,194,0
32794,양금희(梁琴喜),유정주(兪訂炷),49,5,54,1
32795,양금희(梁琴喜),윤건영(尹建永),49,4,53,1
32796,양금희(梁琴喜),윤관석(尹官石),41,0,41,1
32797,양금희(梁琴喜),윤두현(尹斗鉉),119,208,327,0
32798,양금희(梁琴喜),윤미향(尹美香),20,1,21,1
32799,양금희(梁琴喜),윤상현(尹相現),47,42,89,0
32800,양금희(梁琴喜),윤영덕(尹永德),49,4,53,1
32801,양금희(梁琴喜),윤영석(尹永碩),75,77,152,0
32802,양금희(梁琴喜),윤영찬(尹永燦),50,4,54,1
32803,양금희(梁琴喜),윤재갑(尹才鉀),50,7,57,1
32804,양금희(梁琴喜),윤재옥(尹在玉),122,105,227,0
32805,양금희(梁琴喜),윤주경(尹柱卿),85,103,188,0
32806,양금희(梁琴喜),윤준병(尹準炳),50,4,54,1
32807,양금희(梁琴喜),윤창현(尹暢賢),142,230,372,0
32808,양금희(梁琴喜),윤한홍(尹漢洪),106,141,247,0
32809,양금희(梁琴喜),윤호중(尹昊重),51,4,55,1
32810,양금희(梁琴喜),윤후덕(尹厚德),50,6,56,1
32811,양금희(梁琴喜),이개호(李介昊),51,6,57,1
32812,양금희(梁琴喜),이달곤(李達坤),66,73,139,0
32813,양금희(梁琴喜),이동주(李東洲),49,5,54,1
32814,양금희(梁琴喜),이만희(李晩熙),91,95,186,0
32815,양금희(梁琴喜),이명수(李明洙),104,168,272,0
32816,양금희(梁琴喜),이병훈(李炳勳),53,8,61,1
32817,양금희(梁琴喜),이상민(李相珉),50,4,54,1
32818,양금희(梁琴喜),이상헌(李相憲),52,7,59,1
32819,양금희(梁琴喜),이성만(李成萬),41,1,42,1
32820,양금희(梁琴喜),이소영(李素永),52,5,57,1
32821,양금희(梁琴喜),이수진(李壽珍),50,9,59,1
32822,양금희(梁琴喜),이수진(李秀眞),50,6,56,1
32823,양금희(梁琴喜),이양수(李亮壽),87,98,185,0
32824,양금희(梁琴喜),이용(李鏞),114,182,296,0
32825,양금희(梁琴喜),이용빈(李龍彬),53,7,60,1
32826,양금희(梁琴喜),이용선(李庸瑄),50,5,55,1
32827,양금희(梁琴喜),이용우(李龍雨),49,10,59,1
32828,양금희(梁琴喜),이용호(李容鎬),34,33,67,0
32829,양금희(梁琴喜),이원욱(李元旭),52,5,57,1
32830,양금희(梁琴喜),이원택(李源澤),50,4,54,1
32831,양금희(梁琴喜),이은주(李恩周),6,4,10,1
32832,양금희(梁琴喜),이인선(李仁善),38,52,90,0
32833,양금희(梁琴喜),이인영(李仁榮),50,4,54,1
32834,양금희(梁琴喜),이장섭(李將燮),50,5,55,1
32835,양금희(梁琴喜),이재명(李在明),25,4,29,1
32836,양금희(梁琴喜),이재정(李在汀),50,4,54,1
32837,양금희(梁琴喜),이정문(李楨文),50,7,57,1
32838,양금희(梁琴喜),이종배(李鍾培),119,121,240,0
32839,양금희(梁琴喜),이종성(李鍾成),129,198,327,0
32840,양금희(梁琴喜),이주환(李周桓),141,214,355,0
32841,양금희(梁琴喜),이채익(李埰益),84,89,173,0
32842,양금희(梁琴喜),이철규(李喆圭),95,134,229,0
32843,양금희(梁琴喜),이탄희(李誕熙),50,5,55,1
32844,양금희(梁琴喜),이태규(李泰珪),51,84,135,0
32845,양금희(梁琴喜),이학영(李學永),49,5,54,1
32846,양금희(梁琴喜),이해식(李海植),51,5,56,1
32847,양금희(梁琴喜),이헌승(李憲昇),83,143,226,0
32848,양금희(梁琴喜),이형석(李炯錫),50,4,54,1
32849,양금희(梁琴喜),인재근(印在謹),50,5,55,1
32850,양금희(梁琴喜),임병헌(林炳憲),36,46,82,0
32851,양금희(梁琴喜),임오경(林五卿),50,5,55,1
32852,양금희(梁琴喜),임이자(林利子),109,130,239,0
32853,양금희(梁琴喜),임종성(林鍾聲),52,7,59,1
32854,양금희(梁琴喜),임호선(林昊宣),51,9,60,1
32855,양금희(梁琴喜),장경태(張耿態),50,6,56,1
32856,양금희(梁琴喜),장동혁(張東赫),38,76,114,0
32857,양금희(梁琴喜),장제원(張濟元),67,56,123,0
32858,양금희(梁琴喜),장철민(張喆敏),51,4,55,1
32859,양금희(梁琴喜),장혜영(張惠英),8,8,16,1
32860,양금희(梁琴喜),전봉민(田奉珉),89,116,205,0
32861,양금희(梁琴喜),전용기(田溶冀),50,6,56,1
32862,양금희(梁琴喜),전재수(田載秀),50,4,54,1
32863,양금희(梁琴喜),전주혜(全珠惠),100,150,250,0
32864,양금희(梁琴喜),전해철(全海澈),51,4,55,1
32865,양금희(梁琴喜),전혜숙(全惠淑),50,6,56,1
32866,양금희(梁琴喜),정경희(丁慶姬),85,93,178,0
32867,양금희(梁琴喜),정동만(鄭東萬),93,96,189,0
32868,양금희(梁琴喜),정성호(鄭成湖),55,6,61,1
32869,양금희(梁琴喜),정우택(鄭宇澤),53,67,120,0
32870,양금희(梁琴喜),정운천(鄭雲天),90,115,205,0
32871,양금희(梁琴喜),정일영(鄭日永),50,8,58,1
32872,양금희(梁琴喜),정점식(鄭点植),67,62,129,0
32873,양금희(梁琴喜),정진석(鄭鎭碩),88,102,190,0
32874,양금희(梁琴喜),정청래(鄭淸來),49,4,53,1
32875,양금희(梁琴喜),정춘숙(鄭春淑),50,5,55,1
32876,양금희(梁琴喜),정태호(鄭泰浩),50,5,55,1
32877,양금희(梁琴喜),정필모(鄭必模),50,5,55,1
32878,양금희(梁琴喜),정희용(鄭熙溶),120,199,319,0
32879,양금희(梁琴喜),조경태(趙慶泰),87,85,172,0
32880,양금희(梁琴喜),조명희(曺明姬),118,219,337,0
32881,양금희(梁琴喜),조수진(趙修眞),118,182,300,0
32882,양금희(梁琴喜),조승래(趙承來),50,5,55,1
32883,양금희(梁琴喜),조오섭(曺五燮),52,7,59,1
32884,양금희(梁琴喜),조은희(趙恩禧),46,59,105,0
32885,양금희(梁琴喜),조응천(趙應天),52,6,58,1
32886,양금희(梁琴喜),조정식(趙正湜),49,3,52,1
32887,양금희(梁琴喜),조정훈(趙廷訓),1,6,7,1
32888,양금희(梁琴喜),조해진(曺海珍),65,43,108,0
32889,양금희(梁琴喜),주철현(朱哲鉉),52,5,57,1
32890,양금희(梁琴喜),주호영(朱豪英),73,66,139,0
32891,양금희(梁琴喜),지성호(池成浩),135,206,341,0
32892,양금희(梁琴喜),진선미(陳善美),50,5,55,1
32893,양금희(梁琴喜),진성준(陳聲準),50,4,54,1
32894,양금희(梁琴喜),천준호(千俊鎬),49,3,52,1
32895,양금희(梁琴喜),최기상(崔基相),50,5,55,1
32896,양금희(梁琴喜),최승재(崔承宰),97,142,239,0
32897,양금희(梁琴喜),최연숙(崔姸淑),40,78,118,0
32898,양금희(梁琴喜),최영희(崔英姬),43,64,107,0
32899,양금희(梁琴喜),최인호(崔仁昊),52,4,56,1
32900,양금희(梁琴喜),최재형(崔在亨),30,27,57,0
32901,양금희(梁琴喜),최종윤(崔鍾允),51,4,55,1
32902,양금희(梁琴喜),최춘식(崔春植),103,152,255,0
32903,양금희(梁琴喜),최형두(崔炯斗),106,124,230,0
32904,양금희(梁琴喜),최혜영(崔惠英),50,5,55,1
32905,양금희(梁琴喜),추경호(秋慶鎬),148,228,376,0
32906,양금희(梁琴喜),태영호(太永浩),131,203,334,0
32907,양금희(梁琴喜),하영제(河榮帝),109,162,271,1
32908,양금희(梁琴喜),하태경(河泰慶),66,71,137,0
32909,양금희(梁琴喜),한기호(韓起鎬),77,77,154,0
32910,양금희(梁琴喜),한무경(韓茂景),143,217,360,0
32911,양금희(梁琴喜),한병도(韓秉道),50,6,56,1
32912,양금희(梁琴喜),한정애(韓貞愛),50,4,54,1
32913,양금희(梁琴喜),한준호(韓俊鎬),51,4,55,1
32914,양금희(梁琴喜),허숙정(許淑湞),0,0,0,1
32915,양금희(梁琴喜),허영(許榮),52,5,57,1
32916,양금희(梁琴喜),허은아(許垠娥),92,112,204,0
32917,양금희(梁琴喜),허종식(許琮植),52,8,60,1
32918,양금희(梁琴喜),홍기원(洪起元),50,5,55,1
32919,양금희(梁琴喜),홍문표(洪文杓),91,116,207,0
32920,양금희(梁琴喜),홍석준(洪碩晙),98,111,209,0
32921,양금희(梁琴喜),홍성국(洪性國),50,6,56,1
32922,양금희(梁琴喜),홍영표(洪永杓),50,5,55,1
32923,양금희(梁琴喜),홍익표(洪翼杓),51,5,56,1
32924,양금희(梁琴喜),홍정민(洪貞敏),52,5,57,1
32925,양금희(梁琴喜),황보승희(皇甫承希),111,158,269,1
32926,양금희(梁琴喜),황운하(黃雲夏),50,6,56,1
32927,양금희(梁琴喜),황희(黃熙),49,12,61,1
32928,양기대(梁基大),양이원영(梁李媛瑛),90,54,144,0
32929,양기대(梁基大),양정숙(梁貞淑),51,133,184,1
32930,양기대(梁基大),양향자(梁香子),42,40,82,1
32931,양기대(梁基大),어기구(魚基龜),85,71,156,0
32932,양기대(梁基大),엄태영(嚴泰永),51,8,59,1
32933,양기대(梁基大),오기형(吳奇炯),92,49,141,0
32934,양기대(梁基大),오영환(吳永煥),141,179,320,0
32935,양기대(梁基大),용혜인(龍慧仁),13,11,24,1
32936,양기대(梁基大),우상호(禹相虎),79,32,111,0
32937,양기대(梁基大),우원식(禹元植),95,61,156,0
32938,양기대(梁基大),위성곤(魏聖坤),93,100,193,0
32939,양기대(梁基大),유경준(兪京濬),50,4,54,1
32940,양기대(梁基大),유기홍(柳基洪),80,55,135,0
32941,양기대(梁基大),유동수(柳東秀),89,56,145,0
32942,양기대(梁基大),유상범(劉相凡),50,4,54,1
32943,양기대(梁基大),유의동(兪義東),49,4,53,1
32944,양기대(梁基大),유정주(兪訂炷),101,86,187,0
32945,양기대(梁基大),윤건영(尹建永),82,59,141,0
32946,양기대(梁基大),윤관석(尹官石),86,47,133,1
32947,양기대(梁基大),윤두현(尹斗鉉),49,4,53,1
32948,양기대(梁基大),윤미향(尹美香),44,40,84,1
32949,양기대(梁基大),윤상현(尹相現),31,6,37,1
32950,양기대(梁基大),윤영덕(尹永德),97,103,200,0
32951,양기대(梁基大),윤영석(尹永碩),50,4,54,1
32952,양기대(梁基大),윤영찬(尹永燦),83,79,162,0
32953,양기대(梁基大),윤재갑(尹才鉀),102,97,199,0
32954,양기대(梁基大),윤재옥(尹在玉),49,4,53,1
32955,양기대(梁基大),윤주경(尹柱卿),49,4,53,1
32956,양기대(梁基大),윤준병(尹準炳),115,147,262,0
32957,양기대(梁基大),윤창현(尹暢賢),49,5,54,1
32958,양기대(梁基大),윤한홍(尹漢洪),50,4,54,1
32959,양기대(梁基大),윤호중(尹昊重),81,42,123,0
32960,양기대(梁基大),윤후덕(尹厚德),90,65,155,0
32961,양기대(梁基大),이개호(李介昊),101,106,207,0
32962,양기대(梁基大),이달곤(李達坤),52,5,57,1
32963,양기대(梁基大),이동주(李東洲),88,94,182,0
32964,양기대(梁基大),이만희(李晩熙),49,5,54,1
32965,양기대(梁基大),이명수(李明洙),53,10,63,1
32966,양기대(梁基大),이병훈(李炳勳),123,170,293,0
32967,양기대(梁基大),이상민(李相珉),83,38,121,0
32968,양기대(梁基大),이상헌(李相憲),90,94,184,0
32969,양기대(梁基大),이성만(李成萬),94,74,168,1
32970,양기대(梁基大),이소영(李素永),90,55,145,0
32971,양기대(梁基大),이수진(李壽珍),104,107,211,0
32972,양기대(梁基大),이수진(李秀眞),116,112,228,0
32973,양기대(梁基大),이양수(李亮壽),52,4,56,1
32974,양기대(梁基大),이용(李鏞),49,4,53,1
32975,양기대(梁基大),이용빈(李龍彬),132,139,271,0
32976,양기대(梁基大),이용선(李庸瑄),98,84,182,0
32977,양기대(梁基大),이용우(李龍雨),110,89,199,0
32978,양기대(梁基大),이용호(李容鎬),31,18,49,1
32979,양기대(梁基大),이원욱(李元旭),94,90,184,0
32980,양기대(梁基大),이원택(李源澤),85,56,141,0
32981,양기대(梁基大),이은주(李恩周),19,15,34,1
32982,양기대(梁基大),이인선(李仁善),25,4,29,1
32983,양기대(梁基大),이인영(李仁榮),76,52,128,0
32984,양기대(梁基大),이장섭(李將燮),92,85,177,0
32985,양기대(梁基大),이재명(李在明),39,19,58,0
32986,양기대(梁基大),이재정(李在汀),86,46,132,0
32987,양기대(梁基大),이정문(李楨文),91,70,161,0
32988,양기대(梁基大),이종배(李鍾培),50,6,56,1
32989,양기대(梁基大),이종성(李鍾成),49,7,56,1
32990,양기대(梁基大),이주환(李周桓),49,5,54,1
32991,양기대(梁基大),이채익(李埰益),52,5,57,1
32992,양기대(梁基大),이철규(李喆圭),51,5,56,1
32993,양기대(梁基大),이탄희(李誕熙),90,54,144,0
32994,양기대(梁基大),이태규(李泰珪),29,5,34,1
32995,양기대(梁基大),이학영(李學永),93,91,184,0
32996,양기대(梁基大),이해식(李海植),123,96,219,0
32997,양기대(梁基大),이헌승(李憲昇),50,7,57,1
32998,양기대(梁基大),이형석(李炯錫),134,107,241,0
32999,양기대(梁基大),인재근(印在謹),92,60,152,0
33000,양기대(梁基大),임병헌(林炳憲),25,4,29,1
33001,양기대(梁基大),임오경(林五卿),110,100,210,0
33002,양기대(梁基大),임이자(林利子),49,4,53,1
33003,양기대(梁基大),임종성(林鍾聲),107,78,185,0
33004,양기대(梁基大),임호선(林昊宣),140,178,318,0
33005,양기대(梁基大),장경태(張耿態),107,94,201,0
33006,양기대(梁基大),장동혁(張東赫),25,5,30,1
33007,양기대(梁基大),장제원(張濟元),49,4,53,1
33008,양기대(梁基大),장철민(張喆敏),92,82,174,0
33009,양기대(梁基大),장혜영(張惠英),14,11,25,1
33010,양기대(梁基大),전봉민(田奉珉),35,5,40,1
33011,양기대(梁基大),전용기(田溶冀),99,93,192,0
33012,양기대(梁基大),전재수(田載秀),82,68,150,0
33013,양기대(梁基大),전주혜(全珠惠),51,4,55,1
33014,양기대(梁基大),전해철(全海澈),79,47,126,0
33015,양기대(梁基大),전혜숙(全惠淑),96,86,182,0
33016,양기대(梁基大),정경희(丁慶姬),49,4,53,1
33017,양기대(梁基大),정동만(鄭東萬),49,4,53,1
33018,양기대(梁基大),정성호(鄭成湖),82,72,154,0
33019,양기대(梁基大),정우택(鄭宇澤),25,4,29,1
33020,양기대(梁基大),정운천(鄭雲天),49,4,53,1
33021,양기대(梁基大),정일영(鄭日永),106,92,198,0
33022,양기대(梁基大),정점식(鄭点植),50,4,54,1
33023,양기대(梁基大),정진석(鄭鎭碩),50,5,55,1
33024,양기대(梁基大),정청래(鄭淸來),93,44,137,0
33025,양기대(梁基大),정춘숙(鄭春淑),85,62,147,0
33026,양기대(梁基大),정태호(鄭泰浩),89,121,210,0
33027,양기대(梁基大),정필모(鄭必模),90,80,170,0
33028,양기대(梁基大),정희용(鄭熙溶),51,5,56,1
33029,양기대(梁基大),조경태(趙慶泰),49,5,54,1
33030,양기대(梁基大),조명희(曺明姬),49,5,54,1
33031,양기대(梁基大),조수진(趙修眞),49,4,53,1
33032,양기대(梁基大),조승래(趙承來),89,64,153,0
33033,양기대(梁基大),조오섭(曺五燮),102,127,229,0
33034,양기대(梁基大),조은희(趙恩禧),25,7,32,1
33035,양기대(梁基大),조응천(趙應天),74,34,108,0
33036,양기대(梁基大),조정식(趙正湜),77,59,136,0
33037,양기대(梁基大),조정훈(趙廷訓),4,4,8,1
33038,양기대(梁基大),조해진(曺海珍),52,5,57,1
33039,양기대(梁基大),주철현(朱哲鉉),90,71,161,0
33040,양기대(梁基大),주호영(朱豪英),50,4,54,1
33041,양기대(梁基大),지성호(池成浩),50,8,58,1
33042,양기대(梁基大),진선미(陳善美),83,46,129,0
33043,양기대(梁基大),진성준(陳聲準),108,91,199,0
33044,양기대(梁基大),천준호(千俊鎬),94,58,152,0
33045,양기대(梁基大),최기상(崔基相),80,61,141,0
33046,양기대(梁基大),최승재(崔承宰),49,4,53,1
33047,양기대(梁基大),최연숙(崔姸淑),33,6,39,1
33048,양기대(梁基大),최영희(崔英姬),25,5,30,1
33049,양기대(梁基大),최인호(崔仁昊),91,98,189,0
33050,양기대(梁基大),최재형(崔在亨),25,4,29,1
33051,양기대(梁基大),최종윤(崔鍾允),94,84,178,0
33052,양기대(梁基大),최춘식(崔春植),52,7,59,1
33053,양기대(梁基大),최형두(崔炯斗),50,6,56,1
33054,양기대(梁基大),최혜영(崔惠英),95,86,181,0
33055,양기대(梁基大),추경호(秋慶鎬),50,3,53,1
33056,양기대(梁基大),태영호(太永浩),50,4,54,1
33057,양기대(梁基大),하영제(河榮帝),42,2,44,1
33058,양기대(梁基大),하태경(河泰慶),49,4,53,1
33059,양기대(梁基大),한기호(韓起鎬),52,8,60,1
33060,양기대(梁基大),한무경(韓茂景),51,5,56,1
33061,양기대(梁基大),한병도(韓秉道),124,121,245,0
33062,양기대(梁基大),한정애(韓貞愛),78,45,123,0
33063,양기대(梁基大),한준호(韓俊鎬),103,91,194,0
33064,양기대(梁基大),허숙정(許淑湞),1,2,3,0
33065,양기대(梁基大),허영(許榮),119,137,256,0
33066,양기대(梁基大),허은아(許垠娥),50,4,54,1
33067,양기대(梁基大),허종식(許琮植),96,93,189,0
33068,양기대(梁基大),홍기원(洪起元),97,101,198,0
33069,양기대(梁基大),홍문표(洪文杓),50,9,59,1
33070,양기대(梁基大),홍석준(洪碩晙),50,5,55,1
33071,양기대(梁基大),홍성국(洪性國),141,204,345,0
33072,양기대(梁基大),홍영표(洪永杓),88,87,175,0
33073,양기대(梁基大),홍익표(洪翼杓),101,89,190,0
33074,양기대(梁基大),홍정민(洪貞敏),106,84,190,0
33075,양기대(梁基大),황보승희(皇甫承希),47,1,48,1
33076,양기대(梁基大),황운하(黃雲夏),105,101,206,0
33077,양기대(梁基大),황희(黃熙),80,44,124,0
33078,양이원영(梁李媛瑛),양정숙(梁貞淑),102,195,297,1
33079,양이원영(梁李媛瑛),양향자(梁香子),39,38,77,1
33080,양이원영(梁李媛瑛),어기구(魚基龜),79,47,126,0
33081,양이원영(梁李媛瑛),엄태영(嚴泰永),46,5,51,1
33082,양이원영(梁李媛瑛),오기형(吳奇炯),76,52,128,0
33083,양이원영(梁李媛瑛),오영환(吳永煥),159,222,381,0
33084,양이원영(梁李媛瑛),용혜인(龍慧仁),36,84,120,1
33085,양이원영(梁李媛瑛),우상호(禹相虎),73,42,115,0
33086,양이원영(梁李媛瑛),우원식(禹元植),105,142,247,0
33087,양이원영(梁李媛瑛),위성곤(魏聖坤),94,133,227,0
33088,양이원영(梁李媛瑛),유경준(兪京濬),45,5,50,1
33089,양이원영(梁李媛瑛),유기홍(柳基洪),72,48,120,0
33090,양이원영(梁李媛瑛),유동수(柳東秀),86,53,139,0
33091,양이원영(梁李媛瑛),유상범(劉相凡),45,4,49,1
33092,양이원영(梁李媛瑛),유의동(兪義東),46,4,50,1
33093,양이원영(梁李媛瑛),유정주(兪訂炷),134,213,347,0
33094,양이원영(梁李媛瑛),윤건영(尹建永),84,89,173,0
33095,양이원영(梁李媛瑛),윤관석(尹官石),94,71,165,1
33096,양이원영(梁李媛瑛),윤두현(尹斗鉉),45,4,49,1
33097,양이원영(梁李媛瑛),윤미향(尹美香),147,168,315,1
33098,양이원영(梁李媛瑛),윤상현(尹相現),25,4,29,1
33099,양이원영(梁李媛瑛),윤영덕(尹永德),102,152,254,0
33100,양이원영(梁李媛瑛),윤영석(尹永碩),45,5,50,1
33101,양이원영(梁李媛瑛),윤영찬(尹永燦),82,47,129,0
33102,양이원영(梁李媛瑛),윤재갑(尹才鉀),126,131,257,0
33103,양이원영(梁李媛瑛),윤재옥(尹在玉),46,4,50,1
33104,양이원영(梁李媛瑛),윤주경(尹柱卿),45,5,50,1
33105,양이원영(梁李媛瑛),윤준병(尹準炳),165,201,366,0
33106,양이원영(梁李媛瑛),윤창현(尹暢賢),45,5,50,1
33107,양이원영(梁李媛瑛),윤한홍(尹漢洪),45,4,49,1
33108,양이원영(梁李媛瑛),윤호중(尹昊重),73,49,122,0
33109,양이원영(梁李媛瑛),윤후덕(尹厚德),88,84,172,0
33110,양이원영(梁李媛瑛),이개호(李介昊),74,55,129,0
33111,양이원영(梁李媛瑛),이달곤(李達坤),47,5,52,1
33112,양이원영(梁李媛瑛),이동주(李東洲),97,130,227,0
33113,양이원영(梁李媛瑛),이만희(李晩熙),46,4,50,1
33114,양이원영(梁李媛瑛),이명수(李明洙),47,17,64,1
33115,양이원영(梁李媛瑛),이병훈(李炳勳),108,101,209,0
33116,양이원영(梁李媛瑛),이상민(李相珉),71,40,111,0
33117,양이원영(梁李媛瑛),이상헌(李相憲),99,72,171,0
33118,양이원영(梁李媛瑛),이성만(李成萬),100,104,204,1
33119,양이원영(梁李媛瑛),이소영(李素永),103,99,202,0
33120,양이원영(梁李媛瑛),이수진(李壽珍),192,271,463,0
33121,양이원영(梁李媛瑛),이수진(李秀眞),113,127,240,0
33122,양이원영(梁李媛瑛),이양수(李亮壽),45,6,51,1
33123,양이원영(梁李媛瑛),이용(李鏞),45,4,49,1
33124,양이원영(梁李媛瑛),이용빈(李龍彬),135,205,340,0
33125,양이원영(梁李媛瑛),이용선(李庸瑄),97,134,231,0
33126,양이원영(梁李媛瑛),이용우(李龍雨),103,95,198,0
33127,양이원영(梁李媛瑛),이용호(李容鎬),33,14,47,1
33128,양이원영(梁李媛瑛),이원욱(李元旭),95,82,177,0
33129,양이원영(梁李媛瑛),이원택(李源澤),111,107,218,0
33130,양이원영(梁李媛瑛),이은주(李恩周),20,60,80,1
33131,양이원영(梁李媛瑛),이인선(李仁善),25,5,30,1
33132,양이원영(梁李媛瑛),이인영(李仁榮),83,57,140,0
33133,양이원영(梁李媛瑛),이장섭(李將燮),90,77,167,0
33134,양이원영(梁李媛瑛),이재명(李在明),40,24,64,0
33135,양이원영(梁李媛瑛),이재정(李在汀),94,67,161,0
33136,양이원영(梁李媛瑛),이정문(李楨文),80,75,155,0
33137,양이원영(梁李媛瑛),이종배(李鍾培),46,5,51,1
33138,양이원영(梁李媛瑛),이종성(李鍾成),45,9,54,1
33139,양이원영(梁李媛瑛),이주환(李周桓),45,5,50,1
33140,양이원영(梁李媛瑛),이채익(李埰益),47,6,53,1
33141,양이원영(梁李媛瑛),이철규(李喆圭),45,6,51,1
33142,양이원영(梁李媛瑛),이탄희(李誕熙),112,125,237,0
33143,양이원영(梁李媛瑛),이태규(李泰珪),28,6,34,1
33144,양이원영(梁李媛瑛),이학영(李學永),108,103,211,0
33145,양이원영(梁李媛瑛),이해식(李海植),114,105,219,0
33146,양이원영(梁李媛瑛),이헌승(李憲昇),45,4,49,1
33147,양이원영(梁李媛瑛),이형석(李炯錫),105,96,201,0
33148,양이원영(梁李媛瑛),인재근(印在謹),115,112,227,0
33149,양이원영(梁李媛瑛),임병헌(林炳憲),25,4,29,1
33150,양이원영(梁李媛瑛),임오경(林五卿),110,107,217,0
33151,양이원영(梁李媛瑛),임이자(林利子),45,4,49,1
33152,양이원영(梁李媛瑛),임종성(林鍾聲),129,130,259,0
33153,양이원영(梁李媛瑛),임호선(林昊宣),101,112,213,0
33154,양이원영(梁李媛瑛),장경태(張耿態),104,150,254,0
33155,양이원영(梁李媛瑛),장동혁(張東赫),25,4,29,1
33156,양이원영(梁李媛瑛),장제원(張濟元),45,4,49,1
33157,양이원영(梁李媛瑛),장철민(張喆敏),132,85,217,0
33158,양이원영(梁李媛瑛),장혜영(張惠英),21,50,71,1
33159,양이원영(梁李媛瑛),전봉민(田奉珉),35,5,40,1
33160,양이원영(梁李媛瑛),전용기(田溶冀),90,90,180,0
33161,양이원영(梁李媛瑛),전재수(田載秀),82,64,146,0
33162,양이원영(梁李媛瑛),전주혜(全珠惠),46,5,51,1
33163,양이원영(梁李媛瑛),전해철(全海澈),74,52,126,0
33164,양이원영(梁李媛瑛),전혜숙(全惠淑),120,119,239,0
33165,양이원영(梁李媛瑛),정경희(丁慶姬),45,4,49,1
33166,양이원영(梁李媛瑛),정동만(鄭東萬),45,4,49,1
33167,양이원영(梁李媛瑛),정성호(鄭成湖),83,74,157,0
33168,양이원영(梁李媛瑛),정우택(鄭宇澤),25,4,29,1
33169,양이원영(梁李媛瑛),정운천(鄭雲天),45,4,49,1
33170,양이원영(梁李媛瑛),정일영(鄭日永),89,85,174,0
33171,양이원영(梁李媛瑛),정점식(鄭点植),45,4,49,1
33172,양이원영(梁李媛瑛),정진석(鄭鎭碩),45,5,50,1
33173,양이원영(梁李媛瑛),정청래(鄭淸來),109,129,238,0
33174,양이원영(梁李媛瑛),정춘숙(鄭春淑),96,99,195,0
33175,양이원영(梁李媛瑛),정태호(鄭泰浩),81,77,158,0
33176,양이원영(梁李媛瑛),정필모(鄭必模),103,118,221,0
33177,양이원영(梁李媛瑛),정희용(鄭熙溶),46,6,52,1
33178,양이원영(梁李媛瑛),조경태(趙慶泰),45,4,49,1
33179,양이원영(梁李媛瑛),조명희(曺明姬),45,7,52,1
33180,양이원영(梁李媛瑛),조수진(趙修眞),45,4,49,1
33181,양이원영(梁李媛瑛),조승래(趙承來),96,61,157,0
33182,양이원영(梁李媛瑛),조오섭(曺五燮),109,115,224,0
33183,양이원영(梁李媛瑛),조은희(趙恩禧),25,4,29,1
33184,양이원영(梁李媛瑛),조응천(趙應天),65,34,99,0
33185,양이원영(梁李媛瑛),조정식(趙正湜),71,42,113,0
33186,양이원영(梁李媛瑛),조정훈(趙廷訓),6,20,26,1
33187,양이원영(梁李媛瑛),조해진(曺海珍),46,5,51,1
33188,양이원영(梁李媛瑛),주철현(朱哲鉉),104,125,229,0
33189,양이원영(梁李媛瑛),주호영(朱豪英),45,4,49,1
33190,양이원영(梁李媛瑛),지성호(池成浩),45,4,49,1
33191,양이원영(梁李媛瑛),진선미(陳善美),78,66,144,0
33192,양이원영(梁李媛瑛),진성준(陳聲準),109,143,252,0
33193,양이원영(梁李媛瑛),천준호(千俊鎬),93,79,172,0
33194,양이원영(梁李媛瑛),최기상(崔基相),80,69,149,0
33195,양이원영(梁李媛瑛),최승재(崔承宰),45,7,52,1
33196,양이원영(梁李媛瑛),최연숙(崔姸淑),33,14,47,1
33197,양이원영(梁李媛瑛),최영희(崔英姬),25,4,29,1
33198,양이원영(梁李媛瑛),최인호(崔仁昊),77,55,132,0
33199,양이원영(梁李媛瑛),최재형(崔在亨),25,4,29,1
33200,양이원영(梁李媛瑛),최종윤(崔鍾允),121,119,240,0
33201,양이원영(梁李媛瑛),최춘식(崔春植),45,13,58,1
33202,양이원영(梁李媛瑛),최형두(崔炯斗),45,6,51,1
33203,양이원영(梁李媛瑛),최혜영(崔惠英),114,151,265,0
33204,양이원영(梁李媛瑛),추경호(秋慶鎬),45,4,49,1
33205,양이원영(梁李媛瑛),태영호(太永浩),45,7,52,1
33206,양이원영(梁李媛瑛),하영제(河榮帝),36,2,38,1
33207,양이원영(梁李媛瑛),하태경(河泰慶),45,4,49,1
33208,양이원영(梁李媛瑛),한기호(韓起鎬),45,5,50,1
33209,양이원영(梁李媛瑛),한무경(韓茂景),45,5,50,1
33210,양이원영(梁李媛瑛),한병도(韓秉道),101,85,186,0
33211,양이원영(梁李媛瑛),한정애(韓貞愛),77,55,132,0
33212,양이원영(梁李媛瑛),한준호(韓俊鎬),101,94,195,0
33213,양이원영(梁李媛瑛),허숙정(許淑湞),1,2,3,0
33214,양이원영(梁李媛瑛),허영(許榮),119,120,239,0
33215,양이원영(梁李媛瑛),허은아(許垠娥),45,5,50,1
33216,양이원영(梁李媛瑛),허종식(許琮植),95,74,169,0
33217,양이원영(梁李媛瑛),홍기원(洪起元),86,66,152,0
33218,양이원영(梁李媛瑛),홍문표(洪文杓),45,5,50,1
33219,양이원영(梁李媛瑛),홍석준(洪碩晙),45,4,49,1
33220,양이원영(梁李媛瑛),홍성국(洪性國),122,125,247,0
33221,양이원영(梁李媛瑛),홍영표(洪永杓),90,60,150,0
33222,양이원영(梁李媛瑛),홍익표(洪翼杓),95,81,176,0
33223,양이원영(梁李媛瑛),홍정민(洪貞敏),109,144,253,0
33224,양이원영(梁李媛瑛),황보승희(皇甫承希),42,2,44,1
33225,양이원영(梁李媛瑛),황운하(黃雲夏),131,160,291,0
33226,양이원영(梁李媛瑛),황희(黃熙),75,47,122,0
33227,양정숙(梁貞淑),양향자(梁香子),51,149,200,1
33228,양정숙(梁貞淑),어기구(魚基龜),27,81,108,1
33229,양정숙(梁貞淑),엄태영(嚴泰永),5,7,12,1
33230,양정숙(梁貞淑),오기형(吳奇炯),19,34,53,1
33231,양정숙(梁貞淑),오영환(吳永煥),187,476,663,1
33232,양정숙(梁貞淑),용혜인(龍慧仁),59,192,251,1
33233,양정숙(梁貞淑),우상호(禹相虎),19,31,50,1
33234,양정숙(梁貞淑),우원식(禹元植),42,103,145,1
33235,양정숙(梁貞淑),위성곤(魏聖坤),85,287,372,1
33236,양정숙(梁貞淑),유경준(兪京濬),1,5,6,1
33237,양정숙(梁貞淑),유기홍(柳基洪),20,54,74,1
33238,양정숙(梁貞淑),유동수(柳東秀),48,86,134,1
33239,양정숙(梁貞淑),유상범(劉相凡),2,1,3,1
33240,양정숙(梁貞淑),유의동(兪義東),4,6,10,1
33241,양정숙(梁貞淑),유정주(兪訂炷),90,214,304,1
33242,양정숙(梁貞淑),윤건영(尹建永),41,95,136,1
33243,양정숙(梁貞淑),윤관석(尹官石),60,109,169,0
33244,양정숙(梁貞淑),윤두현(尹斗鉉),2,5,7,1
33245,양정숙(梁貞淑),윤미향(尹美香),100,308,408,0
33246,양정숙(梁貞淑),윤상현(尹相現),4,12,16,1
33247,양정숙(梁貞淑),윤영덕(尹永德),69,218,287,1
33248,양정숙(梁貞淑),윤영석(尹永碩),1,4,5,1
33249,양정숙(梁貞淑),윤영찬(尹永燦),35,96,131,1
33250,양정숙(梁貞淑),윤재갑(尹才鉀),136,272,408,1
33251,양정숙(梁貞淑),윤재옥(尹在玉),4,3,7,1
33252,양정숙(梁貞淑),윤주경(尹柱卿),2,3,5,1
33253,양정숙(梁貞淑),윤준병(尹準炳),157,583,740,1
33254,양정숙(梁貞淑),윤창현(尹暢賢),2,9,11,1
33255,양정숙(梁貞淑),윤한홍(尹漢洪),1,4,5,1
33256,양정숙(梁貞淑),윤호중(尹昊重),11,43,54,1
33257,양정숙(梁貞淑),윤후덕(尹厚德),41,137,178,1
33258,양정숙(梁貞淑),이개호(李介昊),56,162,218,1
33259,양정숙(梁貞淑),이달곤(李達坤),5,5,10,1
33260,양정숙(梁貞淑),이동주(李東洲),53,148,201,1
33261,양정숙(梁貞淑),이만희(李晩熙),3,4,7,1
33262,양정숙(梁貞淑),이명수(李明洙),11,49,60,1
33263,양정숙(梁貞淑),이병훈(李炳勳),94,228,322,1
33264,양정숙(梁貞淑),이상민(李相珉),22,46,68,1
33265,양정숙(梁貞淑),이상헌(李相憲),99,247,346,1
33266,양정숙(梁貞淑),이성만(李成萬),127,257,384,0
33267,양정숙(梁貞淑),이소영(李素永),30,67,97,1
33268,양정숙(梁貞淑),이수진(李壽珍),135,404,539,1
33269,양정숙(梁貞淑),이수진(李秀眞),55,175,230,1
33270,양정숙(梁貞淑),이양수(李亮壽),5,7,12,1
33271,양정숙(梁貞淑),이용(李鏞),0,3,3,1
33272,양정숙(梁貞淑),이용빈(李龍彬),174,533,707,1
33273,양정숙(梁貞淑),이용선(李庸瑄),60,210,270,1
33274,양정숙(梁貞淑),이용우(李龍雨),54,121,175,1
33275,양정숙(梁貞淑),이용호(李容鎬),46,114,160,1
33276,양정숙(梁貞淑),이원욱(李元旭),54,146,200,1
33277,양정숙(梁貞淑),이원택(李源澤),75,165,240,1
33278,양정숙(梁貞淑),이은주(李恩周),70,183,253,1
33279,양정숙(梁貞淑),이인선(李仁善),0,10,10,1
33280,양정숙(梁貞淑),이인영(李仁榮),21,47,68,1
33281,양정숙(梁貞淑),이장섭(李將燮),56,141,197,1
33282,양정숙(梁貞淑),이재명(李在明),6,15,21,1
33283,양정숙(梁貞淑),이재정(李在汀),34,81,115,1
33284,양정숙(梁貞淑),이정문(李楨文),72,191,263,1
33285,양정숙(梁貞淑),이종배(李鍾培),4,9,13,1
33286,양정숙(梁貞淑),이종성(李鍾成),2,14,16,1
33287,양정숙(梁貞淑),이주환(李周桓),2,4,6,1
33288,양정숙(梁貞淑),이채익(李埰益),7,19,26,1
33289,양정숙(梁貞淑),이철규(李喆圭),2,3,5,1
33290,양정숙(梁貞淑),이탄희(李誕熙),48,122,170,1
33291,양정숙(梁貞淑),이태규(李泰珪),4,18,22,1
33292,양정숙(梁貞淑),이학영(李學永),63,124,187,1
33293,양정숙(梁貞淑),이해식(李海植),79,158,237,1
33294,양정숙(梁貞淑),이헌승(李憲昇),3,5,8,1
33295,양정숙(梁貞淑),이형석(李炯錫),72,165,237,1
33296,양정숙(梁貞淑),인재근(印在謹),106,226,332,1
33297,양정숙(梁貞淑),임병헌(林炳憲),4,10,14,1
33298,양정숙(梁貞淑),임오경(林五卿),59,131,190,1
33299,양정숙(梁貞淑),임이자(林利子),2,4,6,1
33300,양정숙(梁貞淑),임종성(林鍾聲),80,222,302,1
33301,양정숙(梁貞淑),임호선(林昊宣),105,210,315,1
33302,양정숙(梁貞淑),장경태(張耿態),75,238,313,1
33303,양정숙(梁貞淑),장동혁(張東赫),1,2,3,1
33304,양정숙(梁貞淑),장제원(張濟元),0,1,1,1
33305,양정숙(梁貞淑),장철민(張喆敏),80,149,229,1
33306,양정숙(梁貞淑),장혜영(張惠英),38,167,205,1
33307,양정숙(梁貞淑),전봉민(田奉珉),3,2,5,1
33308,양정숙(梁貞淑),전용기(田溶冀),60,143,203,1
33309,양정숙(梁貞淑),전재수(田載秀),32,76,108,1
33310,양정숙(梁貞淑),전주혜(全珠惠),3,4,7,1
33311,양정숙(梁貞淑),전해철(全海澈),21,56,77,1
33312,양정숙(梁貞淑),전혜숙(全惠淑),92,218,310,1
33313,양정숙(梁貞淑),정경희(丁慶姬),2,0,2,1
33314,양정숙(梁貞淑),정동만(鄭東萬),4,6,10,1
33315,양정숙(梁貞淑),정성호(鄭成湖),38,141,179,1
33316,양정숙(梁貞淑),정우택(鄭宇澤),2,4,6,1
33317,양정숙(梁貞淑),정운천(鄭雲天),2,4,6,1
33318,양정숙(梁貞淑),정일영(鄭日永),47,141,188,1
33319,양정숙(梁貞淑),정점식(鄭点植),1,0,1,1
33320,양정숙(梁貞淑),정진석(鄭鎭碩),3,4,7,1
33321,양정숙(梁貞淑),정청래(鄭淸來),47,89,136,1
33322,양정숙(梁貞淑),정춘숙(鄭春淑),78,133,211,1
33323,양정숙(梁貞淑),정태호(鄭泰浩),26,118,144,1
33324,양정숙(梁貞淑),정필모(鄭必模),41,127,168,1
33325,양정숙(梁貞淑),정희용(鄭熙溶),5,10,15,1
33326,양정숙(梁貞淑),조경태(趙慶泰),4,5,9,1
33327,양정숙(梁貞淑),조명희(曺明姬),2,9,11,1
33328,양정숙(梁貞淑),조수진(趙修眞),2,4,6,1
33329,양정숙(梁貞淑),조승래(趙承來),83,121,204,1
33330,양정숙(梁貞淑),조오섭(曺五燮),88,301,389,1
33331,양정숙(梁貞淑),조은희(趙恩禧),3,4,7,1
33332,양정숙(梁貞淑),조응천(趙應天),19,34,53,1
33333,양정숙(梁貞淑),조정식(趙正湜),15,29,44,1
33334,양정숙(梁貞淑),조정훈(趙廷訓),17,65,82,1
33335,양정숙(梁貞淑),조해진(曺海珍),5,3,8,1
33336,양정숙(梁貞淑),주철현(朱哲鉉),95,224,319,1
33337,양정숙(梁貞淑),주호영(朱豪英),2,3,5,1
33338,양정숙(梁貞淑),지성호(池成浩),1,10,11,1
33339,양정숙(梁貞淑),진선미(陳善美),28,59,87,1
33340,양정숙(梁貞淑),진성준(陳聲準),39,142,181,1
33341,양정숙(梁貞淑),천준호(千俊鎬),31,76,107,1
33342,양정숙(梁貞淑),최기상(崔基相),21,71,92,1
33343,양정숙(梁貞淑),최승재(崔承宰),6,23,29,1
33344,양정숙(梁貞淑),최연숙(崔姸淑),17,47,64,1
33345,양정숙(梁貞淑),최영희(崔英姬),2,7,9,1
33346,양정숙(梁貞淑),최인호(崔仁昊),38,79,117,1
33347,양정숙(梁貞淑),최재형(崔在亨),0,6,6,1
33348,양정숙(梁貞淑),최종윤(崔鍾允),112,268,380,1
33349,양정숙(梁貞淑),최춘식(崔春植),2,22,24,1
33350,양정숙(梁貞淑),최형두(崔炯斗),7,10,17,1
33351,양정숙(梁貞淑),최혜영(崔惠英),97,166,263,1
33352,양정숙(梁貞淑),추경호(秋慶鎬),2,5,7,1
33353,양정숙(梁貞淑),태영호(太永浩),3,21,24,1
33354,양정숙(梁貞淑),하영제(河榮帝),5,15,20,0
33355,양정숙(梁貞淑),하태경(河泰慶),6,9,15,1
33356,양정숙(梁貞淑),한기호(韓起鎬),4,2,6,1
33357,양정숙(梁貞淑),한무경(韓茂景),2,10,12,1
33358,양정숙(梁貞淑),한병도(韓秉道),122,301,423,1
33359,양정숙(梁貞淑),한정애(韓貞愛),23,72,95,1
33360,양정숙(梁貞淑),한준호(韓俊鎬),69,193,262,1
33361,양정숙(梁貞淑),허숙정(許淑湞),1,1,2,1
33362,양정숙(梁貞淑),허영(許榮),78,148,226,1
33363,양정숙(梁貞淑),허은아(許垠娥),2,2,4,1
33364,양정숙(梁貞淑),허종식(許琮植),69,183,252,1
33365,양정숙(梁貞淑),홍기원(洪起元),38,112,150,1
33366,양정숙(梁貞淑),홍문표(洪文杓),10,13,23,1
33367,양정숙(梁貞淑),홍석준(洪碩晙),4,4,8,1
33368,양정숙(梁貞淑),홍성국(洪性國),133,271,404,1
33369,양정숙(梁貞淑),홍영표(洪永杓),26,70,96,1
33370,양정숙(梁貞淑),홍익표(洪翼杓),48,116,164,1
33371,양정숙(梁貞淑),홍정민(洪貞敏),85,192,277,1
33372,양정숙(梁貞淑),황보승희(皇甫承希),8,15,23,0
33373,양정숙(梁貞淑),황운하(黃雲夏),129,296,425,1
33374,양정숙(梁貞淑),황희(黃熙),18,54,72,1
33375,양향자(梁香子),어기구(魚基龜),45,40,85,1
33376,양향자(梁香子),엄태영(嚴泰永),21,3,24,1
33377,양향자(梁香子),오기형(吳奇炯),32,15,47,1
33378,양향자(梁香子),오영환(吳永煥),80,112,192,1
33379,양향자(梁香子),용혜인(龍慧仁),7,20,27,1
33380,양향자(梁香子),우상호(禹相虎),31,21,52,1
33381,양향자(梁香子),우원식(禹元植),48,37,85,1
33382,양향자(梁香子),위성곤(魏聖坤),53,55,108,1
33383,양향자(梁香子),유경준(兪京濬),21,7,28,1
33384,양향자(梁香子),유기홍(柳基洪),31,13,44,1
33385,양향자(梁香子),유동수(柳東秀),42,28,70,1
33386,양향자(梁香子),유상범(劉相凡),22,2,24,1
33387,양향자(梁香子),유의동(兪義東),22,3,25,1
33388,양향자(梁香子),유정주(兪訂炷),57,54,111,1
33389,양향자(梁香子),윤건영(尹建永),37,33,70,1
33390,양향자(梁香子),윤관석(尹官石),56,65,121,1
33391,양향자(梁香子),윤두현(尹斗鉉),21,14,35,1
33392,양향자(梁香子),윤미향(尹美香),39,61,100,1
33393,양향자(梁香子),윤상현(尹相現),1,12,13,1
33394,양향자(梁香子),윤영덕(尹永德),75,113,188,1
33395,양향자(梁香子),윤영석(尹永碩),22,4,26,1
33396,양향자(梁香子),윤영찬(尹永燦),40,33,73,1
33397,양향자(梁香子),윤재갑(尹才鉀),66,69,135,1
33398,양향자(梁香子),윤재옥(尹在玉),21,3,24,1
33399,양향자(梁香子),윤주경(尹柱卿),22,4,26,1
33400,양향자(梁香子),윤준병(尹準炳),46,109,155,1
33401,양향자(梁香子),윤창현(尹暢賢),20,8,28,1
33402,양향자(梁香子),윤한홍(尹漢洪),22,5,27,1
33403,양향자(梁香子),윤호중(尹昊重),30,35,65,1
33404,양향자(梁香子),윤후덕(尹厚德),58,61,119,1
33405,양향자(梁香子),이개호(李介昊),47,41,88,1
33406,양향자(梁香子),이달곤(李達坤),23,1,24,1
33407,양향자(梁香子),이동주(李東洲),40,60,100,1
33408,양향자(梁香子),이만희(李晩熙),22,2,24,1
33409,양향자(梁香子),이명수(李明洙),24,24,48,1
33410,양향자(梁香子),이병훈(李炳勳),78,118,196,1
33411,양향자(梁香子),이상민(李相珉),27,17,44,1
33412,양향자(梁香子),이상헌(李相憲),47,55,102,1
33413,양향자(梁香子),이성만(李成萬),65,50,115,1
33414,양향자(梁香子),이소영(李素永),33,18,51,1
33415,양향자(梁香子),이수진(李壽珍),50,57,107,1
33416,양향자(梁香子),이수진(李秀眞),60,45,105,1
33417,양향자(梁香子),이양수(李亮壽),21,4,25,1
33418,양향자(梁香子),이용(李鏞),20,1,21,1
33419,양향자(梁香子),이용빈(李龍彬),92,142,234,1
33420,양향자(梁香子),이용선(李庸瑄),49,61,110,1
33421,양향자(梁香子),이용우(李龍雨),43,40,83,1
33422,양향자(梁香子),이용호(李容鎬),7,22,29,1
33423,양향자(梁香子),이원욱(李元旭),57,60,117,1
33424,양향자(梁香子),이원택(李源澤),32,22,54,1
33425,양향자(梁香子),이은주(李恩周),14,18,32,1
33426,양향자(梁香子),이인선(李仁善),2,11,13,1
33427,양향자(梁香子),이인영(李仁榮),28,13,41,1
33428,양향자(梁香子),이장섭(李將燮),45,38,83,1
33429,양향자(梁香子),이재명(李在明),1,4,5,1
33430,양향자(梁香子),이재정(李在汀),35,23,58,1
33431,양향자(梁香子),이정문(李楨文),54,62,116,1
33432,양향자(梁香子),이종배(李鍾培),23,14,37,1
33433,양향자(梁香子),이종성(李鍾成),21,13,34,1
33434,양향자(梁香子),이주환(李周桓),23,14,37,1
33435,양향자(梁香子),이채익(李埰益),21,1,22,1
33436,양향자(梁香子),이철규(李喆圭),21,10,31,1
33437,양향자(梁香子),이탄희(李誕熙),41,44,85,1
33438,양향자(梁香子),이태규(李泰珪),10,18,28,1
33439,양향자(梁香子),이학영(李學永),50,46,96,1
33440,양향자(梁香子),이해식(李海植),62,44,106,1
33441,양향자(梁香子),이헌승(李憲昇),21,14,35,1
33442,양향자(梁香子),이형석(李炯錫),82,106,188,1
33443,양향자(梁香子),인재근(印在謹),49,83,132,1
33444,양향자(梁香子),임병헌(林炳憲),3,19,22,1
33445,양향자(梁香子),임오경(林五卿),68,73,141,1
33446,양향자(梁香子),임이자(林利子),20,10,30,1
33447,양향자(梁香子),임종성(林鍾聲),61,76,137,1
33448,양향자(梁香子),임호선(林昊宣),69,88,157,1
33449,양향자(梁香子),장경태(張耿態),60,59,119,1
33450,양향자(梁香子),장동혁(張東赫),0,14,14,1
33451,양향자(梁香子),장제원(張濟元),20,2,22,1
33452,양향자(梁香子),장철민(張喆敏),43,40,83,1
33453,양향자(梁香子),장혜영(張惠英),9,8,17,1
33454,양향자(梁香子),전봉민(田奉珉),9,2,11,1
33455,양향자(梁香子),전용기(田溶冀),66,74,140,1
33456,양향자(梁香子),전재수(田載秀),43,36,79,1
33457,양향자(梁香子),전주혜(全珠惠),23,6,29,1
33458,양향자(梁香子),전해철(全海澈),33,19,52,1
33459,양향자(梁香子),전혜숙(全惠淑),50,62,112,1
33460,양향자(梁香子),정경희(丁慶姬),21,6,27,1
33461,양향자(梁香子),정동만(鄭東萬),20,4,24,1
33462,양향자(梁香子),정성호(鄭成湖),55,48,103,1
33463,양향자(梁香子),정우택(鄭宇澤),5,15,20,1
33464,양향자(梁香子),정운천(鄭雲天),23,8,31,1
33465,양향자(梁香子),정일영(鄭日永),55,72,127,1
33466,양향자(梁香子),정점식(鄭点植),22,1,23,1
33467,양향자(梁香子),정진석(鄭鎭碩),21,3,24,1
33468,양향자(梁香子),정청래(鄭淸來),39,31,70,1
33469,양향자(梁香子),정춘숙(鄭春淑),41,49,90,1
33470,양향자(梁香子),정태호(鄭泰浩),41,51,92,1
33471,양향자(梁香子),정필모(鄭必模),39,36,75,1
33472,양향자(梁香子),정희용(鄭熙溶),22,11,33,1
33473,양향자(梁香子),조경태(趙慶泰),26,5,31,1
33474,양향자(梁香子),조명희(曺明姬),25,16,41,1
33475,양향자(梁香子),조수진(趙修眞),20,2,22,1
33476,양향자(梁香子),조승래(趙承來),51,40,91,1
33477,양향자(梁香子),조오섭(曺五燮),78,127,205,1
33478,양향자(梁香子),조은희(趙恩禧),4,7,11,1
33479,양향자(梁香子),조응천(趙應天),30,14,44,1
33480,양향자(梁香子),조정식(趙正湜),33,21,54,1
33481,양향자(梁香子),조정훈(趙廷訓),2,14,16,1
33482,양향자(梁香子),조해진(曺海珍),21,4,25,1
33483,양향자(梁香子),주철현(朱哲鉉),52,71,123,1
33484,양향자(梁香子),주호영(朱豪英),22,8,30,1
33485,양향자(梁香子),지성호(池成浩),22,8,30,1
33486,양향자(梁香子),진선미(陳善美),36,29,65,1
33487,양향자(梁香子),진성준(陳聲準),54,34,88,1
33488,양향자(梁香子),천준호(千俊鎬),42,28,70,1
33489,양향자(梁香子),최기상(崔基相),32,29,61,1
33490,양향자(梁香子),최승재(崔承宰),23,10,33,1
33491,양향자(梁香子),최연숙(崔姸淑),8,39,47,1
33492,양향자(梁香子),최영희(崔英姬),0,13,13,1
33493,양향자(梁香子),최인호(崔仁昊),41,27,68,1
33494,양향자(梁香子),최재형(崔在亨),0,6,6,1
33495,양향자(梁香子),최종윤(崔鍾允),51,59,110,1
33496,양향자(梁香子),최춘식(崔春植),20,9,29,1
33497,양향자(梁香子),최형두(崔炯斗),24,5,29,1
33498,양향자(梁香子),최혜영(崔惠英),56,67,123,1
33499,양향자(梁香子),추경호(秋慶鎬),22,2,24,1
33500,양향자(梁香子),태영호(太永浩),23,11,34,1
33501,양향자(梁香子),하영제(河榮帝),23,6,29,1
33502,양향자(梁香子),하태경(河泰慶),23,7,30,1
33503,양향자(梁香子),한기호(韓起鎬),22,6,28,1
33504,양향자(梁香子),한무경(韓茂景),22,7,29,1
33505,양향자(梁香子),한병도(韓秉道),44,52,96,1
33506,양향자(梁香子),한정애(韓貞愛),31,35,66,1
33507,양향자(梁香子),한준호(韓俊鎬),53,49,102,1
33508,양향자(梁香子),허숙정(許淑湞),0,0,0,1
33509,양향자(梁香子),허영(許榮),54,66,120,1
33510,양향자(梁香子),허은아(許垠娥),21,3,24,1
33511,양향자(梁香子),허종식(許琮植),55,52,107,1
33512,양향자(梁香子),홍기원(洪起元),47,31,78,1
33513,양향자(梁香子),홍문표(洪文杓),27,10,37,1
33514,양향자(梁香子),홍석준(洪碩晙),21,4,25,1
33515,양향자(梁香子),홍성국(洪性國),68,85,153,1
33516,양향자(梁香子),홍영표(洪永杓),39,31,70,1
33517,양향자(梁香子),홍익표(洪翼杓),43,41,84,1
33518,양향자(梁香子),홍정민(洪貞敏),53,58,111,1
33519,양향자(梁香子),황보승희(皇甫承希),26,21,47,1
33520,양향자(梁香子),황운하(黃雲夏),53,57,110,1
33521,양향자(梁香子),황희(黃熙),28,26,54,1
33522,어기구(魚基龜),엄태영(嚴泰永),51,7,58,1
33523,어기구(魚基龜),오기형(吳奇炯),80,35,115,0
33524,어기구(魚基龜),오영환(吳永煥),114,158,272,0
33525,어기구(魚基龜),용혜인(龍慧仁),13,23,36,1
33526,어기구(魚基龜),우상호(禹相虎),76,31,107,0
33527,어기구(魚基龜),우원식(禹元植),89,52,141,0
33528,어기구(魚基龜),위성곤(魏聖坤),120,162,282,0
33529,어기구(魚基龜),유경준(兪京濬),49,8,57,1
33530,어기구(魚基龜),유기홍(柳基洪),77,48,125,0
33531,어기구(魚基龜),유동수(柳東秀),98,62,160,0
33532,어기구(魚基龜),유상범(劉相凡),49,7,56,1
33533,어기구(魚基龜),유의동(兪義東),49,4,53,1
33534,어기구(魚基龜),유정주(兪訂炷),101,86,187,0
33535,어기구(魚基龜),윤건영(尹建永),82,61,143,0
33536,어기구(魚基龜),윤관석(尹官石),75,38,113,1
33537,어기구(魚基龜),윤두현(尹斗鉉),49,4,53,1
33538,어기구(魚基龜),윤미향(尹美香),41,63,104,1
33539,어기구(魚基龜),윤상현(尹相現),32,9,41,1
33540,어기구(魚基龜),윤영덕(尹永德),93,92,185,0
33541,어기구(魚基龜),윤영석(尹永碩),50,11,61,1
33542,어기구(魚基龜),윤영찬(尹永燦),74,66,140,0
33543,어기구(魚基龜),윤재갑(尹才鉀),113,131,244,0
33544,어기구(魚基龜),윤재옥(尹在玉),49,4,53,1
33545,어기구(魚基龜),윤주경(尹柱卿),50,17,67,1
33546,어기구(魚基龜),윤준병(尹準炳),118,154,272,0
33547,어기구(魚基龜),윤창현(尹暢賢),49,9,58,1
33548,어기구(魚基龜),윤한홍(尹漢洪),51,5,56,1
33549,어기구(魚基龜),윤호중(尹昊重),77,46,123,0
33550,어기구(魚基龜),윤후덕(尹厚德),100,149,249,0
33551,어기구(魚基龜),이개호(李介昊),105,178,283,0
33552,어기구(魚基龜),이달곤(李達坤),52,8,60,1
33553,어기구(魚基龜),이동주(李東洲),93,121,214,0
33554,어기구(魚基龜),이만희(李晩熙),50,4,54,1
33555,어기구(魚基龜),이명수(李明洙),51,23,74,1
33556,어기구(魚基龜),이병훈(李炳勳),110,163,273,0
33557,어기구(魚基龜),이상민(李相珉),83,52,135,0
33558,어기구(魚基龜),이상헌(李相憲),88,77,165,0
33559,어기구(魚基龜),이성만(李成萬),94,91,185,1
33560,어기구(魚基龜),이소영(李素永),86,64,150,0
33561,어기구(魚基龜),이수진(李壽珍),96,73,169,0
33562,어기구(魚基龜),이수진(李秀眞),96,65,161,0
33563,어기구(魚基龜),이양수(李亮壽),51,5,56,1
33564,어기구(魚基龜),이용(李鏞),49,7,56,1
33565,어기구(魚基龜),이용빈(李龍彬),99,86,185,0
33566,어기구(魚基龜),이용선(李庸瑄),95,65,160,0
33567,어기구(魚基龜),이용우(李龍雨),88,66,154,0
33568,어기구(魚基龜),이용호(李容鎬),39,15,54,1
33569,어기구(魚基龜),이원욱(李元旭),85,71,156,0
33570,어기구(魚基龜),이원택(李源澤),95,101,196,0
33571,어기구(魚基龜),이은주(李恩周),17,13,30,1
33572,어기구(魚基龜),이인선(李仁善),25,8,33,1
33573,어기구(魚基龜),이인영(李仁榮),76,45,121,0
33574,어기구(魚基龜),이장섭(李將燮),82,67,149,0
33575,어기구(魚基龜),이재명(李在明),40,20,60,0
33576,어기구(魚基龜),이재정(李在汀),76,42,118,0
33577,어기구(魚基龜),이정문(李楨文),93,70,163,0
33578,어기구(魚基龜),이종배(李鍾培),51,7,58,1
33579,어기구(魚基龜),이종성(李鍾成),49,4,53,1
33580,어기구(魚基龜),이주환(李周桓),49,5,54,1
33581,어기구(魚基龜),이채익(李埰益),51,12,63,1
33582,어기구(魚基龜),이철규(李喆圭),52,8,60,1
33583,어기구(魚基龜),이탄희(李誕熙),86,63,149,0
33584,어기구(魚基龜),이태규(李泰珪),28,6,34,1
33585,어기구(魚基龜),이학영(李學永),90,62,152,0
33586,어기구(魚基龜),이해식(李海植),92,57,149,0
33587,어기구(魚基龜),이헌승(李憲昇),50,7,57,1
33588,어기구(魚基龜),이형석(李炯錫),80,63,143,0
33589,어기구(魚基龜),인재근(印在謹),82,71,153,0
33590,어기구(魚基龜),임병헌(林炳憲),25,5,30,1
33591,어기구(魚基龜),임오경(林五卿),99,98,197,0
33592,어기구(魚基龜),임이자(林利子),50,4,54,1
33593,어기구(魚基龜),임종성(林鍾聲),98,152,250,0
33594,어기구(魚基龜),임호선(林昊宣),92,93,185,0
33595,어기구(魚基龜),장경태(張耿態),95,56,151,0
33596,어기구(魚基龜),장동혁(張東赫),25,7,32,1
33597,어기구(魚基龜),장제원(張濟元),49,4,53,1
33598,어기구(魚基龜),장철민(張喆敏),96,95,191,0
33599,어기구(魚基龜),장혜영(張惠英),13,12,25,1
33600,어기구(魚基龜),전봉민(田奉珉),35,5,40,1
33601,어기구(魚基龜),전용기(田溶冀),88,73,161,0
33602,어기구(魚基龜),전재수(田載秀),84,66,150,0
33603,어기구(魚基龜),전주혜(全珠惠),51,8,59,1
33604,어기구(魚基龜),전해철(全海澈),75,59,134,0
33605,어기구(魚基龜),전혜숙(全惠淑),81,67,148,0
33606,어기구(魚基龜),정경희(丁慶姬),49,5,54,1
33607,어기구(魚基龜),정동만(鄭東萬),49,4,53,1
33608,어기구(魚基龜),정성호(鄭成湖),81,103,184,0
33609,어기구(魚基龜),정우택(鄭宇澤),25,4,29,1
33610,어기구(魚基龜),정운천(鄭雲天),50,11,61,1
33611,어기구(魚基龜),정일영(鄭日永),92,67,159,0
33612,어기구(魚基龜),정점식(鄭点植),52,9,61,1
33613,어기구(魚基龜),정진석(鄭鎭碩),50,11,61,1
33614,어기구(魚基龜),정청래(鄭淸來),80,38,118,0
33615,어기구(魚基龜),정춘숙(鄭春淑),98,126,224,0
33616,어기구(魚基龜),정태호(鄭泰浩),88,87,175,0
33617,어기구(魚基龜),정필모(鄭必模),83,49,132,0
33618,어기구(魚基龜),정희용(鄭熙溶),50,6,56,1
33619,어기구(魚基龜),조경태(趙慶泰),49,6,55,1
33620,어기구(魚基龜),조명희(曺明姬),50,7,57,1
33621,어기구(魚基龜),조수진(趙修眞),49,7,56,1
33622,어기구(魚基龜),조승래(趙承來),88,50,138,0
33623,어기구(魚基龜),조오섭(曺五燮),94,146,240,0
33624,어기구(魚基龜),조은희(趙恩禧),25,6,31,1
33625,어기구(魚基龜),조응천(趙應天),73,38,111,0
33626,어기구(魚基龜),조정식(趙正湜),73,57,130,0
33627,어기구(魚基龜),조정훈(趙廷訓),5,13,18,1
33628,어기구(魚基龜),조해진(曺海珍),51,5,56,1
33629,어기구(魚基龜),주철현(朱哲鉉),93,122,215,0
33630,어기구(魚基龜),주호영(朱豪英),50,4,54,1
33631,어기구(魚基龜),지성호(池成浩),50,5,55,1
33632,어기구(魚基龜),진선미(陳善美),74,40,114,0
33633,어기구(魚基龜),진성준(陳聲準),88,74,162,0
33634,어기구(魚基龜),천준호(千俊鎬),79,39,118,0
33635,어기구(魚基龜),최기상(崔基相),81,72,153,0
33636,어기구(魚基龜),최승재(崔承宰),50,8,58,1
33637,어기구(魚基龜),최연숙(崔姸淑),30,9,39,1
33638,어기구(魚基龜),최영희(崔英姬),25,5,30,1
33639,어기구(魚基龜),최인호(崔仁昊),103,126,229,0
33640,어기구(魚基龜),최재형(崔在亨),26,4,30,1
33641,어기구(魚基龜),최종윤(崔鍾允),94,103,197,0
33642,어기구(魚基龜),최춘식(崔春植),50,6,56,1
33643,어기구(魚基龜),최형두(崔炯斗),50,7,57,1
33644,어기구(魚基龜),최혜영(崔惠英),85,61,146,0
33645,어기구(魚基龜),추경호(秋慶鎬),49,4,53,1
33646,어기구(魚基龜),태영호(太永浩),50,8,58,1
33647,어기구(魚基龜),하영제(河榮帝),41,3,44,1
33648,어기구(魚基龜),하태경(河泰慶),51,8,59,1
33649,어기구(魚基龜),한기호(韓起鎬),51,7,58,1
33650,어기구(魚基龜),한무경(韓茂景),49,6,55,1
33651,어기구(魚基龜),한병도(韓秉道),100,96,196,0
33652,어기구(魚基龜),한정애(韓貞愛),73,43,116,0
33653,어기구(魚基龜),한준호(韓俊鎬),89,79,168,0
33654,어기구(魚基龜),허숙정(許淑湞),1,1,2,0
33655,어기구(魚基龜),허영(許榮),114,131,245,0
33656,어기구(魚基龜),허은아(許垠娥),49,5,54,1
33657,어기구(魚基龜),허종식(許琮植),121,192,313,0
33658,어기구(魚基龜),홍기원(洪起元),95,85,180,0
33659,어기구(魚基龜),홍문표(洪文杓),54,16,70,1
33660,어기구(魚基龜),홍석준(洪碩晙),50,4,54,1
33661,어기구(魚基龜),홍성국(洪性國),102,106,208,0
33662,어기구(魚基龜),홍영표(洪永杓),85,50,135,0
33663,어기구(魚基龜),홍익표(洪翼杓),82,77,159,0
33664,어기구(魚基龜),홍정민(洪貞敏),86,60,146,0
33665,어기구(魚基龜),황보승희(皇甫承希),47,3,50,1
33666,어기구(魚基龜),황운하(黃雲夏),102,86,188,0
33667,어기구(魚基龜),황희(黃熙),79,96,175,0
33668,엄태영(嚴泰永),오기형(吳奇炯),49,4,53,1
33669,엄태영(嚴泰永),오영환(吳永煥),50,11,61,1
33670,엄태영(嚴泰永),용혜인(龍慧仁),2,3,5,1
33671,엄태영(嚴泰永),우상호(禹相虎),51,4,55,1
33672,엄태영(嚴泰永),우원식(禹元植),50,4,54,1
33673,엄태영(嚴泰永),위성곤(魏聖坤),53,5,58,1
33674,엄태영(嚴泰永),유경준(兪京濬),81,124,205,0
33675,엄태영(嚴泰永),유기홍(柳基洪),51,4,55,1
33676,엄태영(嚴泰永),유동수(柳東秀),52,7,59,1
33677,엄태영(嚴泰永),유상범(劉相凡),92,101,193,0
33678,엄태영(嚴泰永),유의동(兪義東),68,42,110,0
33679,엄태영(嚴泰永),유정주(兪訂炷),51,4,55,1
33680,엄태영(嚴泰永),윤건영(尹建永),49,3,52,1
33681,엄태영(嚴泰永),윤관석(尹官石),43,0,43,1
33682,엄태영(嚴泰永),윤두현(尹斗鉉),76,89,165,0
33683,엄태영(嚴泰永),윤미향(尹美香),22,0,22,1
33684,엄태영(嚴泰永),윤상현(尹相現),39,52,91,0
33685,엄태영(嚴泰永),윤영덕(尹永德),50,4,54,1
33686,엄태영(嚴泰永),윤영석(尹永碩),74,95,169,0
33687,엄태영(嚴泰永),윤영찬(尹永燦),52,5,57,1
33688,엄태영(嚴泰永),윤재갑(尹才鉀),55,16,71,1
33689,엄태영(嚴泰永),윤재옥(尹在玉),65,69,134,0
33690,엄태영(嚴泰永),윤주경(尹柱卿),75,75,150,0
33691,엄태영(嚴泰永),윤준병(尹準炳),51,4,55,1
33692,엄태영(嚴泰永),윤창현(尹暢賢),113,100,213,0
33693,엄태영(嚴泰永),윤한홍(尹漢洪),72,83,155,0
33694,엄태영(嚴泰永),윤호중(尹昊重),50,5,55,1
33695,엄태영(嚴泰永),윤후덕(尹厚德),50,4,54,1
33696,엄태영(嚴泰永),이개호(李介昊),51,5,56,1
33697,엄태영(嚴泰永),이달곤(李達坤),68,59,127,0
33698,엄태영(嚴泰永),이동주(李東洲),50,6,56,1
33699,엄태영(嚴泰永),이만희(李晩熙),90,88,178,0
33700,엄태영(嚴泰永),이명수(李明洙),104,173,277,0
33701,엄태영(嚴泰永),이병훈(李炳勳),54,6,60,1
33702,엄태영(嚴泰永),이상민(李相珉),51,4,55,1
33703,엄태영(嚴泰永),이상헌(李相憲),50,7,57,1
33704,엄태영(嚴泰永),이성만(李成萬),42,1,43,1
33705,엄태영(嚴泰永),이소영(李素永),51,4,55,1
33706,엄태영(嚴泰永),이수진(李壽珍),52,5,57,1
33707,엄태영(嚴泰永),이수진(李秀眞),51,5,56,1
33708,엄태영(嚴泰永),이양수(李亮壽),81,79,160,0
33709,엄태영(嚴泰永),이용(李鏞),87,146,233,0
33710,엄태영(嚴泰永),이용빈(李龍彬),51,5,56,1
33711,엄태영(嚴泰永),이용선(李庸瑄),52,5,57,1
33712,엄태영(嚴泰永),이용우(李龍雨),50,5,55,1
33713,엄태영(嚴泰永),이용호(李容鎬),37,26,63,0
33714,엄태영(嚴泰永),이원욱(李元旭),50,6,56,1
33715,엄태영(嚴泰永),이원택(李源澤),51,4,55,1
33716,엄태영(嚴泰永),이은주(李恩周),6,2,8,1
33717,엄태영(嚴泰永),이인선(李仁善),36,56,92,0
33718,엄태영(嚴泰永),이인영(李仁榮),50,4,54,1
33719,엄태영(嚴泰永),이장섭(李將燮),51,6,57,1
33720,엄태영(嚴泰永),이재명(李在明),25,4,29,1
33721,엄태영(嚴泰永),이재정(李在汀),50,4,54,1
33722,엄태영(嚴泰永),이정문(李楨文),50,8,58,1
33723,엄태영(嚴泰永),이종배(李鍾培),100,108,208,0
33724,엄태영(嚴泰永),이종성(李鍾成),112,139,251,0
33725,엄태영(嚴泰永),이주환(李周桓),103,104,207,0
33726,엄태영(嚴泰永),이채익(李埰益),76,97,173,0
33727,엄태영(嚴泰永),이철규(李喆圭),82,70,152,0
33728,엄태영(嚴泰永),이탄희(李誕熙),51,4,55,1
33729,엄태영(嚴泰永),이태규(李泰珪),42,32,74,0
33730,엄태영(嚴泰永),이학영(李學永),51,4,55,1
33731,엄태영(嚴泰永),이해식(李海植),50,4,54,1
33732,엄태영(嚴泰永),이헌승(李憲昇),69,81,150,0
33733,엄태영(嚴泰永),이형석(李炯錫),50,4,54,1
33734,엄태영(嚴泰永),인재근(印在謹),51,6,57,1
33735,엄태영(嚴泰永),임병헌(林炳憲),35,61,96,0
33736,엄태영(嚴泰永),임오경(林五卿),51,4,55,1
33737,엄태영(嚴泰永),임이자(林利子),90,90,180,0
33738,엄태영(嚴泰永),임종성(林鍾聲),52,5,57,1
33739,엄태영(嚴泰永),임호선(林昊宣),52,7,59,1
33740,엄태영(嚴泰永),장경태(張耿態),51,4,55,1
33741,엄태영(嚴泰永),장동혁(張東赫),31,49,80,0
33742,엄태영(嚴泰永),장제원(張濟元),60,33,93,0
33743,엄태영(嚴泰永),장철민(張喆敏),51,4,55,1
33744,엄태영(嚴泰永),장혜영(張惠英),6,2,8,1
33745,엄태영(嚴泰永),전봉민(田奉珉),46,38,84,0
33746,엄태영(嚴泰永),전용기(田溶冀),51,4,55,1
33747,엄태영(嚴泰永),전재수(田載秀),51,5,56,1
33748,엄태영(嚴泰永),전주혜(全珠惠),70,96,166,0
33749,엄태영(嚴泰永),전해철(全海澈),51,4,55,1
33750,엄태영(嚴泰永),전혜숙(全惠淑),52,7,59,1
33751,엄태영(嚴泰永),정경희(丁慶姬),68,98,166,0
33752,엄태영(嚴泰永),정동만(鄭東萬),70,78,148,0
33753,엄태영(嚴泰永),정성호(鄭成湖),51,9,60,1
33754,엄태영(嚴泰永),정우택(鄭宇澤),31,34,65,0
33755,엄태영(嚴泰永),정운천(鄭雲天),92,94,186,0
33756,엄태영(嚴泰永),정일영(鄭日永),51,5,56,1
33757,엄태영(嚴泰永),정점식(鄭点植),80,49,129,0
33758,엄태영(嚴泰永),정진석(鄭鎭碩),69,72,141,0
33759,엄태영(嚴泰永),정청래(鄭淸來),50,4,54,1
33760,엄태영(嚴泰永),정춘숙(鄭春淑),52,6,58,1
33761,엄태영(嚴泰永),정태호(鄭泰浩),51,7,58,1
33762,엄태영(嚴泰永),정필모(鄭必模),51,4,55,1
33763,엄태영(嚴泰永),정희용(鄭熙溶),76,112,188,0
33764,엄태영(嚴泰永),조경태(趙慶泰),69,77,146,0
33765,엄태영(嚴泰永),조명희(曺明姬),97,139,236,0
33766,엄태영(嚴泰永),조수진(趙修眞),74,99,173,0
33767,엄태영(嚴泰永),조승래(趙承來),50,4,54,1
33768,엄태영(嚴泰永),조오섭(曺五燮),52,5,57,1
33769,엄태영(嚴泰永),조은희(趙恩禧),28,29,57,0
33770,엄태영(嚴泰永),조응천(趙應天),50,3,53,1
33771,엄태영(嚴泰永),조정식(趙正湜),49,3,52,1
33772,엄태영(嚴泰永),조정훈(趙廷訓),1,18,19,1
33773,엄태영(嚴泰永),조해진(曺海珍),69,46,115,0
33774,엄태영(嚴泰永),주철현(朱哲鉉),51,5,56,1
33775,엄태영(嚴泰永),주호영(朱豪英),65,40,105,0
33776,엄태영(嚴泰永),지성호(池成浩),96,150,246,0
33777,엄태영(嚴泰永),진선미(陳善美),51,4,55,1
33778,엄태영(嚴泰永),진성준(陳聲準),51,4,55,1
33779,엄태영(嚴泰永),천준호(千俊鎬),50,3,53,1
33780,엄태영(嚴泰永),최기상(崔基相),49,4,53,1
33781,엄태영(嚴泰永),최승재(崔承宰),97,132,229,0
33782,엄태영(嚴泰永),최연숙(崔姸淑),40,33,73,0
33783,엄태영(嚴泰永),최영희(崔英姬),30,47,77,0
33784,엄태영(嚴泰永),최인호(崔仁昊),50,5,55,1
33785,엄태영(嚴泰永),최재형(崔在亨),31,20,51,0
33786,엄태영(嚴泰永),최종윤(崔鍾允),50,4,54,1
33787,엄태영(嚴泰永),최춘식(崔春植),86,126,212,0
33788,엄태영(嚴泰永),최형두(崔炯斗),110,154,264,0
33789,엄태영(嚴泰永),최혜영(崔惠英),50,6,56,1
33790,엄태영(嚴泰永),추경호(秋慶鎬),99,110,209,0
33791,엄태영(嚴泰永),태영호(太永浩),100,142,242,0
33792,엄태영(嚴泰永),하영제(河榮帝),72,95,167,1
33793,엄태영(嚴泰永),하태경(河泰慶),66,58,124,0
33794,엄태영(嚴泰永),한기호(韓起鎬),71,68,139,0
33795,엄태영(嚴泰永),한무경(韓茂景),98,138,236,0
33796,엄태영(嚴泰永),한병도(韓秉道),51,6,57,1
33797,엄태영(嚴泰永),한정애(韓貞愛),50,5,55,1
33798,엄태영(嚴泰永),한준호(韓俊鎬),51,5,56,1
33799,엄태영(嚴泰永),허숙정(許淑湞),0,0,0,1
33800,엄태영(嚴泰永),허영(許榮),54,5,59,1
33801,엄태영(嚴泰永),허은아(許垠娥),70,61,131,0
33802,엄태영(嚴泰永),허종식(許琮植),53,11,64,1
33803,엄태영(嚴泰永),홍기원(洪起元),51,4,55,1
33804,엄태영(嚴泰永),홍문표(洪文杓),84,160,244,0
33805,엄태영(嚴泰永),홍석준(洪碩晙),74,77,151,0
33806,엄태영(嚴泰永),홍성국(洪性國),53,6,59,1
33807,엄태영(嚴泰永),홍영표(洪永杓),51,5,56,1
33808,엄태영(嚴泰永),홍익표(洪翼杓),51,7,58,1
33809,엄태영(嚴泰永),홍정민(洪貞敏),51,5,56,1
33810,엄태영(嚴泰永),황보승희(皇甫承希),66,79,145,1
33811,엄태영(嚴泰永),황운하(黃雲夏),51,8,59,1
33812,엄태영(嚴泰永),황희(黃熙),50,5,55,1
33813,오기형(吳奇炯),오영환(吳永煥),111,77,188,0
33814,오기형(吳奇炯),용혜인(龍慧仁),8,12,20,1
33815,오기형(吳奇炯),우상호(禹相虎),75,33,108,0
33816,오기형(吳奇炯),우원식(禹元植),88,50,138,0
33817,오기형(吳奇炯),위성곤(魏聖坤),86,54,140,0
33818,오기형(吳奇炯),유경준(兪京濬),49,4,53,1
33819,오기형(吳奇炯),유기홍(柳基洪),74,34,108,0
33820,오기형(吳奇炯),유동수(柳東秀),82,42,124,0
33821,오기형(吳奇炯),유상범(劉相凡),50,9,59,1
33822,오기형(吳奇炯),유의동(兪義東),49,9,58,1
33823,오기형(吳奇炯),유정주(兪訂炷),85,65,150,0
33824,오기형(吳奇炯),윤건영(尹建永),84,49,133,0
33825,오기형(吳奇炯),윤관석(尹官石),63,31,94,1
33826,오기형(吳奇炯),윤두현(尹斗鉉),49,9,58,1
33827,오기형(吳奇炯),윤미향(尹美香),36,29,65,1
33828,오기형(吳奇炯),윤상현(尹相現),29,4,33,1
33829,오기형(吳奇炯),윤영덕(尹永德),92,71,163,0
33830,오기형(吳奇炯),윤영석(尹永碩),49,4,53,1
33831,오기형(吳奇炯),윤영찬(尹永燦),78,42,120,0
33832,오기형(吳奇炯),윤재갑(尹才鉀),85,50,135,0
33833,오기형(吳奇炯),윤재옥(尹在玉),49,4,53,1
33834,오기형(吳奇炯),윤주경(尹柱卿),49,10,59,1
33835,오기형(吳奇炯),윤준병(尹準炳),87,73,160,0
33836,오기형(吳奇炯),윤창현(尹暢賢),49,10,59,1
33837,오기형(吳奇炯),윤한홍(尹漢洪),49,9,58,1
33838,오기형(吳奇炯),윤호중(尹昊重),77,40,117,0
33839,오기형(吳奇炯),윤후덕(尹厚德),80,36,116,0
33840,오기형(吳奇炯),이개호(李介昊),76,38,114,0
33841,오기형(吳奇炯),이달곤(李達坤),50,4,54,1
33842,오기형(吳奇炯),이동주(李東洲),80,47,127,0
33843,오기형(吳奇炯),이만희(李晩熙),49,4,53,1
33844,오기형(吳奇炯),이명수(李明洙),50,7,57,1
33845,오기형(吳奇炯),이병훈(李炳勳),82,70,152,0
33846,오기형(吳奇炯),이상민(李相珉),71,31,102,0
33847,오기형(吳奇炯),이상헌(李相憲),74,41,115,0
33848,오기형(吳奇炯),이성만(李成萬),82,57,139,1
33849,오기형(吳奇炯),이소영(李素永),88,54,142,0
33850,오기형(吳奇炯),이수진(李壽珍),93,65,158,0
33851,오기형(吳奇炯),이수진(李秀眞),101,66,167,0
33852,오기형(吳奇炯),이양수(李亮壽),51,4,55,1
33853,오기형(吳奇炯),이용(李鏞),49,4,53,1
33854,오기형(吳奇炯),이용빈(李龍彬),90,69,159,0
33855,오기형(吳奇炯),이용선(李庸瑄),88,50,138,0
33856,오기형(吳奇炯),이용우(李龍雨),107,99,206,0
33857,오기형(吳奇炯),이용호(李容鎬),27,7,34,1
33858,오기형(吳奇炯),이원욱(李元旭),83,44,127,0
33859,오기형(吳奇炯),이원택(李源澤),88,49,137,0
33860,오기형(吳奇炯),이은주(李恩周),14,11,25,1
33861,오기형(吳奇炯),이인선(李仁善),25,4,29,1
33862,오기형(吳奇炯),이인영(李仁榮),71,35,106,0
33863,오기형(吳奇炯),이장섭(李將燮),81,39,120,0
33864,오기형(吳奇炯),이재명(李在明),38,16,54,0
33865,오기형(吳奇炯),이재정(李在汀),80,39,119,0
33866,오기형(吳奇炯),이정문(李楨文),82,48,130,0
33867,오기형(吳奇炯),이종배(李鍾培),49,4,53,1
33868,오기형(吳奇炯),이종성(李鍾成),49,9,58,1
33869,오기형(吳奇炯),이주환(李周桓),49,5,54,1
33870,오기형(吳奇炯),이채익(李埰益),50,4,54,1
33871,오기형(吳奇炯),이철규(李喆圭),51,10,61,1
33872,오기형(吳奇炯),이탄희(李誕熙),84,40,124,0
33873,오기형(吳奇炯),이태규(李泰珪),29,5,34,1
33874,오기형(吳奇炯),이학영(李學永),85,43,128,0
33875,오기형(吳奇炯),이해식(李海植),99,60,159,0
33876,오기형(吳奇炯),이헌승(李憲昇),49,4,53,1
33877,오기형(吳奇炯),이형석(李炯錫),92,55,147,0
33878,오기형(吳奇炯),인재근(印在謹),78,45,123,0
33879,오기형(吳奇炯),임병헌(林炳憲),25,4,29,1
33880,오기형(吳奇炯),임오경(林五卿),88,53,141,0
33881,오기형(吳奇炯),임이자(林利子),49,4,53,1
33882,오기형(吳奇炯),임종성(林鍾聲),79,41,120,0
33883,오기형(吳奇炯),임호선(林昊宣),108,70,178,0
33884,오기형(吳奇炯),장경태(張耿態),99,68,167,0
33885,오기형(吳奇炯),장동혁(張東赫),25,4,29,1
33886,오기형(吳奇炯),장제원(張濟元),49,4,53,1
33887,오기형(吳奇炯),장철민(張喆敏),86,53,139,0
33888,오기형(吳奇炯),장혜영(張惠英),10,9,19,1
33889,오기형(吳奇炯),전봉민(田奉珉),34,4,38,1
33890,오기형(吳奇炯),전용기(田溶冀),84,48,132,0
33891,오기형(吳奇炯),전재수(田載秀),77,38,115,0
33892,오기형(吳奇炯),전주혜(全珠惠),49,5,54,1
33893,오기형(吳奇炯),전해철(全海澈),71,40,111,0
33894,오기형(吳奇炯),전혜숙(全惠淑),78,44,122,0
33895,오기형(吳奇炯),정경희(丁慶姬),49,9,58,1
33896,오기형(吳奇炯),정동만(鄭東萬),49,4,53,1
33897,오기형(吳奇炯),정성호(鄭成湖),72,44,116,0
33898,오기형(吳奇炯),정우택(鄭宇澤),25,4,29,1
33899,오기형(吳奇炯),정운천(鄭雲天),49,5,54,1
33900,오기형(吳奇炯),정일영(鄭日永),82,55,137,0
33901,오기형(吳奇炯),정점식(鄭点植),49,4,53,1
33902,오기형(吳奇炯),정진석(鄭鎭碩),49,4,53,1
33903,오기형(吳奇炯),정청래(鄭淸來),85,47,132,0
33904,오기형(吳奇炯),정춘숙(鄭春淑),81,47,128,0
33905,오기형(吳奇炯),정태호(鄭泰浩),82,54,136,0
33906,오기형(吳奇炯),정필모(鄭必模),86,57,143,0
33907,오기형(吳奇炯),정희용(鄭熙溶),49,5,54,1
33908,오기형(吳奇炯),조경태(趙慶泰),49,4,53,1
33909,오기형(吳奇炯),조명희(曺明姬),49,11,60,1
33910,오기형(吳奇炯),조수진(趙修眞),49,9,58,1
33911,오기형(吳奇炯),조승래(趙承來),79,36,115,0
33912,오기형(吳奇炯),조오섭(曺五燮),87,58,145,0
33913,오기형(吳奇炯),조은희(趙恩禧),25,4,29,1
33914,오기형(吳奇炯),조응천(趙應天),74,31,105,0
33915,오기형(吳奇炯),조정식(趙正湜),72,30,102,0
33916,오기형(吳奇炯),조정훈(趙廷訓),2,5,7,1
33917,오기형(吳奇炯),조해진(曺海珍),50,4,54,1
33918,오기형(吳奇炯),주철현(朱哲鉉),90,63,153,0
33919,오기형(吳奇炯),주호영(朱豪英),50,4,54,1
33920,오기형(吳奇炯),지성호(池成浩),49,4,53,1
33921,오기형(吳奇炯),진선미(陳善美),74,36,110,0
33922,오기형(吳奇炯),진성준(陳聲準),84,61,145,0
33923,오기형(吳奇炯),천준호(千俊鎬),90,46,136,0
33924,오기형(吳奇炯),최기상(崔基相),81,40,121,0
33925,오기형(吳奇炯),최승재(崔承宰),49,10,59,1
33926,오기형(吳奇炯),최연숙(崔姸淑),29,11,40,1
33927,오기형(吳奇炯),최영희(崔英姬),25,6,31,1
33928,오기형(吳奇炯),최인호(崔仁昊),79,39,118,0
33929,오기형(吳奇炯),최재형(崔在亨),25,4,29,1
33930,오기형(吳奇炯),최종윤(崔鍾允),84,59,143,0
33931,오기형(吳奇炯),최춘식(崔春植),49,11,60,1
33932,오기형(吳奇炯),최형두(崔炯斗),49,5,54,1
33933,오기형(吳奇炯),최혜영(崔惠英),93,63,156,0
33934,오기형(吳奇炯),추경호(秋慶鎬),49,3,52,1
33935,오기형(吳奇炯),태영호(太永浩),49,5,54,1
33936,오기형(吳奇炯),하영제(河榮帝),40,1,41,1
33937,오기형(吳奇炯),하태경(河泰慶),50,4,54,1
33938,오기형(吳奇炯),한기호(韓起鎬),49,4,53,1
33939,오기형(吳奇炯),한무경(韓茂景),49,5,54,1
33940,오기형(吳奇炯),한병도(韓秉道),86,46,132,0
33941,오기형(吳奇炯),한정애(韓貞愛),73,37,110,0
33942,오기형(吳奇炯),한준호(韓俊鎬),87,51,138,0
33943,오기형(吳奇炯),허숙정(許淑湞),1,2,3,0
33944,오기형(吳奇炯),허영(許榮),97,68,165,0
33945,오기형(吳奇炯),허은아(許垠娥),49,5,54,1
33946,오기형(吳奇炯),허종식(許琮植),87,53,140,0
33947,오기형(吳奇炯),홍기원(洪起元),94,61,155,0
33948,오기형(吳奇炯),홍문표(洪文杓),49,4,53,1
33949,오기형(吳奇炯),홍석준(洪碩晙),49,4,53,1
33950,오기형(吳奇炯),홍성국(洪性國),98,72,170,0
33951,오기형(吳奇炯),홍영표(洪永杓),79,46,125,0
33952,오기형(吳奇炯),홍익표(洪翼杓),80,34,114,0
33953,오기형(吳奇炯),홍정민(洪貞敏),92,78,170,0
33954,오기형(吳奇炯),황보승희(皇甫承希),44,7,51,1
33955,오기형(吳奇炯),황운하(黃雲夏),95,64,159,0
33956,오기형(吳奇炯),황희(黃熙),73,37,110,0
33957,오영환(吳永煥),용혜인(龍慧仁),41,117,158,1
33958,오영환(吳永煥),우상호(禹相虎),82,52,134,0
33959,오영환(吳永煥),우원식(禹元植),138,151,289,0
33960,오영환(吳永煥),위성곤(魏聖坤),132,255,387,0
33961,오영환(吳永煥),유경준(兪京濬),50,8,58,1
33962,오영환(吳永煥),유기홍(柳基洪),94,93,187,0
33963,오영환(吳永煥),유동수(柳東秀),101,86,187,0
33964,오영환(吳永煥),유상범(劉相凡),51,5,56,1
33965,오영환(吳永煥),유의동(兪義東),52,5,57,1
33966,오영환(吳永煥),유정주(兪訂炷),217,327,544,0
33967,오영환(吳永煥),윤건영(尹建永),111,151,262,0
33968,오영환(吳永煥),윤관석(尹官石),108,108,216,1
33969,오영환(吳永煥),윤두현(尹斗鉉),50,7,57,1
33970,오영환(吳永煥),윤미향(尹美香),100,165,265,1
33971,오영환(吳永煥),윤상현(尹相現),30,7,37,1
33972,오영환(吳永煥),윤영덕(尹永德),146,256,402,0
33973,오영환(吳永煥),윤영석(尹永碩),49,12,61,1
33974,오영환(吳永煥),윤영찬(尹永燦),107,114,221,0
33975,오영환(吳永煥),윤재갑(尹才鉀),177,322,499,0
33976,오영환(吳永煥),윤재옥(尹在玉),52,6,58,1
33977,오영환(吳永煥),윤주경(尹柱卿),49,6,55,1
33978,오영환(吳永煥),윤준병(尹準炳),196,483,679,0
33979,오영환(吳永煥),윤창현(尹暢賢),49,8,57,1
33980,오영환(吳永煥),윤한홍(尹漢洪),49,5,54,1
33981,오영환(吳永煥),윤호중(尹昊重),83,89,172,0
33982,오영환(吳永煥),윤후덕(尹厚德),121,145,266,0
33983,오영환(吳永煥),이개호(李介昊),110,222,332,0
33984,오영환(吳永煥),이달곤(李達坤),51,10,61,1
33985,오영환(吳永煥),이동주(李東洲),122,180,302,0
33986,오영환(吳永煥),이만희(李晩熙),53,9,62,1
33987,오영환(吳永煥),이명수(李明洙),52,31,83,1
33988,오영환(吳永煥),이병훈(李炳勳),177,381,558,0
33989,오영환(吳永煥),이상민(李相珉),81,60,141,0
33990,오영환(吳永煥),이상헌(李相憲),155,235,390,0
33991,오영환(吳永煥),이성만(李成萬),192,319,511,1
33992,오영환(吳永煥),이소영(李素永),123,120,243,0
33993,오영환(吳永煥),이수진(李壽珍),205,383,588,0
33994,오영환(吳永煥),이수진(李秀眞),236,371,607,0
33995,오영환(吳永煥),이양수(李亮壽),53,8,61,1
33996,오영환(吳永煥),이용(李鏞),50,9,59,1
33997,오영환(吳永煥),이용빈(李龍彬),226,411,637,0
33998,오영환(吳永煥),이용선(李庸瑄),132,172,304,0
33999,오영환(吳永煥),이용우(李龍雨),181,233,414,0
34000,오영환(吳永煥),이용호(李容鎬),55,38,93,1
34001,오영환(吳永煥),이원욱(李元旭),124,152,276,0
34002,오영환(吳永煥),이원택(李源澤),173,211,384,0
34003,오영환(吳永煥),이은주(李恩周),39,106,145,1
34004,오영환(吳永煥),이인선(李仁善),25,8,33,1
34005,오영환(吳永煥),이인영(李仁榮),82,68,150,0
34006,오영환(吳永煥),이장섭(李將燮),108,174,282,0
34007,오영환(吳永煥),이재명(李在明),39,23,62,0
34008,오영환(吳永煥),이재정(李在汀),118,115,233,0
34009,오영환(吳永煥),이정문(李楨文),132,195,327,0
34010,오영환(吳永煥),이종배(李鍾培),52,10,62,1
34011,오영환(吳永煥),이종성(李鍾成),51,13,64,1
34012,오영환(吳永煥),이주환(李周桓),50,6,56,1
34013,오영환(吳永煥),이채익(李埰益),51,18,69,1
34014,오영환(吳永煥),이철규(李喆圭),52,6,58,1
34015,오영환(吳永煥),이탄희(李誕熙),133,156,289,0
34016,오영환(吳永煥),이태규(李泰珪),30,8,38,1
34017,오영환(吳永煥),이학영(李學永),138,216,354,0
34018,오영환(吳永煥),이해식(李海植),171,238,409,0
34019,오영환(吳永煥),이헌승(李憲昇),49,6,55,1
34020,오영환(吳永煥),이형석(李炯錫),185,249,434,0
34021,오영환(吳永煥),인재근(印在謹),131,174,305,0
34022,오영환(吳永煥),임병헌(林炳憲),25,4,29,1
34023,오영환(吳永煥),임오경(林五卿),261,397,658,0
34024,오영환(吳永煥),임이자(林利子),49,6,55,1
34025,오영환(吳永煥),임종성(林鍾聲),147,213,360,0
34026,오영환(吳永煥),임호선(林昊宣),274,450,724,0
34027,오영환(吳永煥),장경태(張耿態),242,365,607,0
34028,오영환(吳永煥),장동혁(張東赫),25,4,29,1
34029,오영환(吳永煥),장제원(張濟元),49,7,56,1
34030,오영환(吳永煥),장철민(張喆敏),207,279,486,0
34031,오영환(吳永煥),장혜영(張惠英),29,59,88,1
34032,오영환(吳永煥),전봉민(田奉珉),36,6,42,1
34033,오영환(吳永煥),전용기(田溶冀),170,282,452,0
34034,오영환(吳永煥),전재수(田載秀),100,108,208,0
34035,오영환(吳永煥),전주혜(全珠惠),51,6,57,1
34036,오영환(吳永煥),전해철(全海澈),85,85,170,0
34037,오영환(吳永煥),전혜숙(全惠淑),148,230,378,0
34038,오영환(吳永煥),정경희(丁慶姬),50,5,55,1
34039,오영환(吳永煥),정동만(鄭東萬),49,4,53,1
34040,오영환(吳永煥),정성호(鄭成湖),104,134,238,0
34041,오영환(吳永煥),정우택(鄭宇澤),27,8,35,1
34042,오영환(吳永煥),정운천(鄭雲天),52,5,57,1
34043,오영환(吳永煥),정일영(鄭日永),137,221,358,0
34044,오영환(吳永煥),정점식(鄭点植),49,5,54,1
34045,오영환(吳永煥),정진석(鄭鎭碩),53,8,61,1
34046,오영환(吳永煥),정청래(鄭淸來),203,314,517,0
34047,오영환(吳永煥),정춘숙(鄭春淑),131,159,290,0
34048,오영환(吳永煥),정태호(鄭泰浩),100,151,251,0
34049,오영환(吳永煥),정필모(鄭必模),126,137,263,0
34050,오영환(吳永煥),정희용(鄭熙溶),52,8,60,1
34051,오영환(吳永煥),조경태(趙慶泰),51,6,57,1
34052,오영환(吳永煥),조명희(曺明姬),50,11,61,1
34053,오영환(吳永煥),조수진(趙修眞),52,7,59,1
34054,오영환(吳永煥),조승래(趙承來),122,126,248,0
34055,오영환(吳永煥),조오섭(曺五燮),149,328,477,0
34056,오영환(吳永煥),조은희(趙恩禧),27,9,36,1
34057,오영환(吳永煥),조응천(趙應天),104,69,173,0
34058,오영환(吳永煥),조정식(趙正湜),87,70,157,0
34059,오영환(吳永煥),조정훈(趙廷訓),7,26,33,1
34060,오영환(吳永煥),조해진(曺海珍),51,6,57,1
34061,오영환(吳永煥),주철현(朱哲鉉),183,264,447,0
34062,오영환(吳永煥),주호영(朱豪英),50,4,54,1
34063,오영환(吳永煥),지성호(池成浩),52,9,61,1
34064,오영환(吳永煥),진선미(陳善美),97,74,171,0
34065,오영환(吳永煥),진성준(陳聲準),135,201,336,0
34066,오영환(吳永煥),천준호(千俊鎬),119,127,246,0
34067,오영환(吳永煥),최기상(崔基相),110,148,258,0
34068,오영환(吳永煥),최승재(崔承宰),55,12,67,1
34069,오영환(吳永煥),최연숙(崔姸淑),36,20,56,1
34070,오영환(吳永煥),최영희(崔英姬),25,8,33,1
34071,오영환(吳永煥),최인호(崔仁昊),109,128,237,0
34072,오영환(吳永煥),최재형(崔在亨),25,6,31,1
34073,오영환(吳永煥),최종윤(崔鍾允),159,294,453,0
34074,오영환(吳永煥),최춘식(崔春植),54,21,75,1
34075,오영환(吳永煥),최형두(崔炯斗),52,18,70,1
34076,오영환(吳永煥),최혜영(崔惠英),256,388,644,0
34077,오영환(吳永煥),추경호(秋慶鎬),50,9,59,1
34078,오영환(吳永煥),태영호(太永浩),51,13,64,1
34079,오영환(吳永煥),하영제(河榮帝),42,6,48,1
34080,오영환(吳永煥),하태경(河泰慶),52,8,60,1
34081,오영환(吳永煥),한기호(韓起鎬),50,7,57,1
34082,오영환(吳永煥),한무경(韓茂景),51,7,58,1
34083,오영환(吳永煥),한병도(韓秉道),212,245,457,0
34084,오영환(吳永煥),한정애(韓貞愛),95,95,190,0
34085,오영환(吳永煥),한준호(韓俊鎬),205,309,514,0
34086,오영환(吳永煥),허숙정(許淑湞),1,1,2,0
34087,오영환(吳永煥),허영(許榮),191,274,465,0
34088,오영환(吳永煥),허은아(許垠娥),50,8,58,1
34089,오영환(吳永煥),허종식(許琮植),135,215,350,0
34090,오영환(吳永煥),홍기원(洪起元),146,183,329,0
34091,오영환(吳永煥),홍문표(洪文杓),49,22,71,1
34092,오영환(吳永煥),홍석준(洪碩晙),51,6,57,1
34093,오영환(吳永煥),홍성국(洪性國),238,392,630,0
34094,오영환(吳永煥),홍영표(洪永杓),111,91,202,0
34095,오영환(吳永煥),홍익표(洪翼杓),119,144,263,0
34096,오영환(吳永煥),홍정민(洪貞敏),165,271,436,0
34097,오영환(吳永煥),황보승희(皇甫承希),50,6,56,1
34098,오영환(吳永煥),황운하(黃雲夏),178,274,452,0
34099,오영환(吳永煥),황희(黃熙),90,57,147,0
34100,용혜인(龍慧仁),우상호(禹相虎),8,9,17,1
34101,용혜인(龍慧仁),우원식(禹元植),23,50,73,1
34102,용혜인(龍慧仁),위성곤(魏聖坤),17,46,63,1
34103,용혜인(龍慧仁),유경준(兪京濬),2,4,6,1
34104,용혜인(龍慧仁),유기홍(柳基洪),9,20,29,1
34105,용혜인(龍慧仁),유동수(柳東秀),15,23,38,1
34106,용혜인(龍慧仁),유상범(劉相凡),1,1,2,1
34107,용혜인(龍慧仁),유의동(兪義東),2,5,7,1
34108,용혜인(龍慧仁),유정주(兪訂炷),27,80,107,1
34109,용혜인(龍慧仁),윤건영(尹建永),16,36,52,1
34110,용혜인(龍慧仁),윤관석(尹官石),20,30,50,1
34111,용혜인(龍慧仁),윤두현(尹斗鉉),1,1,2,1
34112,용혜인(龍慧仁),윤미향(尹美香),31,170,201,1
34113,용혜인(龍慧仁),윤상현(尹相現),0,1,1,1
34114,용혜인(龍慧仁),윤영덕(尹永德),17,59,76,1
34115,용혜인(龍慧仁),윤영석(尹永碩),1,4,5,1
34116,용혜인(龍慧仁),윤영찬(尹永燦),10,26,36,1
34117,용혜인(龍慧仁),윤재갑(尹才鉀),27,69,96,1
34118,용혜인(龍慧仁),윤재옥(尹在玉),2,1,3,1
34119,용혜인(龍慧仁),윤주경(尹柱卿),1,11,12,1
34120,용혜인(龍慧仁),윤준병(尹準炳),19,73,92,1
34121,용혜인(龍慧仁),윤창현(尹暢賢),1,11,12,1
34122,용혜인(龍慧仁),윤한홍(尹漢洪),1,2,3,1
34123,용혜인(龍慧仁),윤호중(尹昊重),7,19,26,1
34124,용혜인(龍慧仁),윤후덕(尹厚德),16,28,44,1
34125,용혜인(龍慧仁),이개호(李介昊),13,23,36,1
34126,용혜인(龍慧仁),이달곤(李達坤),2,2,4,1
34127,용혜인(龍慧仁),이동주(李東洲),26,56,82,1
34128,용혜인(龍慧仁),이만희(李晩熙),2,1,3,1
34129,용혜인(龍慧仁),이명수(李明洙),2,17,19,1
34130,용혜인(龍慧仁),이병훈(李炳勳),18,34,52,1
34131,용혜인(龍慧仁),이상민(李相珉),7,23,30,1
34132,용혜인(龍慧仁),이상헌(李相憲),17,50,67,1
34133,용혜인(龍慧仁),이성만(李成萬),31,79,110,1
34134,용혜인(龍慧仁),이소영(李素永),30,76,106,1
34135,용혜인(龍慧仁),이수진(李壽珍),43,171,214,1
34136,용혜인(龍慧仁),이수진(李秀眞),25,41,66,1
34137,용혜인(龍慧仁),이양수(李亮壽),1,9,10,1
34138,용혜인(龍慧仁),이용(李鏞),1,3,4,1
34139,용혜인(龍慧仁),이용빈(李龍彬),26,94,120,1
34140,용혜인(龍慧仁),이용선(李庸瑄),16,43,59,1
34141,용혜인(龍慧仁),이용우(李龍雨),21,29,50,1
34142,용혜인(龍慧仁),이용호(李容鎬),10,17,27,1
34143,용혜인(龍慧仁),이원욱(李元旭),12,36,48,1
34144,용혜인(龍慧仁),이원택(李源澤),21,41,62,1
34145,용혜인(龍慧仁),이은주(李恩周),42,167,209,1
34146,용혜인(龍慧仁),이인선(李仁善),0,0,0,1
34147,용혜인(龍慧仁),이인영(李仁榮),11,20,31,1
34148,용혜인(龍慧仁),이장섭(李將燮),13,24,37,1
34149,용혜인(龍慧仁),이재명(李在明),6,10,16,1
34150,용혜인(龍慧仁),이재정(李在汀),17,32,49,1
34151,용혜인(龍慧仁),이정문(李楨文),14,31,45,1
34152,용혜인(龍慧仁),이종배(李鍾培),2,5,7,1
34153,용혜인(龍慧仁),이종성(李鍾成),1,10,11,1
34154,용혜인(龍慧仁),이주환(李周桓),1,4,5,1
34155,용혜인(龍慧仁),이채익(李埰益),3,16,19,1
34156,용혜인(龍慧仁),이철규(李喆圭),1,2,3,1
34157,용혜인(龍慧仁),이탄희(李誕熙),31,75,106,1
34158,용혜인(龍慧仁),이태규(李泰珪),1,10,11,1
34159,용혜인(龍慧仁),이학영(李學永),30,100,130,1
34160,용혜인(龍慧仁),이해식(李海植),19,41,60,1
34161,용혜인(龍慧仁),이헌승(李憲昇),1,1,2,1
34162,용혜인(龍慧仁),이형석(李炯錫),20,43,63,1
34163,용혜인(龍慧仁),인재근(印在謹),20,59,79,1
34164,용혜인(龍慧仁),임병헌(林炳憲),0,2,2,1
34165,용혜인(龍慧仁),임오경(林五卿),11,24,35,1
34166,용혜인(龍慧仁),임이자(林利子),1,1,2,1
34167,용혜인(龍慧仁),임종성(林鍾聲),28,60,88,1
34168,용혜인(龍慧仁),임호선(林昊宣),21,50,71,1
34169,용혜인(龍慧仁),장경태(張耿態),23,57,80,1
34170,용혜인(龍慧仁),장동혁(張東赫),0,0,0,1
34171,용혜인(龍慧仁),장제원(張濟元),1,2,3,1
34172,용혜인(龍慧仁),장철민(張喆敏),17,31,48,1
34173,용혜인(龍慧仁),장혜영(張惠英),41,174,215,1
34174,용혜인(龍慧仁),전봉민(田奉珉),1,2,3,1
34175,용혜인(龍慧仁),전용기(田溶冀),26,93,119,1
34176,용혜인(龍慧仁),전재수(田載秀),12,24,36,1
34177,용혜인(龍慧仁),전주혜(全珠惠),2,9,11,1
34178,용혜인(龍慧仁),전해철(全海澈),8,29,37,1
34179,용혜인(龍慧仁),전혜숙(全惠淑),25,54,79,1
34180,용혜인(龍慧仁),정경희(丁慶姬),1,1,2,1
34181,용혜인(龍慧仁),정동만(鄭東萬),1,2,3,1
34182,용혜인(龍慧仁),정성호(鄭成湖),28,92,120,1
34183,용혜인(龍慧仁),정우택(鄭宇澤),0,3,3,1
34184,용혜인(龍慧仁),정운천(鄭雲天),2,4,6,1
34185,용혜인(龍慧仁),정일영(鄭日永),18,37,55,1
34186,용혜인(龍慧仁),정점식(鄭点植),1,1,2,1
34187,용혜인(龍慧仁),정진석(鄭鎭碩),1,2,3,1
34188,용혜인(龍慧仁),정청래(鄭淸來),20,28,48,1
34189,용혜인(龍慧仁),정춘숙(鄭春淑),26,95,121,1
34190,용혜인(龍慧仁),정태호(鄭泰浩),10,39,49,1
34191,용혜인(龍慧仁),정필모(鄭必模),17,42,59,1
34192,용혜인(龍慧仁),정희용(鄭熙溶),2,3,5,1
34193,용혜인(龍慧仁),조경태(趙慶泰),2,2,4,1
34194,용혜인(龍慧仁),조명희(曺明姬),2,11,13,1
34195,용혜인(龍慧仁),조수진(趙修眞),1,6,7,1
34196,용혜인(龍慧仁),조승래(趙承來),13,25,38,1
34197,용혜인(龍慧仁),조오섭(曺五燮),35,86,121,1
34198,용혜인(龍慧仁),조은희(趙恩禧),2,2,4,1
34199,용혜인(龍慧仁),조응천(趙應天),6,12,18,1
34200,용혜인(龍慧仁),조정식(趙正湜),7,9,16,1
34201,용혜인(龍慧仁),조정훈(趙廷訓),12,50,62,1
34202,용혜인(龍慧仁),조해진(曺海珍),2,2,4,1
34203,용혜인(龍慧仁),주철현(朱哲鉉),15,49,64,1
34204,용혜인(龍慧仁),주호영(朱豪英),1,1,2,1
34205,용혜인(龍慧仁),지성호(池成浩),1,10,11,1
34206,용혜인(龍慧仁),진선미(陳善美),13,34,47,1
34207,용혜인(龍慧仁),진성준(陳聲準),17,30,47,1
34208,용혜인(龍慧仁),천준호(千俊鎬),15,32,47,1
34209,용혜인(龍慧仁),최기상(崔基相),15,34,49,1
34210,용혜인(龍慧仁),최승재(崔承宰),3,7,10,1
34211,용혜인(龍慧仁),최연숙(崔姸淑),5,26,31,1
34212,용혜인(龍慧仁),최영희(崔英姬),0,1,1,1
34213,용혜인(龍慧仁),최인호(崔仁昊),8,12,20,1
34214,용혜인(龍慧仁),최재형(崔在亨),0,0,0,1
34215,용혜인(龍慧仁),최종윤(崔鍾允),25,47,72,1
34216,용혜인(龍慧仁),최춘식(崔春植),1,2,3,1
34217,용혜인(龍慧仁),최형두(崔炯斗),1,4,5,1
34218,용혜인(龍慧仁),최혜영(崔惠英),28,83,111,1
34219,용혜인(龍慧仁),추경호(秋慶鎬),2,9,11,1
34220,용혜인(龍慧仁),태영호(太永浩),3,12,15,1
34221,용혜인(龍慧仁),하영제(河榮帝),1,2,3,1
34222,용혜인(龍慧仁),하태경(河泰慶),1,5,6,1
34223,용혜인(龍慧仁),한기호(韓起鎬),1,3,4,1
34224,용혜인(龍慧仁),한무경(韓茂景),1,5,6,1
34225,용혜인(龍慧仁),한병도(韓秉道),19,26,45,1
34226,용혜인(龍慧仁),한정애(韓貞愛),10,24,34,1
34227,용혜인(龍慧仁),한준호(韓俊鎬),17,34,51,1
34228,용혜인(龍慧仁),허숙정(許淑湞),1,1,2,1
34229,용혜인(龍慧仁),허영(許榮),27,42,69,1
34230,용혜인(龍慧仁),허은아(許垠娥),1,8,9,1
34231,용혜인(龍慧仁),허종식(許琮植),23,49,72,1
34232,용혜인(龍慧仁),홍기원(洪起元),16,23,39,1
34233,용혜인(龍慧仁),홍문표(洪文杓),2,4,6,1
34234,용혜인(龍慧仁),홍석준(洪碩晙),1,2,3,1
34235,용혜인(龍慧仁),홍성국(洪性國),26,54,80,1
34236,용혜인(龍慧仁),홍영표(洪永杓),12,20,32,1
34237,용혜인(龍慧仁),홍익표(洪翼杓),10,22,32,1
34238,용혜인(龍慧仁),홍정민(洪貞敏),22,43,65,1
34239,용혜인(龍慧仁),황보승희(皇甫承希),4,10,14,1
34240,용혜인(龍慧仁),황운하(黃雲夏),27,50,77,1
34241,용혜인(龍慧仁),황희(黃熙),9,8,17,1
34242,우상호(禹相虎),우원식(禹元植),80,44,124,0
34243,우상호(禹相虎),위성곤(魏聖坤),82,44,126,0
34244,우상호(禹相虎),유경준(兪京濬),49,4,53,1
34245,우상호(禹相虎),유기홍(柳基洪),78,37,115,0
34246,우상호(禹相虎),유동수(柳東秀),79,40,119,0
34247,우상호(禹相虎),유상범(劉相凡),50,4,54,1
34248,우상호(禹相虎),유의동(兪義東),49,4,53,1
34249,우상호(禹相虎),유정주(兪訂炷),84,53,137,0
34250,우상호(禹相虎),윤건영(尹建永),75,38,113,0
34251,우상호(禹相虎),윤관석(尹官石),71,36,107,1
34252,우상호(禹相虎),윤두현(尹斗鉉),50,4,54,1
34253,우상호(禹相虎),윤미향(尹美香),32,29,61,1
34254,우상호(禹相虎),윤상현(尹相現),31,4,35,1
34255,우상호(禹相虎),윤영덕(尹永德),84,43,127,0
34256,우상호(禹相虎),윤영석(尹永碩),50,4,54,1
34257,우상호(禹相虎),윤영찬(尹永燦),78,45,123,0
34258,우상호(禹相虎),윤재갑(尹才鉀),81,48,129,0
34259,우상호(禹相虎),윤재옥(尹在玉),49,4,53,1
34260,우상호(禹相虎),윤주경(尹柱卿),49,4,53,1
34261,우상호(禹相虎),윤준병(尹準炳),82,47,129,0
34262,우상호(禹相虎),윤창현(尹暢賢),49,5,54,1
34263,우상호(禹相虎),윤한홍(尹漢洪),50,4,54,1
34264,우상호(禹相虎),윤호중(尹昊重),78,44,122,0
34265,우상호(禹相虎),윤후덕(尹厚德),77,44,121,0
34266,우상호(禹相虎),이개호(李介昊),83,40,123,0
34267,우상호(禹相虎),이달곤(李達坤),50,4,54,1
34268,우상호(禹相虎),이동주(李東洲),78,46,124,0
34269,우상호(禹相虎),이만희(李晩熙),50,4,54,1
34270,우상호(禹相虎),이명수(李明洙),50,7,57,1
34271,우상호(禹相虎),이병훈(李炳勳),81,57,138,0
34272,우상호(禹相虎),이상민(李相珉),75,35,110,0
34273,우상호(禹相虎),이상헌(李相憲),79,38,117,0
34274,우상호(禹相虎),이성만(李成萬),67,54,121,1
34275,우상호(禹相虎),이소영(李素永),78,33,111,0
34276,우상호(禹相虎),이수진(李壽珍),82,45,127,0
34277,우상호(禹相虎),이수진(李秀眞),81,45,126,0
34278,우상호(禹相虎),이양수(李亮壽),52,4,56,1
34279,우상호(禹相虎),이용(李鏞),50,4,54,1
34280,우상호(禹相虎),이용빈(李龍彬),89,69,158,0
34281,우상호(禹相虎),이용선(李庸瑄),80,44,124,0
34282,우상호(禹相虎),이용우(李龍雨),77,40,117,0
34283,우상호(禹相虎),이용호(李容鎬),29,6,35,1
34284,우상호(禹相虎),이원욱(李元旭),81,44,125,0
34285,우상호(禹相虎),이원택(李源澤),77,40,117,0
34286,우상호(禹相虎),이은주(李恩周),14,13,27,1
34287,우상호(禹相虎),이인선(李仁善),25,4,29,1
34288,우상호(禹相虎),이인영(李仁榮),73,50,123,0
34289,우상호(禹相虎),이장섭(李將燮),79,42,121,0
34290,우상호(禹相虎),이재명(李在明),38,18,56,0
34291,우상호(禹相虎),이재정(李在汀),76,35,111,0
34292,우상호(禹相虎),이정문(李楨文),80,41,121,0
34293,우상호(禹相虎),이종배(李鍾培),50,5,55,1
34294,우상호(禹相虎),이종성(李鍾成),50,5,55,1
34295,우상호(禹相虎),이주환(李周桓),50,4,54,1
34296,우상호(禹相虎),이채익(李埰益),50,5,55,1
34297,우상호(禹相虎),이철규(李喆圭),52,4,56,1
34298,우상호(禹相虎),이탄희(李誕熙),79,39,118,0
34299,우상호(禹相虎),이태규(李泰珪),28,4,32,1
34300,우상호(禹相虎),이학영(李學永),80,45,125,0
34301,우상호(禹相虎),이해식(李海植),79,39,118,0
34302,우상호(禹相虎),이헌승(李憲昇),51,4,55,1
34303,우상호(禹相虎),이형석(李炯錫),83,49,132,0
34304,우상호(禹相虎),인재근(印在謹),81,43,124,0
34305,우상호(禹相虎),임병헌(林炳憲),25,4,29,1
34306,우상호(禹相虎),임오경(林五卿),81,39,120,0
34307,우상호(禹相虎),임이자(林利子),49,4,53,1
34308,우상호(禹相虎),임종성(林鍾聲),83,44,127,0
34309,우상호(禹相虎),임호선(林昊宣),83,41,124,0
34310,우상호(禹相虎),장경태(張耿態),80,45,125,0
34311,우상호(禹相虎),장동혁(張東赫),25,4,29,1
34312,우상호(禹相虎),장제원(張濟元),49,4,53,1
34313,우상호(禹相虎),장철민(張喆敏),78,33,111,0
34314,우상호(禹相虎),장혜영(張惠英),11,6,17,1
34315,우상호(禹相虎),전봉민(田奉珉),34,4,38,1
34316,우상호(禹相虎),전용기(田溶冀),78,45,123,0
34317,우상호(禹相虎),전재수(田載秀),79,33,112,0
34318,우상호(禹相虎),전주혜(全珠惠),51,4,55,1
34319,우상호(禹相虎),전해철(全海澈),76,41,117,0
34320,우상호(禹相虎),전혜숙(全惠淑),81,42,123,0
34321,우상호(禹相虎),정경희(丁慶姬),50,4,54,1
34322,우상호(禹相虎),정동만(鄭東萬),49,5,54,1
34323,우상호(禹相虎),정성호(鄭成湖),77,39,116,0
34324,우상호(禹相虎),정우택(鄭宇澤),26,4,30,1
34325,우상호(禹相虎),정운천(鄭雲天),50,5,55,1
34326,우상호(禹相虎),정일영(鄭日永),75,39,114,0
34327,우상호(禹相虎),정점식(鄭点植),50,4,54,1
34328,우상호(禹相虎),정진석(鄭鎭碩),50,4,54,1
34329,우상호(禹相虎),정청래(鄭淸來),79,38,117,0
34330,우상호(禹相虎),정춘숙(鄭春淑),80,45,125,0
34331,우상호(禹相虎),정태호(鄭泰浩),80,52,132,0
34332,우상호(禹相虎),정필모(鄭必模),80,44,124,0
34333,우상호(禹相虎),정희용(鄭熙溶),49,4,53,1
34334,우상호(禹相虎),조경태(趙慶泰),50,4,54,1
34335,우상호(禹相虎),조명희(曺明姬),50,4,54,1
34336,우상호(禹相虎),조수진(趙修眞),50,4,54,1
34337,우상호(禹相虎),조승래(趙承來),81,38,119,0
34338,우상호(禹相虎),조오섭(曺五燮),81,48,129,0
34339,우상호(禹相虎),조은희(趙恩禧),26,4,30,1
34340,우상호(禹相虎),조응천(趙應天),73,28,101,0
34341,우상호(禹相虎),조정식(趙正湜),75,35,110,0
34342,우상호(禹相虎),조정훈(趙廷訓),1,2,3,1
34343,우상호(禹相虎),조해진(曺海珍),51,4,55,1
34344,우상호(禹相虎),주철현(朱哲鉉),76,38,114,0
34345,우상호(禹相虎),주호영(朱豪英),49,4,53,1
34346,우상호(禹相虎),지성호(池成浩),50,4,54,1
34347,우상호(禹相虎),진선미(陳善美),77,35,112,0
34348,우상호(禹相虎),진성준(陳聲準),82,53,135,0
34349,우상호(禹相虎),천준호(千俊鎬),78,39,117,0
34350,우상호(禹相虎),최기상(崔基相),75,31,106,0
34351,우상호(禹相虎),최승재(崔承宰),50,4,54,1
34352,우상호(禹相虎),최연숙(崔姸淑),30,8,38,1
34353,우상호(禹相虎),최영희(崔英姬),25,5,30,1
34354,우상호(禹相虎),최인호(崔仁昊),79,33,112,0
34355,우상호(禹相虎),최재형(崔在亨),25,4,29,1
34356,우상호(禹相虎),최종윤(崔鍾允),79,51,130,0
34357,우상호(禹相虎),최춘식(崔春植),49,5,54,1
34358,우상호(禹相虎),최형두(崔炯斗),51,4,55,1
34359,우상호(禹相虎),최혜영(崔惠英),79,47,126,0
34360,우상호(禹相虎),추경호(秋慶鎬),49,4,53,1
34361,우상호(禹相虎),태영호(太永浩),49,4,53,1
34362,우상호(禹相虎),하영제(河榮帝),42,1,43,1
34363,우상호(禹相虎),하태경(河泰慶),49,4,53,1
34364,우상호(禹相虎),한기호(韓起鎬),51,4,55,1
34365,우상호(禹相虎),한무경(韓茂景),49,4,53,1
34366,우상호(禹相虎),한병도(韓秉道),79,38,117,0
34367,우상호(禹相虎),한정애(韓貞愛),74,37,111,0
34368,우상호(禹相虎),한준호(韓俊鎬),85,74,159,0
34369,우상호(禹相虎),허숙정(許淑湞),1,1,2,0
34370,우상호(禹相虎),허영(許榮),82,38,120,0
34371,우상호(禹相虎),허은아(許垠娥),49,4,53,1
34372,우상호(禹相虎),허종식(許琮植),78,43,121,0
34373,우상호(禹相虎),홍기원(洪起元),85,40,125,0
34374,우상호(禹相虎),홍문표(洪文杓),50,4,54,1
34375,우상호(禹相虎),홍석준(洪碩晙),50,4,54,1
34376,우상호(禹相虎),홍성국(洪性國),81,47,128,0
34377,우상호(禹相虎),홍영표(洪永杓),76,38,114,0
34378,우상호(禹相虎),홍익표(洪翼杓),83,42,125,0
34379,우상호(禹相虎),홍정민(洪貞敏),87,58,145,0
34380,우상호(禹相虎),황보승희(皇甫承希),47,1,48,1
34381,우상호(禹相虎),황운하(黃雲夏),79,40,119,0
34382,우상호(禹相虎),황희(黃熙),76,40,116,0
34383,우원식(禹元植),위성곤(魏聖坤),115,125,240,0
34384,우원식(禹元植),유경준(兪京濬),49,5,54,1
34385,우원식(禹元植),유기홍(柳基洪),82,54,136,0
34386,우원식(禹元植),유동수(柳東秀),84,55,139,0
34387,우원식(禹元植),유상범(劉相凡),50,4,54,1
34388,우원식(禹元植),유의동(兪義東),49,4,53,1
34389,우원식(禹元植),유정주(兪訂炷),110,119,229,0
34390,우원식(禹元植),윤건영(尹建永),86,69,155,0
34391,우원식(禹元植),윤관석(尹官石),72,55,127,1
34392,우원식(禹元植),윤두현(尹斗鉉),50,5,55,1
34393,우원식(禹元植),윤미향(尹美香),61,91,152,1
34394,우원식(禹元植),윤상현(尹相現),30,5,35,1
34395,우원식(禹元植),윤영덕(尹永德),110,125,235,0
34396,우원식(禹元植),윤영석(尹永碩),50,5,55,1
34397,우원식(禹元植),윤영찬(尹永燦),83,53,136,0
34398,우원식(禹元植),윤재갑(尹才鉀),113,78,191,0
34399,우원식(禹元植),윤재옥(尹在玉),49,4,53,1
34400,우원식(禹元植),윤주경(尹柱卿),49,4,53,1
34401,우원식(禹元植),윤준병(尹準炳),97,141,238,0
34402,우원식(禹元植),윤창현(尹暢賢),49,4,53,1
34403,우원식(禹元植),윤한홍(尹漢洪),49,4,53,1
34404,우원식(禹元植),윤호중(尹昊重),79,60,139,0
34405,우원식(禹元植),윤후덕(尹厚德),95,110,205,0
34406,우원식(禹元植),이개호(李介昊),88,63,151,0
34407,우원식(禹元植),이달곤(李達坤),51,6,57,1
34408,우원식(禹元植),이동주(李東洲),113,216,329,0
34409,우원식(禹元植),이만희(李晩熙),50,4,54,1
34410,우원식(禹元植),이명수(李明洙),49,8,57,1
34411,우원식(禹元植),이병훈(李炳勳),98,101,199,0
34412,우원식(禹元植),이상민(李相珉),79,35,114,0
34413,우원식(禹元植),이상헌(李相憲),88,60,148,0
34414,우원식(禹元植),이성만(李成萬),88,96,184,1
34415,우원식(禹元植),이소영(李素永),104,68,172,0
34416,우원식(禹元植),이수진(李壽珍),128,157,285,0
34417,우원식(禹元植),이수진(李秀眞),99,75,174,0
34418,우원식(禹元植),이양수(李亮壽),51,4,55,1
34419,우원식(禹元植),이용(李鏞),50,4,54,1
34420,우원식(禹元植),이용빈(李龍彬),116,160,276,0
34421,우원식(禹元植),이용선(李庸瑄),93,76,169,0
34422,우원식(禹元植),이용우(李龍雨),98,63,161,0
34423,우원식(禹元植),이용호(李容鎬),28,9,37,1
34424,우원식(禹元植),이원욱(李元旭),91,74,165,0
34425,우원식(禹元植),이원택(李源澤),98,71,169,0
34426,우원식(禹元植),이은주(李恩周),17,27,44,1
34427,우원식(禹元植),이인선(李仁善),25,4,29,1
34428,우원식(禹元植),이인영(李仁榮),74,42,116,0
34429,우원식(禹元植),이장섭(李將燮),98,90,188,0
34430,우원식(禹元植),이재명(李在明),40,25,65,0
34431,우원식(禹元植),이재정(李在汀),85,53,138,0
34432,우원식(禹元植),이정문(李楨文),93,92,185,0
34433,우원식(禹元植),이종배(李鍾培),51,6,57,1
34434,우원식(禹元植),이종성(李鍾成),50,4,54,1
34435,우원식(禹元植),이주환(李周桓),50,4,54,1
34436,우원식(禹元植),이채익(李埰益),50,5,55,1
34437,우원식(禹元植),이철규(李喆圭),50,4,54,1
34438,우원식(禹元植),이탄희(李誕熙),104,81,185,0
34439,우원식(禹元植),이태규(李泰珪),28,4,32,1
34440,우원식(禹元植),이학영(李學永),110,169,279,0
34441,우원식(禹元植),이해식(李海植),130,154,284,0
34442,우원식(禹元植),이헌승(李憲昇),50,5,55,1
34443,우원식(禹元植),이형석(李炯錫),117,117,234,0
34444,우원식(禹元植),인재근(印在謹),101,125,226,0
34445,우원식(禹元植),임병헌(林炳憲),25,4,29,1
34446,우원식(禹元植),임오경(林五卿),88,75,163,0
34447,우원식(禹元植),임이자(林利子),49,4,53,1
34448,우원식(禹元植),임종성(林鍾聲),102,144,246,0
34449,우원식(禹元植),임호선(林昊宣),119,139,258,0
34450,우원식(禹元植),장경태(張耿態),103,97,200,0
34451,우원식(禹元植),장동혁(張東赫),25,4,29,1
34452,우원식(禹元植),장제원(張濟元),49,4,53,1
34453,우원식(禹元植),장철민(張喆敏),97,93,190,0
34454,우원식(禹元植),장혜영(張惠英),16,21,37,1
34455,우원식(禹元植),전봉민(田奉珉),35,5,40,1
34456,우원식(禹元植),전용기(田溶冀),88,79,167,0
34457,우원식(禹元植),전재수(田載秀),83,50,133,0
34458,우원식(禹元植),전주혜(全珠惠),51,5,56,1
34459,우원식(禹元植),전해철(全海澈),78,60,138,0
34460,우원식(禹元植),전혜숙(全惠淑),103,95,198,0
34461,우원식(禹元植),정경희(丁慶姬),50,4,54,1
34462,우원식(禹元植),정동만(鄭東萬),49,4,53,1
34463,우원식(禹元植),정성호(鄭成湖),85,71,156,0
34464,우원식(禹元植),정우택(鄭宇澤),26,5,31,1
34465,우원식(禹元植),정운천(鄭雲天),50,4,54,1
34466,우원식(禹元植),정일영(鄭日永),105,102,207,0
34467,우원식(禹元植),정점식(鄭点植),49,4,53,1
34468,우원식(禹元植),정진석(鄭鎭碩),49,4,53,1
34469,우원식(禹元植),정청래(鄭淸來),92,55,147,0
34470,우원식(禹元植),정춘숙(鄭春淑),94,83,177,0
34471,우원식(禹元植),정태호(鄭泰浩),85,70,155,0
34472,우원식(禹元植),정필모(鄭必模),95,79,174,0
34473,우원식(禹元植),정희용(鄭熙溶),50,5,55,1
34474,우원식(禹元植),조경태(趙慶泰),50,4,54,1
34475,우원식(禹元植),조명희(曺明姬),51,5,56,1
34476,우원식(禹元植),조수진(趙修眞),50,4,54,1
34477,우원식(禹元植),조승래(趙承來),86,51,137,0
34478,우원식(禹元植),조오섭(曺五燮),117,197,314,0
34479,우원식(禹元植),조은희(趙恩禧),26,4,30,1
34480,우원식(禹元植),조응천(趙應天),81,34,115,0
34481,우원식(禹元植),조정식(趙正湜),77,54,131,0
34482,우원식(禹元植),조정훈(趙廷訓),4,11,15,1
34483,우원식(禹元植),조해진(曺海珍),50,5,55,1
34484,우원식(禹元植),주철현(朱哲鉉),105,118,223,0
34485,우원식(禹元植),주호영(朱豪英),49,4,53,1
34486,우원식(禹元植),지성호(池成浩),50,4,54,1
34487,우원식(禹元植),진선미(陳善美),81,75,156,0
34488,우원식(禹元植),진성준(陳聲準),118,145,263,0
34489,우원식(禹元植),천준호(千俊鎬),109,75,184,0
34490,우원식(禹元植),최기상(崔基相),91,95,186,0
34491,우원식(禹元植),최승재(崔承宰),51,4,55,1
34492,우원식(禹元植),최연숙(崔姸淑),34,10,44,1
34493,우원식(禹元植),최영희(崔英姬),25,5,30,1
34494,우원식(禹元植),최인호(崔仁昊),86,78,164,0
34495,우원식(禹元植),최재형(崔在亨),25,5,30,1
34496,우원식(禹元植),최종윤(崔鍾允),93,96,189,0
34497,우원식(禹元植),최춘식(崔春植),49,4,53,1
34498,우원식(禹元植),최형두(崔炯斗),50,4,54,1
34499,우원식(禹元植),최혜영(崔惠英),117,97,214,0
34500,우원식(禹元植),추경호(秋慶鎬),49,4,53,1
34501,우원식(禹元植),태영호(太永浩),49,5,54,1
34502,우원식(禹元植),하영제(河榮帝),41,1,42,1
34503,우원식(禹元植),하태경(河泰慶),49,6,55,1
34504,우원식(禹元植),한기호(韓起鎬),50,4,54,1
34505,우원식(禹元植),한무경(韓茂景),49,4,53,1
34506,우원식(禹元植),한병도(韓秉道),109,72,181,0
34507,우원식(禹元植),한정애(韓貞愛),86,58,144,0
34508,우원식(禹元植),한준호(韓俊鎬),100,97,197,0
34509,우원식(禹元植),허숙정(許淑湞),1,2,3,0
34510,우원식(禹元植),허영(許榮),125,132,257,0
34511,우원식(禹元植),허은아(許垠娥),49,4,53,1
34512,우원식(禹元植),허종식(許琮植),90,92,182,0
34513,우원식(禹元植),홍기원(洪起元),103,81,184,0
34514,우원식(禹元植),홍문표(洪文杓),49,5,54,1
34515,우원식(禹元植),홍석준(洪碩晙),49,4,53,1
34516,우원식(禹元植),홍성국(洪性國),103,98,201,0
34517,우원식(禹元植),홍영표(洪永杓),84,49,133,0
34518,우원식(禹元植),홍익표(洪翼杓),95,78,173,0
34519,우원식(禹元植),홍정민(洪貞敏),104,73,177,0
34520,우원식(禹元植),황보승희(皇甫承希),46,1,47,1
34521,우원식(禹元植),황운하(黃雲夏),93,88,181,0
34522,우원식(禹元植),황희(黃熙),82,45,127,0
34523,위성곤(魏聖坤),유경준(兪京濬),49,5,54,1
34524,위성곤(魏聖坤),유기홍(柳基洪),83,60,143,0
34525,위성곤(魏聖坤),유동수(柳東秀),101,91,192,0
34526,위성곤(魏聖坤),유상범(劉相凡),50,5,55,1
34527,위성곤(魏聖坤),유의동(兪義東),49,4,53,1
34528,위성곤(魏聖坤),유정주(兪訂炷),114,180,294,0
34529,위성곤(魏聖坤),윤건영(尹建永),90,109,199,0
34530,위성곤(魏聖坤),윤관석(尹官石),75,55,130,1
34531,위성곤(魏聖坤),윤두현(尹斗鉉),49,4,53,1
34532,위성곤(魏聖坤),윤미향(尹美香),52,110,162,1
34533,위성곤(魏聖坤),윤상현(尹相現),30,6,36,1
34534,위성곤(魏聖坤),윤영덕(尹永德),124,191,315,0
34535,위성곤(魏聖坤),윤영석(尹永碩),52,9,61,1
34536,위성곤(魏聖坤),윤영찬(尹永燦),84,54,138,0
34537,위성곤(魏聖坤),윤재갑(尹才鉀),212,334,546,0
34538,위성곤(魏聖坤),윤재옥(尹在玉),49,5,54,1
34539,위성곤(魏聖坤),윤주경(尹柱卿),50,5,55,1
34540,위성곤(魏聖坤),윤준병(尹準炳),152,331,483,0
34541,위성곤(魏聖坤),윤창현(尹暢賢),51,7,58,1
34542,위성곤(魏聖坤),윤한홍(尹漢洪),50,4,54,1
34543,위성곤(魏聖坤),윤호중(尹昊重),82,54,136,0
34544,위성곤(魏聖坤),윤후덕(尹厚德),88,82,170,0
34545,위성곤(魏聖坤),이개호(李介昊),184,321,505,0
34546,위성곤(魏聖坤),이달곤(李達坤),53,9,62,1
34547,위성곤(魏聖坤),이동주(李東洲),108,193,301,0
34548,위성곤(魏聖坤),이만희(李晩熙),52,6,58,1
34549,위성곤(魏聖坤),이명수(李明洙),53,18,71,1
34550,위성곤(魏聖坤),이병훈(李炳勳),119,228,347,0
34551,위성곤(魏聖坤),이상민(李相珉),78,36,114,0
34552,위성곤(魏聖坤),이상헌(李相憲),106,170,276,0
34553,위성곤(魏聖坤),이성만(李成萬),87,110,197,1
34554,위성곤(魏聖坤),이소영(李素永),95,88,183,0
34555,위성곤(魏聖坤),이수진(李壽珍),120,181,301,0
34556,위성곤(魏聖坤),이수진(李秀眞),106,138,244,0
34557,위성곤(魏聖坤),이양수(李亮壽),57,9,66,1
34558,위성곤(魏聖坤),이용(李鏞),49,6,55,1
34559,위성곤(魏聖坤),이용빈(李龍彬),148,252,400,0
34560,위성곤(魏聖坤),이용선(李庸瑄),105,113,218,0
34561,위성곤(魏聖坤),이용우(李龍雨),106,118,224,0
34562,위성곤(魏聖坤),이용호(李容鎬),38,29,67,1
34563,위성곤(魏聖坤),이원욱(李元旭),87,106,193,0
34564,위성곤(魏聖坤),이원택(李源澤),148,173,321,0
34565,위성곤(魏聖坤),이은주(李恩周),22,36,58,1
34566,위성곤(魏聖坤),이인선(李仁善),25,4,29,1
34567,위성곤(魏聖坤),이인영(李仁榮),77,53,130,0
34568,위성곤(魏聖坤),이장섭(李將燮),88,97,185,0
34569,위성곤(魏聖坤),이재명(李在明),40,24,64,0
34570,위성곤(魏聖坤),이재정(李在汀),86,61,147,0
34571,위성곤(魏聖坤),이정문(李楨文),96,91,187,0
34572,위성곤(魏聖坤),이종배(李鍾培),50,5,55,1
34573,위성곤(魏聖坤),이종성(李鍾成),50,6,56,1
34574,위성곤(魏聖坤),이주환(李周桓),49,6,55,1
34575,위성곤(魏聖坤),이채익(李埰益),52,5,57,1
34576,위성곤(魏聖坤),이철규(李喆圭),53,12,65,1
34577,위성곤(魏聖坤),이탄희(李誕熙),94,87,181,0
34578,위성곤(魏聖坤),이태규(李泰珪),29,7,36,1
34579,위성곤(魏聖坤),이학영(李學永),112,140,252,0
34580,위성곤(魏聖坤),이해식(李海植),132,142,274,0
34581,위성곤(魏聖坤),이헌승(李憲昇),51,4,55,1
34582,위성곤(魏聖坤),이형석(李炯錫),106,150,256,0
34583,위성곤(魏聖坤),인재근(印在謹),105,134,239,0
34584,위성곤(魏聖坤),임병헌(林炳憲),25,4,29,1
34585,위성곤(魏聖坤),임오경(林五卿),91,84,175,0
34586,위성곤(魏聖坤),임이자(林利子),50,6,56,1
34587,위성곤(魏聖坤),임종성(林鍾聲),101,134,235,0
34588,위성곤(魏聖坤),임호선(林昊宣),131,225,356,0
34589,위성곤(魏聖坤),장경태(張耿態),110,161,271,0
34590,위성곤(魏聖坤),장동혁(張東赫),25,5,30,1
34591,위성곤(魏聖坤),장제원(張濟元),49,6,55,1
34592,위성곤(魏聖坤),장철민(張喆敏),90,103,193,0
34593,위성곤(魏聖坤),장혜영(張惠英),15,31,46,1
34594,위성곤(魏聖坤),전봉민(田奉珉),35,5,40,1
34595,위성곤(魏聖坤),전용기(田溶冀),107,108,215,0
34596,위성곤(魏聖坤),전재수(田載秀),96,103,199,0
34597,위성곤(魏聖坤),전주혜(全珠惠),51,5,56,1
34598,위성곤(魏聖坤),전해철(全海澈),76,59,135,0
34599,위성곤(魏聖坤),전혜숙(全惠淑),101,100,201,0
34600,위성곤(魏聖坤),정경희(丁慶姬),49,5,54,1
34601,위성곤(魏聖坤),정동만(鄭東萬),49,7,56,1
34602,위성곤(魏聖坤),정성호(鄭成湖),86,90,176,0
34603,위성곤(魏聖坤),정우택(鄭宇澤),25,7,32,1
34604,위성곤(魏聖坤),정운천(鄭雲天),56,19,75,1
34605,위성곤(魏聖坤),정일영(鄭日永),108,143,251,0
34606,위성곤(魏聖坤),정점식(鄭点植),53,8,61,1
34607,위성곤(魏聖坤),정진석(鄭鎭碩),50,14,64,1
34608,위성곤(魏聖坤),정청래(鄭淸來),88,56,144,0
34609,위성곤(魏聖坤),정춘숙(鄭春淑),114,120,234,0
34610,위성곤(魏聖坤),정태호(鄭泰浩),92,117,209,0
34611,위성곤(魏聖坤),정필모(鄭必模),95,97,192,0
34612,위성곤(魏聖坤),정희용(鄭熙溶),51,10,61,1
34613,위성곤(魏聖坤),조경태(趙慶泰),56,17,73,1
34614,위성곤(魏聖坤),조명희(曺明姬),51,12,63,1
34615,위성곤(魏聖坤),조수진(趙修眞),49,4,53,1
34616,위성곤(魏聖坤),조승래(趙承來),88,61,149,0
34617,위성곤(魏聖坤),조오섭(曺五燮),118,226,344,0
34618,위성곤(魏聖坤),조은희(趙恩禧),25,4,29,1
34619,위성곤(魏聖坤),조응천(趙應天),90,40,130,0
34620,위성곤(魏聖坤),조정식(趙正湜),78,49,127,0
34621,위성곤(魏聖坤),조정훈(趙廷訓),7,24,31,1
34622,위성곤(魏聖坤),조해진(曺海珍),52,6,58,1
34623,위성곤(魏聖坤),주철현(朱哲鉉),149,266,415,0
34624,위성곤(魏聖坤),주호영(朱豪英),50,4,54,1
34625,위성곤(魏聖坤),지성호(池成浩),49,7,56,1
34626,위성곤(魏聖坤),진선미(陳善美),95,62,157,0
34627,위성곤(魏聖坤),진성준(陳聲準),110,182,292,0
34628,위성곤(魏聖坤),천준호(千俊鎬),105,75,180,0
34629,위성곤(魏聖坤),최기상(崔基相),93,100,193,0
34630,위성곤(魏聖坤),최승재(崔承宰),50,14,64,1
34631,위성곤(魏聖坤),최연숙(崔姸淑),33,10,43,1
34632,위성곤(魏聖坤),최영희(崔英姬),25,5,30,1
34633,위성곤(魏聖坤),최인호(崔仁昊),127,153,280,0
34634,위성곤(魏聖坤),최재형(崔在亨),25,5,30,1
34635,위성곤(魏聖坤),최종윤(崔鍾允),105,159,264,0
34636,위성곤(魏聖坤),최춘식(崔春植),51,8,59,1
34637,위성곤(魏聖坤),최형두(崔炯斗),51,11,62,1
34638,위성곤(魏聖坤),최혜영(崔惠英),95,124,219,0
34639,위성곤(魏聖坤),추경호(秋慶鎬),50,4,54,1
34640,위성곤(魏聖坤),태영호(太永浩),49,8,57,1
34641,위성곤(魏聖坤),하영제(河榮帝),41,7,48,1
34642,위성곤(魏聖坤),하태경(河泰慶),51,7,58,1
34643,위성곤(魏聖坤),한기호(韓起鎬),50,6,56,1
34644,위성곤(魏聖坤),한무경(韓茂景),50,7,57,1
34645,위성곤(魏聖坤),한병도(韓秉道),114,184,298,0
34646,위성곤(魏聖坤),한정애(韓貞愛),87,61,148,0
34647,위성곤(魏聖坤),한준호(韓俊鎬),104,111,215,0
34648,위성곤(魏聖坤),허숙정(許淑湞),1,3,4,0
34649,위성곤(魏聖坤),허영(許榮),150,224,374,0
34650,위성곤(魏聖坤),허은아(許垠娥),49,6,55,1
34651,위성곤(魏聖坤),허종식(許琮植),105,130,235,0
34652,위성곤(魏聖坤),홍기원(洪起元),98,90,188,0
34653,위성곤(魏聖坤),홍문표(洪文杓),79,60,139,1
34654,위성곤(魏聖坤),홍석준(洪碩晙),50,5,55,1
34655,위성곤(魏聖坤),홍성국(洪性國),139,193,332,0
34656,위성곤(魏聖坤),홍영표(洪永杓),83,57,140,0
34657,위성곤(魏聖坤),홍익표(洪翼杓),89,75,164,0
34658,위성곤(魏聖坤),홍정민(洪貞敏),103,136,239,0
34659,위성곤(魏聖坤),황보승희(皇甫承希),47,3,50,1
34660,위성곤(魏聖坤),황운하(黃雲夏),106,144,250,0
34661,위성곤(魏聖坤),황희(黃熙),81,52,133,0
34662,유경준(兪京濬),유기홍(柳基洪),50,4,54,1
34663,유경준(兪京濬),유동수(柳東秀),52,11,63,1
34664,유경준(兪京濬),유상범(劉相凡),73,73,146,0
34665,유경준(兪京濬),유의동(兪義東),80,85,165,0
34666,유경준(兪京濬),유정주(兪訂炷),49,4,53,1
34667,유경준(兪京濬),윤건영(尹建永),49,4,53,1
34668,유경준(兪京濬),윤관석(尹官石),40,0,40,1
34669,유경준(兪京濬),윤두현(尹斗鉉),77,98,175,0
34670,유경준(兪京濬),윤미향(尹美香),20,3,23,1
34671,유경준(兪京濬),윤상현(尹相現),39,54,93,0
34672,유경준(兪京濬),윤영덕(尹永德),49,4,53,1
34673,유경준(兪京濬),윤영석(尹永碩),70,55,125,0
34674,유경준(兪京濬),윤영찬(尹永燦),49,4,53,1
34675,유경준(兪京濬),윤재갑(尹才鉀),52,5,57,1
34676,유경준(兪京濬),윤재옥(尹在玉),77,72,149,0
34677,유경준(兪京濬),윤주경(尹柱卿),71,72,143,0
34678,유경준(兪京濬),윤준병(尹準炳),49,4,53,1
34679,유경준(兪京濬),윤창현(尹暢賢),104,112,216,0
34680,유경준(兪京濬),윤한홍(尹漢洪),79,103,182,0
34681,유경준(兪京濬),윤호중(尹昊重),49,5,54,1
34682,유경준(兪京濬),윤후덕(尹厚德),49,5,54,1
34683,유경준(兪京濬),이개호(李介昊),50,4,54,1
34684,유경준(兪京濬),이달곤(李達坤),66,59,125,0
34685,유경준(兪京濬),이동주(李東洲),49,4,53,1
34686,유경준(兪京濬),이만희(李晩熙),74,67,141,0
34687,유경준(兪京濬),이명수(李明洙),106,160,266,0
34688,유경준(兪京濬),이병훈(李炳勳),50,7,57,1
34689,유경준(兪京濬),이상민(李相珉),49,4,53,1
34690,유경준(兪京濬),이상헌(李相憲),49,5,54,1
34691,유경준(兪京濬),이성만(李成萬),40,1,41,1
34692,유경준(兪京濬),이소영(李素永),49,4,53,1
34693,유경준(兪京濬),이수진(李壽珍),49,5,54,1
34694,유경준(兪京濬),이수진(李秀眞),49,4,53,1
34695,유경준(兪京濬),이양수(李亮壽),74,63,137,0
34696,유경준(兪京濬),이용(李鏞),89,116,205,0
34697,유경준(兪京濬),이용빈(李龍彬),49,5,54,1
34698,유경준(兪京濬),이용선(李庸瑄),49,4,53,1
34699,유경준(兪京濬),이용우(李龍雨),49,4,53,1
34700,유경준(兪京濬),이용호(李容鎬),32,15,47,0
34701,유경준(兪京濬),이원욱(李元旭),49,5,54,1
34702,유경준(兪京濬),이원택(李源澤),49,4,53,1
34703,유경준(兪京濬),이은주(李恩周),5,3,8,1
34704,유경준(兪京濬),이인선(李仁善),29,48,77,0
34705,유경준(兪京濬),이인영(李仁榮),49,4,53,1
34706,유경준(兪京濬),이장섭(李將燮),49,4,53,1
34707,유경준(兪京濬),이재명(李在明),25,4,29,1
34708,유경준(兪京濬),이재정(李在汀),49,4,53,1
34709,유경준(兪京濬),이정문(李楨文),49,7,56,1
34710,유경준(兪京濬),이종배(李鍾培),95,115,210,0
34711,유경준(兪京濬),이종성(李鍾成),97,131,228,0
34712,유경준(兪京濬),이주환(李周桓),91,118,209,0
34713,유경준(兪京濬),이채익(李埰益),85,121,206,0
34714,유경준(兪京濬),이철규(李喆圭),68,60,128,0
34715,유경준(兪京濬),이탄희(李誕熙),49,7,56,1
34716,유경준(兪京濬),이태규(李泰珪),49,61,110,0
34717,유경준(兪京濬),이학영(李學永),49,4,53,1
34718,유경준(兪京濬),이해식(李海植),49,4,53,1
34719,유경준(兪京濬),이헌승(李憲昇),74,92,166,0
34720,유경준(兪京濬),이형석(李炯錫),49,4,53,1
34721,유경준(兪京濬),인재근(印在謹),49,4,53,1
34722,유경준(兪京濬),임병헌(林炳憲),33,45,78,0
34723,유경준(兪京濬),임오경(林五卿),49,4,53,1
34724,유경준(兪京濬),임이자(林利子),77,77,154,0
34725,유경준(兪京濬),임종성(林鍾聲),50,7,57,1
34726,유경준(兪京濬),임호선(林昊宣),50,5,55,1
34727,유경준(兪京濬),장경태(張耿態),50,5,55,1
34728,유경준(兪京濬),장동혁(張東赫),33,49,82,0
34729,유경준(兪京濬),장제원(張濟元),66,33,99,0
34730,유경준(兪京濬),장철민(張喆敏),49,5,54,1
34731,유경준(兪京濬),장혜영(張惠英),6,4,10,1
34732,유경준(兪京濬),전봉민(田奉珉),62,89,151,0
34733,유경준(兪京濬),전용기(田溶冀),49,5,54,1
34734,유경준(兪京濬),전재수(田載秀),49,4,53,1
34735,유경준(兪京濬),전주혜(全珠惠),73,82,155,0
34736,유경준(兪京濬),전해철(全海澈),49,4,53,1
34737,유경준(兪京濬),전혜숙(全惠淑),50,7,57,1
34738,유경준(兪京濬),정경희(丁慶姬),74,77,151,0
34739,유경준(兪京濬),정동만(鄭東萬),89,131,220,0
34740,유경준(兪京濬),정성호(鄭成湖),51,10,61,1
34741,유경준(兪京濬),정우택(鄭宇澤),48,71,119,0
34742,유경준(兪京濬),정운천(鄭雲天),79,77,156,0
34743,유경준(兪京濬),정일영(鄭日永),50,6,56,1
34744,유경준(兪京濬),정점식(鄭点植),73,59,132,0
34745,유경준(兪京濬),정진석(鄭鎭碩),73,69,142,0
34746,유경준(兪京濬),정청래(鄭淸來),49,4,53,1
34747,유경준(兪京濬),정춘숙(鄭春淑),49,5,54,1
34748,유경준(兪京濬),정태호(鄭泰浩),49,6,55,1
34749,유경준(兪京濬),정필모(鄭必模),49,4,53,1
34750,유경준(兪京濬),정희용(鄭熙溶),86,97,183,0
34751,유경준(兪京濬),조경태(趙慶泰),82,82,164,0
34752,유경준(兪京濬),조명희(曺明姬),104,162,266,0
34753,유경준(兪京濬),조수진(趙修眞),91,112,203,0
34754,유경준(兪京濬),조승래(趙承來),49,3,52,1
34755,유경준(兪京濬),조오섭(曺五燮),49,4,53,1
34756,유경준(兪京濬),조은희(趙恩禧),37,44,81,0
34757,유경준(兪京濬),조응천(趙應天),51,4,55,1
34758,유경준(兪京濬),조정식(趙正湜),49,3,52,1
34759,유경준(兪京濬),조정훈(趙廷訓),2,14,16,1
34760,유경준(兪京濬),조해진(曺海珍),64,41,105,0
34761,유경준(兪京濬),주철현(朱哲鉉),50,5,55,1
34762,유경준(兪京濬),주호영(朱豪英),65,47,112,0
34763,유경준(兪京濬),지성호(池成浩),98,146,244,0
34764,유경준(兪京濬),진선미(陳善美),49,4,53,1
34765,유경준(兪京濬),진성준(陳聲準),49,4,53,1
34766,유경준(兪京濬),천준호(千俊鎬),49,3,52,1
34767,유경준(兪京濬),최기상(崔基相),49,4,53,1
34768,유경준(兪京濬),최승재(崔承宰),82,82,164,0
34769,유경준(兪京濬),최연숙(崔姸淑),42,38,80,0
34770,유경준(兪京濬),최영희(崔英姬),28,35,63,0
34771,유경준(兪京濬),최인호(崔仁昊),50,4,54,1
34772,유경준(兪京濬),최재형(崔在亨),30,26,56,0
34773,유경준(兪京濬),최종윤(崔鍾允),49,4,53,1
34774,유경준(兪京濬),최춘식(崔春植),83,103,186,0
34775,유경준(兪京濬),최형두(崔炯斗),77,83,160,0
34776,유경준(兪京濬),최혜영(崔惠英),49,7,56,1
34777,유경준(兪京濬),추경호(秋慶鎬),111,108,219,0
34778,유경준(兪京濬),태영호(太永浩),118,188,306,0
34779,유경준(兪京濬),하영제(河榮帝),75,103,178,1
34780,유경준(兪京濬),하태경(河泰慶),63,59,122,0
34781,유경준(兪京濬),한기호(韓起鎬),71,67,138,0
34782,유경준(兪京濬),한무경(韓茂景),90,144,234,0
34783,유경준(兪京濬),한병도(韓秉道),49,4,53,1
34784,유경준(兪京濬),한정애(韓貞愛),49,6,55,1
34785,유경준(兪京濬),한준호(韓俊鎬),49,4,53,1
34786,유경준(兪京濬),허숙정(許淑湞),0,0,0,1
34787,유경준(兪京濬),허영(許榮),49,4,53,1
34788,유경준(兪京濬),허은아(許垠娥),80,88,168,0
34789,유경준(兪京濬),허종식(許琮植),49,8,57,1
34790,유경준(兪京濬),홍기원(洪起元),49,4,53,1
34791,유경준(兪京濬),홍문표(洪文杓),77,86,163,0
34792,유경준(兪京濬),홍석준(洪碩晙),74,67,141,0
34793,유경준(兪京濬),홍성국(洪性國),49,5,54,1
34794,유경준(兪京濬),홍영표(洪永杓),49,6,55,1
34795,유경준(兪京濬),홍익표(洪翼杓),49,7,56,1
34796,유경준(兪京濬),홍정민(洪貞敏),49,7,56,1
34797,유경준(兪京濬),황보승희(皇甫承希),102,130,232,1
34798,유경준(兪京濬),황운하(黃雲夏),49,5,54,1
34799,유경준(兪京濬),황희(黃熙),49,4,53,1
34800,유기홍(柳基洪),유동수(柳東秀),81,40,121,0
34801,유기홍(柳基洪),유상범(劉相凡),49,4,53,1
34802,유기홍(柳基洪),유의동(兪義東),49,4,53,1
34803,유기홍(柳基洪),유정주(兪訂炷),87,84,171,0
34804,유기홍(柳基洪),윤건영(尹建永),78,49,127,0
34805,유기홍(柳基洪),윤관석(尹官石),66,38,104,1
34806,유기홍(柳基洪),윤두현(尹斗鉉),49,5,54,1
34807,유기홍(柳基洪),윤미향(尹美香),34,37,71,1
34808,유기홍(柳基洪),윤상현(尹相現),31,4,35,1
34809,유기홍(柳基洪),윤영덕(尹永德),95,94,189,0
34810,유기홍(柳基洪),윤영석(尹永碩),50,5,55,1
34811,유기홍(柳基洪),윤영찬(尹永燦),79,60,139,0
34812,유기홍(柳基洪),윤재갑(尹才鉀),85,58,143,0
34813,유기홍(柳基洪),윤재옥(尹在玉),49,4,53,1
34814,유기홍(柳基洪),윤주경(尹柱卿),49,5,54,1
34815,유기홍(柳基洪),윤준병(尹準炳),82,73,155,0
34816,유기홍(柳基洪),윤창현(尹暢賢),49,4,53,1
34817,유기홍(柳基洪),윤한홍(尹漢洪),50,4,54,1
34818,유기홍(柳基洪),윤호중(尹昊重),76,56,132,0
34819,유기홍(柳基洪),윤후덕(尹厚德),80,63,143,0
34820,유기홍(柳基洪),이개호(李介昊),80,48,128,0
34821,유기홍(柳基洪),이달곤(李達坤),51,8,59,1
34822,유기홍(柳基洪),이동주(李東洲),86,80,166,0
34823,유기홍(柳基洪),이만희(李晩熙),49,5,54,1
34824,유기홍(柳基洪),이명수(李明洙),50,9,59,1
34825,유기홍(柳基洪),이병훈(李炳勳),91,68,159,0
34826,유기홍(柳基洪),이상민(李相珉),75,44,119,0
34827,유기홍(柳基洪),이상헌(李相憲),81,55,136,0
34828,유기홍(柳基洪),이성만(李成萬),69,52,121,1
34829,유기홍(柳基洪),이소영(李素永),81,42,123,0
34830,유기홍(柳基洪),이수진(李壽珍),89,66,155,0
34831,유기홍(柳基洪),이수진(李秀眞),84,54,138,0
34832,유기홍(柳基洪),이양수(李亮壽),51,6,57,1
34833,유기홍(柳基洪),이용(李鏞),49,4,53,1
34834,유기홍(柳基洪),이용빈(李龍彬),85,85,170,0
34835,유기홍(柳基洪),이용선(李庸瑄),81,59,140,0
34836,유기홍(柳基洪),이용우(李龍雨),81,41,122,0
34837,유기홍(柳基洪),이용호(李容鎬),28,6,34,1
34838,유기홍(柳基洪),이원욱(李元旭),84,69,153,0
34839,유기홍(柳基洪),이원택(李源澤),76,49,125,0
34840,유기홍(柳基洪),이은주(李恩周),13,14,27,1
34841,유기홍(柳基洪),이인선(李仁善),25,4,29,1
34842,유기홍(柳基洪),이인영(李仁榮),74,46,120,0
34843,유기홍(柳基洪),이장섭(李將燮),78,66,144,0
34844,유기홍(柳基洪),이재명(李在明),39,22,61,0
34845,유기홍(柳基洪),이재정(李在汀),76,51,127,0
34846,유기홍(柳基洪),이정문(李楨文),90,79,169,0
34847,유기홍(柳基洪),이종배(李鍾培),50,6,56,1
34848,유기홍(柳基洪),이종성(李鍾成),49,7,56,1
34849,유기홍(柳基洪),이주환(李周桓),49,5,54,1
34850,유기홍(柳基洪),이채익(李埰益),51,5,56,1
34851,유기홍(柳基洪),이철규(李喆圭),50,5,55,1
34852,유기홍(柳基洪),이탄희(李誕熙),91,51,142,0
34853,유기홍(柳基洪),이태규(李泰珪),29,4,33,1
34854,유기홍(柳基洪),이학영(李學永),86,108,194,0
34855,유기홍(柳基洪),이해식(李海植),84,54,138,0
34856,유기홍(柳基洪),이헌승(李憲昇),50,6,56,1
34857,유기홍(柳基洪),이형석(李炯錫),86,68,154,0
34858,유기홍(柳基洪),인재근(印在謹),91,80,171,0
34859,유기홍(柳基洪),임병헌(林炳憲),25,5,30,1
34860,유기홍(柳基洪),임오경(林五卿),80,52,132,0
34861,유기홍(柳基洪),임이자(林利子),49,4,53,1
34862,유기홍(柳基洪),임종성(林鍾聲),82,75,157,0
34863,유기홍(柳基洪),임호선(林昊宣),91,107,198,0
34864,유기홍(柳基洪),장경태(張耿態),84,61,145,0
34865,유기홍(柳基洪),장동혁(張東赫),25,4,29,1
34866,유기홍(柳基洪),장제원(張濟元),49,4,53,1
34867,유기홍(柳基洪),장철민(張喆敏),82,58,140,0
34868,유기홍(柳基洪),장혜영(張惠英),16,15,31,1
34869,유기홍(柳基洪),전봉민(田奉珉),35,5,40,1
34870,유기홍(柳基洪),전용기(田溶冀),80,60,140,0
34871,유기홍(柳基洪),전재수(田載秀),80,39,119,0
34872,유기홍(柳基洪),전주혜(全珠惠),51,4,55,1
34873,유기홍(柳基洪),전해철(全海澈),74,55,129,0
34874,유기홍(柳基洪),전혜숙(全惠淑),79,50,129,0
34875,유기홍(柳基洪),정경희(丁慶姬),49,4,53,1
34876,유기홍(柳基洪),정동만(鄭東萬),49,4,53,1
34877,유기홍(柳基洪),정성호(鄭成湖),84,48,132,0
34878,유기홍(柳基洪),정우택(鄭宇澤),25,4,29,1
34879,유기홍(柳基洪),정운천(鄭雲天),49,4,53,1
34880,유기홍(柳基洪),정일영(鄭日永),78,47,125,0
34881,유기홍(柳基洪),정점식(鄭点植),50,4,54,1
34882,유기홍(柳基洪),정진석(鄭鎭碩),50,7,57,1
34883,유기홍(柳基洪),정청래(鄭淸來),79,42,121,0
34884,유기홍(柳基洪),정춘숙(鄭春淑),84,62,146,0
34885,유기홍(柳基洪),정태호(鄭泰浩),84,65,149,0
34886,유기홍(柳基洪),정필모(鄭必模),80,58,138,0
34887,유기홍(柳基洪),정희용(鄭熙溶),50,5,55,1
34888,유기홍(柳基洪),조경태(趙慶泰),49,4,53,1
34889,유기홍(柳基洪),조명희(曺明姬),49,5,54,1
34890,유기홍(柳基洪),조수진(趙修眞),49,4,53,1
34891,유기홍(柳基洪),조승래(趙承來),88,71,159,0
34892,유기홍(柳基洪),조오섭(曺五燮),84,111,195,0
34893,유기홍(柳基洪),조은희(趙恩禧),25,4,29,1
34894,유기홍(柳基洪),조응천(趙應天),79,41,120,0
34895,유기홍(柳基洪),조정식(趙正湜),77,46,123,0
34896,유기홍(柳基洪),조정훈(趙廷訓),1,8,9,1
34897,유기홍(柳基洪),조해진(曺海珍),52,6,58,1
34898,유기홍(柳基洪),주철현(朱哲鉉),84,55,139,0
34899,유기홍(柳基洪),주호영(朱豪英),49,4,53,1
34900,유기홍(柳基洪),지성호(池成浩),49,4,53,1
34901,유기홍(柳基洪),진선미(陳善美),78,44,122,0
34902,유기홍(柳基洪),진성준(陳聲準),85,58,143,0
34903,유기홍(柳基洪),천준호(千俊鎬),76,41,117,0
34904,유기홍(柳基洪),최기상(崔基相),86,68,154,0
34905,유기홍(柳基洪),최승재(崔承宰),49,5,54,1
34906,유기홍(柳基洪),최연숙(崔姸淑),31,11,42,1
34907,유기홍(柳基洪),최영희(崔英姬),25,4,29,1
34908,유기홍(柳基洪),최인호(崔仁昊),88,69,157,0
34909,유기홍(柳基洪),최재형(崔在亨),25,4,29,1
34910,유기홍(柳基洪),최종윤(崔鍾允),80,78,158,0
34911,유기홍(柳基洪),최춘식(崔春植),49,5,54,1
34912,유기홍(柳基洪),최형두(崔炯斗),50,7,57,1
34913,유기홍(柳基洪),최혜영(崔惠英),86,76,162,0
34914,유기홍(柳基洪),추경호(秋慶鎬),49,3,52,1
34915,유기홍(柳基洪),태영호(太永浩),49,4,53,1
34916,유기홍(柳基洪),하영제(河榮帝),42,1,43,1
34917,유기홍(柳基洪),하태경(河泰慶),49,5,54,1
34918,유기홍(柳基洪),한기호(韓起鎬),50,6,56,1
34919,유기홍(柳基洪),한무경(韓茂景),49,4,53,1
34920,유기홍(柳基洪),한병도(韓秉道),85,60,145,0
34921,유기홍(柳基洪),한정애(韓貞愛),75,56,131,0
34922,유기홍(柳基洪),한준호(韓俊鎬),87,82,169,0
34923,유기홍(柳基洪),허숙정(許淑湞),1,1,2,0
34924,유기홍(柳基洪),허영(許榮),80,75,155,0
34925,유기홍(柳基洪),허은아(許垠娥),49,4,53,1
34926,유기홍(柳基洪),허종식(許琮植),80,59,139,0
34927,유기홍(柳基洪),홍기원(洪起元),92,47,139,0
34928,유기홍(柳基洪),홍문표(洪文杓),50,5,55,1
34929,유기홍(柳基洪),홍석준(洪碩晙),50,4,54,1
34930,유기홍(柳基洪),홍성국(洪性國),85,63,148,0
34931,유기홍(柳基洪),홍영표(洪永杓),79,40,119,0
34932,유기홍(柳基洪),홍익표(洪翼杓),78,54,132,0
34933,유기홍(柳基洪),홍정민(洪貞敏),88,65,153,0
34934,유기홍(柳基洪),황보승희(皇甫承希),46,1,47,1
34935,유기홍(柳基洪),황운하(黃雲夏),81,63,144,0
34936,유기홍(柳基洪),황희(黃熙),79,39,118,0
34937,유동수(柳東秀),유상범(劉相凡),51,4,55,1
34938,유동수(柳東秀),유의동(兪義東),50,4,54,1
34939,유동수(柳東秀),유정주(兪訂炷),97,61,158,0
34940,유동수(柳東秀),윤건영(尹建永),80,39,119,0
34941,유동수(柳東秀),윤관석(尹官石),97,75,172,1
34942,유동수(柳東秀),윤두현(尹斗鉉),50,4,54,1
34943,유동수(柳東秀),윤미향(尹美香),47,49,96,1
34944,유동수(柳東秀),윤상현(尹相現),34,15,49,1
34945,유동수(柳東秀),윤영덕(尹永德),89,57,146,0
34946,유동수(柳東秀),윤영석(尹永碩),51,7,58,1
34947,유동수(柳東秀),윤영찬(尹永燦),83,46,129,0
34948,유동수(柳東秀),윤재갑(尹才鉀),108,72,180,0
34949,유동수(柳東秀),윤재옥(尹在玉),51,4,55,1
34950,유동수(柳東秀),윤주경(尹柱卿),50,8,58,1
34951,유동수(柳東秀),윤준병(尹準炳),101,74,175,0
34952,유동수(柳東秀),윤창현(尹暢賢),50,6,56,1
34953,유동수(柳東秀),윤한홍(尹漢洪),52,4,56,1
34954,유동수(柳東秀),윤호중(尹昊重),79,47,126,0
34955,유동수(柳東秀),윤후덕(尹厚德),92,87,179,0
34956,유동수(柳東秀),이개호(李介昊),105,73,178,0
34957,유동수(柳東秀),이달곤(李達坤),51,6,57,1
34958,유동수(柳東秀),이동주(李東洲),93,71,164,0
34959,유동수(柳東秀),이만희(李晩熙),52,5,57,1
34960,유동수(柳東秀),이명수(李明洙),52,11,63,1
34961,유동수(柳東秀),이병훈(李炳勳),104,80,184,0
34962,유동수(柳東秀),이상민(李相珉),79,38,117,0
34963,유동수(柳東秀),이상헌(李相憲),97,89,186,0
34964,유동수(柳東秀),이성만(李成萬),136,164,300,1
34965,유동수(柳東秀),이소영(李素永),82,43,125,0
34966,유동수(柳東秀),이수진(李壽珍),105,75,180,0
34967,유동수(柳東秀),이수진(李秀眞),96,70,166,0
34968,유동수(柳東秀),이양수(李亮壽),52,8,60,1
34969,유동수(柳東秀),이용(李鏞),49,4,53,1
34970,유동수(柳東秀),이용빈(李龍彬),102,96,198,0
34971,유동수(柳東秀),이용선(李庸瑄),96,68,164,0
34972,유동수(柳東秀),이용우(李龍雨),105,73,178,0
34973,유동수(柳東秀),이용호(李容鎬),34,19,53,1
34974,유동수(柳東秀),이원욱(李元旭),100,82,182,0
34975,유동수(柳東秀),이원택(李源澤),89,56,145,0
34976,유동수(柳東秀),이은주(李恩周),14,19,33,1
34977,유동수(柳東秀),이인선(李仁善),25,4,29,1
34978,유동수(柳東秀),이인영(李仁榮),79,49,128,0
34979,유동수(柳東秀),이장섭(李將燮),84,51,135,0
34980,유동수(柳東秀),이재명(李在明),40,17,57,0
34981,유동수(柳東秀),이재정(李在汀),80,39,119,0
34982,유동수(柳東秀),이정문(李楨文),94,71,165,0
34983,유동수(柳東秀),이종배(李鍾培),54,6,60,1
34984,유동수(柳東秀),이종성(李鍾成),51,14,65,1
34985,유동수(柳東秀),이주환(李周桓),50,7,57,1
34986,유동수(柳東秀),이채익(李埰益),52,6,58,1
34987,유동수(柳東秀),이철규(李喆圭),54,8,62,1
34988,유동수(柳東秀),이탄희(李誕熙),86,51,137,0
34989,유동수(柳東秀),이태규(李泰珪),33,11,44,1
34990,유동수(柳東秀),이학영(李學永),93,67,160,0
34991,유동수(柳東秀),이해식(李海植),101,58,159,0
34992,유동수(柳東秀),이헌승(李憲昇),50,4,54,1
34993,유동수(柳東秀),이형석(李炯錫),88,62,150,0
34994,유동수(柳東秀),인재근(印在謹),92,62,154,0
34995,유동수(柳東秀),임병헌(林炳憲),25,4,29,1
34996,유동수(柳東秀),임오경(林五卿),92,64,156,0
34997,유동수(柳東秀),임이자(林利子),50,5,55,1
34998,유동수(柳東秀),임종성(林鍾聲),128,152,280,0
34999,유동수(柳東秀),임호선(林昊宣),92,69,161,0
35000,유동수(柳東秀),장경태(張耿態),95,86,181,0
35001,유동수(柳東秀),장동혁(張東赫),25,4,29,1
35002,유동수(柳東秀),장제원(張濟元),49,4,53,1
35003,유동수(柳東秀),장철민(張喆敏),91,73,164,0
35004,유동수(柳東秀),장혜영(張惠英),12,15,27,1
35005,유동수(柳東秀),전봉민(田奉珉),35,5,40,1
35006,유동수(柳東秀),전용기(田溶冀),89,77,166,0
35007,유동수(柳東秀),전재수(田載秀),84,46,130,0
35008,유동수(柳東秀),전주혜(全珠惠),51,4,55,1
35009,유동수(柳東秀),전해철(全海澈),78,43,121,0
35010,유동수(柳東秀),전혜숙(全惠淑),95,78,173,0
35011,유동수(柳東秀),정경희(丁慶姬),50,5,55,1
35012,유동수(柳東秀),정동만(鄭東萬),50,4,54,1
35013,유동수(柳東秀),정성호(鄭成湖),91,76,167,0
35014,유동수(柳東秀),정우택(鄭宇澤),25,5,30,1
35015,유동수(柳東秀),정운천(鄭雲天),51,4,55,1
35016,유동수(柳東秀),정일영(鄭日永),126,123,249,0
35017,유동수(柳東秀),정점식(鄭点植),51,4,55,1
35018,유동수(柳東秀),정진석(鄭鎭碩),51,7,58,1
35019,유동수(柳東秀),정청래(鄭淸來),84,54,138,0
35020,유동수(柳東秀),정춘숙(鄭春淑),136,180,316,0
35021,유동수(柳東秀),정태호(鄭泰浩),87,79,166,0
35022,유동수(柳東秀),정필모(鄭必模),87,56,143,0
35023,유동수(柳東秀),정희용(鄭熙溶),51,6,57,1
35024,유동수(柳東秀),조경태(趙慶泰),49,5,54,1
35025,유동수(柳東秀),조명희(曺明姬),51,9,60,1
35026,유동수(柳東秀),조수진(趙修眞),51,5,56,1
35027,유동수(柳東秀),조승래(趙承來),89,62,151,0
35028,유동수(柳東秀),조오섭(曺五燮),89,69,158,0
35029,유동수(柳東秀),조은희(趙恩禧),25,4,29,1
35030,유동수(柳東秀),조응천(趙應天),78,46,124,0
35031,유동수(柳東秀),조정식(趙正湜),80,37,117,0
35032,유동수(柳東秀),조정훈(趙廷訓),3,10,13,1
35033,유동수(柳東秀),조해진(曺海珍),51,6,57,1
35034,유동수(柳東秀),주철현(朱哲鉉),93,45,138,0
35035,유동수(柳東秀),주호영(朱豪英),51,4,55,1
35036,유동수(柳東秀),지성호(池成浩),50,5,55,1
35037,유동수(柳東秀),진선미(陳善美),81,49,130,0
35038,유동수(柳東秀),진성준(陳聲準),89,57,146,0
35039,유동수(柳東秀),천준호(千俊鎬),84,44,128,0
35040,유동수(柳東秀),최기상(崔基相),80,44,124,0
35041,유동수(柳東秀),최승재(崔承宰),51,5,56,1
35042,유동수(柳東秀),최연숙(崔姸淑),31,14,45,1
35043,유동수(柳東秀),최영희(崔英姬),25,5,30,1
35044,유동수(柳東秀),최인호(崔仁昊),85,68,153,0
35045,유동수(柳東秀),최재형(崔在亨),26,5,31,1
35046,유동수(柳東秀),최종윤(崔鍾允),102,93,195,0
35047,유동수(柳東秀),최춘식(崔春植),52,6,58,1
35048,유동수(柳東秀),최형두(崔炯斗),50,4,54,1
35049,유동수(柳東秀),최혜영(崔惠英),83,51,134,0
35050,유동수(柳東秀),추경호(秋慶鎬),50,5,55,1
35051,유동수(柳東秀),태영호(太永浩),52,7,59,1
35052,유동수(柳東秀),하영제(河榮帝),42,1,43,1
35053,유동수(柳東秀),하태경(河泰慶),50,5,55,1
35054,유동수(柳東秀),한기호(韓起鎬),51,5,56,1
35055,유동수(柳東秀),한무경(韓茂景),49,4,53,1
35056,유동수(柳東秀),한병도(韓秉道),97,65,162,0
35057,유동수(柳東秀),한정애(韓貞愛),79,50,129,0
35058,유동수(柳東秀),한준호(韓俊鎬),87,69,156,0
35059,유동수(柳東秀),허숙정(許淑湞),1,1,2,0
35060,유동수(柳東秀),허영(許榮),96,64,160,0
35061,유동수(柳東秀),허은아(許垠娥),49,6,55,1
35062,유동수(柳東秀),허종식(許琮植),139,163,302,0
35063,유동수(柳東秀),홍기원(洪起元),94,70,164,0
35064,유동수(柳東秀),홍문표(洪文杓),51,5,56,1
35065,유동수(柳東秀),홍석준(洪碩晙),51,4,55,1
35066,유동수(柳東秀),홍성국(洪性國),115,95,210,0
35067,유동수(柳東秀),홍영표(洪永杓),96,83,179,0
35068,유동수(柳東秀),홍익표(洪翼杓),81,54,135,0
35069,유동수(柳東秀),홍정민(洪貞敏),102,71,173,0
35070,유동수(柳東秀),황보승희(皇甫承希),48,2,50,1
35071,유동수(柳東秀),황운하(黃雲夏),103,96,199,0
35072,유동수(柳東秀),황희(黃熙),78,43,121,0
35073,유상범(劉相凡),유의동(兪義東),64,76,140,0
35074,유상범(劉相凡),유정주(兪訂炷),51,5,56,1
35075,유상범(劉相凡),윤건영(尹建永),49,3,52,1
35076,유상범(劉相凡),윤관석(尹官石),41,0,41,1
35077,유상범(劉相凡),윤두현(尹斗鉉),78,95,173,0
35078,유상범(劉相凡),윤미향(尹美香),22,0,22,1
35079,유상범(劉相凡),윤상현(尹相現),38,32,70,0
35080,유상범(劉相凡),윤영덕(尹永德),50,6,56,1
35081,유상범(劉相凡),윤영석(尹永碩),62,43,105,0
35082,유상범(劉相凡),윤영찬(尹永燦),49,4,53,1
35083,유상범(劉相凡),윤재갑(尹才鉀),52,4,56,1
35084,유상범(劉相凡),윤재옥(尹在玉),66,54,120,0
35085,유상범(劉相凡),윤주경(尹柱卿),69,67,136,0
35086,유상범(劉相凡),윤준병(尹準炳),49,4,53,1
35087,유상범(劉相凡),윤창현(尹暢賢),79,110,189,0
35088,유상범(劉相凡),윤한홍(尹漢洪),66,71,137,0
35089,유상범(劉相凡),윤호중(尹昊重),50,4,54,1
35090,유상범(劉相凡),윤후덕(尹厚德),49,4,53,1
35091,유상범(劉相凡),이개호(李介昊),50,5,55,1
35092,유상범(劉相凡),이달곤(李達坤),60,54,114,0
35093,유상범(劉相凡),이동주(李東洲),50,4,54,1
35094,유상범(劉相凡),이만희(李晩熙),87,80,167,0
35095,유상범(劉相凡),이명수(李明洙),82,83,165,0
35096,유상범(劉相凡),이병훈(李炳勳),51,6,57,1
35097,유상범(劉相凡),이상민(李相珉),49,4,53,1
35098,유상범(劉相凡),이상헌(李相憲),49,6,55,1
35099,유상범(劉相凡),이성만(李成萬),40,0,40,1
35100,유상범(劉相凡),이소영(李素永),52,4,56,1
35101,유상범(劉相凡),이수진(李壽珍),51,5,56,1
35102,유상범(劉相凡),이수진(李秀眞),50,4,54,1
35103,유상범(劉相凡),이양수(李亮壽),80,73,153,0
35104,유상범(劉相凡),이용(李鏞),82,83,165,0
35105,유상범(劉相凡),이용빈(李龍彬),50,5,55,1
35106,유상범(劉相凡),이용선(李庸瑄),49,4,53,1
35107,유상범(劉相凡),이용우(李龍雨),50,10,60,1
35108,유상범(劉相凡),이용호(李容鎬),30,18,48,0
35109,유상범(劉相凡),이원욱(李元旭),51,4,55,1
35110,유상범(劉相凡),이원택(李源澤),49,5,54,1
35111,유상범(劉相凡),이은주(李恩周),5,2,7,1
35112,유상범(劉相凡),이인선(李仁善),31,27,58,0
35113,유상범(劉相凡),이인영(李仁榮),49,4,53,1
35114,유상범(劉相凡),이장섭(李將燮),49,4,53,1
35115,유상범(劉相凡),이재명(李在明),25,4,29,1
35116,유상범(劉相凡),이재정(李在汀),49,4,53,1
35117,유상범(劉相凡),이정문(李楨文),51,5,56,1
35118,유상범(劉相凡),이종배(李鍾培),70,59,129,0
35119,유상범(劉相凡),이종성(李鍾成),69,85,154,0
35120,유상범(劉相凡),이주환(李周桓),78,62,140,0
35121,유상범(劉相凡),이채익(李埰益),69,66,135,0
35122,유상범(劉相凡),이철규(李喆圭),80,86,166,0
35123,유상범(劉相凡),이탄희(李誕熙),49,5,54,1
35124,유상범(劉相凡),이태규(李泰珪),41,42,83,0
35125,유상범(劉相凡),이학영(李學永),49,4,53,1
35126,유상범(劉相凡),이해식(李海植),49,4,53,1
35127,유상범(劉相凡),이헌승(李憲昇),64,66,130,0
35128,유상범(劉相凡),이형석(李炯錫),50,4,54,1
35129,유상범(劉相凡),인재근(印在謹),50,4,54,1
35130,유상범(劉相凡),임병헌(林炳憲),30,31,61,0
35131,유상범(劉相凡),임오경(林五卿),49,4,53,1
35132,유상범(劉相凡),임이자(林利子),70,71,141,0
35133,유상범(劉相凡),임종성(林鍾聲),51,4,55,1
35134,유상범(劉相凡),임호선(林昊宣),51,6,57,1
35135,유상범(劉相凡),장경태(張耿態),51,4,55,1
35136,유상범(劉相凡),장동혁(張東赫),32,60,92,0
35137,유상범(劉相凡),장제원(張濟元),62,40,102,0
35138,유상범(劉相凡),장철민(張喆敏),50,4,54,1
35139,유상범(劉相凡),장혜영(張惠英),6,2,8,1
35140,유상범(劉相凡),전봉민(田奉珉),44,54,98,0
35141,유상범(劉相凡),전용기(田溶冀),49,4,53,1
35142,유상범(劉相凡),전재수(田載秀),49,4,53,1
35143,유상범(劉相凡),전주혜(全珠惠),84,125,209,0
35144,유상범(劉相凡),전해철(全海澈),49,4,53,1
35145,유상범(劉相凡),전혜숙(全惠淑),49,4,53,1
35146,유상범(劉相凡),정경희(丁慶姬),73,78,151,0
35147,유상범(劉相凡),정동만(鄭東萬),65,52,117,0
35148,유상범(劉相凡),정성호(鄭成湖),50,4,54,1
35149,유상범(劉相凡),정우택(鄭宇澤),35,36,71,0
35150,유상범(劉相凡),정운천(鄭雲天),70,59,129,0
35151,유상범(劉相凡),정일영(鄭日永),50,4,54,1
35152,유상범(劉相凡),정점식(鄭点植),67,74,141,0
35153,유상범(劉相凡),정진석(鄭鎭碩),70,76,146,0
35154,유상범(劉相凡),정청래(鄭淸來),51,4,55,1
35155,유상범(劉相凡),정춘숙(鄭春淑),50,4,54,1
35156,유상범(劉相凡),정태호(鄭泰浩),49,4,53,1
35157,유상범(劉相凡),정필모(鄭必模),49,4,53,1
35158,유상범(劉相凡),정희용(鄭熙溶),77,67,144,0
35159,유상범(劉相凡),조경태(趙慶泰),71,58,129,0
35160,유상범(劉相凡),조명희(曺明姬),75,99,174,0
35161,유상범(劉相凡),조수진(趙修眞),79,165,244,0
35162,유상범(劉相凡),조승래(趙承來),50,4,54,1
35163,유상범(劉相凡),조오섭(曺五燮),49,5,54,1
35164,유상범(劉相凡),조은희(趙恩禧),37,43,80,0
35165,유상범(劉相凡),조응천(趙應天),49,3,52,1
35166,유상범(劉相凡),조정식(趙正湜),49,3,52,1
35167,유상범(劉相凡),조정훈(趙廷訓),1,21,22,1
35168,유상범(劉相凡),조해진(曺海珍),63,35,98,0
35169,유상범(劉相凡),주철현(朱哲鉉),51,5,56,1
35170,유상범(劉相凡),주호영(朱豪英),65,41,106,0
35171,유상범(劉相凡),지성호(池成浩),76,83,159,0
35172,유상범(劉相凡),진선미(陳善美),49,4,53,1
35173,유상범(劉相凡),진성준(陳聲準),49,4,53,1
35174,유상범(劉相凡),천준호(千俊鎬),49,3,52,1
35175,유상범(劉相凡),최기상(崔基相),50,4,54,1
35176,유상범(劉相凡),최승재(崔承宰),74,88,162,0
35177,유상범(劉相凡),최연숙(崔姸淑),36,40,76,0
35178,유상범(劉相凡),최영희(崔英姬),30,36,66,0
35179,유상범(劉相凡),최인호(崔仁昊),51,4,55,1
35180,유상범(劉相凡),최재형(崔在亨),31,16,47,0
35181,유상범(劉相凡),최종윤(崔鍾允),50,4,54,1
35182,유상범(劉相凡),최춘식(崔春植),84,102,186,0
35183,유상범(劉相凡),최형두(崔炯斗),90,76,166,0
35184,유상범(劉相凡),최혜영(崔惠英),49,4,53,1
35185,유상범(劉相凡),추경호(秋慶鎬),74,81,155,0
35186,유상범(劉相凡),태영호(太永浩),80,101,181,0
35187,유상범(劉相凡),하영제(河榮帝),61,62,123,1
35188,유상범(劉相凡),하태경(河泰慶),63,46,109,0
35189,유상범(劉相凡),한기호(韓起鎬),76,73,149,0
35190,유상범(劉相凡),한무경(韓茂景),75,102,177,0
35191,유상범(劉相凡),한병도(韓秉道),51,6,57,1
35192,유상범(劉相凡),한정애(韓貞愛),49,4,53,1
35193,유상범(劉相凡),한준호(韓俊鎬),50,4,54,1
35194,유상범(劉相凡),허숙정(許淑湞),0,0,0,1
35195,유상범(劉相凡),허영(許榮),54,13,67,1
35196,유상범(劉相凡),허은아(許垠娥),66,56,122,0
35197,유상범(劉相凡),허종식(許琮植),50,5,55,1
35198,유상범(劉相凡),홍기원(洪起元),49,4,53,1
35199,유상범(劉相凡),홍문표(洪文杓),64,62,126,0
35200,유상범(劉相凡),홍석준(洪碩晙),63,48,111,0
35201,유상범(劉相凡),홍성국(洪性國),50,4,54,1
35202,유상범(劉相凡),홍영표(洪永杓),49,4,53,1
35203,유상범(劉相凡),홍익표(洪翼杓),51,4,55,1
35204,유상범(劉相凡),홍정민(洪貞敏),51,4,55,1
35205,유상범(劉相凡),황보승희(皇甫承希),64,68,132,1
35206,유상범(劉相凡),황운하(黃雲夏),50,5,55,1
35207,유상범(劉相凡),황희(黃熙),49,10,59,1
35208,유의동(兪義東),유정주(兪訂炷),52,5,57,1
35209,유의동(兪義東),윤건영(尹建永),49,3,52,1
35210,유의동(兪義東),윤관석(尹官石),40,0,40,1
35211,유의동(兪義東),윤두현(尹斗鉉),76,79,155,0
35212,유의동(兪義東),윤미향(尹美香),20,1,21,1
35213,유의동(兪義東),윤상현(尹相現),34,36,70,0
35214,유의동(兪義東),윤영덕(尹永德),49,4,53,1
35215,유의동(兪義東),윤영석(尹永碩),61,42,103,0
35216,유의동(兪義東),윤영찬(尹永燦),49,5,54,1
35217,유의동(兪義東),윤재갑(尹才鉀),54,7,61,1
35218,유의동(兪義東),윤재옥(尹在玉),79,57,136,0
35219,유의동(兪義東),윤주경(尹柱卿),75,73,148,0
35220,유의동(兪義東),윤준병(尹準炳),50,5,55,1
35221,유의동(兪義東),윤창현(尹暢賢),93,109,202,0
35222,유의동(兪義東),윤한홍(尹漢洪),77,71,148,0
35223,유의동(兪義東),윤호중(尹昊重),49,4,53,1
35224,유의동(兪義東),윤후덕(尹厚德),50,4,54,1
35225,유의동(兪義東),이개호(李介昊),49,4,53,1
35226,유의동(兪義東),이달곤(李達坤),60,41,101,0
35227,유의동(兪義東),이동주(李東洲),50,4,54,1
35228,유의동(兪義東),이만희(李晩熙),64,45,109,0
35229,유의동(兪義東),이명수(李明洙),67,85,152,0
35230,유의동(兪義東),이병훈(李炳勳),52,4,56,1
35231,유의동(兪義東),이상민(李相珉),49,4,53,1
35232,유의동(兪義東),이상헌(李相憲),50,4,54,1
35233,유의동(兪義東),이성만(李成萬),40,0,40,1
35234,유의동(兪義東),이소영(李素永),49,5,54,1
35235,유의동(兪義東),이수진(李壽珍),50,5,55,1
35236,유의동(兪義東),이수진(李秀眞),50,4,54,1
35237,유의동(兪義東),이양수(李亮壽),75,59,134,0
35238,유의동(兪義東),이용(李鏞),74,74,148,0
35239,유의동(兪義東),이용빈(李龍彬),51,5,56,1
35240,유의동(兪義東),이용선(李庸瑄),50,5,55,1
35241,유의동(兪義東),이용우(李龍雨),50,11,61,1
35242,유의동(兪義東),이용호(李容鎬),30,16,46,0
35243,유의동(兪義東),이원욱(李元旭),52,5,57,1
35244,유의동(兪義東),이원택(李源澤),49,4,53,1
35245,유의동(兪義東),이은주(李恩周),5,3,8,1
35246,유의동(兪義東),이인선(李仁善),27,67,94,0
35247,유의동(兪義東),이인영(李仁榮),49,4,53,1
35248,유의동(兪義東),이장섭(李將燮),51,4,55,1
35249,유의동(兪義東),이재명(李在明),25,4,29,1
35250,유의동(兪義東),이재정(李在汀),49,4,53,1
35251,유의동(兪義東),이정문(李楨文),49,4,53,1
35252,유의동(兪義東),이종배(李鍾培),84,59,143,0
35253,유의동(兪義東),이종성(李鍾成),76,97,173,0
35254,유의동(兪義東),이주환(李周桓),89,60,149,0
35255,유의동(兪義東),이채익(李埰益),65,63,128,0
35256,유의동(兪義東),이철규(李喆圭),69,67,136,0
35257,유의동(兪義東),이탄희(李誕熙),49,5,54,1
35258,유의동(兪義東),이태규(李泰珪),41,34,75,0
35259,유의동(兪義東),이학영(李學永),49,4,53,1
35260,유의동(兪義東),이해식(李海植),50,4,54,1
35261,유의동(兪義東),이헌승(李憲昇),64,81,145,0
35262,유의동(兪義東),이형석(李炯錫),53,5,58,1
35263,유의동(兪義東),인재근(印在謹),49,4,53,1
35264,유의동(兪義東),임병헌(林炳憲),28,27,55,0
35265,유의동(兪義東),임오경(林五卿),49,4,53,1
35266,유의동(兪義東),임이자(林利子),65,65,130,0
35267,유의동(兪義東),임종성(林鍾聲),53,12,65,1
35268,유의동(兪義東),임호선(林昊宣),49,6,55,1
35269,유의동(兪義東),장경태(張耿態),49,4,53,1
35270,유의동(兪義東),장동혁(張東赫),28,24,52,0
35271,유의동(兪義東),장제원(張濟元),59,35,94,0
35272,유의동(兪義東),장철민(張喆敏),52,8,60,1
35273,유의동(兪義東),장혜영(張惠英),5,10,15,1
35274,유의동(兪義東),전봉민(田奉珉),49,40,89,0
35275,유의동(兪義東),전용기(田溶冀),49,4,53,1
35276,유의동(兪義東),전재수(田載秀),49,4,53,1
35277,유의동(兪義東),전주혜(全珠惠),74,78,152,0
35278,유의동(兪義東),전해철(全海澈),49,4,53,1
35279,유의동(兪義東),전혜숙(全惠淑),52,5,57,1
35280,유의동(兪義東),정경희(丁慶姬),65,56,121,0
35281,유의동(兪義東),정동만(鄭東萬),70,97,167,0
35282,유의동(兪義東),정성호(鄭成湖),49,4,53,1
35283,유의동(兪義東),정우택(鄭宇澤),29,29,58,0
35284,유의동(兪義東),정운천(鄭雲天),74,55,129,0
35285,유의동(兪義東),정일영(鄭日永),49,4,53,1
35286,유의동(兪義東),정점식(鄭点植),65,44,109,0
35287,유의동(兪義東),정진석(鄭鎭碩),79,68,147,0
35288,유의동(兪義東),정청래(鄭淸來),49,4,53,1
35289,유의동(兪義東),정춘숙(鄭春淑),49,4,53,1
35290,유의동(兪義東),정태호(鄭泰浩),49,5,54,1
35291,유의동(兪義東),정필모(鄭必模),49,5,54,1
35292,유의동(兪義東),정희용(鄭熙溶),72,93,165,0
35293,유의동(兪義東),조경태(趙慶泰),65,38,103,0
35294,유의동(兪義東),조명희(曺明姬),80,114,194,0
35295,유의동(兪義東),조수진(趙修眞),76,108,184,0
35296,유의동(兪義東),조승래(趙承來),53,4,57,1
35297,유의동(兪義東),조오섭(曺五燮),50,5,55,1
35298,유의동(兪義東),조은희(趙恩禧),27,22,49,0
35299,유의동(兪義東),조응천(趙應天),49,3,52,1
35300,유의동(兪義東),조정식(趙正湜),49,4,53,1
35301,유의동(兪義東),조정훈(趙廷訓),0,4,4,1
35302,유의동(兪義東),조해진(曺海珍),61,36,97,0
35303,유의동(兪義東),주철현(朱哲鉉),50,4,54,1
35304,유의동(兪義東),주호영(朱豪英),63,55,118,0
35305,유의동(兪義東),지성호(池成浩),75,69,144,0
35306,유의동(兪義東),진선미(陳善美),51,4,55,1
35307,유의동(兪義東),진성준(陳聲準),49,4,53,1
35308,유의동(兪義東),천준호(千俊鎬),49,3,52,1
35309,유의동(兪義東),최기상(崔基相),49,4,53,1
35310,유의동(兪義東),최승재(崔承宰),71,64,135,0
35311,유의동(兪義東),최연숙(崔姸淑),39,44,83,0
35312,유의동(兪義東),최영희(崔英姬),32,23,55,0
35313,유의동(兪義東),최인호(崔仁昊),50,4,54,1
35314,유의동(兪義東),최재형(崔在亨),27,14,41,0
35315,유의동(兪義東),최종윤(崔鍾允),49,4,53,1
35316,유의동(兪義東),최춘식(崔春植),74,75,149,0
35317,유의동(兪義東),최형두(崔炯斗),71,47,118,0
35318,유의동(兪義東),최혜영(崔惠英),50,4,54,1
35319,유의동(兪義東),추경호(秋慶鎬),87,124,211,0
35320,유의동(兪義東),태영호(太永浩),81,75,156,0
35321,유의동(兪義東),하영제(河榮帝),64,66,130,1
35322,유의동(兪義東),하태경(河泰慶),67,50,117,0
35323,유의동(兪義東),한기호(韓起鎬),74,87,161,0
35324,유의동(兪義東),한무경(韓茂景),78,104,182,0
35325,유의동(兪義東),한병도(韓秉道),49,4,53,1
35326,유의동(兪義東),한정애(韓貞愛),53,10,63,1
35327,유의동(兪義東),한준호(韓俊鎬),49,4,53,1
35328,유의동(兪義東),허숙정(許淑湞),0,0,0,1
35329,유의동(兪義東),허영(許榮),51,9,60,1
35330,유의동(兪義東),허은아(許垠娥),72,64,136,0
35331,유의동(兪義東),허종식(許琮植),51,5,56,1
35332,유의동(兪義東),홍기원(洪起元),50,7,57,1
35333,유의동(兪義東),홍문표(洪文杓),73,55,128,0
35334,유의동(兪義東),홍석준(洪碩晙),69,48,117,0
35335,유의동(兪義東),홍성국(洪性國),51,8,59,1
35336,유의동(兪義東),홍영표(洪永杓),51,4,55,1
35337,유의동(兪義東),홍익표(洪翼杓),49,4,53,1
35338,유의동(兪義東),홍정민(洪貞敏),51,5,56,1
35339,유의동(兪義東),황보승희(皇甫承希),79,95,174,1
35340,유의동(兪義東),황운하(黃雲夏),50,4,54,1
35341,유의동(兪義東),황희(黃熙),49,10,59,1
35342,유정주(兪訂炷),윤건영(尹建永),109,125,234,0
35343,유정주(兪訂炷),윤관석(尹官石),86,64,150,1
35344,유정주(兪訂炷),윤두현(尹斗鉉),49,4,53,1
35345,유정주(兪訂炷),윤미향(尹美香),67,148,215,1
35346,유정주(兪訂炷),윤상현(尹相現),30,5,35,1
35347,유정주(兪訂炷),윤영덕(尹永德),127,236,363,0
35348,유정주(兪訂炷),윤영석(尹永碩),50,4,54,1
35349,유정주(兪訂炷),윤영찬(尹永燦),99,72,171,0
35350,유정주(兪訂炷),윤재갑(尹才鉀),128,153,281,0
35351,유정주(兪訂炷),윤재옥(尹在玉),52,6,58,1
35352,유정주(兪訂炷),윤주경(尹柱卿),49,5,54,1
35353,유정주(兪訂炷),윤준병(尹準炳),133,232,365,0
35354,유정주(兪訂炷),윤창현(尹暢賢),49,5,54,1
35355,유정주(兪訂炷),윤한홍(尹漢洪),49,4,53,1
35356,유정주(兪訂炷),윤호중(尹昊重),82,59,141,0
35357,유정주(兪訂炷),윤후덕(尹厚德),98,110,208,0
35358,유정주(兪訂炷),이개호(李介昊),92,92,184,0
35359,유정주(兪訂炷),이달곤(李達坤),50,6,56,1
35360,유정주(兪訂炷),이동주(李東洲),127,176,303,0
35361,유정주(兪訂炷),이만희(李晩熙),49,4,53,1
35362,유정주(兪訂炷),이명수(李明洙),51,20,71,1
35363,유정주(兪訂炷),이병훈(李炳勳),174,294,468,0
35364,유정주(兪訂炷),이상민(李相珉),74,40,114,0
35365,유정주(兪訂炷),이상헌(李相憲),163,273,436,0
35366,유정주(兪訂炷),이성만(李成萬),102,133,235,1
35367,유정주(兪訂炷),이소영(李素永),101,108,209,0
35368,유정주(兪訂炷),이수진(李壽珍),147,285,432,0
35369,유정주(兪訂炷),이수진(李秀眞),164,239,403,0
35370,유정주(兪訂炷),이양수(李亮壽),53,5,58,1
35371,유정주(兪訂炷),이용(李鏞),50,6,56,1
35372,유정주(兪訂炷),이용빈(李龍彬),162,251,413,0
35373,유정주(兪訂炷),이용선(李庸瑄),114,150,264,0
35374,유정주(兪訂炷),이용우(李龍雨),131,155,286,0
35375,유정주(兪訂炷),이용호(李容鎬),37,21,58,1
35376,유정주(兪訂炷),이원욱(李元旭),110,128,238,0
35377,유정주(兪訂炷),이원택(李源澤),110,126,236,0
35378,유정주(兪訂炷),이은주(李恩周),27,63,90,1
35379,유정주(兪訂炷),이인선(李仁善),25,4,29,1
35380,유정주(兪訂炷),이인영(李仁榮),74,49,123,0
35381,유정주(兪訂炷),이장섭(李將燮),108,110,218,0
35382,유정주(兪訂炷),이재명(李在明),41,28,69,0
35383,유정주(兪訂炷),이재정(李在汀),97,71,168,0
35384,유정주(兪訂炷),이정문(李楨文),113,137,250,0
35385,유정주(兪訂炷),이종배(李鍾培),51,7,58,1
35386,유정주(兪訂炷),이종성(李鍾成),49,6,55,1
35387,유정주(兪訂炷),이주환(李周桓),49,6,55,1
35388,유정주(兪訂炷),이채익(李埰益),52,7,59,1
35389,유정주(兪訂炷),이철규(李喆圭),52,6,58,1
35390,유정주(兪訂炷),이탄희(李誕熙),107,131,238,0
35391,유정주(兪訂炷),이태규(李泰珪),29,6,35,1
35392,유정주(兪訂炷),이학영(李學永),123,157,280,0
35393,유정주(兪訂炷),이해식(李海植),108,104,212,0
35394,유정주(兪訂炷),이헌승(李憲昇),51,4,55,1
35395,유정주(兪訂炷),이형석(李炯錫),124,136,260,0
35396,유정주(兪訂炷),인재근(印在謹),109,114,223,0
35397,유정주(兪訂炷),임병헌(林炳憲),26,6,32,1
35398,유정주(兪訂炷),임오경(林五卿),177,229,406,0
35399,유정주(兪訂炷),임이자(林利子),50,4,54,1
35400,유정주(兪訂炷),임종성(林鍾聲),119,158,277,0
35401,유정주(兪訂炷),임호선(林昊宣),145,210,355,0
35402,유정주(兪訂炷),장경태(張耿態),158,310,468,0
35403,유정주(兪訂炷),장동혁(張東赫),25,4,29,1
35404,유정주(兪訂炷),장제원(張濟元),49,4,53,1
35405,유정주(兪訂炷),장철민(張喆敏),126,139,265,0
35406,유정주(兪訂炷),장혜영(張惠英),31,61,92,1
35407,유정주(兪訂炷),전봉민(田奉珉),35,5,40,1
35408,유정주(兪訂炷),전용기(田溶冀),145,237,382,0
35409,유정주(兪訂炷),전재수(田載秀),101,123,224,0
35410,유정주(兪訂炷),전주혜(全珠惠),50,6,56,1
35411,유정주(兪訂炷),전해철(全海澈),80,62,142,0
35412,유정주(兪訂炷),전혜숙(全惠淑),118,122,240,0
35413,유정주(兪訂炷),정경희(丁慶姬),49,4,53,1
35414,유정주(兪訂炷),정동만(鄭東萬),49,4,53,1
35415,유정주(兪訂炷),정성호(鄭成湖),90,90,180,0
35416,유정주(兪訂炷),정우택(鄭宇澤),26,5,31,1
35417,유정주(兪訂炷),정운천(鄭雲天),49,4,53,1
35418,유정주(兪訂炷),정일영(鄭日永),110,125,235,0
35419,유정주(兪訂炷),정점식(鄭点植),49,4,53,1
35420,유정주(兪訂炷),정진석(鄭鎭碩),51,5,56,1
35421,유정주(兪訂炷),정청래(鄭淸來),102,98,200,0
35422,유정주(兪訂炷),정춘숙(鄭春淑),113,130,243,0
35423,유정주(兪訂炷),정태호(鄭泰浩),93,91,184,0
35424,유정주(兪訂炷),정필모(鄭必模),117,138,255,0
35425,유정주(兪訂炷),정희용(鄭熙溶),51,6,57,1
35426,유정주(兪訂炷),조경태(趙慶泰),49,5,54,1
35427,유정주(兪訂炷),조명희(曺明姬),50,7,57,1
35428,유정주(兪訂炷),조수진(趙修眞),51,4,55,1
35429,유정주(兪訂炷),조승래(趙承來),126,138,264,0
35430,유정주(兪訂炷),조오섭(曺五燮),114,192,306,0
35431,유정주(兪訂炷),조은희(趙恩禧),26,4,30,1
35432,유정주(兪訂炷),조응천(趙應天),78,45,123,0
35433,유정주(兪訂炷),조정식(趙正湜),81,53,134,0
35434,유정주(兪訂炷),조정훈(趙廷訓),5,20,25,1
35435,유정주(兪訂炷),조해진(曺海珍),51,5,56,1
35436,유정주(兪訂炷),주철현(朱哲鉉),115,150,265,0
35437,유정주(兪訂炷),주호영(朱豪英),51,4,55,1
35438,유정주(兪訂炷),지성호(池成浩),49,4,53,1
35439,유정주(兪訂炷),진선미(陳善美),91,71,162,0
35440,유정주(兪訂炷),진성준(陳聲準),121,167,288,0
35441,유정주(兪訂炷),천준호(千俊鎬),104,102,206,0
35442,유정주(兪訂炷),최기상(崔基相),97,120,217,0
35443,유정주(兪訂炷),최승재(崔承宰),51,6,57,1
35444,유정주(兪訂炷),최연숙(崔姸淑),32,15,47,1
35445,유정주(兪訂炷),최영희(崔英姬),25,4,29,1
35446,유정주(兪訂炷),최인호(崔仁昊),99,105,204,0
35447,유정주(兪訂炷),최재형(崔在亨),25,4,29,1
35448,유정주(兪訂炷),최종윤(崔鍾允),111,169,280,0
35449,유정주(兪訂炷),최춘식(崔春植),49,13,62,1
35450,유정주(兪訂炷),최형두(崔炯斗),51,9,60,1
35451,유정주(兪訂炷),최혜영(崔惠英),154,221,375,0
35452,유정주(兪訂炷),추경호(秋慶鎬),49,3,52,1
35453,유정주(兪訂炷),태영호(太永浩),49,5,54,1
35454,유정주(兪訂炷),하영제(河榮帝),40,2,42,1
35455,유정주(兪訂炷),하태경(河泰慶),49,5,54,1
35456,유정주(兪訂炷),한기호(韓起鎬),50,7,57,1
35457,유정주(兪訂炷),한무경(韓茂景),52,7,59,1
35458,유정주(兪訂炷),한병도(韓秉道),139,200,339,0
35459,유정주(兪訂炷),한정애(韓貞愛),85,66,151,0
35460,유정주(兪訂炷),한준호(韓俊鎬),142,200,342,0
35461,유정주(兪訂炷),허숙정(許淑湞),1,2,3,0
35462,유정주(兪訂炷),허영(許榮),146,187,333,0
35463,유정주(兪訂炷),허은아(許垠娥),49,5,54,1
35464,유정주(兪訂炷),허종식(許琮植),116,126,242,0
35465,유정주(兪訂炷),홍기원(洪起元),116,109,225,0
35466,유정주(兪訂炷),홍문표(洪文杓),50,6,56,1
35467,유정주(兪訂炷),홍석준(洪碩晙),49,4,53,1
35468,유정주(兪訂炷),홍성국(洪性國),138,156,294,0
35469,유정주(兪訂炷),홍영표(洪永杓),86,58,144,0
35470,유정주(兪訂炷),홍익표(洪翼杓),97,97,194,0
35471,유정주(兪訂炷),홍정민(洪貞敏),182,288,470,0
35472,유정주(兪訂炷),황보승희(皇甫承希),49,4,53,1
35473,유정주(兪訂炷),황운하(黃雲夏),137,197,334,0
35474,유정주(兪訂炷),황희(黃熙),93,53,146,0
35475,윤건영(尹建永),윤관석(尹官石),65,51,116,1
35476,윤건영(尹建永),윤두현(尹斗鉉),49,4,53,1
35477,윤건영(尹建永),윤미향(尹美香),47,67,114,1
35478,윤건영(尹建永),윤상현(尹相現),30,5,35,1
35479,윤건영(尹建永),윤영덕(尹永德),96,110,206,0
35480,윤건영(尹建永),윤영석(尹永碩),49,3,52,1
35481,윤건영(尹建永),윤영찬(尹永燦),91,70,161,0
35482,윤건영(尹建永),윤재갑(尹才鉀),102,106,208,0
35483,윤건영(尹建永),윤재옥(尹在玉),49,3,52,1
35484,윤건영(尹建永),윤주경(尹柱卿),49,5,54,1
35485,윤건영(尹建永),윤준병(尹準炳),99,135,234,0
35486,윤건영(尹建永),윤창현(尹暢賢),49,5,54,1
35487,윤건영(尹建永),윤한홍(尹漢洪),49,3,52,1
35488,윤건영(尹建永),윤호중(尹昊重),76,45,121,0
35489,윤건영(尹建永),윤후덕(尹厚德),81,40,121,0
35490,윤건영(尹建永),이개호(李介昊),82,63,145,0
35491,윤건영(尹建永),이달곤(李達坤),51,5,56,1
35492,윤건영(尹建永),이동주(李東洲),93,82,175,0
35493,윤건영(尹建永),이만희(李晩熙),49,3,52,1
35494,윤건영(尹建永),이명수(李明洙),49,14,63,1
35495,윤건영(尹建永),이병훈(李炳勳),95,89,184,0
35496,윤건영(尹建永),이상민(李相珉),79,43,122,0
35497,윤건영(尹建永),이상헌(李相憲),86,71,157,0
35498,윤건영(尹建永),이성만(李成萬),89,73,162,1
35499,윤건영(尹建永),이소영(李素永),79,54,133,0
35500,윤건영(尹建永),이수진(李壽珍),103,139,242,0
35501,윤건영(尹建永),이수진(李秀眞),96,81,177,0
35502,윤건영(尹建永),이양수(李亮壽),50,4,54,1
35503,윤건영(尹建永),이용(李鏞),49,3,52,1
35504,윤건영(尹建永),이용빈(李龍彬),109,105,214,0
35505,윤건영(尹建永),이용선(李庸瑄),89,83,172,0
35506,윤건영(尹建永),이용우(李龍雨),106,108,214,0
35507,윤건영(尹建永),이용호(李容鎬),29,10,39,1
35508,윤건영(尹建永),이원욱(李元旭),83,68,151,0
35509,윤건영(尹建永),이원택(李源澤),92,71,163,0
35510,윤건영(尹建永),이은주(李恩周),16,16,32,1
35511,윤건영(尹建永),이인선(李仁善),25,3,28,1
35512,윤건영(尹建永),이인영(李仁榮),77,61,138,0
35513,윤건영(尹建永),이장섭(李將燮),85,65,150,0
35514,윤건영(尹建永),이재명(李在明),41,22,63,0
35515,윤건영(尹建永),이재정(李在汀),78,46,124,0
35516,윤건영(尹建永),이정문(李楨文),89,67,156,0
35517,윤건영(尹建永),이종배(李鍾培),50,5,55,1
35518,윤건영(尹建永),이종성(李鍾成),49,3,52,1
35519,윤건영(尹建永),이주환(李周桓),49,4,53,1
35520,윤건영(尹建永),이채익(李埰益),50,5,55,1
35521,윤건영(尹建永),이철규(李喆圭),50,5,55,1
35522,윤건영(尹建永),이탄희(李誕熙),93,77,170,0
35523,윤건영(尹建永),이태규(李泰珪),29,4,33,1
35524,윤건영(尹建永),이학영(李學永),85,67,152,0
35525,윤건영(尹建永),이해식(李海植),91,72,163,0
35526,윤건영(尹建永),이헌승(李憲昇),49,3,52,1
35527,윤건영(尹建永),이형석(李炯錫),90,92,182,0
35528,윤건영(尹建永),인재근(印在謹),88,91,179,0
35529,윤건영(尹建永),임병헌(林炳憲),25,4,29,1
35530,윤건영(尹建永),임오경(林五卿),85,71,156,0
35531,윤건영(尹建永),임이자(林利子),49,4,53,1
35532,윤건영(尹建永),임종성(林鍾聲),89,74,163,0
35533,윤건영(尹建永),임호선(林昊宣),103,132,235,0
35534,윤건영(尹建永),장경태(張耿態),88,98,186,0
35535,윤건영(尹建永),장동혁(張東赫),25,3,28,1
35536,윤건영(尹建永),장제원(張濟元),49,4,53,1
35537,윤건영(尹建永),장철민(張喆敏),87,69,156,0
35538,윤건영(尹建永),장혜영(張惠英),9,11,20,1
35539,윤건영(尹建永),전봉민(田奉珉),35,4,39,1
35540,윤건영(尹建永),전용기(田溶冀),83,77,160,0
35541,윤건영(尹建永),전재수(田載秀),77,54,131,0
35542,윤건영(尹建永),전주혜(全珠惠),50,5,55,1
35543,윤건영(尹建永),전해철(全海澈),74,56,130,0
35544,윤건영(尹建永),전혜숙(全惠淑),87,63,150,0
35545,윤건영(尹建永),정경희(丁慶姬),49,3,52,1
35546,윤건영(尹建永),정동만(鄭東萬),49,4,53,1
35547,윤건영(尹建永),정성호(鄭成湖),79,59,138,0
35548,윤건영(尹建永),정우택(鄭宇澤),25,3,28,1
35549,윤건영(尹建永),정운천(鄭雲天),49,3,52,1
35550,윤건영(尹建永),정일영(鄭日永),101,115,216,0
35551,윤건영(尹建永),정점식(鄭点植),49,3,52,1
35552,윤건영(尹建永),정진석(鄭鎭碩),49,3,52,1
35553,윤건영(尹建永),정청래(鄭淸來),83,44,127,0
35554,윤건영(尹建永),정춘숙(鄭春淑),81,51,132,0
35555,윤건영(尹建永),정태호(鄭泰浩),89,89,178,0
35556,윤건영(尹建永),정필모(鄭必模),98,97,195,0
35557,윤건영(尹建永),정희용(鄭熙溶),50,5,55,1
35558,윤건영(尹建永),조경태(趙慶泰),49,3,52,1
35559,윤건영(尹建永),조명희(曺明姬),49,5,54,1
35560,윤건영(尹建永),조수진(趙修眞),49,3,52,1
35561,윤건영(尹建永),조승래(趙承來),93,68,161,0
35562,윤건영(尹建永),조오섭(曺五燮),93,124,217,0
35563,윤건영(尹建永),조은희(趙恩禧),25,3,28,1
35564,윤건영(尹建永),조응천(趙應天),77,34,111,0
35565,윤건영(尹建永),조정식(趙正湜),78,49,127,0
35566,윤건영(尹建永),조정훈(趙廷訓),3,8,11,1
35567,윤건영(尹建永),조해진(曺海珍),51,5,56,1
35568,윤건영(尹建永),주철현(朱哲鉉),91,89,180,0
35569,윤건영(尹建永),주호영(朱豪英),49,4,53,1
35570,윤건영(尹建永),지성호(池成浩),49,5,54,1
35571,윤건영(尹建永),진선미(陳善美),78,39,117,0
35572,윤건영(尹建永),진성준(陳聲準),93,78,171,0
35573,윤건영(尹建永),천준호(千俊鎬),93,60,153,0
35574,윤건영(尹建永),최기상(崔基相),89,82,171,0
35575,윤건영(尹建永),최승재(崔承宰),49,6,55,1
35576,윤건영(尹建永),최연숙(崔姸淑),32,8,40,1
35577,윤건영(尹建永),최영희(崔英姬),25,4,29,1
35578,윤건영(尹建永),최인호(崔仁昊),83,70,153,0
35579,윤건영(尹建永),최재형(崔在亨),25,3,28,1
35580,윤건영(尹建永),최종윤(崔鍾允),94,121,215,0
35581,윤건영(尹建永),최춘식(崔春植),49,4,53,1
35582,윤건영(尹建永),최형두(崔炯斗),49,4,53,1
35583,윤건영(尹建永),최혜영(崔惠英),95,86,181,0
35584,윤건영(尹建永),추경호(秋慶鎬),49,4,53,1
35585,윤건영(尹建永),태영호(太永浩),49,4,53,1
35586,윤건영(尹建永),하영제(河榮帝),40,1,41,1
35587,윤건영(尹建永),하태경(河泰慶),50,4,54,1
35588,윤건영(尹建永),한기호(韓起鎬),49,3,52,1
35589,윤건영(尹建永),한무경(韓茂景),49,5,54,1
35590,윤건영(尹建永),한병도(韓秉道),91,71,162,0
35591,윤건영(尹建永),한정애(韓貞愛),77,41,118,0
35592,윤건영(尹建永),한준호(韓俊鎬),83,82,165,0
35593,윤건영(尹建永),허숙정(許淑湞),1,2,3,0
35594,윤건영(尹建永),허영(許榮),105,120,225,0
35595,윤건영(尹建永),허은아(許垠娥),49,4,53,1
35596,윤건영(尹建永),허종식(許琮植),91,78,169,0
35597,윤건영(尹建永),홍기원(洪起元),93,75,168,0
35598,윤건영(尹建永),홍문표(洪文杓),49,6,55,1
35599,윤건영(尹建永),홍석준(洪碩晙),49,4,53,1
35600,윤건영(尹建永),홍성국(洪性國),97,111,208,0
35601,윤건영(尹建永),홍영표(洪永杓),85,53,138,0
35602,윤건영(尹建永),홍익표(洪翼杓),82,56,138,0
35603,윤건영(尹建永),홍정민(洪貞敏),99,134,233,0
35604,윤건영(尹建永),황보승희(皇甫承希),44,2,46,1
35605,윤건영(尹建永),황운하(黃雲夏),99,106,205,0
35606,윤건영(尹建永),황희(黃熙),80,38,118,0
35607,윤관석(尹官石),윤두현(尹斗鉉),40,1,41,1
35608,윤관석(尹官石),윤미향(尹美香),49,55,104,0
35609,윤관석(尹官石),윤상현(尹相現),23,6,29,1
35610,윤관석(尹官石),윤영덕(尹永德),76,53,129,1
35611,윤관석(尹官石),윤영석(尹永碩),41,1,42,1
35612,윤관석(尹官石),윤영찬(尹永燦),72,45,117,1
35613,윤관석(尹官石),윤재갑(尹才鉀),84,61,145,1
35614,윤관석(尹官石),윤재옥(尹在玉),40,0,40,1
35615,윤관석(尹官石),윤주경(尹柱卿),40,0,40,1
35616,윤관석(尹官石),윤준병(尹準炳),80,84,164,1
35617,윤관석(尹官石),윤창현(尹暢賢),40,0,40,1
35618,윤관석(尹官石),윤한홍(尹漢洪),41,0,41,1
35619,윤관석(尹官石),윤호중(尹昊重),69,74,143,1
35620,윤관석(尹官石),윤후덕(尹厚德),91,81,172,1
35621,윤관석(尹官石),이개호(李介昊),78,47,125,1
35622,윤관석(尹官石),이달곤(李達坤),42,2,44,1
35623,윤관석(尹官石),이동주(李東洲),75,81,156,1
35624,윤관석(尹官石),이만희(李晩熙),40,0,40,1
35625,윤관석(尹官石),이명수(李明洙),41,5,46,1
35626,윤관석(尹官石),이병훈(李炳勳),88,61,149,1
35627,윤관석(尹官石),이상민(李相珉),73,38,111,1
35628,윤관석(尹官石),이상헌(李相憲),98,66,164,1
35629,윤관석(尹官石),이성만(李成萬),119,134,253,0
35630,윤관석(尹官石),이소영(李素永),72,32,104,1
35631,윤관석(尹官石),이수진(李壽珍),95,74,169,1
35632,윤관석(尹官石),이수진(李秀眞),91,63,154,1
35633,윤관석(尹官石),이양수(李亮壽),41,0,41,1
35634,윤관석(尹官石),이용(李鏞),40,0,40,1
35635,윤관석(尹官石),이용빈(李龍彬),99,98,197,1
35636,윤관석(尹官石),이용선(李庸瑄),76,54,130,1
35637,윤관석(尹官石),이용우(李龍雨),86,56,142,1
35638,윤관석(尹官石),이용호(李容鎬),32,14,46,1
35639,윤관석(尹官石),이원욱(李元旭),98,74,172,1
35640,윤관석(尹官石),이원택(李源澤),86,64,150,1
35641,윤관석(尹官石),이은주(李恩周),21,26,47,1
35642,윤관석(尹官石),이인선(李仁善),16,0,16,1
35643,윤관석(尹官石),이인영(李仁榮),71,46,117,1
35644,윤관석(尹官石),이장섭(李將燮),78,60,138,1
35645,윤관석(尹官石),이재명(李在明),27,12,39,1
35646,윤관석(尹官石),이재정(李在汀),73,48,121,1
35647,윤관석(尹官石),이정문(李楨文),88,75,163,1
35648,윤관석(尹官石),이종배(李鍾培),41,2,43,1
35649,윤관석(尹官石),이종성(李鍾成),40,0,40,1
35650,윤관석(尹官石),이주환(李周桓),40,0,40,1
35651,윤관석(尹官石),이채익(李埰益),42,3,45,1
35652,윤관석(尹官石),이철규(李喆圭),41,0,41,1
35653,윤관석(尹官石),이탄희(李誕熙),93,58,151,1
35654,윤관석(尹官石),이태규(李泰珪),20,0,20,1
35655,윤관석(尹官石),이학영(李學永),84,100,184,1
35656,윤관석(尹官石),이해식(李海植),83,57,140,1
35657,윤관석(尹官石),이헌승(李憲昇),41,0,41,1
35658,윤관석(尹官石),이형석(李炯錫),88,55,143,1
35659,윤관석(尹官石),인재근(印在謹),85,80,165,1
35660,윤관석(尹官石),임병헌(林炳憲),16,0,16,1
35661,윤관석(尹官石),임오경(林五卿),87,76,163,1
35662,윤관석(尹官石),임이자(林利子),40,0,40,1
35663,윤관석(尹官石),임종성(林鍾聲),100,91,191,1
35664,윤관석(尹官石),임호선(林昊宣),95,93,188,1
35665,윤관석(尹官石),장경태(張耿態),78,53,131,1
35666,윤관석(尹官石),장동혁(張東赫),16,0,16,1
35667,윤관석(尹官石),장제원(張濟元),40,0,40,1
35668,윤관석(尹官石),장철민(張喆敏),81,60,141,1
35669,윤관석(尹官石),장혜영(張惠英),12,8,20,1
35670,윤관석(尹官石),전봉민(田奉珉),26,1,27,1
35671,윤관석(尹官石),전용기(田溶冀),86,67,153,1
35672,윤관석(尹官石),전재수(田載秀),87,48,135,1
35673,윤관석(尹官石),전주혜(全珠惠),42,1,43,1
35674,윤관석(尹官石),전해철(全海澈),68,50,118,1
35675,윤관석(尹官石),전혜숙(全惠淑),90,80,170,1
35676,윤관석(尹官石),정경희(丁慶姬),40,0,40,1
35677,윤관석(尹官石),정동만(鄭東萬),40,0,40,1
35678,윤관석(尹官石),정성호(鄭成湖),87,101,188,1
35679,윤관석(尹官石),정우택(鄭宇澤),16,0,16,1
35680,윤관석(尹官石),정운천(鄭雲天),40,0,40,1
35681,윤관석(尹官石),정일영(鄭日永),109,112,221,1
35682,윤관석(尹官石),정점식(鄭点植),41,0,41,1
35683,윤관석(尹官石),정진석(鄭鎭碩),41,2,43,1
35684,윤관석(尹官石),정청래(鄭淸來),81,50,131,1
35685,윤관석(尹官石),정춘숙(鄭春淑),82,65,147,1
35686,윤관석(尹官石),정태호(鄭泰浩),75,64,139,1
35687,윤관석(尹官石),정필모(鄭必模),75,50,125,1
35688,윤관석(尹官石),정희용(鄭熙溶),41,1,42,1
35689,윤관석(尹官石),조경태(趙慶泰),40,0,40,1
35690,윤관석(尹官石),조명희(曺明姬),40,2,42,1
35691,윤관석(尹官石),조수진(趙修眞),40,0,40,1
35692,윤관석(尹官石),조승래(趙承來),75,49,124,1
35693,윤관석(尹官石),조오섭(曺五燮),90,83,173,1
35694,윤관석(尹官石),조은희(趙恩禧),16,1,17,1
35695,윤관석(尹官石),조응천(趙應天),73,30,103,1
35696,윤관석(尹官石),조정식(趙正湜),65,39,104,1
35697,윤관석(尹官石),조정훈(趙廷訓),1,4,5,1
35698,윤관석(尹官石),조해진(曺海珍),42,1,43,1
35699,윤관석(尹官石),주철현(朱哲鉉),79,54,133,1
35700,윤관석(尹官石),주호영(朱豪英),40,0,40,1
35701,윤관석(尹官石),지성호(池成浩),40,0,40,1
35702,윤관석(尹官石),진선미(陳善美),72,45,117,1
35703,윤관석(尹官石),진성준(陳聲準),73,48,121,1
35704,윤관석(尹官石),천준호(千俊鎬),75,48,123,1
35705,윤관석(尹官石),최기상(崔基相),66,50,116,1
35706,윤관석(尹官石),최승재(崔承宰),42,0,42,1
35707,윤관석(尹官石),최연숙(崔姸淑),21,10,31,1
35708,윤관석(尹官石),최영희(崔英姬),16,1,17,1
35709,윤관석(尹官石),최인호(崔仁昊),79,57,136,1
35710,윤관석(尹官石),최재형(崔在亨),16,0,16,1
35711,윤관석(尹官石),최종윤(崔鍾允),91,88,179,1
35712,윤관석(尹官石),최춘식(崔春植),40,0,40,1
35713,윤관석(尹官石),최형두(崔炯斗),41,1,42,1
35714,윤관석(尹官石),최혜영(崔惠英),86,91,177,1
35715,윤관석(尹官石),추경호(秋慶鎬),40,0,40,1
35716,윤관석(尹官石),태영호(太永浩),40,0,40,1
35717,윤관석(尹官石),하영제(河榮帝),42,2,44,0
35718,윤관석(尹官石),하태경(河泰慶),40,0,40,1
35719,윤관석(尹官石),한기호(韓起鎬),41,0,41,1
35720,윤관석(尹官石),한무경(韓茂景),40,0,40,1
35721,윤관석(尹官石),한병도(韓秉道),87,53,140,1
35722,윤관석(尹官石),한정애(韓貞愛),75,45,120,1
35723,윤관석(尹官石),한준호(韓俊鎬),93,71,164,1
35724,윤관석(尹官石),허숙정(許淑湞),0,0,0,1
35725,윤관석(尹官石),허영(許榮),88,71,159,1
35726,윤관석(尹官石),허은아(許垠娥),40,0,40,1
35727,윤관석(尹官石),허종식(許琮植),120,114,234,1
35728,윤관석(尹官石),홍기원(洪起元),80,41,121,1
35729,윤관석(尹官石),홍문표(洪文杓),41,2,43,1
35730,윤관석(尹官石),홍석준(洪碩晙),41,0,41,1
35731,윤관석(尹官石),홍성국(洪性國),104,97,201,1
35732,윤관석(尹官石),홍영표(洪永杓),90,66,156,1
35733,윤관석(尹官石),홍익표(洪翼杓),77,59,136,1
35734,윤관석(尹官石),홍정민(洪貞敏),85,63,148,1
35735,윤관석(尹官石),황보승희(皇甫承希),42,0,42,0
35736,윤관석(尹官石),황운하(黃雲夏),100,78,178,1
35737,윤관석(尹官石),황희(黃熙),68,35,103,1
35738,윤두현(尹斗鉉),윤미향(尹美香),20,1,21,1
35739,윤두현(尹斗鉉),윤상현(尹相現),41,38,79,0
35740,윤두현(尹斗鉉),윤영덕(尹永德),49,5,54,1
35741,윤두현(尹斗鉉),윤영석(尹永碩),70,49,119,0
35742,윤두현(尹斗鉉),윤영찬(尹永燦),49,7,56,1
35743,윤두현(尹斗鉉),윤재갑(尹才鉀),51,10,61,1
35744,윤두현(尹斗鉉),윤재옥(尹在玉),85,85,170,0
35745,윤두현(尹斗鉉),윤주경(尹柱卿),92,125,217,0
35746,윤두현(尹斗鉉),윤준병(尹準炳),49,5,54,1
35747,윤두현(尹斗鉉),윤창현(尹暢賢),97,148,245,0
35748,윤두현(尹斗鉉),윤한홍(尹漢洪),82,94,176,0
35749,윤두현(尹斗鉉),윤호중(尹昊重),50,4,54,1
35750,윤두현(尹斗鉉),윤후덕(尹厚德),49,4,53,1
35751,윤두현(尹斗鉉),이개호(李介昊),50,4,54,1
35752,윤두현(尹斗鉉),이달곤(李達坤),67,81,148,0
35753,윤두현(尹斗鉉),이동주(李東洲),49,4,53,1
35754,윤두현(尹斗鉉),이만희(李晩熙),85,107,192,0
35755,윤두현(尹斗鉉),이명수(李明洙),92,123,215,0
35756,윤두현(尹斗鉉),이병훈(李炳勳),52,5,57,1
35757,윤두현(尹斗鉉),이상민(李相珉),49,6,55,1
35758,윤두현(尹斗鉉),이상헌(李相憲),50,6,56,1
35759,윤두현(尹斗鉉),이성만(李成萬),40,0,40,1
35760,윤두현(尹斗鉉),이소영(李素永),51,5,56,1
35761,윤두현(尹斗鉉),이수진(李壽珍),50,6,56,1
35762,윤두현(尹斗鉉),이수진(李秀眞),49,5,54,1
35763,윤두현(尹斗鉉),이양수(李亮壽),80,98,178,0
35764,윤두현(尹斗鉉),이용(李鏞),80,115,195,0
35765,윤두현(尹斗鉉),이용빈(李龍彬),52,7,59,1
35766,윤두현(尹斗鉉),이용선(李庸瑄),49,4,53,1
35767,윤두현(尹斗鉉),이용우(李龍雨),50,11,61,1
35768,윤두현(尹斗鉉),이용호(李容鎬),33,19,52,0
35769,윤두현(尹斗鉉),이원욱(李元旭),51,4,55,1
35770,윤두현(尹斗鉉),이원택(李源澤),49,4,53,1
35771,윤두현(尹斗鉉),이은주(李恩周),4,4,8,1
35772,윤두현(尹斗鉉),이인선(李仁善),35,43,78,0
35773,윤두현(尹斗鉉),이인영(李仁榮),49,4,53,1
35774,윤두현(尹斗鉉),이장섭(李將燮),49,4,53,1
35775,윤두현(尹斗鉉),이재명(李在明),25,5,30,1
35776,윤두현(尹斗鉉),이재정(李在汀),49,5,54,1
35777,윤두현(尹斗鉉),이정문(李楨文),49,4,53,1
35778,윤두현(尹斗鉉),이종배(李鍾培),89,106,195,0
35779,윤두현(尹斗鉉),이종성(李鍾成),100,157,257,0
35780,윤두현(尹斗鉉),이주환(李周桓),81,103,184,0
35781,윤두현(尹斗鉉),이채익(李埰益),78,76,154,0
35782,윤두현(尹斗鉉),이철규(李喆圭),82,116,198,0
35783,윤두현(尹斗鉉),이탄희(李誕熙),49,4,53,1
35784,윤두현(尹斗鉉),이태규(李泰珪),48,68,116,0
35785,윤두현(尹斗鉉),이학영(李學永),49,4,53,1
35786,윤두현(尹斗鉉),이해식(李海植),49,5,54,1
35787,윤두현(尹斗鉉),이헌승(李憲昇),67,89,156,0
35788,윤두현(尹斗鉉),이형석(李炯錫),50,4,54,1
35789,윤두현(尹斗鉉),인재근(印在謹),54,8,62,1
35790,윤두현(尹斗鉉),임병헌(林炳憲),32,49,81,0
35791,윤두현(尹斗鉉),임오경(林五卿),49,4,53,1
35792,윤두현(尹斗鉉),임이자(林利子),86,103,189,0
35793,윤두현(尹斗鉉),임종성(林鍾聲),53,6,59,1
35794,윤두현(尹斗鉉),임호선(林昊宣),50,7,57,1
35795,윤두현(尹斗鉉),장경태(張耿態),49,4,53,1
35796,윤두현(尹斗鉉),장동혁(張東赫),29,40,69,0
35797,윤두현(尹斗鉉),장제원(張濟元),66,48,114,0
35798,윤두현(尹斗鉉),장철민(張喆敏),50,4,54,1
35799,윤두현(尹斗鉉),장혜영(張惠英),9,7,16,1
35800,윤두현(尹斗鉉),전봉민(田奉珉),57,70,127,0
35801,윤두현(尹斗鉉),전용기(田溶冀),49,5,54,1
35802,윤두현(尹斗鉉),전재수(田載秀),49,4,53,1
35803,윤두현(尹斗鉉),전주혜(全珠惠),85,131,216,0
35804,윤두현(尹斗鉉),전해철(全海澈),50,4,54,1
35805,윤두현(尹斗鉉),전혜숙(全惠淑),49,9,58,1
35806,윤두현(尹斗鉉),정경희(丁慶姬),87,112,199,0
35807,윤두현(尹斗鉉),정동만(鄭東萬),70,64,134,0
35808,윤두현(尹斗鉉),정성호(鄭成湖),51,4,55,1
35809,윤두현(尹斗鉉),정우택(鄭宇澤),30,40,70,0
35810,윤두현(尹斗鉉),정운천(鄭雲天),75,92,167,0
35811,윤두현(尹斗鉉),정일영(鄭日永),49,4,53,1
35812,윤두현(尹斗鉉),정점식(鄭点植),74,49,123,0
35813,윤두현(尹斗鉉),정진석(鄭鎭碩),84,116,200,0
35814,윤두현(尹斗鉉),정청래(鄭淸來),49,4,53,1
35815,윤두현(尹斗鉉),정춘숙(鄭春淑),49,5,54,1
35816,윤두현(尹斗鉉),정태호(鄭泰浩),49,5,54,1
35817,윤두현(尹斗鉉),정필모(鄭必模),49,4,53,1
35818,윤두현(尹斗鉉),정희용(鄭熙溶),111,154,265,0
35819,윤두현(尹斗鉉),조경태(趙慶泰),79,67,146,0
35820,윤두현(尹斗鉉),조명희(曺明姬),95,158,253,0
35821,윤두현(尹斗鉉),조수진(趙修眞),100,141,241,0
35822,윤두현(尹斗鉉),조승래(趙承來),49,6,55,1
35823,윤두현(尹斗鉉),조오섭(曺五燮),51,4,55,1
35824,윤두현(尹斗鉉),조은희(趙恩禧),35,52,87,0
35825,윤두현(尹斗鉉),조응천(趙應天),49,3,52,1
35826,윤두현(尹斗鉉),조정식(趙正湜),49,3,52,1
35827,윤두현(尹斗鉉),조정훈(趙廷訓),1,6,7,1
35828,윤두현(尹斗鉉),조해진(曺海珍),65,38,103,0
35829,윤두현(尹斗鉉),주철현(朱哲鉉),52,5,57,1
35830,윤두현(尹斗鉉),주호영(朱豪英),69,75,144,0
35831,윤두현(尹斗鉉),지성호(池成浩),94,147,241,0
35832,윤두현(尹斗鉉),진선미(陳善美),49,4,53,1
35833,윤두현(尹斗鉉),진성준(陳聲準),49,4,53,1
35834,윤두현(尹斗鉉),천준호(千俊鎬),49,3,52,1
35835,윤두현(尹斗鉉),최기상(崔基相),50,4,54,1
35836,윤두현(尹斗鉉),최승재(崔承宰),96,125,221,0
35837,윤두현(尹斗鉉),최연숙(崔姸淑),49,73,122,0
35838,윤두현(尹斗鉉),최영희(崔英姬),29,40,69,0
35839,윤두현(尹斗鉉),최인호(崔仁昊),51,4,55,1
35840,윤두현(尹斗鉉),최재형(崔在亨),29,14,43,0
35841,윤두현(尹斗鉉),최종윤(崔鍾允),50,6,56,1
35842,윤두현(尹斗鉉),최춘식(崔春植),85,141,226,0
35843,윤두현(尹斗鉉),최형두(崔炯斗),81,80,161,0
35844,윤두현(尹斗鉉),최혜영(崔惠英),50,11,61,1
35845,윤두현(尹斗鉉),추경호(秋慶鎬),108,140,248,0
35846,윤두현(尹斗鉉),태영호(太永浩),100,163,263,0
35847,윤두현(尹斗鉉),하영제(河榮帝),77,106,183,1
35848,윤두현(尹斗鉉),하태경(河泰慶),71,56,127,0
35849,윤두현(尹斗鉉),한기호(韓起鎬),70,80,150,0
35850,윤두현(尹斗鉉),한무경(韓茂景),102,143,245,0
35851,윤두현(尹斗鉉),한병도(韓秉道),51,6,57,1
35852,윤두현(尹斗鉉),한정애(韓貞愛),49,5,54,1
35853,윤두현(尹斗鉉),한준호(韓俊鎬),50,5,55,1
35854,윤두현(尹斗鉉),허숙정(許淑湞),0,0,0,1
35855,윤두현(尹斗鉉),허영(許榮),52,4,56,1
35856,윤두현(尹斗鉉),허은아(許垠娥),85,97,182,0
35857,윤두현(尹斗鉉),허종식(許琮植),49,7,56,1
35858,윤두현(尹斗鉉),홍기원(洪起元),49,4,53,1
35859,윤두현(尹斗鉉),홍문표(洪文杓),71,77,148,0
35860,윤두현(尹斗鉉),홍석준(洪碩晙),84,124,208,0
35861,윤두현(尹斗鉉),홍성국(洪性國),49,4,53,1
35862,윤두현(尹斗鉉),홍영표(洪永杓),49,4,53,1
35863,윤두현(尹斗鉉),홍익표(洪翼杓),50,4,54,1
35864,윤두현(尹斗鉉),홍정민(洪貞敏),50,6,56,1
35865,윤두현(尹斗鉉),황보승희(皇甫承希),81,138,219,1
35866,윤두현(尹斗鉉),황운하(黃雲夏),49,6,55,1
35867,윤두현(尹斗鉉),황희(黃熙),49,12,61,1
35868,윤미향(尹美香),윤상현(尹相現),1,0,1,1
35869,윤미향(尹美香),윤영덕(尹永德),62,118,180,1
35870,윤미향(尹美香),윤영석(尹永碩),20,1,21,1
35871,윤미향(尹美香),윤영찬(尹永燦),45,39,84,1
35872,윤미향(尹美香),윤재갑(尹才鉀),100,145,245,1
35873,윤미향(尹美香),윤재옥(尹在玉),20,0,20,1
35874,윤미향(尹美香),윤주경(尹柱卿),20,4,24,1
35875,윤미향(尹美香),윤준병(尹準炳),116,220,336,1
35876,윤미향(尹美香),윤창현(尹暢賢),20,2,22,1
35877,윤미향(尹美香),윤한홍(尹漢洪),20,1,21,1
35878,윤미향(尹美香),윤호중(尹昊重),30,39,69,1
35879,윤미향(尹美香),윤후덕(尹厚德),45,91,136,1
35880,윤미향(尹美香),이개호(李介昊),40,53,93,1
35881,윤미향(尹美香),이달곤(李達坤),20,0,20,1
35882,윤미향(尹美香),이동주(李東洲),51,113,164,1
35883,윤미향(尹美香),이만희(李晩熙),20,0,20,1
35884,윤미향(尹美香),이명수(李明洙),20,7,27,1
35885,윤미향(尹美香),이병훈(李炳勳),55,99,154,1
35886,윤미향(尹美香),이상민(李相珉),37,25,62,1
35887,윤미향(尹美香),이상헌(李相憲),49,66,115,1
35888,윤미향(尹美香),이성만(李成萬),91,211,302,0
35889,윤미향(尹美香),이소영(李素永),50,49,99,1
35890,윤미향(尹美香),이수진(李壽珍),196,368,564,1
35891,윤미향(尹美香),이수진(李秀眞),80,122,202,1
35892,윤미향(尹美香),이양수(李亮壽),20,0,20,1
35893,윤미향(尹美香),이용(李鏞),20,0,20,1
35894,윤미향(尹美香),이용빈(李龍彬),88,165,253,1
35895,윤미향(尹美香),이용선(李庸瑄),50,83,133,1
35896,윤미향(尹美香),이용우(李龍雨),64,70,134,1
35897,윤미향(尹美香),이용호(李容鎬),4,24,28,1
35898,윤미향(尹美香),이원욱(李元旭),59,80,139,1
35899,윤미향(尹美香),이원택(李源澤),58,75,133,1
35900,윤미향(尹美香),이은주(李恩周),30,109,139,1
35901,윤미향(尹美香),이인선(李仁善),0,0,0,1
35902,윤미향(尹美香),이인영(李仁榮),36,33,69,1
35903,윤미향(尹美香),이장섭(李將燮),40,50,90,1
35904,윤미향(尹美香),이재명(李在明),5,10,15,1
35905,윤미향(尹美香),이재정(李在汀),48,52,100,1
35906,윤미향(尹美香),이정문(李楨文),49,63,112,1
35907,윤미향(尹美香),이종배(李鍾培),20,1,21,1
35908,윤미향(尹美香),이종성(李鍾成),20,1,21,1
35909,윤미향(尹美香),이주환(李周桓),20,2,22,1
35910,윤미향(尹美香),이채익(李埰益),20,2,22,1
35911,윤미향(尹美香),이철규(李喆圭),20,1,21,1
35912,윤미향(尹美香),이탄희(李誕熙),75,112,187,1
35913,윤미향(尹美香),이태규(李泰珪),3,3,6,1
35914,윤미향(尹美香),이학영(李學永),57,98,155,1
35915,윤미향(尹美香),이해식(李海植),52,83,135,1
35916,윤미향(尹美香),이헌승(李憲昇),20,1,21,1
35917,윤미향(尹美香),이형석(李炯錫),55,89,144,1
35918,윤미향(尹美香),인재근(印在謹),67,139,206,1
35919,윤미향(尹美香),임병헌(林炳憲),0,1,1,1
35920,윤미향(尹美香),임오경(林五卿),54,69,123,1
35921,윤미향(尹美香),임이자(林利子),20,0,20,1
35922,윤미향(尹美香),임종성(林鍾聲),94,163,257,1
35923,윤미향(尹美香),임호선(林昊宣),63,102,165,1
35924,윤미향(尹美香),장경태(張耿態),63,121,184,1
35925,윤미향(尹美香),장동혁(張東赫),0,0,0,1
35926,윤미향(尹美香),장제원(張濟元),20,0,20,1
35927,윤미향(尹美香),장철민(張喆敏),107,127,234,1
35928,윤미향(尹美香),장혜영(張惠英),34,119,153,1
35929,윤미향(尹美香),전봉민(田奉珉),9,0,9,1
35930,윤미향(尹美香),전용기(田溶冀),48,78,126,1
35931,윤미향(尹美香),전재수(田載秀),42,43,85,1
35932,윤미향(尹美香),전주혜(全珠惠),20,1,21,1
35933,윤미향(尹美香),전해철(全海澈),35,44,79,1
35934,윤미향(尹美香),전혜숙(全惠淑),77,115,192,1
35935,윤미향(尹美香),정경희(丁慶姬),20,0,20,1
35936,윤미향(尹美香),정동만(鄭東萬),20,1,21,1
35937,윤미향(尹美香),정성호(鄭成湖),48,78,126,1
35938,윤미향(尹美香),정우택(鄭宇澤),0,0,0,1
35939,윤미향(尹美香),정운천(鄭雲天),21,0,21,1
35940,윤미향(尹美香),정일영(鄭日永),51,86,137,1
35941,윤미향(尹美香),정점식(鄭点植),20,0,20,1
35942,윤미향(尹美香),정진석(鄭鎭碩),20,1,21,1
35943,윤미향(尹美香),정청래(鄭淸來),57,99,156,1
35944,윤미향(尹美香),정춘숙(鄭春淑),65,103,168,1
35945,윤미향(尹美香),정태호(鄭泰浩),42,82,124,1
35946,윤미향(尹美香),정필모(鄭必模),52,73,125,1
35947,윤미향(尹美香),정희용(鄭熙溶),21,1,22,1
35948,윤미향(尹美香),조경태(趙慶泰),21,2,23,1
35949,윤미향(尹美香),조명희(曺明姬),20,4,24,1
35950,윤미향(尹美香),조수진(趙修眞),20,1,21,1
35951,윤미향(尹美香),조승래(趙承來),38,32,70,1
35952,윤미향(尹美香),조오섭(曺五燮),60,132,192,1
35953,윤미향(尹美香),조은희(趙恩禧),1,1,2,1
35954,윤미향(尹美香),조응천(趙應天),31,12,43,1
35955,윤미향(尹美香),조정식(趙正湜),35,30,65,1
35956,윤미향(尹美香),조정훈(趙廷訓),9,27,36,1
35957,윤미향(尹美香),조해진(曺海珍),20,0,20,1
35958,윤미향(尹美香),주철현(朱哲鉉),64,96,160,1
35959,윤미향(尹美香),주호영(朱豪英),20,0,20,1
35960,윤미향(尹美香),지성호(池成浩),20,2,22,1
35961,윤미향(尹美香),진선미(陳善美),50,75,125,1
35962,윤미향(尹美香),진성준(陳聲準),63,108,171,1
35963,윤미향(尹美香),천준호(千俊鎬),55,41,96,1
35964,윤미향(尹美香),최기상(崔基相),37,41,78,1
35965,윤미향(尹美香),최승재(崔承宰),21,6,27,1
35966,윤미향(尹美香),최연숙(崔姸淑),7,23,30,1
35967,윤미향(尹美香),최영희(崔英姬),0,0,0,1
35968,윤미향(尹美香),최인호(崔仁昊),35,46,81,1
35969,윤미향(尹美香),최재형(崔在亨),0,0,0,1
35970,윤미향(尹美香),최종윤(崔鍾允),77,99,176,1
35971,윤미향(尹美香),최춘식(崔春植),20,1,21,1
35972,윤미향(尹美香),최형두(崔炯斗),21,1,22,1
35973,윤미향(尹美香),최혜영(崔惠英),68,143,211,1
35974,윤미향(尹美香),추경호(秋慶鎬),20,3,23,1
35975,윤미향(尹美香),태영호(太永浩),20,3,23,1
35976,윤미향(尹美香),하영제(河榮帝),21,1,22,0
35977,윤미향(尹美香),하태경(河泰慶),20,2,22,1
35978,윤미향(尹美香),한기호(韓起鎬),21,0,21,1
35979,윤미향(尹美香),한무경(韓茂景),20,1,21,1
35980,윤미향(尹美香),한병도(韓秉道),58,76,134,1
35981,윤미향(尹美香),한정애(韓貞愛),43,120,163,1
35982,윤미향(尹美香),한준호(韓俊鎬),43,78,121,1
35983,윤미향(尹美香),허숙정(許淑湞),1,1,2,1
35984,윤미향(尹美香),허영(許榮),71,89,160,1
35985,윤미향(尹美香),허은아(許垠娥),20,1,21,1
35986,윤미향(尹美香),허종식(許琮植),51,68,119,1
35987,윤미향(尹美香),홍기원(洪起元),46,62,108,1
35988,윤미향(尹美香),홍문표(洪文杓),20,3,23,1
35989,윤미향(尹美香),홍석준(洪碩晙),20,0,20,1
35990,윤미향(尹美香),홍성국(洪性國),83,116,199,1
35991,윤미향(尹美香),홍영표(洪永杓),46,49,95,1
35992,윤미향(尹美香),홍익표(洪翼杓),50,47,97,1
35993,윤미향(尹美香),홍정민(洪貞敏),51,85,136,1
35994,윤미향(尹美香),황보승희(皇甫承希),21,1,22,0
35995,윤미향(尹美香),황운하(黃雲夏),100,169,269,1
35996,윤미향(尹美香),황희(黃熙),37,19,56,1
35997,윤상현(尹相現),윤영덕(尹永德),29,12,41,1
35998,윤상현(尹相現),윤영석(尹永碩),47,61,108,0
35999,윤상현(尹相現),윤영찬(尹永燦),30,5,35,1
36000,윤상현(尹相現),윤재갑(尹才鉀),32,5,37,1
36001,윤상현(尹相現),윤재옥(尹在玉),37,23,60,0
36002,윤상현(尹相現),윤주경(尹柱卿),40,32,72,0
36003,윤상현(尹相現),윤준병(尹準炳),31,10,41,1
36004,윤상현(尹相現),윤창현(尹暢賢),42,57,99,0
36005,윤상현(尹相現),윤한홍(尹漢洪),37,35,72,0
36006,윤상현(尹相現),윤호중(尹昊重),31,6,37,1
36007,윤상현(尹相現),윤후덕(尹厚德),30,5,35,1
36008,윤상현(尹相現),이개호(李介昊),32,6,38,1
36009,윤상현(尹相現),이달곤(李達坤),36,30,66,0
36010,윤상현(尹相現),이동주(李東洲),29,5,34,1
36011,윤상현(尹相現),이만희(李晩熙),39,27,66,0
36012,윤상현(尹相現),이명수(李明洙),48,93,141,0
36013,윤상현(尹相現),이병훈(李炳勳),32,12,44,1
36014,윤상현(尹相現),이상민(李相珉),31,4,35,1
36015,윤상현(尹相現),이상헌(李相憲),31,13,44,1
36016,윤상현(尹相現),이성만(李成萬),26,7,33,1
36017,윤상현(尹相現),이소영(李素永),32,5,37,1
36018,윤상현(尹相現),이수진(李壽珍),31,7,38,1
36019,윤상현(尹相現),이수진(李秀眞),30,4,34,1
36020,윤상현(尹相現),이양수(李亮壽),41,32,73,0
36021,윤상현(尹相現),이용(李鏞),41,52,93,0
36022,윤상현(尹相現),이용빈(李龍彬),31,6,37,1
36023,윤상현(尹相現),이용선(李庸瑄),32,9,41,1
36024,윤상현(尹相現),이용우(李龍雨),29,6,35,1
36025,윤상현(尹相現),이용호(李容鎬),30,15,45,0
36026,윤상현(尹相現),이원욱(李元旭),32,8,40,1
36027,윤상현(尹相現),이원택(李源澤),30,5,35,1
36028,윤상현(尹相現),이은주(李恩周),1,2,3,1
36029,윤상현(尹相現),이인선(李仁善),28,38,66,0
36030,윤상현(尹相現),이인영(李仁榮),30,4,34,1
36031,윤상현(尹相現),이장섭(李將燮),30,4,34,1
36032,윤상현(尹相現),이재명(李在明),25,4,29,1
36033,윤상현(尹相現),이재정(李在汀),30,4,34,1
36034,윤상현(尹相現),이정문(李楨文),30,7,37,1
36035,윤상현(尹相現),이종배(李鍾培),48,66,114,0
36036,윤상현(尹相現),이종성(李鍾成),41,52,93,0
36037,윤상현(尹相現),이주환(李周桓),49,58,107,0
36038,윤상현(尹相現),이채익(李埰益),45,66,111,0
36039,윤상현(尹相現),이철규(李喆圭),44,33,77,0
36040,윤상현(尹相現),이탄희(李誕熙),30,5,35,1
36041,윤상현(尹相現),이태규(李泰珪),28,25,53,0
36042,윤상현(尹相現),이학영(李學永),31,5,36,1
36043,윤상현(尹相現),이해식(李海植),30,4,34,1
36044,윤상현(尹相現),이헌승(李憲昇),45,88,133,0
36045,윤상현(尹相現),이형석(李炯錫),30,7,37,1
36046,윤상현(尹相現),인재근(印在謹),31,5,36,1
36047,윤상현(尹相現),임병헌(林炳憲),30,32,62,0
36048,윤상현(尹相現),임오경(林五卿),30,8,38,1
36049,윤상현(尹相現),임이자(林利子),39,39,78,0
36050,윤상현(尹相現),임종성(林鍾聲),32,6,38,1
36051,윤상현(尹相現),임호선(林昊宣),31,4,35,1
36052,윤상현(尹相現),장경태(張耿態),30,5,35,1
36053,윤상현(尹相現),장동혁(張東赫),27,32,59,0
36054,윤상현(尹相現),장제원(張濟元),37,28,65,0
36055,윤상현(尹相現),장철민(張喆敏),32,7,39,1
36056,윤상현(尹相現),장혜영(張惠英),3,1,4,1
36057,윤상현(尹相現),전봉민(田奉珉),36,38,74,0
36058,윤상현(尹相現),전용기(田溶冀),30,6,36,1
36059,윤상현(尹相現),전재수(田載秀),30,4,34,1
36060,윤상현(尹相現),전주혜(全珠惠),35,30,65,0
36061,윤상현(尹相現),전해철(全海澈),31,4,35,1
36062,윤상현(尹相現),전혜숙(全惠淑),30,6,36,1
36063,윤상현(尹相現),정경희(丁慶姬),37,30,67,0
36064,윤상현(尹相現),정동만(鄭東萬),35,41,76,0
36065,윤상현(尹相現),정성호(鄭成湖),33,9,42,1
36066,윤상현(尹相現),정우택(鄭宇澤),30,30,60,0
36067,윤상현(尹相現),정운천(鄭雲天),41,48,89,0
36068,윤상현(尹相現),정일영(鄭日永),33,10,43,1
36069,윤상현(尹相現),정점식(鄭点植),33,25,58,0
36070,윤상현(尹相現),정진석(鄭鎭碩),34,33,67,0
36071,윤상현(尹相現),정청래(鄭淸來),29,5,34,1
36072,윤상현(尹相現),정춘숙(鄭春淑),31,5,36,1
36073,윤상현(尹相現),정태호(鄭泰浩),30,4,34,1
36074,윤상현(尹相現),정필모(鄭必模),30,4,34,1
36075,윤상현(尹相現),정희용(鄭熙溶),38,34,72,0
36076,윤상현(尹相現),조경태(趙慶泰),43,39,82,0
36077,윤상현(尹相現),조명희(曺明姬),41,40,81,0
36078,윤상현(尹相現),조수진(趙修眞),44,38,82,0
36079,윤상현(尹相現),조승래(趙承來),30,5,35,1
36080,윤상현(尹相現),조오섭(曺五燮),31,7,38,1
36081,윤상현(尹相現),조은희(趙恩禧),29,24,53,0
36082,윤상현(尹相現),조응천(趙應天),30,4,34,1
36083,윤상현(尹相現),조정식(趙正湜),29,4,33,1
36084,윤상현(尹相現),조정훈(趙廷訓),0,8,8,1
36085,윤상현(尹相現),조해진(曺海珍),34,24,58,0
36086,윤상현(尹相現),주철현(朱哲鉉),32,6,38,1
36087,윤상현(尹相現),주호영(朱豪英),36,30,66,0
36088,윤상현(尹相現),지성호(池成浩),37,63,100,0
36089,윤상현(尹相現),진선미(陳善美),30,4,34,1
36090,윤상현(尹相現),진성준(陳聲準),30,4,34,1
36091,윤상현(尹相現),천준호(千俊鎬),29,3,32,1
36092,윤상현(尹相現),최기상(崔基相),30,5,35,1
36093,윤상현(尹相現),최승재(崔承宰),42,65,107,0
36094,윤상현(尹相現),최연숙(崔姸淑),30,45,75,0
36095,윤상현(尹相現),최영희(崔英姬),30,41,71,0
36096,윤상현(尹相現),최인호(崔仁昊),32,5,37,1
36097,윤상현(尹相現),최재형(崔在亨),27,24,51,0
36098,윤상현(尹相現),최종윤(崔鍾允),31,6,37,1
36099,윤상현(尹相現),최춘식(崔春植),43,55,98,0
36100,윤상현(尹相現),최형두(崔炯斗),53,59,112,0
36101,윤상현(尹相現),최혜영(崔惠英),30,5,35,1
36102,윤상현(尹相現),추경호(秋慶鎬),38,42,80,0
36103,윤상현(尹相現),태영호(太永浩),44,59,103,0
36104,윤상현(尹相現),하영제(河榮帝),27,38,65,1
36105,윤상현(尹相現),하태경(河泰慶),33,35,68,0
36106,윤상현(尹相現),한기호(韓起鎬),37,29,66,0
36107,윤상현(尹相現),한무경(韓茂景),38,50,88,0
36108,윤상현(尹相現),한병도(韓秉道),30,7,37,1
36109,윤상현(尹相現),한정애(韓貞愛),31,4,35,1
36110,윤상현(尹相現),한준호(韓俊鎬),32,5,37,1
36111,윤상현(尹相現),허숙정(許淑湞),0,0,0,1
36112,윤상현(尹相現),허영(許榮),33,6,39,1
36113,윤상현(尹相現),허은아(許垠娥),37,32,69,0
36114,윤상현(尹相現),허종식(許琮植),38,22,60,1
36115,윤상현(尹相現),홍기원(洪起元),30,5,35,1
36116,윤상현(尹相現),홍문표(洪文杓),45,60,105,0
36117,윤상현(尹相現),홍석준(洪碩晙),39,37,76,0
36118,윤상현(尹相現),홍성국(洪性國),31,6,37,1
36119,윤상현(尹相現),홍영표(洪永杓),32,6,38,1
36120,윤상현(尹相現),홍익표(洪翼杓),31,8,39,1
36121,윤상현(尹相現),홍정민(洪貞敏),32,4,36,1
36122,윤상현(尹相現),황보승희(皇甫承希),40,38,78,1
36123,윤상현(尹相現),황운하(黃雲夏),32,6,38,1
36124,윤상현(尹相現),황희(黃熙),29,4,33,1
36125,윤영덕(尹永德),윤영석(尹永碩),49,12,61,1
36126,윤영덕(尹永德),윤영찬(尹永燦),89,70,159,0
36127,윤영덕(尹永德),윤재갑(尹才鉀),134,165,299,0
36128,윤영덕(尹永德),윤재옥(尹在玉),49,5,54,1
36129,윤영덕(尹永德),윤주경(尹柱卿),49,5,54,1
36130,윤영덕(尹永德),윤준병(尹準炳),119,194,313,0
36131,윤영덕(尹永德),윤창현(尹暢賢),49,6,55,1
36132,윤영덕(尹永德),윤한홍(尹漢洪),49,7,56,1
36133,윤영덕(尹永德),윤호중(尹昊重),83,58,141,0
36134,윤영덕(尹永德),윤후덕(尹厚德),85,82,167,0
36135,윤영덕(尹永德),이개호(李介昊),109,129,238,0
36136,윤영덕(尹永德),이달곤(李達坤),51,6,57,1
36137,윤영덕(尹永德),이동주(李東洲),110,243,353,0
36138,윤영덕(尹永德),이만희(李晩熙),50,5,55,1
36139,윤영덕(尹永德),이명수(李明洙),50,12,62,1
36140,윤영덕(尹永德),이병훈(李炳勳),143,247,390,0
36141,윤영덕(尹永德),이상민(李相珉),78,40,118,0
36142,윤영덕(尹永德),이상헌(李相憲),86,103,189,0
36143,윤영덕(尹永德),이성만(李成萬),100,126,226,1
36144,윤영덕(尹永德),이소영(李素永),95,68,163,0
36145,윤영덕(尹永德),이수진(李壽珍),122,241,363,0
36146,윤영덕(尹永德),이수진(李秀眞),125,185,310,0
36147,윤영덕(尹永德),이양수(李亮壽),51,9,60,1
36148,윤영덕(尹永德),이용(李鏞),49,5,54,1
36149,윤영덕(尹永德),이용빈(李龍彬),176,356,532,0
36150,윤영덕(尹永德),이용선(李庸瑄),106,138,244,0
36151,윤영덕(尹永德),이용우(李龍雨),122,182,304,0
36152,윤영덕(尹永德),이용호(李容鎬),31,20,51,1
36153,윤영덕(尹永德),이원욱(李元旭),95,111,206,0
36154,윤영덕(尹永德),이원택(李源澤),108,96,204,0
36155,윤영덕(尹永德),이은주(李恩周),24,52,76,1
36156,윤영덕(尹永德),이인선(李仁善),25,4,29,1
36157,윤영덕(尹永德),이인영(李仁榮),79,54,133,0
36158,윤영덕(尹永德),이장섭(李將燮),98,99,197,0
36159,윤영덕(尹永德),이재명(李在明),41,26,67,0
36160,윤영덕(尹永德),이재정(李在汀),82,68,150,0
36161,윤영덕(尹永德),이정문(李楨文),104,127,231,0
36162,윤영덕(尹永德),이종배(李鍾培),50,6,56,1
36163,윤영덕(尹永德),이종성(李鍾成),49,9,58,1
36164,윤영덕(尹永德),이주환(李周桓),49,4,53,1
36165,윤영덕(尹永德),이채익(李埰益),51,13,64,1
36166,윤영덕(尹永德),이철규(李喆圭),51,6,57,1
36167,윤영덕(尹永德),이탄희(李誕熙),105,118,223,0
36168,윤영덕(尹永德),이태규(李泰珪),29,5,34,1
36169,윤영덕(尹永德),이학영(李學永),110,125,235,0
36170,윤영덕(尹永德),이해식(李海植),114,114,228,0
36171,윤영덕(尹永德),이헌승(李憲昇),50,4,54,1
36172,윤영덕(尹永德),이형석(李炯錫),145,198,343,0
36173,윤영덕(尹永德),인재근(印在謹),123,126,249,0
36174,윤영덕(尹永德),임병헌(林炳憲),25,4,29,1
36175,윤영덕(尹永德),임오경(林五卿),104,116,220,0
36176,윤영덕(尹永德),임이자(林利子),49,4,53,1
36177,윤영덕(尹永德),임종성(林鍾聲),102,122,224,0
36178,윤영덕(尹永德),임호선(林昊宣),129,209,338,0
36179,윤영덕(尹永德),장경태(張耿態),132,196,328,0
36180,윤영덕(尹永德),장동혁(張東赫),25,4,29,1
36181,윤영덕(尹永德),장제원(張濟元),49,5,54,1
36182,윤영덕(尹永德),장철민(張喆敏),94,89,183,0
36183,윤영덕(尹永德),장혜영(張惠英),23,46,69,1
36184,윤영덕(尹永德),전봉민(田奉珉),35,6,41,1
36185,윤영덕(尹永德),전용기(田溶冀),105,115,220,0
36186,윤영덕(尹永德),전재수(田載秀),89,66,155,0
36187,윤영덕(尹永德),전주혜(全珠惠),50,4,54,1
36188,윤영덕(尹永德),전해철(全海澈),84,58,142,0
36189,윤영덕(尹永德),전혜숙(全惠淑),90,86,176,0
36190,윤영덕(尹永德),정경희(丁慶姬),49,5,54,1
36191,윤영덕(尹永德),정동만(鄭東萬),49,4,53,1
36192,윤영덕(尹永德),정성호(鄭成湖),80,92,172,0
36193,윤영덕(尹永德),정우택(鄭宇澤),25,5,30,1
36194,윤영덕(尹永德),정운천(鄭雲天),49,6,55,1
36195,윤영덕(尹永德),정일영(鄭日永),94,130,224,0
36196,윤영덕(尹永德),정점식(鄭点植),49,4,53,1
36197,윤영덕(尹永德),정진석(鄭鎭碩),49,7,56,1
36198,윤영덕(尹永德),정청래(鄭淸來),104,92,196,0
36199,윤영덕(尹永德),정춘숙(鄭春淑),96,93,189,0
36200,윤영덕(尹永德),정태호(鄭泰浩),96,119,215,0
36201,윤영덕(尹永德),정필모(鄭必模),98,126,224,0
36202,윤영덕(尹永德),정희용(鄭熙溶),50,8,58,1
36203,윤영덕(尹永德),조경태(趙慶泰),49,4,53,1
36204,윤영덕(尹永德),조명희(曺明姬),49,6,55,1
36205,윤영덕(尹永德),조수진(趙修眞),49,4,53,1
36206,윤영덕(尹永德),조승래(趙承來),91,75,166,0
36207,윤영덕(尹永德),조오섭(曺五燮),178,318,496,0
36208,윤영덕(尹永德),조은희(趙恩禧),25,5,30,1
36209,윤영덕(尹永德),조응천(趙應天),84,38,122,0
36210,윤영덕(尹永德),조정식(趙正湜),79,65,144,0
36211,윤영덕(尹永德),조정훈(趙廷訓),6,14,20,1
36212,윤영덕(尹永德),조해진(曺海珍),51,5,56,1
36213,윤영덕(尹永德),주철현(朱哲鉉),129,231,360,0
36214,윤영덕(尹永德),주호영(朱豪英),50,4,54,1
36215,윤영덕(尹永德),지성호(池成浩),49,4,53,1
36216,윤영덕(尹永德),진선미(陳善美),85,69,154,0
36217,윤영덕(尹永德),진성준(陳聲準),113,175,288,0
36218,윤영덕(尹永德),천준호(千俊鎬),103,92,195,0
36219,윤영덕(尹永德),최기상(崔基相),90,115,205,0
36220,윤영덕(尹永德),최승재(崔承宰),49,6,55,1
36221,윤영덕(尹永德),최연숙(崔姸淑),36,15,51,1
36222,윤영덕(尹永德),최영희(崔英姬),25,6,31,1
36223,윤영덕(尹永德),최인호(崔仁昊),88,107,195,0
36224,윤영덕(尹永德),최재형(崔在亨),25,5,30,1
36225,윤영덕(尹永德),최종윤(崔鍾允),104,138,242,0
36226,윤영덕(尹永德),최춘식(崔春植),49,4,53,1
36227,윤영덕(尹永德),최형두(崔炯斗),50,11,61,1
36228,윤영덕(尹永德),최혜영(崔惠英),110,138,248,0
36229,윤영덕(尹永德),추경호(秋慶鎬),50,3,53,1
36230,윤영덕(尹永德),태영호(太永浩),49,4,53,1
36231,윤영덕(尹永德),하영제(河榮帝),41,5,46,1
36232,윤영덕(尹永德),하태경(河泰慶),51,6,57,1
36233,윤영덕(尹永德),한기호(韓起鎬),49,6,55,1
36234,윤영덕(尹永德),한무경(韓茂景),49,8,57,1
36235,윤영덕(尹永德),한병도(韓秉道),93,100,193,0
36236,윤영덕(尹永德),한정애(韓貞愛),77,63,140,0
36237,윤영덕(尹永德),한준호(韓俊鎬),105,128,233,0
36238,윤영덕(尹永德),허숙정(許淑湞),1,1,2,0
36239,윤영덕(尹永德),허영(許榮),129,154,283,0
36240,윤영덕(尹永德),허은아(許垠娥),49,5,54,1
36241,윤영덕(尹永德),허종식(許琮植),99,125,224,0
36242,윤영덕(尹永德),홍기원(洪起元),113,122,235,0
36243,윤영덕(尹永德),홍문표(洪文杓),50,21,71,1
36244,윤영덕(尹永德),홍석준(洪碩晙),50,5,55,1
36245,윤영덕(尹永德),홍성국(洪性國),120,179,299,0
36246,윤영덕(尹永德),홍영표(洪永杓),83,75,158,0
36247,윤영덕(尹永德),홍익표(洪翼杓),96,86,182,0
36248,윤영덕(尹永德),홍정민(洪貞敏),124,174,298,0
36249,윤영덕(尹永德),황보승희(皇甫承希),45,5,50,1
36250,윤영덕(尹永德),황운하(黃雲夏),125,237,362,0
36251,윤영덕(尹永德),황희(黃熙),85,45,130,0
36252,윤영석(尹永碩),윤영찬(尹永燦),50,5,55,1
36253,윤영석(尹永碩),윤재갑(尹才鉀),53,8,61,1
36254,윤영석(尹永碩),윤재옥(尹在玉),66,51,117,0
36255,윤영석(尹永碩),윤주경(尹柱卿),61,47,108,0
36256,윤영석(尹永碩),윤준병(尹準炳),50,5,55,1
36257,윤영석(尹永碩),윤창현(尹暢賢),84,77,161,0
36258,윤영석(尹永碩),윤한홍(尹漢洪),74,87,161,0
36259,윤영석(尹永碩),윤호중(尹昊重),50,6,56,1
36260,윤영석(尹永碩),윤후덕(尹厚德),50,7,57,1
36261,윤영석(尹永碩),이개호(李介昊),50,7,57,1
36262,윤영석(尹永碩),이달곤(李達坤),65,90,155,0
36263,윤영석(尹永碩),이동주(李東洲),49,5,54,1
36264,윤영석(尹永碩),이만희(李晩熙),71,38,109,0
36265,윤영석(尹永碩),이명수(李明洙),94,111,205,0
36266,윤영석(尹永碩),이병훈(李炳勳),51,11,62,1
36267,윤영석(尹永碩),이상민(李相珉),50,4,54,1
36268,윤영석(尹永碩),이상헌(李相憲),50,16,66,1
36269,윤영석(尹永碩),이성만(李成萬),41,1,42,1
36270,윤영석(尹永碩),이소영(李素永),50,6,56,1
36271,윤영석(尹永碩),이수진(李壽珍),50,6,56,1
36272,윤영석(尹永碩),이수진(李秀眞),50,5,55,1
36273,윤영석(尹永碩),이양수(李亮壽),71,55,126,0
36274,윤영석(尹永碩),이용(李鏞),67,60,127,0
36275,윤영석(尹永碩),이용빈(李龍彬),50,7,57,1
36276,윤영석(尹永碩),이용선(李庸瑄),50,5,55,1
36277,윤영석(尹永碩),이용우(李龍雨),50,5,55,1
36278,윤영석(尹永碩),이용호(李容鎬),28,13,41,0
36279,윤영석(尹永碩),이원욱(李元旭),51,6,57,1
36280,윤영석(尹永碩),이원택(李源澤),50,5,55,1
36281,윤영석(尹永碩),이은주(李恩周),5,3,8,1
36282,윤영석(尹永碩),이인선(李仁善),29,22,51,0
36283,윤영석(尹永碩),이인영(李仁榮),50,4,54,1
36284,윤영석(尹永碩),이장섭(李將燮),50,6,56,1
36285,윤영석(尹永碩),이재명(李在明),25,4,29,1
36286,윤영석(尹永碩),이재정(李在汀),50,5,55,1
36287,윤영석(尹永碩),이정문(李楨文),50,5,55,1
36288,윤영석(尹永碩),이종배(李鍾培),79,87,166,0
36289,윤영석(尹永碩),이종성(李鍾成),91,102,193,0
36290,윤영석(尹永碩),이주환(李周桓),76,77,153,0
36291,윤영석(尹永碩),이채익(李埰益),84,92,176,0
36292,윤영석(尹永碩),이철규(李喆圭),79,75,154,0
36293,윤영석(尹永碩),이탄희(李誕熙),50,5,55,1
36294,윤영석(尹永碩),이태규(李泰珪),42,46,88,0
36295,윤영석(尹永碩),이학영(李學永),49,5,54,1
36296,윤영석(尹永碩),이해식(李海植),51,5,56,1
36297,윤영석(尹永碩),이헌승(李憲昇),65,56,121,0
36298,윤영석(尹永碩),이형석(李炯錫),49,7,56,1
36299,윤영석(尹永碩),인재근(印在謹),49,5,54,1
36300,윤영석(尹永碩),임병헌(林炳憲),31,31,62,0
36301,윤영석(尹永碩),임오경(林五卿),51,11,62,1
36302,윤영석(尹永碩),임이자(林利子),88,69,157,0
36303,윤영석(尹永碩),임종성(林鍾聲),50,5,55,1
36304,윤영석(尹永碩),임호선(林昊宣),51,6,57,1
36305,윤영석(尹永碩),장경태(張耿態),50,5,55,1
36306,윤영석(尹永碩),장동혁(張東赫),26,11,37,0
36307,윤영석(尹永碩),장제원(張濟元),60,34,94,0
36308,윤영석(尹永碩),장철민(張喆敏),51,5,56,1
36309,윤영석(尹永碩),장혜영(張惠英),5,3,8,1
36310,윤영석(尹永碩),전봉민(田奉珉),53,49,102,0
36311,윤영석(尹永碩),전용기(田溶冀),51,5,56,1
36312,윤영석(尹永碩),전재수(田載秀),50,5,55,1
36313,윤영석(尹永碩),전주혜(全珠惠),62,44,106,0
36314,윤영석(尹永碩),전해철(全海澈),51,4,55,1
36315,윤영석(尹永碩),전혜숙(全惠淑),50,6,56,1
36316,윤영석(尹永碩),정경희(丁慶姬),68,58,126,0
36317,윤영석(尹永碩),정동만(鄭東萬),65,57,122,0
36318,윤영석(尹永碩),정성호(鄭成湖),50,4,54,1
36319,윤영석(尹永碩),정우택(鄭宇澤),28,39,67,0
36320,윤영석(尹永碩),정운천(鄭雲天),72,68,140,0
36321,윤영석(尹永碩),정일영(鄭日永),49,4,53,1
36322,윤영석(尹永碩),정점식(鄭点植),65,54,119,0
36323,윤영석(尹永碩),정진석(鄭鎭碩),70,54,124,0
36324,윤영석(尹永碩),정청래(鄭淸來),50,5,55,1
36325,윤영석(尹永碩),정춘숙(鄭春淑),50,5,55,1
36326,윤영석(尹永碩),정태호(鄭泰浩),50,5,55,1
36327,윤영석(尹永碩),정필모(鄭必模),50,6,56,1
36328,윤영석(尹永碩),정희용(鄭熙溶),77,71,148,0
36329,윤영석(尹永碩),조경태(趙慶泰),67,57,124,0
36330,윤영석(尹永碩),조명희(曺明姬),76,96,172,0
36331,윤영석(尹永碩),조수진(趙修眞),68,62,130,0
36332,윤영석(尹永碩),조승래(趙承來),50,6,56,1
36333,윤영석(尹永碩),조오섭(曺五燮),51,7,58,1
36334,윤영석(尹永碩),조은희(趙恩禧),29,15,44,0
36335,윤영석(尹永碩),조응천(趙應天),50,3,53,1
36336,윤영석(尹永碩),조정식(趙正湜),49,4,53,1
36337,윤영석(尹永碩),조정훈(趙廷訓),1,9,10,1
36338,윤영석(尹永碩),조해진(曺海珍),64,54,118,0
36339,윤영석(尹永碩),주철현(朱哲鉉),50,6,56,1
36340,윤영석(尹永碩),주호영(朱豪英),62,40,102,0
36341,윤영석(尹永碩),지성호(池成浩),71,73,144,0
36342,윤영석(尹永碩),진선미(陳善美),50,5,55,1
36343,윤영석(尹永碩),진성준(陳聲準),50,5,55,1
36344,윤영석(尹永碩),천준호(千俊鎬),49,4,53,1
36345,윤영석(尹永碩),최기상(崔基相),49,4,53,1
36346,윤영석(尹永碩),최승재(崔承宰),73,78,151,0
36347,윤영석(尹永碩),최연숙(崔姸淑),33,30,63,0
36348,윤영석(尹永碩),최영희(崔英姬),30,15,45,0
36349,윤영석(尹永碩),최인호(崔仁昊),50,6,56,1
36350,윤영석(尹永碩),최재형(崔在亨),26,17,43,0
36351,윤영석(尹永碩),최종윤(崔鍾允),50,5,55,1
36352,윤영석(尹永碩),최춘식(崔春植),70,72,142,0
36353,윤영석(尹永碩),최형두(崔炯斗),101,134,235,0
36354,윤영석(尹永碩),최혜영(崔惠英),49,5,54,1
36355,윤영석(尹永碩),추경호(秋慶鎬),82,78,160,0
36356,윤영석(尹永碩),태영호(太永浩),73,90,163,0
36357,윤영석(尹永碩),하영제(河榮帝),61,64,125,1
36358,윤영석(尹永碩),하태경(河泰慶),62,44,106,0
36359,윤영석(尹永碩),한기호(韓起鎬),62,54,116,0
36360,윤영석(尹永碩),한무경(韓茂景),81,63,144,0
36361,윤영석(尹永碩),한병도(韓秉道),49,6,55,1
36362,윤영석(尹永碩),한정애(韓貞愛),50,5,55,1
36363,윤영석(尹永碩),한준호(韓俊鎬),50,6,56,1
36364,윤영석(尹永碩),허숙정(許淑湞),0,0,0,1
36365,윤영석(尹永碩),허영(許榮),51,6,57,1
36366,윤영석(尹永碩),허은아(許垠娥),63,45,108,0
36367,윤영석(尹永碩),허종식(許琮植),53,10,63,1
36368,윤영석(尹永碩),홍기원(洪起元),50,6,56,1
36369,윤영석(尹永碩),홍문표(洪文杓),68,56,124,0
36370,윤영석(尹永碩),홍석준(洪碩晙),63,50,113,0
36371,윤영석(尹永碩),홍성국(洪性國),50,12,62,1
36372,윤영석(尹永碩),홍영표(洪永杓),50,5,55,1
36373,윤영석(尹永碩),홍익표(洪翼杓),50,10,60,1
36374,윤영석(尹永碩),홍정민(洪貞敏),50,5,55,1
36375,윤영석(尹永碩),황보승희(皇甫承希),65,60,125,1
36376,윤영석(尹永碩),황운하(黃雲夏),50,4,54,1
36377,윤영석(尹永碩),황희(黃熙),49,4,53,1
36378,윤영찬(尹永燦),윤재갑(尹才鉀),88,74,162,0
36379,윤영찬(尹永燦),윤재옥(尹在玉),49,4,53,1
36380,윤영찬(尹永燦),윤주경(尹柱卿),49,7,56,1
36381,윤영찬(尹永燦),윤준병(尹準炳),93,93,186,0
36382,윤영찬(尹永燦),윤창현(尹暢賢),49,7,56,1
36383,윤영찬(尹永燦),윤한홍(尹漢洪),50,4,54,1
36384,윤영찬(尹永燦),윤호중(尹昊重),76,49,125,0
36385,윤영찬(尹永燦),윤후덕(尹厚德),84,62,146,0
36386,윤영찬(尹永燦),이개호(李介昊),83,58,141,0
36387,윤영찬(尹永燦),이달곤(李達坤),50,7,57,1
36388,윤영찬(尹永燦),이동주(李東洲),82,60,142,0
36389,윤영찬(尹永燦),이만희(李晩熙),49,4,53,1
36390,윤영찬(尹永燦),이명수(李明洙),50,17,67,1
36391,윤영찬(尹永燦),이병훈(李炳勳),100,105,205,0
36392,윤영찬(尹永燦),이상민(李相珉),75,49,124,0
36393,윤영찬(尹永燦),이상헌(李相憲),89,55,144,0
36394,윤영찬(尹永燦),이성만(李成萬),74,51,125,1
36395,윤영찬(尹永燦),이소영(李素永),85,43,128,0
36396,윤영찬(尹永燦),이수진(李壽珍),94,62,156,0
36397,윤영찬(尹永燦),이수진(李秀眞),94,68,162,0
36398,윤영찬(尹永燦),이양수(李亮壽),50,4,54,1
36399,윤영찬(尹永燦),이용(李鏞),49,4,53,1
36400,윤영찬(尹永燦),이용빈(李龍彬),114,139,253,0
36401,윤영찬(尹永燦),이용선(李庸瑄),86,59,145,0
36402,윤영찬(尹永燦),이용우(李龍雨),90,72,162,0
36403,윤영찬(尹永燦),이용호(李容鎬),32,22,54,1
36404,윤영찬(尹永燦),이원욱(李元旭),110,129,239,0
36405,윤영찬(尹永燦),이원택(李源澤),86,48,134,0
36406,윤영찬(尹永燦),이은주(李恩周),12,18,30,1
36407,윤영찬(尹永燦),이인선(李仁善),25,4,29,1
36408,윤영찬(尹永燦),이인영(李仁榮),75,50,125,0
36409,윤영찬(尹永燦),이장섭(李將燮),99,127,226,0
36410,윤영찬(尹永燦),이재명(李在明),38,18,56,0
36411,윤영찬(尹永燦),이재정(李在汀),75,47,122,0
36412,윤영찬(尹永燦),이정문(李楨文),83,79,162,0
36413,윤영찬(尹永燦),이종배(李鍾培),49,9,58,1
36414,윤영찬(尹永燦),이종성(李鍾成),49,6,55,1
36415,윤영찬(尹永燦),이주환(李周桓),49,6,55,1
36416,윤영찬(尹永燦),이채익(李埰益),51,7,58,1
36417,윤영찬(尹永燦),이철규(李喆圭),52,6,58,1
36418,윤영찬(尹永燦),이탄희(李誕熙),90,60,150,0
36419,윤영찬(尹永燦),이태규(李泰珪),29,5,34,1
36420,윤영찬(尹永燦),이학영(李學永),88,69,157,0
36421,윤영찬(尹永燦),이해식(李海植),93,58,151,0
36422,윤영찬(尹永燦),이헌승(李憲昇),50,6,56,1
36423,윤영찬(尹永燦),이형석(李炯錫),88,69,157,0
36424,윤영찬(尹永燦),인재근(印在謹),82,77,159,0
36425,윤영찬(尹永燦),임병헌(林炳憲),25,4,29,1
36426,윤영찬(尹永燦),임오경(林五卿),84,53,137,0
36427,윤영찬(尹永燦),임이자(林利子),49,4,53,1
36428,윤영찬(尹永燦),임종성(林鍾聲),85,71,156,0
36429,윤영찬(尹永燦),임호선(林昊宣),106,147,253,0
36430,윤영찬(尹永燦),장경태(張耿態),89,80,169,0
36431,윤영찬(尹永燦),장동혁(張東赫),25,4,29,1
36432,윤영찬(尹永燦),장제원(張濟元),49,4,53,1
36433,윤영찬(尹永燦),장철민(張喆敏),88,68,156,0
36434,윤영찬(尹永燦),장혜영(張惠英),14,11,25,1
36435,윤영찬(尹永燦),전봉민(田奉珉),34,5,39,1
36436,윤영찬(尹永燦),전용기(田溶冀),94,99,193,0
36437,윤영찬(尹永燦),전재수(田載秀),83,46,129,0
36438,윤영찬(尹永燦),전주혜(全珠惠),50,4,54,1
36439,윤영찬(尹永燦),전해철(全海澈),78,48,126,0
36440,윤영찬(尹永燦),전혜숙(全惠淑),96,101,197,0
36441,윤영찬(尹永燦),정경희(丁慶姬),49,6,55,1
36442,윤영찬(尹永燦),정동만(鄭東萬),49,4,53,1
36443,윤영찬(尹永燦),정성호(鄭成湖),76,57,133,0
36444,윤영찬(尹永燦),정우택(鄭宇澤),25,4,29,1
36445,윤영찬(尹永燦),정운천(鄭雲天),49,4,53,1
36446,윤영찬(尹永燦),정일영(鄭日永),87,62,149,0
36447,윤영찬(尹永燦),정점식(鄭点植),50,4,54,1
36448,윤영찬(尹永燦),정진석(鄭鎭碩),50,5,55,1
36449,윤영찬(尹永燦),정청래(鄭淸來),80,44,124,0
36450,윤영찬(尹永燦),정춘숙(鄭春淑),87,68,155,0
36451,윤영찬(尹永燦),정태호(鄭泰浩),88,79,167,0
36452,윤영찬(尹永燦),정필모(鄭必模),94,86,180,0
36453,윤영찬(尹永燦),정희용(鄭熙溶),49,5,54,1
36454,윤영찬(尹永燦),조경태(趙慶泰),49,5,54,1
36455,윤영찬(尹永燦),조명희(曺明姬),49,8,57,1
36456,윤영찬(尹永燦),조수진(趙修眞),50,4,54,1
36457,윤영찬(尹永燦),조승래(趙承來),103,109,212,0
36458,윤영찬(尹永燦),조오섭(曺五燮),85,79,164,0
36459,윤영찬(尹永燦),조은희(趙恩禧),25,4,29,1
36460,윤영찬(尹永燦),조응천(趙應天),74,39,113,0
36461,윤영찬(尹永燦),조정식(趙正湜),80,36,116,0
36462,윤영찬(尹永燦),조정훈(趙廷訓),5,11,16,1
36463,윤영찬(尹永燦),조해진(曺海珍),50,5,55,1
36464,윤영찬(尹永燦),주철현(朱哲鉉),84,50,134,0
36465,윤영찬(尹永燦),주호영(朱豪英),49,4,53,1
36466,윤영찬(尹永燦),지성호(池成浩),49,4,53,1
36467,윤영찬(尹永燦),진선미(陳善美),79,42,121,0
36468,윤영찬(尹永燦),진성준(陳聲準),88,57,145,0
36469,윤영찬(尹永燦),천준호(千俊鎬),84,50,134,0
36470,윤영찬(尹永燦),최기상(崔基相),76,42,118,0
36471,윤영찬(尹永燦),최승재(崔承宰),50,6,56,1
36472,윤영찬(尹永燦),최연숙(崔姸淑),30,14,44,1
36473,윤영찬(尹永燦),최영희(崔英姬),25,5,30,1
36474,윤영찬(尹永燦),최인호(崔仁昊),86,63,149,0
36475,윤영찬(尹永燦),최재형(崔在亨),25,4,29,1
36476,윤영찬(尹永燦),최종윤(崔鍾允),93,101,194,0
36477,윤영찬(尹永燦),최춘식(崔春植),49,6,55,1
36478,윤영찬(尹永燦),최형두(崔炯斗),50,6,56,1
36479,윤영찬(尹永燦),최혜영(崔惠英),93,85,178,0
36480,윤영찬(尹永燦),추경호(秋慶鎬),49,5,54,1
36481,윤영찬(尹永燦),태영호(太永浩),49,4,53,1
36482,윤영찬(尹永燦),하영제(河榮帝),41,3,44,1
36483,윤영찬(尹永燦),하태경(河泰慶),50,5,55,1
36484,윤영찬(尹永燦),한기호(韓起鎬),50,6,56,1
36485,윤영찬(尹永燦),한무경(韓茂景),49,6,55,1
36486,윤영찬(尹永燦),한병도(韓秉道),90,95,185,0
36487,윤영찬(尹永燦),한정애(韓貞愛),79,58,137,0
36488,윤영찬(尹永燦),한준호(韓俊鎬),102,107,209,0
36489,윤영찬(尹永燦),허숙정(許淑湞),1,1,2,0
36490,윤영찬(尹永燦),허영(許榮),93,90,183,0
36491,윤영찬(尹永燦),허은아(許垠娥),50,4,54,1
36492,윤영찬(尹永燦),허종식(許琮植),88,75,163,0
36493,윤영찬(尹永燦),홍기원(洪起元),92,81,173,0
36494,윤영찬(尹永燦),홍문표(洪文杓),50,6,56,1
36495,윤영찬(尹永燦),홍석준(洪碩晙),50,4,54,1
36496,윤영찬(尹永燦),홍성국(洪性國),116,144,260,0
36497,윤영찬(尹永燦),홍영표(洪永杓),85,73,158,0
36498,윤영찬(尹永燦),홍익표(洪翼杓),96,87,183,0
36499,윤영찬(尹永燦),홍정민(洪貞敏),98,87,185,0
36500,윤영찬(尹永燦),황보승희(皇甫承希),45,1,46,1
36501,윤영찬(尹永燦),황운하(黃雲夏),94,70,164,0
36502,윤영찬(尹永燦),황희(黃熙),83,46,129,0
36503,윤재갑(尹才鉀),윤재옥(尹在玉),55,8,63,1
36504,윤재갑(尹才鉀),윤주경(尹柱卿),52,7,59,1
36505,윤재갑(尹才鉀),윤준병(尹準炳),154,267,421,0
36506,윤재갑(尹才鉀),윤창현(尹暢賢),52,6,58,1
36507,윤재갑(尹才鉀),윤한홍(尹漢洪),51,10,61,1
36508,윤재갑(尹才鉀),윤호중(尹昊重),79,66,145,0
36509,윤재갑(尹才鉀),윤후덕(尹厚德),93,84,177,0
36510,윤재갑(尹才鉀),이개호(李介昊),191,296,487,0
36511,윤재갑(尹才鉀),이달곤(李達坤),56,13,69,1
36512,윤재갑(尹才鉀),이동주(李東洲),123,155,278,0
36513,윤재갑(尹才鉀),이만희(李晩熙),53,7,60,1
36514,윤재갑(尹才鉀),이명수(李明洙),59,35,94,1
36515,윤재갑(尹才鉀),이병훈(李炳勳),138,222,360,0
36516,윤재갑(尹才鉀),이상민(李相珉),81,48,129,0
36517,윤재갑(尹才鉀),이상헌(李相憲),141,154,295,0
36518,윤재갑(尹才鉀),이성만(李成萬),128,168,296,1
36519,윤재갑(尹才鉀),이소영(李素永),95,67,162,0
36520,윤재갑(尹才鉀),이수진(李壽珍),164,195,359,0
36521,윤재갑(尹才鉀),이수진(李秀眞),115,151,266,0
36522,윤재갑(尹才鉀),이양수(李亮壽),58,15,73,1
36523,윤재갑(尹才鉀),이용(李鏞),52,9,61,1
36524,윤재갑(尹才鉀),이용빈(李龍彬),160,245,405,0
36525,윤재갑(尹才鉀),이용선(李庸瑄),112,121,233,0
36526,윤재갑(尹才鉀),이용우(李龍雨),121,124,245,0
36527,윤재갑(尹才鉀),이용호(李容鎬),33,39,72,1
36528,윤재갑(尹才鉀),이원욱(李元旭),100,92,192,0
36529,윤재갑(尹才鉀),이원택(李源澤),151,172,323,0
36530,윤재갑(尹才鉀),이은주(李恩周),37,49,86,1
36531,윤재갑(尹才鉀),이인선(李仁善),25,5,30,1
36532,윤재갑(尹才鉀),이인영(李仁榮),84,57,141,0
36533,윤재갑(尹才鉀),이장섭(李將燮),104,93,197,0
36534,윤재갑(尹才鉀),이재명(李在明),41,22,63,0
36535,윤재갑(尹才鉀),이재정(李在汀),90,63,153,0
36536,윤재갑(尹才鉀),이정문(李楨文),115,117,232,0
36537,윤재갑(尹才鉀),이종배(李鍾培),52,10,62,1
36538,윤재갑(尹才鉀),이종성(李鍾成),51,8,59,1
36539,윤재갑(尹才鉀),이주환(李周桓),51,10,61,1
36540,윤재갑(尹才鉀),이채익(李埰益),55,23,78,1
36541,윤재갑(尹才鉀),이철규(李喆圭),53,5,58,1
36542,윤재갑(尹才鉀),이탄희(李誕熙),102,100,202,0
36543,윤재갑(尹才鉀),이태규(李泰珪),33,8,41,1
36544,윤재갑(尹才鉀),이학영(李學永),112,134,246,0
36545,윤재갑(尹才鉀),이해식(李海植),114,123,237,0
36546,윤재갑(尹才鉀),이헌승(李憲昇),51,6,57,1
36547,윤재갑(尹才鉀),이형석(李炯錫),127,117,244,0
36548,윤재갑(尹才鉀),인재근(印在謹),135,137,272,0
36549,윤재갑(尹才鉀),임병헌(林炳憲),25,4,29,1
36550,윤재갑(尹才鉀),임오경(林五卿),104,126,230,0
36551,윤재갑(尹才鉀),임이자(林利子),51,5,56,1
36552,윤재갑(尹才鉀),임종성(林鍾聲),121,125,246,0
36553,윤재갑(尹才鉀),임호선(林昊宣),152,215,367,0
36554,윤재갑(尹才鉀),장경태(張耿態),134,142,276,0
36555,윤재갑(尹才鉀),장동혁(張東赫),25,6,31,1
36556,윤재갑(尹才鉀),장제원(張濟元),49,6,55,1
36557,윤재갑(尹才鉀),장철민(張喆敏),114,114,228,0
36558,윤재갑(尹才鉀),장혜영(張惠英),24,34,58,1
36559,윤재갑(尹才鉀),전봉민(田奉珉),37,8,45,1
36560,윤재갑(尹才鉀),전용기(田溶冀),131,153,284,0
36561,윤재갑(尹才鉀),전재수(田載秀),93,61,154,0
36562,윤재갑(尹才鉀),전주혜(全珠惠),52,6,58,1
36563,윤재갑(尹才鉀),전해철(全海澈),82,64,146,0
36564,윤재갑(尹才鉀),전혜숙(全惠淑),137,114,251,0
36565,윤재갑(尹才鉀),정경희(丁慶姬),52,5,57,1
36566,윤재갑(尹才鉀),정동만(鄭東萬),51,9,60,1
36567,윤재갑(尹才鉀),정성호(鄭成湖),107,110,217,0
36568,윤재갑(尹才鉀),정우택(鄭宇澤),27,8,35,1
36569,윤재갑(尹才鉀),정운천(鄭雲天),62,15,77,1
36570,윤재갑(尹才鉀),정일영(鄭日永),112,154,266,0
36571,윤재갑(尹才鉀),정점식(鄭点植),52,6,58,1
36572,윤재갑(尹才鉀),정진석(鄭鎭碩),55,12,67,1
36573,윤재갑(尹才鉀),정청래(鄭淸來),110,80,190,0
36574,윤재갑(尹才鉀),정춘숙(鄭春淑),116,90,206,0
36575,윤재갑(尹才鉀),정태호(鄭泰浩),98,94,192,0
36576,윤재갑(尹才鉀),정필모(鄭必模),100,113,213,0
36577,윤재갑(尹才鉀),정희용(鄭熙溶),52,11,63,1
36578,윤재갑(尹才鉀),조경태(趙慶泰),67,33,100,1
36579,윤재갑(尹才鉀),조명희(曺明姬),54,22,76,1
36580,윤재갑(尹才鉀),조수진(趙修眞),55,8,63,1
36581,윤재갑(尹才鉀),조승래(趙承來),105,78,183,0
36582,윤재갑(尹才鉀),조오섭(曺五燮),154,193,347,0
36583,윤재갑(尹才鉀),조은희(趙恩禧),25,6,31,1
36584,윤재갑(尹才鉀),조응천(趙應天),81,37,118,0
36585,윤재갑(尹才鉀),조정식(趙正湜),80,69,149,0
36586,윤재갑(尹才鉀),조정훈(趙廷訓),9,21,30,1
36587,윤재갑(尹才鉀),조해진(曺海珍),51,6,57,1
36588,윤재갑(尹才鉀),주철현(朱哲鉉),160,272,432,0
36589,윤재갑(尹才鉀),주호영(朱豪英),50,6,56,1
36590,윤재갑(尹才鉀),지성호(池成浩),49,5,54,1
36591,윤재갑(尹才鉀),진선미(陳善美),87,53,140,0
36592,윤재갑(尹才鉀),진성준(陳聲準),108,122,230,0
36593,윤재갑(尹才鉀),천준호(千俊鎬),97,80,177,0
36594,윤재갑(尹才鉀),최기상(崔基相),89,77,166,0
36595,윤재갑(尹才鉀),최승재(崔承宰),51,9,60,1
36596,윤재갑(尹才鉀),최연숙(崔姸淑),38,18,56,1
36597,윤재갑(尹才鉀),최영희(崔英姬),25,10,35,1
36598,윤재갑(尹才鉀),최인호(崔仁昊),114,117,231,0
36599,윤재갑(尹才鉀),최재형(崔在亨),25,4,29,1
36600,윤재갑(尹才鉀),최종윤(崔鍾允),128,146,274,0
36601,윤재갑(尹才鉀),최춘식(崔春植),55,19,74,1
36602,윤재갑(尹才鉀),최형두(崔炯斗),56,15,71,1
36603,윤재갑(尹才鉀),최혜영(崔惠英),123,139,262,0
36604,윤재갑(尹才鉀),추경호(秋慶鎬),51,6,57,1
36605,윤재갑(尹才鉀),태영호(太永浩),53,9,62,1
36606,윤재갑(尹才鉀),하영제(河榮帝),45,13,58,1
36607,윤재갑(尹才鉀),하태경(河泰慶),53,8,61,1
36608,윤재갑(尹才鉀),한기호(韓起鎬),53,6,59,1
36609,윤재갑(尹才鉀),한무경(韓茂景),50,8,58,1
36610,윤재갑(尹才鉀),한병도(韓秉道),116,108,224,0
36611,윤재갑(尹才鉀),한정애(韓貞愛),89,60,149,0
36612,윤재갑(尹才鉀),한준호(韓俊鎬),105,96,201,0
36613,윤재갑(尹才鉀),허숙정(許淑湞),1,1,2,0
36614,윤재갑(尹才鉀),허영(許榮),147,152,299,0
36615,윤재갑(尹才鉀),허은아(許垠娥),50,5,55,1
36616,윤재갑(尹才鉀),허종식(許琮植),119,158,277,0
36617,윤재갑(尹才鉀),홍기원(洪起元),105,114,219,0
36618,윤재갑(尹才鉀),홍문표(洪文杓),91,79,170,1
36619,윤재갑(尹才鉀),홍석준(洪碩晙),52,5,57,1
36620,윤재갑(尹才鉀),홍성국(洪性國),172,199,371,0
36621,윤재갑(尹才鉀),홍영표(洪永杓),92,61,153,0
36622,윤재갑(尹才鉀),홍익표(洪翼杓),100,97,197,0
36623,윤재갑(尹才鉀),홍정민(洪貞敏),120,144,264,0
36624,윤재갑(尹才鉀),황보승희(皇甫承希),51,4,55,1
36625,윤재갑(尹才鉀),황운하(黃雲夏),154,174,328,0
36626,윤재갑(尹才鉀),황희(黃熙),85,58,143,0
36627,윤재옥(尹在玉),윤주경(尹柱卿),66,47,113,0
36628,윤재옥(尹在玉),윤준병(尹準炳),50,5,55,1
36629,윤재옥(尹在玉),윤창현(尹暢賢),87,76,163,0
36630,윤재옥(尹在玉),윤한홍(尹漢洪),69,68,137,0
36631,윤재옥(尹在玉),윤호중(尹昊重),49,4,53,1
36632,윤재옥(尹在玉),윤후덕(尹厚德),50,4,54,1
36633,윤재옥(尹在玉),이개호(李介昊),49,4,53,1
36634,윤재옥(尹在玉),이달곤(李達坤),60,48,108,0
36635,윤재옥(尹在玉),이동주(李東洲),50,4,54,1
36636,윤재옥(尹在玉),이만희(李晩熙),71,59,130,0
36637,윤재옥(尹在玉),이명수(李明洙),89,107,196,0
36638,윤재옥(尹在玉),이병훈(李炳勳),52,6,58,1
36639,윤재옥(尹在玉),이상민(李相珉),49,5,54,1
36640,윤재옥(尹在玉),이상헌(李相憲),49,5,54,1
36641,윤재옥(尹在玉),이성만(李成萬),40,0,40,1
36642,윤재옥(尹在玉),이소영(李素永),50,4,54,1
36643,윤재옥(尹在玉),이수진(李壽珍),50,4,54,1
36644,윤재옥(尹在玉),이수진(李秀眞),50,6,56,1
36645,윤재옥(尹在玉),이양수(李亮壽),75,57,132,0
36646,윤재옥(尹在玉),이용(李鏞),74,86,160,0
36647,윤재옥(尹在玉),이용빈(李龍彬),50,5,55,1
36648,윤재옥(尹在玉),이용선(李庸瑄),50,4,54,1
36649,윤재옥(尹在玉),이용우(李龍雨),50,5,55,1
36650,윤재옥(尹在玉),이용호(李容鎬),27,17,44,0
36651,윤재옥(尹在玉),이원욱(李元旭),53,5,58,1
36652,윤재옥(尹在玉),이원택(李源澤),49,4,53,1
36653,윤재옥(尹在玉),이은주(李恩周),4,2,6,1
36654,윤재옥(尹在玉),이인선(李仁善),30,33,63,0
36655,윤재옥(尹在玉),이인영(李仁榮),49,4,53,1
36656,윤재옥(尹在玉),이장섭(李將燮),51,4,55,1
36657,윤재옥(尹在玉),이재명(李在明),25,4,29,1
36658,윤재옥(尹在玉),이재정(李在汀),49,4,53,1
36659,윤재옥(尹在玉),이정문(李楨文),49,4,53,1
36660,윤재옥(尹在玉),이종배(李鍾培),91,54,145,0
36661,윤재옥(尹在玉),이종성(李鍾成),77,62,139,0
36662,윤재옥(尹在玉),이주환(李周桓),81,61,142,0
36663,윤재옥(尹在玉),이채익(李埰益),65,56,121,0
36664,윤재옥(尹在玉),이철규(李喆圭),73,50,123,0
36665,윤재옥(尹在玉),이탄희(李誕熙),49,4,53,1
36666,윤재옥(尹在玉),이태규(李泰珪),35,23,58,0
36667,윤재옥(尹在玉),이학영(李學永),49,4,53,1
36668,윤재옥(尹在玉),이해식(李海植),50,4,54,1
36669,윤재옥(尹在玉),이헌승(李憲昇),68,42,110,0
36670,윤재옥(尹在玉),이형석(李炯錫),53,5,58,1
36671,윤재옥(尹在玉),인재근(印在謹),49,5,54,1
36672,윤재옥(尹在玉),임병헌(林炳憲),29,22,51,0
36673,윤재옥(尹在玉),임오경(林五卿),49,5,54,1
36674,윤재옥(尹在玉),임이자(林利子),70,55,125,0
36675,윤재옥(尹在玉),임종성(林鍾聲),53,6,59,1
36676,윤재옥(尹在玉),임호선(林昊宣),50,8,58,1
36677,윤재옥(尹在玉),장경태(張耿態),49,4,53,1
36678,윤재옥(尹在玉),장동혁(張東赫),27,17,44,0
36679,윤재옥(尹在玉),장제원(張濟元),60,31,91,0
36680,윤재옥(尹在玉),장철민(張喆敏),52,5,57,1
36681,윤재옥(尹在玉),장혜영(張惠英),5,2,7,1
36682,윤재옥(尹在玉),전봉민(田奉珉),57,54,111,0
36683,윤재옥(尹在玉),전용기(田溶冀),49,4,53,1
36684,윤재옥(尹在玉),전재수(田載秀),49,4,53,1
36685,윤재옥(尹在玉),전주혜(全珠惠),69,55,124,0
36686,윤재옥(尹在玉),전해철(全海澈),50,4,54,1
36687,윤재옥(尹在玉),전혜숙(全惠淑),52,6,58,1
36688,윤재옥(尹在玉),정경희(丁慶姬),69,56,125,0
36689,윤재옥(尹在玉),정동만(鄭東萬),71,43,114,0
36690,윤재옥(尹在玉),정성호(鄭成湖),50,4,54,1
36691,윤재옥(尹在玉),정우택(鄭宇澤),33,33,66,0
36692,윤재옥(尹在玉),정운천(鄭雲天),67,40,107,0
36693,윤재옥(尹在玉),정일영(鄭日永),49,4,53,1
36694,윤재옥(尹在玉),정점식(鄭点植),63,37,100,0
36695,윤재옥(尹在玉),정진석(鄭鎭碩),93,73,166,0
36696,윤재옥(尹在玉),정청래(鄭淸來),49,5,54,1
36697,윤재옥(尹在玉),정춘숙(鄭春淑),49,5,54,1
36698,윤재옥(尹在玉),정태호(鄭泰浩),49,4,53,1
36699,윤재옥(尹在玉),정필모(鄭必模),49,4,53,1
36700,윤재옥(尹在玉),정희용(鄭熙溶),104,99,203,0
36701,윤재옥(尹在玉),조경태(趙慶泰),66,41,107,0
36702,윤재옥(尹在玉),조명희(曺明姬),73,66,139,0
36703,윤재옥(尹在玉),조수진(趙修眞),79,66,145,0
36704,윤재옥(尹在玉),조승래(趙承來),53,5,58,1
36705,윤재옥(尹在玉),조오섭(曺五燮),50,4,54,1
36706,윤재옥(尹在玉),조은희(趙恩禧),33,24,57,0
36707,윤재옥(尹在玉),조응천(趙應天),49,3,52,1
36708,윤재옥(尹在玉),조정식(趙正湜),49,3,52,1
36709,윤재옥(尹在玉),조정훈(趙廷訓),1,2,3,1
36710,윤재옥(尹在玉),조해진(曺海珍),62,34,96,0
36711,윤재옥(尹在玉),주철현(朱哲鉉),50,4,54,1
36712,윤재옥(尹在玉),주호영(朱豪英),65,43,108,0
36713,윤재옥(尹在玉),지성호(池成浩),79,67,146,0
36714,윤재옥(尹在玉),진선미(陳善美),51,4,55,1
36715,윤재옥(尹在玉),진성준(陳聲準),49,4,53,1
36716,윤재옥(尹在玉),천준호(千俊鎬),49,3,52,1
36717,윤재옥(尹在玉),최기상(崔基相),49,4,53,1
36718,윤재옥(尹在玉),최승재(崔承宰),69,58,127,0
36719,윤재옥(尹在玉),최연숙(崔姸淑),32,23,55,0
36720,윤재옥(尹在玉),최영희(崔英姬),29,14,43,0
36721,윤재옥(尹在玉),최인호(崔仁昊),50,4,54,1
36722,윤재옥(尹在玉),최재형(崔在亨),27,11,38,0
36723,윤재옥(尹在玉),최종윤(崔鍾允),49,4,53,1
36724,윤재옥(尹在玉),최춘식(崔春植),77,65,142,0
36725,윤재옥(尹在玉),최형두(崔炯斗),70,47,117,0
36726,윤재옥(尹在玉),최혜영(崔惠英),49,4,53,1
36727,윤재옥(尹在玉),추경호(秋慶鎬),94,96,190,0
36728,윤재옥(尹在玉),태영호(太永浩),80,81,161,0
36729,윤재옥(尹在玉),하영제(河榮帝),61,50,111,1
36730,윤재옥(尹在玉),하태경(河泰慶),65,45,110,0
36731,윤재옥(尹在玉),한기호(韓起鎬),62,52,114,0
36732,윤재옥(尹在玉),한무경(韓茂景),82,71,153,0
36733,윤재옥(尹在玉),한병도(韓秉道),49,4,53,1
36734,윤재옥(尹在玉),한정애(韓貞愛),53,5,58,1
36735,윤재옥(尹在玉),한준호(韓俊鎬),50,4,54,1
36736,윤재옥(尹在玉),허숙정(許淑湞),0,0,0,1
36737,윤재옥(尹在玉),허영(許榮),52,4,56,1
36738,윤재옥(尹在玉),허은아(許垠娥),70,44,114,0
36739,윤재옥(尹在玉),허종식(許琮植),51,5,56,1
36740,윤재옥(尹在玉),홍기원(洪起元),49,4,53,1
36741,윤재옥(尹在玉),홍문표(洪文杓),72,58,130,0
36742,윤재옥(尹在玉),홍석준(洪碩晙),92,81,173,0
36743,윤재옥(尹在玉),홍성국(洪性國),51,5,56,1
36744,윤재옥(尹在玉),홍영표(洪永杓),51,4,55,1
36745,윤재옥(尹在玉),홍익표(洪翼杓),49,4,53,1
36746,윤재옥(尹在玉),홍정민(洪貞敏),51,5,56,1
36747,윤재옥(尹在玉),황보승희(皇甫承希),71,59,130,1
36748,윤재옥(尹在玉),황운하(黃雲夏),50,5,55,1
36749,윤재옥(尹在玉),황희(黃熙),49,6,55,1
36750,윤주경(尹柱卿),윤준병(尹準炳),50,4,54,1
36751,윤주경(尹柱卿),윤창현(尹暢賢),94,137,231,0
36752,윤주경(尹柱卿),윤한홍(尹漢洪),77,82,159,0
36753,윤주경(尹柱卿),윤호중(尹昊重),49,4,53,1
36754,윤주경(尹柱卿),윤후덕(尹厚德),50,6,56,1
36755,윤주경(尹柱卿),이개호(李介昊),50,4,54,1
36756,윤주경(尹柱卿),이달곤(李達坤),68,55,123,0
36757,윤주경(尹柱卿),이동주(李東洲),50,10,60,1
36758,윤주경(尹柱卿),이만희(李晩熙),69,55,124,0
36759,윤주경(尹柱卿),이명수(李明洙),76,76,152,0
36760,윤주경(尹柱卿),이병훈(李炳勳),52,7,59,1
36761,윤주경(尹柱卿),이상민(李相珉),49,4,53,1
36762,윤주경(尹柱卿),이상헌(李相憲),50,5,55,1
36763,윤주경(尹柱卿),이성만(李成萬),40,2,42,1
36764,윤주경(尹柱卿),이소영(李素永),49,6,55,1
36765,윤주경(尹柱卿),이수진(李壽珍),49,7,56,1
36766,윤주경(尹柱卿),이수진(李秀眞),49,10,59,1
36767,윤주경(尹柱卿),이양수(李亮壽),68,72,140,0
36768,윤주경(尹柱卿),이용(李鏞),71,107,178,0
36769,윤주경(尹柱卿),이용빈(李龍彬),50,8,58,1
36770,윤주경(尹柱卿),이용선(李庸瑄),49,14,63,1
36771,윤주경(尹柱卿),이용우(李龍雨),50,13,63,1
36772,윤주경(尹柱卿),이용호(李容鎬),32,16,48,0
36773,윤주경(尹柱卿),이원욱(李元旭),50,5,55,1
36774,윤주경(尹柱卿),이원택(李源澤),50,4,54,1
36775,윤주경(尹柱卿),이은주(李恩周),6,6,12,1
36776,윤주경(尹柱卿),이인선(李仁善),37,33,70,0
36777,윤주경(尹柱卿),이인영(李仁榮),49,4,53,1
36778,윤주경(尹柱卿),이장섭(李將燮),49,5,54,1
36779,윤주경(尹柱卿),이재명(李在明),25,4,29,1
36780,윤주경(尹柱卿),이재정(李在汀),49,5,54,1
36781,윤주경(尹柱卿),이정문(李楨文),49,8,57,1
36782,윤주경(尹柱卿),이종배(李鍾培),84,75,159,0
36783,윤주경(尹柱卿),이종성(李鍾成),86,122,208,0
36784,윤주경(尹柱卿),이주환(李周桓),71,75,146,0
36785,윤주경(尹柱卿),이채익(李埰益),78,85,163,0
36786,윤주경(尹柱卿),이철규(李喆圭),76,71,147,0
36787,윤주경(尹柱卿),이탄희(李誕熙),49,5,54,1
36788,윤주경(尹柱卿),이태규(李泰珪),37,39,76,0
36789,윤주경(尹柱卿),이학영(李學永),49,5,54,1
36790,윤주경(尹柱卿),이해식(李海植),49,5,54,1
36791,윤주경(尹柱卿),이헌승(李憲昇),62,67,129,0
36792,윤주경(尹柱卿),이형석(李炯錫),49,4,53,1
36793,윤주경(尹柱卿),인재근(印在謹),49,5,54,1
36794,윤주경(尹柱卿),임병헌(林炳憲),34,41,75,0
36795,윤주경(尹柱卿),임오경(林五卿),49,5,54,1
36796,윤주경(尹柱卿),임이자(林利子),67,56,123,0
36797,윤주경(尹柱卿),임종성(林鍾聲),51,6,57,1
36798,윤주경(尹柱卿),임호선(林昊宣),49,5,54,1
36799,윤주경(尹柱卿),장경태(張耿態),49,5,54,1
36800,윤주경(尹柱卿),장동혁(張東赫),33,36,69,0
36801,윤주경(尹柱卿),장제원(張濟元),60,39,99,0
36802,윤주경(尹柱卿),장철민(張喆敏),49,4,53,1
36803,윤주경(尹柱卿),장혜영(張惠英),6,9,15,1
36804,윤주경(尹柱卿),전봉민(田奉珉),54,46,100,0
36805,윤주경(尹柱卿),전용기(田溶冀),49,6,55,1
36806,윤주경(尹柱卿),전재수(田載秀),49,4,53,1
36807,윤주경(尹柱卿),전주혜(全珠惠),85,115,200,0
36808,윤주경(尹柱卿),전해철(全海澈),50,12,62,1
36809,윤주경(尹柱卿),전혜숙(全惠淑),49,8,57,1
36810,윤주경(尹柱卿),정경희(丁慶姬),71,97,168,0
36811,윤주경(尹柱卿),정동만(鄭東萬),65,44,109,0
36812,윤주경(尹柱卿),정성호(鄭成湖),53,5,58,1
36813,윤주경(尹柱卿),정우택(鄭宇澤),32,42,74,0
36814,윤주경(尹柱卿),정운천(鄭雲天),72,66,138,0
36815,윤주경(尹柱卿),정일영(鄭日永),49,7,56,1
36816,윤주경(尹柱卿),정점식(鄭点植),62,43,105,0
36817,윤주경(尹柱卿),정진석(鄭鎭碩),69,78,147,0
36818,윤주경(尹柱卿),정청래(鄭淸來),49,4,53,1
36819,윤주경(尹柱卿),정춘숙(鄭春淑),49,6,55,1
36820,윤주경(尹柱卿),정태호(鄭泰浩),49,4,53,1
36821,윤주경(尹柱卿),정필모(鄭必模),49,5,54,1
36822,윤주경(尹柱卿),정희용(鄭熙溶),76,83,159,0
36823,윤주경(尹柱卿),조경태(趙慶泰),67,52,119,0
36824,윤주경(尹柱卿),조명희(曺明姬),79,111,190,0
36825,윤주경(尹柱卿),조수진(趙修眞),73,97,170,0
36826,윤주경(尹柱卿),조승래(趙承來),50,5,55,1
36827,윤주경(尹柱卿),조오섭(曺五燮),50,8,58,1
36828,윤주경(尹柱卿),조은희(趙恩禧),32,27,59,0
36829,윤주경(尹柱卿),조응천(趙應天),49,4,53,1
36830,윤주경(尹柱卿),조정식(趙正湜),49,9,58,1
36831,윤주경(尹柱卿),조정훈(趙廷訓),2,9,11,1
36832,윤주경(尹柱卿),조해진(曺海珍),66,38,104,0
36833,윤주경(尹柱卿),주철현(朱哲鉉),50,5,55,1
36834,윤주경(尹柱卿),주호영(朱豪英),64,44,108,0
36835,윤주경(尹柱卿),지성호(池成浩),74,108,182,0
36836,윤주경(尹柱卿),진선미(陳善美),49,5,54,1
36837,윤주경(尹柱卿),진성준(陳聲準),49,4,53,1
36838,윤주경(尹柱卿),천준호(千俊鎬),49,3,52,1
36839,윤주경(尹柱卿),최기상(崔基相),49,5,54,1
36840,윤주경(尹柱卿),최승재(崔承宰),88,121,209,0
36841,윤주경(尹柱卿),최연숙(崔姸淑),37,52,89,0
36842,윤주경(尹柱卿),최영희(崔英姬),28,34,62,0
36843,윤주경(尹柱卿),최인호(崔仁昊),50,10,60,1
36844,윤주경(尹柱卿),최재형(崔在亨),26,18,44,0
36845,윤주경(尹柱卿),최종윤(崔鍾允),49,5,54,1
36846,윤주경(尹柱卿),최춘식(崔春植),67,78,145,0
36847,윤주경(尹柱卿),최형두(崔炯斗),75,79,154,0
36848,윤주경(尹柱卿),최혜영(崔惠英),50,9,59,1
36849,윤주경(尹柱卿),추경호(秋慶鎬),77,88,165,0
36850,윤주경(尹柱卿),태영호(太永浩),85,124,209,0
36851,윤주경(尹柱卿),하영제(河榮帝),64,75,139,1
36852,윤주경(尹柱卿),하태경(河泰慶),63,56,119,0
36853,윤주경(尹柱卿),한기호(韓起鎬),77,73,150,0
36854,윤주경(尹柱卿),한무경(韓茂景),79,91,170,0
36855,윤주경(尹柱卿),한병도(韓秉道),50,5,55,1
36856,윤주경(尹柱卿),한정애(韓貞愛),49,4,53,1
36857,윤주경(尹柱卿),한준호(韓俊鎬),49,4,53,1
36858,윤주경(尹柱卿),허숙정(許淑湞),0,0,0,1
36859,윤주경(尹柱卿),허영(許榮),50,5,55,1
36860,윤주경(尹柱卿),허은아(許垠娥),70,68,138,0
36861,윤주경(尹柱卿),허종식(許琮植),49,14,63,1
36862,윤주경(尹柱卿),홍기원(洪起元),49,6,55,1
36863,윤주경(尹柱卿),홍문표(洪文杓),75,71,146,0
36864,윤주경(尹柱卿),홍석준(洪碩晙),62,50,112,0
36865,윤주경(尹柱卿),홍성국(洪性國),49,5,54,1
36866,윤주경(尹柱卿),홍영표(洪永杓),49,6,55,1
36867,윤주경(尹柱卿),홍익표(洪翼杓),49,7,56,1
36868,윤주경(尹柱卿),홍정민(洪貞敏),49,9,58,1
36869,윤주경(尹柱卿),황보승희(皇甫承希),70,93,163,1
36870,윤주경(尹柱卿),황운하(黃雲夏),49,7,56,1
36871,윤주경(尹柱卿),황희(黃熙),49,21,70,1
36872,윤준병(尹準炳),윤창현(尹暢賢),49,6,55,1
36873,윤준병(尹準炳),윤한홍(尹漢洪),50,5,55,1
36874,윤준병(尹準炳),윤호중(尹昊重),79,59,138,0
36875,윤준병(尹準炳),윤후덕(尹厚德),96,116,212,0
36876,윤준병(尹準炳),이개호(李介昊),108,175,283,0
36877,윤준병(尹準炳),이달곤(李達坤),52,7,59,1
36878,윤준병(尹準炳),이동주(李東洲),101,159,260,0
36879,윤준병(尹準炳),이만희(李晩熙),49,4,53,1
36880,윤준병(尹準炳),이명수(李明洙),54,39,93,1
36881,윤준병(尹準炳),이병훈(李炳勳),130,234,364,0
36882,윤준병(尹準炳),이상민(李相珉),77,45,122,0
36883,윤준병(尹準炳),이상헌(李相憲),126,220,346,0
36884,윤준병(尹準炳),이성만(李成萬),117,182,299,1
36885,윤준병(尹準炳),이소영(李素永),112,106,218,0
36886,윤준병(尹準炳),이수진(李壽珍),187,329,516,0
36887,윤준병(尹準炳),이수진(李秀眞),126,176,302,0
36888,윤준병(尹準炳),이양수(李亮壽),51,6,57,1
36889,윤준병(尹準炳),이용(李鏞),49,6,55,1
36890,윤준병(尹準炳),이용빈(李龍彬),221,456,677,0
36891,윤준병(尹準炳),이용선(李庸瑄),133,201,334,0
36892,윤준병(尹準炳),이용우(李龍雨),119,147,266,0
36893,윤준병(尹準炳),이용호(李容鎬),58,69,127,1
36894,윤준병(尹準炳),이원욱(李元旭),107,118,225,0
36895,윤준병(尹準炳),이원택(李源澤),114,188,302,0
36896,윤준병(尹準炳),이은주(李恩周),29,56,85,1
36897,윤준병(尹準炳),이인선(李仁善),25,4,29,1
36898,윤준병(尹準炳),이인영(李仁榮),78,71,149,0
36899,윤준병(尹準炳),이장섭(李將燮),105,117,222,0
36900,윤준병(尹準炳),이재명(李在明),40,25,65,0
36901,윤준병(尹準炳),이재정(李在汀),81,64,145,0
36902,윤준병(尹準炳),이정문(李楨文),108,150,258,0
36903,윤준병(尹準炳),이종배(李鍾培),50,6,56,1
36904,윤준병(尹準炳),이종성(李鍾成),49,5,54,1
36905,윤준병(尹準炳),이주환(李周桓),49,4,53,1
36906,윤준병(尹準炳),이채익(李埰益),52,8,60,1
36907,윤준병(尹準炳),이철규(李喆圭),54,6,60,1
36908,윤준병(尹準炳),이탄희(李誕熙),105,106,211,0
36909,윤준병(尹準炳),이태규(李泰珪),28,4,32,1
36910,윤준병(尹準炳),이학영(李學永),121,160,281,0
36911,윤준병(尹準炳),이해식(李海植),141,177,318,0
36912,윤준병(尹準炳),이헌승(李憲昇),51,5,56,1
36913,윤준병(尹準炳),이형석(李炯錫),114,169,283,0
36914,윤준병(尹準炳),인재근(印在謹),128,217,345,0
36915,윤준병(尹準炳),임병헌(林炳憲),26,4,30,1
36916,윤준병(尹準炳),임오경(林五卿),114,148,262,0
36917,윤준병(尹準炳),임이자(林利子),49,4,53,1
36918,윤준병(尹準炳),임종성(林鍾聲),161,235,396,0
36919,윤준병(尹準炳),임호선(林昊宣),158,252,410,0
36920,윤준병(尹準炳),장경태(張耿態),148,250,398,0
36921,윤준병(尹準炳),장동혁(張東赫),25,4,29,1
36922,윤준병(尹準炳),장제원(張濟元),49,5,54,1
36923,윤준병(尹準炳),장철민(張喆敏),139,166,305,0
36924,윤준병(尹準炳),장혜영(張惠英),13,35,48,1
36925,윤준병(尹準炳),전봉민(田奉珉),35,5,40,1
36926,윤준병(尹準炳),전용기(田溶冀),117,128,245,0
36927,윤준병(尹準炳),전재수(田載秀),102,90,192,0
36928,윤준병(尹準炳),전주혜(全珠惠),51,5,56,1
36929,윤준병(尹準炳),전해철(全海澈),81,93,174,0
36930,윤준병(尹準炳),전혜숙(全惠淑),111,143,254,0
36931,윤준병(尹準炳),정경희(丁慶姬),49,4,53,1
36932,윤준병(尹準炳),정동만(鄭東萬),49,5,54,1
36933,윤준병(尹準炳),정성호(鄭成湖),94,125,219,0
36934,윤준병(尹準炳),정우택(鄭宇澤),25,4,29,1
36935,윤준병(尹準炳),정운천(鄭雲天),51,15,66,1
36936,윤준병(尹準炳),정일영(鄭日永),123,202,325,0
36937,윤준병(尹準炳),정점식(鄭点植),50,4,54,1
36938,윤준병(尹準炳),정진석(鄭鎭碩),50,7,57,1
36939,윤준병(尹準炳),정청래(鄭淸來),87,83,170,0
36940,윤준병(尹準炳),정춘숙(鄭春淑),119,134,253,0
36941,윤준병(尹準炳),정태호(鄭泰浩),107,164,271,0
36942,윤준병(尹準炳),정필모(鄭必模),111,183,294,0
36943,윤준병(尹準炳),정희용(鄭熙溶),50,5,55,1
36944,윤준병(尹準炳),조경태(趙慶泰),50,4,54,1
36945,윤준병(尹準炳),조명희(曺明姬),49,6,55,1
36946,윤준병(尹準炳),조수진(趙修眞),49,6,55,1
36947,윤준병(尹準炳),조승래(趙承來),119,102,221,0
36948,윤준병(尹準炳),조오섭(曺五燮),140,291,431,0
36949,윤준병(尹準炳),조은희(趙恩禧),25,4,29,1
36950,윤준병(尹準炳),조응천(趙應天),84,57,141,0
36951,윤준병(尹準炳),조정식(趙正湜),80,66,146,0
36952,윤준병(尹準炳),조정훈(趙廷訓),10,14,24,1
36953,윤준병(尹準炳),조해진(曺海珍),51,5,56,1
36954,윤준병(尹準炳),주철현(朱哲鉉),131,217,348,0
36955,윤준병(尹準炳),주호영(朱豪英),49,4,53,1
36956,윤준병(尹準炳),지성호(池成浩),49,4,53,1
36957,윤준병(尹準炳),진선미(陳善美),98,72,170,0
36958,윤준병(尹準炳),진성준(陳聲準),129,188,317,0
36959,윤준병(尹準炳),천준호(千俊鎬),124,121,245,0
36960,윤준병(尹準炳),최기상(崔基相),89,89,178,0
36961,윤준병(尹準炳),최승재(崔承宰),49,13,62,1
36962,윤준병(尹準炳),최연숙(崔姸淑),38,23,61,1
36963,윤준병(尹準炳),최영희(崔英姬),25,6,31,1
36964,윤준병(尹準炳),최인호(崔仁昊),100,130,230,0
36965,윤준병(尹準炳),최재형(崔在亨),25,4,29,1
36966,윤준병(尹準炳),최종윤(崔鍾允),147,297,444,0
36967,윤준병(尹準炳),최춘식(崔春植),50,14,64,1
36968,윤준병(尹準炳),최형두(崔炯斗),53,12,65,1
36969,윤준병(尹準炳),최혜영(崔惠英),125,198,323,0
36970,윤준병(尹準炳),추경호(秋慶鎬),50,5,55,1
36971,윤준병(尹準炳),태영호(太永浩),49,6,55,1
36972,윤준병(尹準炳),하영제(河榮帝),42,5,47,1
36973,윤준병(尹準炳),하태경(河泰慶),49,6,55,1
36974,윤준병(尹準炳),한기호(韓起鎬),51,5,56,1
36975,윤준병(尹準炳),한무경(韓茂景),49,5,54,1
36976,윤준병(尹準炳),한병도(韓秉道),165,332,497,0
36977,윤준병(尹準炳),한정애(韓貞愛),82,83,165,0
36978,윤준병(尹準炳),한준호(韓俊鎬),116,156,272,0
36979,윤준병(尹準炳),허숙정(許淑湞),1,2,3,0
36980,윤준병(尹準炳),허영(許榮),150,247,397,0
36981,윤준병(尹準炳),허은아(許垠娥),49,4,53,1
36982,윤준병(尹準炳),허종식(許琮植),151,197,348,0
36983,윤준병(尹準炳),홍기원(洪起元),120,169,289,0
36984,윤준병(尹準炳),홍문표(洪文杓),55,15,70,1
36985,윤준병(尹準炳),홍석준(洪碩晙),50,4,54,1
36986,윤준병(尹準炳),홍성국(洪性國),157,254,411,0
36987,윤준병(尹準炳),홍영표(洪永杓),91,85,176,0
36988,윤준병(尹準炳),홍익표(洪翼杓),98,119,217,0
36989,윤준병(尹準炳),홍정민(洪貞敏),136,211,347,0
36990,윤준병(尹準炳),황보승희(皇甫承希),46,4,50,1
36991,윤준병(尹準炳),황운하(黃雲夏),151,243,394,0
36992,윤준병(尹準炳),황희(黃熙),79,67,146,0
36993,윤창현(尹暢賢),윤한홍(尹漢洪),102,131,233,0
36994,윤창현(尹暢賢),윤호중(尹昊重),49,4,53,1
36995,윤창현(尹暢賢),윤후덕(尹厚德),50,4,54,1
36996,윤창현(尹暢賢),이개호(李介昊),49,5,54,1
36997,윤창현(尹暢賢),이달곤(李達坤),67,64,131,0
36998,윤창현(尹暢賢),이동주(李東洲),49,5,54,1
36999,윤창현(尹暢賢),이만희(李晩熙),75,75,150,0
37000,윤창현(尹暢賢),이명수(李明洙),102,148,250,0
37001,윤창현(尹暢賢),이병훈(李炳勳),51,9,60,1
37002,윤창현(尹暢賢),이상민(李相珉),49,5,54,1
37003,윤창현(尹暢賢),이상헌(李相憲),50,8,58,1
37004,윤창현(尹暢賢),이성만(李成萬),40,3,43,1
37005,윤창현(尹暢賢),이소영(李素永),49,6,55,1
37006,윤창현(尹暢賢),이수진(李壽珍),49,5,54,1
37007,윤창현(尹暢賢),이수진(李秀眞),49,6,55,1
37008,윤창현(尹暢賢),이양수(李亮壽),99,95,194,0
37009,윤창현(尹暢賢),이용(李鏞),88,147,235,0
37010,윤창현(尹暢賢),이용빈(李龍彬),50,7,57,1
37011,윤창현(尹暢賢),이용선(李庸瑄),49,6,55,1
37012,윤창현(尹暢賢),이용우(李龍雨),50,14,64,1
37013,윤창현(尹暢賢),이용호(李容鎬),30,26,56,0
37014,윤창현(尹暢賢),이원욱(李元旭),50,5,55,1
37015,윤창현(尹暢賢),이원택(李源澤),49,5,54,1
37016,윤창현(尹暢賢),이은주(李恩周),5,3,8,1
37017,윤창현(尹暢賢),이인선(李仁善),29,45,74,0
37018,윤창현(尹暢賢),이인영(李仁榮),49,5,54,1
37019,윤창현(尹暢賢),이장섭(李將燮),49,6,55,1
37020,윤창현(尹暢賢),이재명(李在明),25,4,29,1
37021,윤창현(尹暢賢),이재정(李在汀),49,4,53,1
37022,윤창현(尹暢賢),이정문(李楨文),49,8,57,1
37023,윤창현(尹暢賢),이종배(李鍾培),125,146,271,0
37024,윤창현(尹暢賢),이종성(李鍾成),114,172,286,0
37025,윤창현(尹暢賢),이주환(李周桓),133,149,282,0
37026,윤창현(尹暢賢),이채익(李埰益),89,91,180,0
37027,윤창현(尹暢賢),이철규(李喆圭),121,114,235,0
37028,윤창현(尹暢賢),이탄희(李誕熙),49,5,54,1
37029,윤창현(尹暢賢),이태규(李泰珪),52,56,108,0
37030,윤창현(尹暢賢),이학영(李學永),49,5,54,1
37031,윤창현(尹暢賢),이해식(李海植),50,6,56,1
37032,윤창현(尹暢賢),이헌승(李憲昇),71,97,168,0
37033,윤창현(尹暢賢),이형석(李炯錫),49,4,53,1
37034,윤창현(尹暢賢),인재근(印在謹),49,7,56,1
37035,윤창현(尹暢賢),임병헌(林炳憲),35,39,74,0
37036,윤창현(尹暢賢),임오경(林五卿),49,5,54,1
37037,윤창현(尹暢賢),임이자(林利子),119,112,231,0
37038,윤창현(尹暢賢),임종성(林鍾聲),50,7,57,1
37039,윤창현(尹暢賢),임호선(林昊宣),50,6,56,1
37040,윤창현(尹暢賢),장경태(張耿態),49,6,55,1
37041,윤창현(尹暢賢),장동혁(張東赫),35,53,88,0
37042,윤창현(尹暢賢),장제원(張濟元),65,40,105,0
37043,윤창현(尹暢賢),장철민(張喆敏),49,6,55,1
37044,윤창현(尹暢賢),장혜영(張惠英),5,7,12,1
37045,윤창현(尹暢賢),전봉민(田奉珉),65,61,126,0
37046,윤창현(尹暢賢),전용기(田溶冀),49,6,55,1
37047,윤창현(尹暢賢),전재수(田載秀),49,4,53,1
37048,윤창현(尹暢賢),전주혜(全珠惠),94,142,236,0
37049,윤창현(尹暢賢),전해철(全海澈),50,4,54,1
37050,윤창현(尹暢賢),전혜숙(全惠淑),49,9,58,1
37051,윤창현(尹暢賢),정경희(丁慶姬),80,93,173,0
37052,윤창현(尹暢賢),정동만(鄭東萬),101,83,184,0
37053,윤창현(尹暢賢),정성호(鄭成湖),51,5,56,1
37054,윤창현(尹暢賢),정우택(鄭宇澤),47,87,134,0
37055,윤창현(尹暢賢),정운천(鄭雲天),127,136,263,0
37056,윤창현(尹暢賢),정일영(鄭日永),49,7,56,1
37057,윤창현(尹暢賢),정점식(鄭点植),68,60,128,0
37058,윤창현(尹暢賢),정진석(鄭鎭碩),102,113,215,0
37059,윤창현(尹暢賢),정청래(鄭淸來),51,4,55,1
37060,윤창현(尹暢賢),정춘숙(鄭春淑),49,5,54,1
37061,윤창현(尹暢賢),정태호(鄭泰浩),49,6,55,1
37062,윤창현(尹暢賢),정필모(鄭必模),49,6,55,1
37063,윤창현(尹暢賢),정희용(鄭熙溶),109,128,237,0
37064,윤창현(尹暢賢),조경태(趙慶泰),85,103,188,0
37065,윤창현(尹暢賢),조명희(曺明姬),120,178,298,0
37066,윤창현(尹暢賢),조수진(趙修眞),102,171,273,0
37067,윤창현(尹暢賢),조승래(趙承來),49,7,56,1
37068,윤창현(尹暢賢),조오섭(曺五燮),49,7,56,1
37069,윤창현(尹暢賢),조은희(趙恩禧),36,33,69,0
37070,윤창현(尹暢賢),조응천(趙應天),50,4,54,1
37071,윤창현(尹暢賢),조정식(趙正湜),49,3,52,1
37072,윤창현(尹暢賢),조정훈(趙廷訓),1,15,16,1
37073,윤창현(尹暢賢),조해진(曺海珍),72,44,116,0
37074,윤창현(尹暢賢),주철현(朱哲鉉),50,6,56,1
37075,윤창현(尹暢賢),주호영(朱豪英),65,49,114,0
37076,윤창현(尹暢賢),지성호(池成浩),134,186,320,0
37077,윤창현(尹暢賢),진선미(陳善美),49,5,54,1
37078,윤창현(尹暢賢),진성준(陳聲準),49,4,53,1
37079,윤창현(尹暢賢),천준호(千俊鎬),49,3,52,1
37080,윤창현(尹暢賢),최기상(崔基相),49,5,54,1
37081,윤창현(尹暢賢),최승재(崔承宰),117,150,267,0
37082,윤창현(尹暢賢),최연숙(崔姸淑),37,68,105,0
37083,윤창현(尹暢賢),최영희(崔英姬),31,38,69,0
37084,윤창현(尹暢賢),최인호(崔仁昊),49,5,54,1
37085,윤창현(尹暢賢),최재형(崔在亨),31,25,56,0
37086,윤창현(尹暢賢),최종윤(崔鍾允),49,5,54,1
37087,윤창현(尹暢賢),최춘식(崔春植),88,143,231,0
37088,윤창현(尹暢賢),최형두(崔炯斗),101,108,209,0
37089,윤창현(尹暢賢),최혜영(崔惠英),50,7,57,1
37090,윤창현(尹暢賢),추경호(秋慶鎬),156,219,375,0
37091,윤창현(尹暢賢),태영호(太永浩),120,216,336,0
37092,윤창현(尹暢賢),하영제(河榮帝),72,128,200,1
37093,윤창현(尹暢賢),하태경(河泰慶),63,61,124,0
37094,윤창현(尹暢賢),한기호(韓起鎬),74,68,142,0
37095,윤창현(尹暢賢),한무경(韓茂景),117,173,290,0
37096,윤창현(尹暢賢),한병도(韓秉道),50,4,54,1
37097,윤창현(尹暢賢),한정애(韓貞愛),49,6,55,1
37098,윤창현(尹暢賢),한준호(韓俊鎬),49,5,54,1
37099,윤창현(尹暢賢),허숙정(許淑湞),0,0,0,1
37100,윤창현(尹暢賢),허영(許榮),51,5,56,1
37101,윤창현(尹暢賢),허은아(許垠娥),100,106,206,0
37102,윤창현(尹暢賢),허종식(許琮植),50,10,60,1
37103,윤창현(尹暢賢),홍기원(洪起元),49,5,54,1
37104,윤창현(尹暢賢),홍문표(洪文杓),101,116,217,0
37105,윤창현(尹暢賢),홍석준(洪碩晙),86,113,199,0
37106,윤창현(尹暢賢),홍성국(洪性國),49,6,55,1
37107,윤창현(尹暢賢),홍영표(洪永杓),49,7,56,1
37108,윤창현(尹暢賢),홍익표(洪翼杓),49,5,54,1
37109,윤창현(尹暢賢),홍정민(洪貞敏),49,7,56,1
37110,윤창현(尹暢賢),황보승희(皇甫承希),82,130,212,1
37111,윤창현(尹暢賢),황운하(黃雲夏),49,8,57,1
37112,윤창현(尹暢賢),황희(黃熙),49,12,61,1
37113,윤한홍(尹漢洪),윤호중(尹昊重),50,5,55,1
37114,윤한홍(尹漢洪),윤후덕(尹厚德),50,4,54,1
37115,윤한홍(尹漢洪),이개호(李介昊),50,4,54,1
37116,윤한홍(尹漢洪),이달곤(李達坤),74,80,154,0
37117,윤한홍(尹漢洪),이동주(李東洲),49,4,53,1
37118,윤한홍(尹漢洪),이만희(李晩熙),76,61,137,0
37119,윤한홍(尹漢洪),이명수(李明洙),87,95,182,0
37120,윤한홍(尹漢洪),이병훈(李炳勳),51,7,58,1
37121,윤한홍(尹漢洪),이상민(李相珉),51,4,55,1
37122,윤한홍(尹漢洪),이상헌(李相憲),51,4,55,1
37123,윤한홍(尹漢洪),이성만(李成萬),41,0,41,1
37124,윤한홍(尹漢洪),이소영(李素永),50,4,54,1
37125,윤한홍(尹漢洪),이수진(李壽珍),50,4,54,1
37126,윤한홍(尹漢洪),이수진(李秀眞),50,5,55,1
37127,윤한홍(尹漢洪),이양수(李亮壽),68,62,130,0
37128,윤한홍(尹漢洪),이용(李鏞),87,118,205,0
37129,윤한홍(尹漢洪),이용빈(李龍彬),52,5,57,1
37130,윤한홍(尹漢洪),이용선(李庸瑄),50,4,54,1
37131,윤한홍(尹漢洪),이용우(李龍雨),50,12,62,1
37132,윤한홍(尹漢洪),이용호(李容鎬),31,17,48,0
37133,윤한홍(尹漢洪),이원욱(李元旭),51,7,58,1
37134,윤한홍(尹漢洪),이원택(李源澤),50,5,55,1
37135,윤한홍(尹漢洪),이은주(李恩周),5,2,7,1
37136,윤한홍(尹漢洪),이인선(李仁善),29,28,57,0
37137,윤한홍(尹漢洪),이인영(李仁榮),50,4,54,1
37138,윤한홍(尹漢洪),이장섭(李將燮),50,4,54,1
37139,윤한홍(尹漢洪),이재명(李在明),25,4,29,1
37140,윤한홍(尹漢洪),이재정(李在汀),50,4,54,1
37141,윤한홍(尹漢洪),이정문(李楨文),50,5,55,1
37142,윤한홍(尹漢洪),이종배(李鍾培),81,88,169,0
37143,윤한홍(尹漢洪),이종성(李鍾成),76,98,174,0
37144,윤한홍(尹漢洪),이주환(李周桓),91,107,198,0
37145,윤한홍(尹漢洪),이채익(李埰益),69,79,148,0
37146,윤한홍(尹漢洪),이철규(李喆圭),76,68,144,0
37147,윤한홍(尹漢洪),이탄희(李誕熙),50,4,54,1
37148,윤한홍(尹漢洪),이태규(李泰珪),33,44,77,0
37149,윤한홍(尹漢洪),이학영(李學永),49,5,54,1
37150,윤한홍(尹漢洪),이해식(李海植),51,4,55,1
37151,윤한홍(尹漢洪),이헌승(李憲昇),67,47,114,0
37152,윤한홍(尹漢洪),이형석(李炯錫),49,5,54,1
37153,윤한홍(尹漢洪),인재근(印在謹),49,6,55,1
37154,윤한홍(尹漢洪),임병헌(林炳憲),28,28,56,0
37155,윤한홍(尹漢洪),임오경(林五卿),50,4,54,1
37156,윤한홍(尹漢洪),임이자(林利子),75,80,155,0
37157,윤한홍(尹漢洪),임종성(林鍾聲),50,5,55,1
37158,윤한홍(尹漢洪),임호선(林昊宣),50,4,54,1
37159,윤한홍(尹漢洪),장경태(張耿態),50,4,54,1
37160,윤한홍(尹漢洪),장동혁(張東赫),30,35,65,0
37161,윤한홍(尹漢洪),장제원(張濟元),63,70,133,0
37162,윤한홍(尹漢洪),장철민(張喆敏),50,4,54,1
37163,윤한홍(尹漢洪),장혜영(張惠英),6,3,9,1
37164,윤한홍(尹漢洪),전봉민(田奉珉),46,55,101,0
37165,윤한홍(尹漢洪),전용기(田溶冀),51,4,55,1
37166,윤한홍(尹漢洪),전재수(田載秀),50,4,54,1
37167,윤한홍(尹漢洪),전주혜(全珠惠),77,88,165,0
37168,윤한홍(尹漢洪),전해철(全海澈),51,4,55,1
37169,윤한홍(尹漢洪),전혜숙(全惠淑),50,5,55,1
37170,윤한홍(尹漢洪),정경희(丁慶姬),67,71,138,0
37171,윤한홍(尹漢洪),정동만(鄭東萬),70,45,115,0
37172,윤한홍(尹漢洪),정성호(鄭成湖),51,5,56,1
37173,윤한홍(尹漢洪),정우택(鄭宇澤),29,41,70,0
37174,윤한홍(尹漢洪),정운천(鄭雲天),71,76,147,0
37175,윤한홍(尹漢洪),정일영(鄭日永),49,5,54,1
37176,윤한홍(尹漢洪),정점식(鄭点植),64,66,130,0
37177,윤한홍(尹漢洪),정진석(鄭鎭碩),67,66,133,0
37178,윤한홍(尹漢洪),정청래(鄭淸來),49,4,53,1
37179,윤한홍(尹漢洪),정춘숙(鄭春淑),50,5,55,1
37180,윤한홍(尹漢洪),정태호(鄭泰浩),50,4,54,1
37181,윤한홍(尹漢洪),정필모(鄭必模),50,4,54,1
37182,윤한홍(尹漢洪),정희용(鄭熙溶),71,81,152,0
37183,윤한홍(尹漢洪),조경태(趙慶泰),79,66,145,0
37184,윤한홍(尹漢洪),조명희(曺明姬),86,106,192,0
37185,윤한홍(尹漢洪),조수진(趙修眞),93,106,199,0
37186,윤한홍(尹漢洪),조승래(趙承來),50,4,54,1
37187,윤한홍(尹漢洪),조오섭(曺五燮),51,6,57,1
37188,윤한홍(尹漢洪),조은희(趙恩禧),27,31,58,0
37189,윤한홍(尹漢洪),조응천(趙應天),50,3,53,1
37190,윤한홍(尹漢洪),조정식(趙正湜),49,3,52,1
37191,윤한홍(尹漢洪),조정훈(趙廷訓),0,6,6,1
37192,윤한홍(尹漢洪),조해진(曺海珍),62,53,115,0
37193,윤한홍(尹漢洪),주철현(朱哲鉉),50,5,55,1
37194,윤한홍(尹漢洪),주호영(朱豪英),61,41,102,0
37195,윤한홍(尹漢洪),지성호(池成浩),78,110,188,0
37196,윤한홍(尹漢洪),진선미(陳善美),50,4,54,1
37197,윤한홍(尹漢洪),진성준(陳聲準),50,4,54,1
37198,윤한홍(尹漢洪),천준호(千俊鎬),49,3,52,1
37199,윤한홍(尹漢洪),최기상(崔基相),49,4,53,1
37200,윤한홍(尹漢洪),최승재(崔承宰),66,84,150,0
37201,윤한홍(尹漢洪),최연숙(崔姸淑),32,35,67,0
37202,윤한홍(尹漢洪),최영희(崔英姬),29,23,52,0
37203,윤한홍(尹漢洪),최인호(崔仁昊),50,4,54,1
37204,윤한홍(尹漢洪),최재형(崔在亨),29,15,44,0
37205,윤한홍(尹漢洪),최종윤(崔鍾允),50,4,54,1
37206,윤한홍(尹漢洪),최춘식(崔春植),67,66,133,0
37207,윤한홍(尹漢洪),최형두(崔炯斗),99,128,227,0
37208,윤한홍(尹漢洪),최혜영(崔惠英),50,4,54,1
37209,윤한홍(尹漢洪),추경호(秋慶鎬),115,122,237,0
37210,윤한홍(尹漢洪),태영호(太永浩),98,118,216,0
37211,윤한홍(尹漢洪),하영제(河榮帝),76,133,209,1
37212,윤한홍(尹漢洪),하태경(河泰慶),61,37,98,0
37213,윤한홍(尹漢洪),한기호(韓起鎬),75,74,149,0
37214,윤한홍(尹漢洪),한무경(韓茂景),86,115,201,0
37215,윤한홍(尹漢洪),한병도(韓秉道),49,5,54,1
37216,윤한홍(尹漢洪),한정애(韓貞愛),50,4,54,1
37217,윤한홍(尹漢洪),한준호(韓俊鎬),51,4,55,1
37218,윤한홍(尹漢洪),허숙정(許淑湞),0,0,0,1
37219,윤한홍(尹漢洪),허영(許榮),50,5,55,1
37220,윤한홍(尹漢洪),허은아(許垠娥),67,59,126,0
37221,윤한홍(尹漢洪),허종식(許琮植),52,5,57,1
37222,윤한홍(尹漢洪),홍기원(洪起元),50,4,54,1
37223,윤한홍(尹漢洪),홍문표(洪文杓),86,93,179,0
37224,윤한홍(尹漢洪),홍석준(洪碩晙),67,66,133,0
37225,윤한홍(尹漢洪),홍성국(洪性國),50,5,55,1
37226,윤한홍(尹漢洪),홍영표(洪永杓),51,5,56,1
37227,윤한홍(尹漢洪),홍익표(洪翼杓),50,4,54,1
37228,윤한홍(尹漢洪),홍정민(洪貞敏),51,4,55,1
37229,윤한홍(尹漢洪),황보승희(皇甫承希),68,85,153,1
37230,윤한홍(尹漢洪),황운하(黃雲夏),50,8,58,1
37231,윤한홍(尹漢洪),황희(黃熙),49,11,60,1
37232,윤호중(尹昊重),윤후덕(尹厚德),78,55,133,0
37233,윤호중(尹昊重),이개호(李介昊),79,53,132,0
37234,윤호중(尹昊重),이달곤(李達坤),52,5,57,1
37235,윤호중(尹昊重),이동주(李東洲),75,59,134,0
37236,윤호중(尹昊重),이만희(李晩熙),50,4,54,1
37237,윤호중(尹昊重),이명수(李明洙),50,8,58,1
37238,윤호중(尹昊重),이병훈(李炳勳),79,73,152,0
37239,윤호중(尹昊重),이상민(李相珉),74,39,113,0
37240,윤호중(尹昊重),이상헌(李相憲),80,54,134,0
37241,윤호중(尹昊重),이성만(李成萬),67,61,128,1
37242,윤호중(尹昊重),이소영(李素永),78,41,119,0
37243,윤호중(尹昊重),이수진(李壽珍),82,56,138,0
37244,윤호중(尹昊重),이수진(李秀眞),82,47,129,0
37245,윤호중(尹昊重),이양수(李亮壽),52,4,56,1
37246,윤호중(尹昊重),이용(李鏞),50,5,55,1
37247,윤호중(尹昊重),이용빈(李龍彬),83,76,159,0
37248,윤호중(尹昊重),이용선(李庸瑄),81,57,138,0
37249,윤호중(尹昊重),이용우(李龍雨),81,51,132,0
37250,윤호중(尹昊重),이용호(李容鎬),29,9,38,1
37251,윤호중(尹昊重),이원욱(李元旭),81,63,144,0
37252,윤호중(尹昊重),이원택(李源澤),77,44,121,0
37253,윤호중(尹昊重),이은주(李恩周),10,18,28,1
37254,윤호중(尹昊重),이인선(李仁善),25,4,29,1
37255,윤호중(尹昊重),이인영(李仁榮),74,40,114,0
37256,윤호중(尹昊重),이장섭(李將燮),80,60,140,0
37257,윤호중(尹昊重),이재명(李在明),39,22,61,0
37258,윤호중(尹昊重),이재정(李在汀),77,55,132,0
37259,윤호중(尹昊重),이정문(李楨文),85,77,162,0
37260,윤호중(尹昊重),이종배(李鍾培),51,7,58,1
37261,윤호중(尹昊重),이종성(李鍾成),50,4,54,1
37262,윤호중(尹昊重),이주환(李周桓),50,4,54,1
37263,윤호중(尹昊重),이채익(李埰益),51,7,58,1
37264,윤호중(尹昊重),이철규(李喆圭),52,4,56,1
37265,윤호중(尹昊重),이탄희(李誕熙),80,48,128,0
37266,윤호중(尹昊重),이태규(李泰珪),28,4,32,1
37267,윤호중(尹昊重),이학영(李學永),85,120,205,0
37268,윤호중(尹昊重),이해식(李海植),79,41,120,0
37269,윤호중(尹昊重),이헌승(李憲昇),50,4,54,1
37270,윤호중(尹昊重),이형석(李炯錫),84,67,151,0
37271,윤호중(尹昊重),인재근(印在謹),78,67,145,0
37272,윤호중(尹昊重),임병헌(林炳憲),25,4,29,1
37273,윤호중(尹昊重),임오경(林五卿),81,56,137,0
37274,윤호중(尹昊重),임이자(林利子),49,4,53,1
37275,윤호중(尹昊重),임종성(林鍾聲),85,94,179,0
37276,윤호중(尹昊重),임호선(林昊宣),87,105,192,0
37277,윤호중(尹昊重),장경태(張耿態),80,83,163,0
37278,윤호중(尹昊重),장동혁(張東赫),25,4,29,1
37279,윤호중(尹昊重),장제원(張濟元),49,4,53,1
37280,윤호중(尹昊重),장철민(張喆敏),81,53,134,0
37281,윤호중(尹昊重),장혜영(張惠英),10,8,18,1
37282,윤호중(尹昊重),전봉민(田奉珉),35,5,40,1
37283,윤호중(尹昊重),전용기(田溶冀),78,61,139,0
37284,윤호중(尹昊重),전재수(田載秀),79,40,119,0
37285,윤호중(尹昊重),전주혜(全珠惠),52,4,56,1
37286,윤호중(尹昊重),전해철(全海澈),76,52,128,0
37287,윤호중(尹昊重),전혜숙(全惠淑),78,61,139,0
37288,윤호중(尹昊重),정경희(丁慶姬),50,4,54,1
37289,윤호중(尹昊重),정동만(鄭東萬),49,4,53,1
37290,윤호중(尹昊重),정성호(鄭成湖),76,64,140,0
37291,윤호중(尹昊重),정우택(鄭宇澤),26,5,31,1
37292,윤호중(尹昊重),정운천(鄭雲天),50,5,55,1
37293,윤호중(尹昊重),정일영(鄭日永),77,73,150,0
37294,윤호중(尹昊重),정점식(鄭点植),50,4,54,1
37295,윤호중(尹昊重),정진석(鄭鎭碩),50,5,55,1
37296,윤호중(尹昊重),정청래(鄭淸來),78,42,120,0
37297,윤호중(尹昊重),정춘숙(鄭春淑),81,55,136,0
37298,윤호중(尹昊重),정태호(鄭泰浩),79,52,131,0
37299,윤호중(尹昊重),정필모(鄭必模),88,60,148,0
37300,윤호중(尹昊重),정희용(鄭熙溶),50,5,55,1
37301,윤호중(尹昊重),조경태(趙慶泰),50,5,55,1
37302,윤호중(尹昊重),조명희(曺明姬),50,6,56,1
37303,윤호중(尹昊重),조수진(趙修眞),50,4,54,1
37304,윤호중(尹昊重),조승래(趙承來),83,77,160,0
37305,윤호중(尹昊重),조오섭(曺五燮),80,88,168,0
37306,윤호중(尹昊重),조은희(趙恩禧),26,4,30,1
37307,윤호중(尹昊重),조응천(趙應天),74,51,125,0
37308,윤호중(尹昊重),조정식(趙正湜),74,52,126,0
37309,윤호중(尹昊重),조정훈(趙廷訓),1,7,8,1
37310,윤호중(尹昊重),조해진(曺海珍),52,5,57,1
37311,윤호중(尹昊重),주철현(朱哲鉉),78,50,128,0
37312,윤호중(尹昊重),주호영(朱豪英),49,4,53,1
37313,윤호중(尹昊重),지성호(池成浩),50,4,54,1
37314,윤호중(尹昊重),진선미(陳善美),77,42,119,0
37315,윤호중(尹昊重),진성준(陳聲準),80,55,135,0
37316,윤호중(尹昊重),천준호(千俊鎬),79,52,131,0
37317,윤호중(尹昊重),최기상(崔基相),78,50,128,0
37318,윤호중(尹昊重),최승재(崔承宰),50,4,54,1
37319,윤호중(尹昊重),최연숙(崔姸淑),31,10,41,1
37320,윤호중(尹昊重),최영희(崔英姬),25,6,31,1
37321,윤호중(尹昊重),최인호(崔仁昊),81,77,158,0
37322,윤호중(尹昊重),최재형(崔在亨),25,5,30,1
37323,윤호중(尹昊重),최종윤(崔鍾允),88,70,158,0
37324,윤호중(尹昊重),최춘식(崔春植),49,5,54,1
37325,윤호중(尹昊重),최형두(崔炯斗),50,4,54,1
37326,윤호중(尹昊重),최혜영(崔惠英),79,76,155,0
37327,윤호중(尹昊重),추경호(秋慶鎬),49,4,53,1
37328,윤호중(尹昊重),태영호(太永浩),49,4,53,1
37329,윤호중(尹昊重),하영제(河榮帝),42,2,44,1
37330,윤호중(尹昊重),하태경(河泰慶),49,4,53,1
37331,윤호중(尹昊重),한기호(韓起鎬),51,4,55,1
37332,윤호중(尹昊重),한무경(韓茂景),49,4,53,1
37333,윤호중(尹昊重),한병도(韓秉道),81,61,142,0
37334,윤호중(尹昊重),한정애(韓貞愛),75,71,146,0
37335,윤호중(尹昊重),한준호(韓俊鎬),85,100,185,0
37336,윤호중(尹昊重),허숙정(許淑湞),1,1,2,0
37337,윤호중(尹昊重),허영(許榮),87,75,162,0
37338,윤호중(尹昊重),허은아(許垠娥),49,5,54,1
37339,윤호중(尹昊重),허종식(許琮植),80,60,140,0
37340,윤호중(尹昊重),홍기원(洪起元),83,64,147,0
37341,윤호중(尹昊重),홍문표(洪文杓),50,5,55,1
37342,윤호중(尹昊重),홍석준(洪碩晙),50,4,54,1
37343,윤호중(尹昊重),홍성국(洪性國),84,66,150,0
37344,윤호중(尹昊重),홍영표(洪永杓),79,50,129,0
37345,윤호중(尹昊重),홍익표(洪翼杓),80,67,147,0
37346,윤호중(尹昊重),홍정민(洪貞敏),82,59,141,0
37347,윤호중(尹昊重),황보승희(皇甫承希),46,2,48,1
37348,윤호중(尹昊重),황운하(黃雲夏),80,77,157,0
37349,윤호중(尹昊重),황희(黃熙),74,44,118,0
37350,윤후덕(尹厚德),이개호(李介昊),94,85,179,0
37351,윤후덕(尹厚德),이달곤(李達坤),51,6,57,1
37352,윤후덕(尹厚德),이동주(李東洲),96,195,291,0
37353,윤후덕(尹厚德),이만희(李晩熙),49,5,54,1
37354,윤후덕(尹厚德),이명수(李明洙),50,12,62,1
37355,윤후덕(尹厚德),이병훈(李炳勳),117,144,261,0
37356,윤후덕(尹厚德),이상민(李相珉),74,34,108,0
37357,윤후덕(尹厚德),이상헌(李相憲),92,93,185,0
37358,윤후덕(尹厚德),이성만(李成萬),85,90,175,1
37359,윤후덕(尹厚德),이소영(李素永),83,61,144,0
37360,윤후덕(尹厚德),이수진(李壽珍),97,111,208,0
37361,윤후덕(尹厚德),이수진(李秀眞),115,94,209,0
37362,윤후덕(尹厚德),이양수(李亮壽),52,5,57,1
37363,윤후덕(尹厚德),이용(李鏞),49,4,53,1
37364,윤후덕(尹厚德),이용빈(李龍彬),105,128,233,0
37365,윤후덕(尹厚德),이용선(李庸瑄),92,80,172,0
37366,윤후덕(尹厚德),이용우(李龍雨),92,68,160,0
37367,윤후덕(尹厚德),이용호(李容鎬),32,14,46,1
37368,윤후덕(尹厚德),이원욱(李元旭),119,147,266,0
37369,윤후덕(尹厚德),이원택(李源澤),77,52,129,0
37370,윤후덕(尹厚德),이은주(李恩周),19,35,54,1
37371,윤후덕(尹厚德),이인선(李仁善),25,5,30,1
37372,윤후덕(尹厚德),이인영(李仁榮),77,38,115,0
37373,윤후덕(尹厚德),이장섭(李將燮),86,58,144,0
37374,윤후덕(尹厚德),이재명(李在明),39,25,64,0
37375,윤후덕(尹厚德),이재정(李在汀),78,50,128,0
37376,윤후덕(尹厚德),이정문(李楨文),125,152,277,0
37377,윤후덕(尹厚德),이종배(李鍾培),50,5,55,1
37378,윤후덕(尹厚德),이종성(李鍾成),49,5,54,1
37379,윤후덕(尹厚德),이주환(李周桓),50,6,56,1
37380,윤후덕(尹厚德),이채익(李埰益),52,5,57,1
37381,윤후덕(尹厚德),이철규(李喆圭),51,5,56,1
37382,윤후덕(尹厚德),이탄희(李誕熙),96,68,164,0
37383,윤후덕(尹厚德),이태규(李泰珪),29,6,35,1
37384,윤후덕(尹厚德),이학영(李學永),88,80,168,0
37385,윤후덕(尹厚德),이해식(李海植),100,71,171,0
37386,윤후덕(尹厚德),이헌승(李憲昇),51,6,57,1
37387,윤후덕(尹厚德),이형석(李炯錫),109,112,221,0
37388,윤후덕(尹厚德),인재근(印在謹),81,64,145,0
37389,윤후덕(尹厚德),임병헌(林炳憲),26,4,30,1
37390,윤후덕(尹厚德),임오경(林五卿),120,101,221,0
37391,윤후덕(尹厚德),임이자(林利子),49,4,53,1
37392,윤후덕(尹厚德),임종성(林鍾聲),151,208,359,0
37393,윤후덕(尹厚德),임호선(林昊宣),100,88,188,0
37394,윤후덕(尹厚德),장경태(張耿態),100,100,200,0
37395,윤후덕(尹厚德),장동혁(張東赫),25,4,29,1
37396,윤후덕(尹厚德),장제원(張濟元),49,4,53,1
37397,윤후덕(尹厚德),장철민(張喆敏),113,98,211,0
37398,윤후덕(尹厚德),장혜영(張惠英),21,27,48,1
37399,윤후덕(尹厚德),전봉민(田奉珉),36,5,41,1
37400,윤후덕(尹厚德),전용기(田溶冀),132,114,246,0
37401,윤후덕(尹厚德),전재수(田載秀),86,74,160,0
37402,윤후덕(尹厚德),전주혜(全珠惠),51,4,55,1
37403,윤후덕(尹厚德),전해철(全海澈),76,62,138,0
37404,윤후덕(尹厚德),전혜숙(全惠淑),99,112,211,0
37405,윤후덕(尹厚德),정경희(丁慶姬),49,5,54,1
37406,윤후덕(尹厚德),정동만(鄭東萬),50,4,54,1
37407,윤후덕(尹厚德),정성호(鄭成湖),118,230,348,0
37408,윤후덕(尹厚德),정우택(鄭宇澤),25,5,30,1
37409,윤후덕(尹厚德),정운천(鄭雲天),49,6,55,1
37410,윤후덕(尹厚德),정일영(鄭日永),113,92,205,0
37411,윤후덕(尹厚德),정점식(鄭点植),50,5,55,1
37412,윤후덕(尹厚德),정진석(鄭鎭碩),50,7,57,1
37413,윤후덕(尹厚德),정청래(鄭淸來),92,61,153,0
37414,윤후덕(尹厚德),정춘숙(鄭春淑),131,199,330,0
37415,윤후덕(尹厚德),정태호(鄭泰浩),81,62,143,0
37416,윤후덕(尹厚德),정필모(鄭必模),88,62,150,0
37417,윤후덕(尹厚德),정희용(鄭熙溶),50,5,55,1
37418,윤후덕(尹厚德),조경태(趙慶泰),49,4,53,1
37419,윤후덕(尹厚德),조명희(曺明姬),49,6,55,1
37420,윤후덕(尹厚德),조수진(趙修眞),49,5,54,1
37421,윤후덕(尹厚德),조승래(趙承來),86,62,148,0
37422,윤후덕(尹厚德),조오섭(曺五燮),96,157,253,0
37423,윤후덕(尹厚德),조은희(趙恩禧),26,4,30,1
37424,윤후덕(尹厚德),조응천(趙應天),80,37,117,0
37425,윤후덕(尹厚德),조정식(趙正湜),83,56,139,0
37426,윤후덕(尹厚德),조정훈(趙廷訓),4,9,13,1
37427,윤후덕(尹厚德),조해진(曺海珍),51,6,57,1
37428,윤후덕(尹厚德),주철현(朱哲鉉),96,92,188,0
37429,윤후덕(尹厚德),주호영(朱豪英),49,4,53,1
37430,윤후덕(尹厚德),지성호(池成浩),49,5,54,1
37431,윤후덕(尹厚德),진선미(陳善美),83,67,150,0
37432,윤후덕(尹厚德),진성준(陳聲準),104,94,198,0
37433,윤후덕(尹厚德),천준호(千俊鎬),90,62,152,0
37434,윤후덕(尹厚德),최기상(崔基相),88,79,167,0
37435,윤후덕(尹厚德),최승재(崔承宰),49,4,53,1
37436,윤후덕(尹厚德),최연숙(崔姸淑),29,14,43,1
37437,윤후덕(尹厚德),최영희(崔英姬),25,5,30,1
37438,윤후덕(尹厚德),최인호(崔仁昊),105,95,200,0
37439,윤후덕(尹厚德),최재형(崔在亨),25,5,30,1
37440,윤후덕(尹厚德),최종윤(崔鍾允),100,123,223,0
37441,윤후덕(尹厚德),최춘식(崔春植),49,9,58,1
37442,윤후덕(尹厚德),최형두(崔炯斗),50,6,56,1
37443,윤후덕(尹厚德),최혜영(崔惠英),89,70,159,0
37444,윤후덕(尹厚德),추경호(秋慶鎬),49,4,53,1
37445,윤후덕(尹厚德),태영호(太永浩),49,6,55,1
37446,윤후덕(尹厚德),하영제(河榮帝),41,1,42,1
37447,윤후덕(尹厚德),하태경(河泰慶),50,5,55,1
37448,윤후덕(尹厚德),한기호(韓起鎬),52,10,62,1
37449,윤후덕(尹厚德),한무경(韓茂景),50,4,54,1
37450,윤후덕(尹厚德),한병도(韓秉道),105,72,177,0
37451,윤후덕(尹厚德),한정애(韓貞愛),82,67,149,0
37452,윤후덕(尹厚德),한준호(韓俊鎬),92,106,198,0
37453,윤후덕(尹厚德),허숙정(許淑湞),1,3,4,0
37454,윤후덕(尹厚德),허영(許榮),131,154,285,0
37455,윤후덕(尹厚德),허은아(許垠娥),49,5,54,1
37456,윤후덕(尹厚德),허종식(許琮植),115,170,285,0
37457,윤후덕(尹厚德),홍기원(洪起元),96,154,250,0
37458,윤후덕(尹厚德),홍문표(洪文杓),50,5,55,1
37459,윤후덕(尹厚德),홍석준(洪碩晙),50,4,54,1
37460,윤후덕(尹厚德),홍성국(洪性國),98,103,201,0
37461,윤후덕(尹厚德),홍영표(洪永杓),84,55,139,0
37462,윤후덕(尹厚德),홍익표(洪翼杓),91,81,172,0
37463,윤후덕(尹厚德),홍정민(洪貞敏),93,101,194,0
37464,윤후덕(尹厚德),황보승희(皇甫承希),46,2,48,1
37465,윤후덕(尹厚德),황운하(黃雲夏),94,88,182,0
37466,윤후덕(尹厚德),황희(黃熙),79,67,146,0
37467,이개호(李介昊),이달곤(李達坤),53,7,60,1
37468,이개호(李介昊),이동주(李東洲),95,89,184,0
37469,이개호(李介昊),이만희(李晩熙),56,4,60,1
37470,이개호(李介昊),이명수(李明洙),50,6,56,1
37471,이개호(李介昊),이병훈(李炳勳),111,228,339,0
37472,이개호(李介昊),이상민(李相珉),83,32,115,0
37473,이개호(李介昊),이상헌(李相憲),97,132,229,0
37474,이개호(李介昊),이성만(李成萬),87,84,171,1
37475,이개호(李介昊),이소영(李素永),80,50,130,0
37476,이개호(李介昊),이수진(李壽珍),98,80,178,0
37477,이개호(李介昊),이수진(李秀眞),90,72,162,0
37478,이개호(李介昊),이양수(李亮壽),57,4,61,1
37479,이개호(李介昊),이용(李鏞),50,6,56,1
37480,이개호(李介昊),이용빈(李龍彬),130,134,264,0
37481,이개호(李介昊),이용선(李庸瑄),104,87,191,0
37482,이개호(李介昊),이용우(李龍雨),94,71,165,0
37483,이개호(李介昊),이용호(李容鎬),34,11,45,1
37484,이개호(李介昊),이원욱(李元旭),96,72,168,0
37485,이개호(李介昊),이원택(李源澤),106,118,224,0
37486,이개호(李介昊),이은주(李恩周),18,19,37,1
37487,이개호(李介昊),이인선(李仁善),25,5,30,1
37488,이개호(李介昊),이인영(李仁榮),75,45,120,0
37489,이개호(李介昊),이장섭(李將燮),104,110,214,0
37490,이개호(李介昊),이재명(李在明),41,19,60,0
37491,이개호(李介昊),이재정(李在汀),80,35,115,0
37492,이개호(李介昊),이정문(李楨文),91,57,148,0
37493,이개호(李介昊),이종배(李鍾培),52,5,57,1
37494,이개호(李介昊),이종성(李鍾成),50,4,54,1
37495,이개호(李介昊),이주환(李周桓),50,4,54,1
37496,이개호(李介昊),이채익(李埰益),51,5,56,1
37497,이개호(李介昊),이철규(李喆圭),52,7,59,1
37498,이개호(李介昊),이탄희(李誕熙),85,49,134,0
37499,이개호(李介昊),이태규(李泰珪),30,5,35,1
37500,이개호(李介昊),이학영(李學永),94,96,190,0
37501,이개호(李介昊),이해식(李海植),98,79,177,0
37502,이개호(李介昊),이헌승(李憲昇),56,5,61,1
37503,이개호(李介昊),이형석(李炯錫),107,78,185,0
37504,이개호(李介昊),인재근(印在謹),113,86,199,0
37505,이개호(李介昊),임병헌(林炳憲),25,4,29,1
37506,이개호(李介昊),임오경(林五卿),93,86,179,0
37507,이개호(李介昊),임이자(林利子),49,4,53,1
37508,이개호(李介昊),임종성(林鍾聲),101,80,181,0
37509,이개호(李介昊),임호선(林昊宣),105,148,253,0
37510,이개호(李介昊),장경태(張耿態),94,109,203,0
37511,이개호(李介昊),장동혁(張東赫),25,4,29,1
37512,이개호(李介昊),장제원(張濟元),50,5,55,1
37513,이개호(李介昊),장철민(張喆敏),84,82,166,0
37514,이개호(李介昊),장혜영(張惠英),11,12,23,1
37515,이개호(李介昊),전봉민(田奉珉),35,5,40,1
37516,이개호(李介昊),전용기(田溶冀),119,96,215,0
37517,이개호(李介昊),전재수(田載秀),79,71,150,0
37518,이개호(李介昊),전주혜(全珠惠),52,4,56,1
37519,이개호(李介昊),전해철(全海澈),78,45,123,0
37520,이개호(李介昊),전혜숙(全惠淑),93,79,172,0
37521,이개호(李介昊),정경희(丁慶姬),50,4,54,1
37522,이개호(李介昊),정동만(鄭東萬),49,5,54,1
37523,이개호(李介昊),정성호(鄭成湖),86,79,165,0
37524,이개호(李介昊),정우택(鄭宇澤),27,5,32,1
37525,이개호(李介昊),정운천(鄭雲天),58,9,67,1
37526,이개호(李介昊),정일영(鄭日永),96,93,189,0
37527,이개호(李介昊),정점식(鄭点植),50,6,56,1
37528,이개호(李介昊),정진석(鄭鎭碩),50,5,55,1
37529,이개호(李介昊),정청래(鄭淸來),86,55,141,0
37530,이개호(李介昊),정춘숙(鄭春淑),91,72,163,0
37531,이개호(李介昊),정태호(鄭泰浩),82,117,199,0
37532,이개호(李介昊),정필모(鄭必模),85,57,142,0
37533,이개호(李介昊),정희용(鄭熙溶),55,5,60,1
37534,이개호(李介昊),조경태(趙慶泰),55,13,68,1
37535,이개호(李介昊),조명희(曺明姬),50,7,57,1
37536,이개호(李介昊),조수진(趙修眞),54,4,58,1
37537,이개호(李介昊),조승래(趙承來),85,57,142,0
37538,이개호(李介昊),조오섭(曺五燮),108,176,284,0
37539,이개호(李介昊),조은희(趙恩禧),26,4,30,1
37540,이개호(李介昊),조응천(趙應天),73,36,109,0
37541,이개호(李介昊),조정식(趙正湜),79,50,129,0
37542,이개호(李介昊),조정훈(趙廷訓),3,7,10,1
37543,이개호(李介昊),조해진(曺海珍),51,5,56,1
37544,이개호(李介昊),주철현(朱哲鉉),137,208,345,0
37545,이개호(李介昊),주호영(朱豪英),49,4,53,1
37546,이개호(李介昊),지성호(池成浩),50,4,54,1
37547,이개호(李介昊),진선미(陳善美),77,45,122,0
37548,이개호(李介昊),진성준(陳聲準),86,83,169,0
37549,이개호(李介昊),천준호(千俊鎬),85,58,143,0
37550,이개호(李介昊),최기상(崔基相),84,54,138,0
37551,이개호(李介昊),최승재(崔承宰),50,6,56,1
37552,이개호(李介昊),최연숙(崔姸淑),30,9,39,1
37553,이개호(李介昊),최영희(崔英姬),25,6,31,1
37554,이개호(李介昊),최인호(崔仁昊),110,102,212,0
37555,이개호(李介昊),최재형(崔在亨),25,5,30,1
37556,이개호(李介昊),최종윤(崔鍾允),96,83,179,0
37557,이개호(李介昊),최춘식(崔春植),50,5,55,1
37558,이개호(李介昊),최형두(崔炯斗),53,11,64,1
37559,이개호(李介昊),최혜영(崔惠英),81,80,161,0
37560,이개호(李介昊),추경호(秋慶鎬),54,3,57,1
37561,이개호(李介昊),태영호(太永浩),49,5,54,1
37562,이개호(李介昊),하영제(河榮帝),43,7,50,1
37563,이개호(李介昊),하태경(河泰慶),50,5,55,1
37564,이개호(李介昊),한기호(韓起鎬),51,7,58,1
37565,이개호(李介昊),한무경(韓茂景),49,4,53,1
37566,이개호(李介昊),한병도(韓秉道),96,101,197,0
37567,이개호(李介昊),한정애(韓貞愛),77,47,124,0
37568,이개호(李介昊),한준호(韓俊鎬),91,93,184,0
37569,이개호(李介昊),허숙정(許淑湞),1,2,3,0
37570,이개호(李介昊),허영(許榮),115,165,280,0
37571,이개호(李介昊),허은아(許垠娥),49,4,53,1
37572,이개호(李介昊),허종식(許琮植),95,111,206,0
37573,이개호(李介昊),홍기원(洪起元),94,82,176,0
37574,이개호(李介昊),홍문표(洪文杓),80,53,133,1
37575,이개호(李介昊),홍석준(洪碩晙),50,5,55,1
37576,이개호(李介昊),홍성국(洪性國),129,137,266,0
37577,이개호(李介昊),홍영표(洪永杓),82,50,132,0
37578,이개호(李介昊),홍익표(洪翼杓),87,94,181,0
37579,이개호(李介昊),홍정민(洪貞敏),95,77,172,0
37580,이개호(李介昊),황보승희(皇甫承希),47,2,49,1
37581,이개호(李介昊),황운하(黃雲夏),90,84,174,0
37582,이개호(李介昊),황희(黃熙),83,60,143,0
37583,이달곤(李達坤),이동주(李東洲),51,5,56,1
37584,이달곤(李達坤),이만희(李晩熙),65,65,130,0
37585,이달곤(李達坤),이명수(李明洙),71,111,182,0
37586,이달곤(李達坤),이병훈(李炳勳),54,6,60,1
37587,이달곤(李達坤),이상민(李相珉),51,5,56,1
37588,이달곤(李達坤),이상헌(李相憲),53,8,61,1
37589,이달곤(李達坤),이성만(李成萬),43,2,45,1
37590,이달곤(李達坤),이소영(李素永),51,6,57,1
37591,이달곤(李達坤),이수진(李壽珍),52,6,58,1
37592,이달곤(李達坤),이수진(李秀眞),52,5,57,1
37593,이달곤(李達坤),이양수(李亮壽),69,67,136,0
37594,이달곤(李達坤),이용(李鏞),65,65,130,0
37595,이달곤(李達坤),이용빈(李龍彬),52,8,60,1
37596,이달곤(李達坤),이용선(李庸瑄),52,5,57,1
37597,이달곤(李達坤),이용우(李龍雨),52,8,60,1
37598,이달곤(李達坤),이용호(李容鎬),30,18,48,0
37599,이달곤(李達坤),이원욱(李元旭),51,7,58,1
37600,이달곤(李達坤),이원택(李源澤),52,4,56,1
37601,이달곤(李達坤),이은주(李恩周),6,5,11,1
37602,이달곤(李達坤),이인선(李仁善),26,20,46,0
37603,이달곤(李達坤),이인영(李仁榮),51,6,57,1
37604,이달곤(李達坤),이장섭(李將燮),53,5,58,1
37605,이달곤(李達坤),이재명(李在明),26,6,32,1
37606,이달곤(李達坤),이재정(李在汀),52,6,58,1
37607,이달곤(李達坤),이정문(李楨文),50,5,55,1
37608,이달곤(李達坤),이종배(李鍾培),69,54,123,0
37609,이달곤(李達坤),이종성(李鍾成),67,89,156,0
37610,이달곤(李達坤),이주환(李周桓),72,71,143,0
37611,이달곤(李達坤),이채익(李埰益),75,74,149,0
37612,이달곤(李達坤),이철규(李喆圭),66,45,111,0
37613,이달곤(李達坤),이탄희(李誕熙),52,5,57,1
37614,이달곤(李達坤),이태규(李泰珪),34,35,69,0
37615,이달곤(李達坤),이학영(李學永),51,5,56,1
37616,이달곤(李達坤),이해식(李海植),52,7,59,1
37617,이달곤(李達坤),이헌승(李憲昇),61,67,128,0
37618,이달곤(李達坤),이형석(李炯錫),51,5,56,1
37619,이달곤(李達坤),인재근(印在謹),51,7,58,1
37620,이달곤(李達坤),임병헌(林炳憲),26,41,67,0
37621,이달곤(李達坤),임오경(林五卿),51,5,56,1
37622,이달곤(李達坤),임이자(林利子),68,53,121,0
37623,이달곤(李達坤),임종성(林鍾聲),53,6,59,1
37624,이달곤(李達坤),임호선(林昊宣),52,7,59,1
37625,이달곤(李達坤),장경태(張耿態),51,6,57,1
37626,이달곤(李達坤),장동혁(張東赫),26,18,44,0
37627,이달곤(李達坤),장제원(張濟元),60,34,94,0
37628,이달곤(李達坤),장철민(張喆敏),51,5,56,1
37629,이달곤(李達坤),장혜영(張惠英),6,2,8,1
37630,이달곤(李達坤),전봉민(田奉珉),47,43,90,0
37631,이달곤(李達坤),전용기(田溶冀),51,5,56,1
37632,이달곤(李達坤),전재수(田載秀),51,5,56,1
37633,이달곤(李達坤),전주혜(全珠惠),66,60,126,0
37634,이달곤(李達坤),전해철(全海澈),52,6,58,1
37635,이달곤(李達坤),전혜숙(全惠淑),52,6,58,1
37636,이달곤(李達坤),정경희(丁慶姬),63,66,129,0
37637,이달곤(李達坤),정동만(鄭東萬),63,52,115,0
37638,이달곤(李達坤),정성호(鄭成湖),51,5,56,1
37639,이달곤(李達坤),정우택(鄭宇澤),25,26,51,0
37640,이달곤(李達坤),정운천(鄭雲天),64,58,122,0
37641,이달곤(李達坤),정일영(鄭日永),50,5,55,1
37642,이달곤(李達坤),정점식(鄭点植),72,56,128,0
37643,이달곤(李達坤),정진석(鄭鎭碩),64,56,120,0
37644,이달곤(李達坤),정청래(鄭淸來),50,5,55,1
37645,이달곤(李達坤),정춘숙(鄭春淑),52,7,59,1
37646,이달곤(李達坤),정태호(鄭泰浩),51,8,59,1
37647,이달곤(李達坤),정필모(鄭必模),52,5,57,1
37648,이달곤(李達坤),정희용(鄭熙溶),67,56,123,0
37649,이달곤(李達坤),조경태(趙慶泰),69,65,134,0
37650,이달곤(李達坤),조명희(曺明姬),65,114,179,0
37651,이달곤(李達坤),조수진(趙修眞),74,70,144,0
37652,이달곤(李達坤),조승래(趙承來),52,6,58,1
37653,이달곤(李達坤),조오섭(曺五燮),51,7,58,1
37654,이달곤(李達坤),조은희(趙恩禧),26,34,60,0
37655,이달곤(李達坤),조응천(趙應天),50,3,53,1
37656,이달곤(李達坤),조정식(趙正湜),50,4,54,1
37657,이달곤(李達坤),조정훈(趙廷訓),0,1,1,1
37658,이달곤(李達坤),조해진(曺海珍),65,54,119,0
37659,이달곤(李達坤),주철현(朱哲鉉),53,8,61,1
37660,이달곤(李達坤),주호영(朱豪英),58,35,93,0
37661,이달곤(李達坤),지성호(池成浩),61,72,133,0
37662,이달곤(李達坤),진선미(陳善美),51,5,56,1
37663,이달곤(李達坤),진성준(陳聲準),52,5,57,1
37664,이달곤(李達坤),천준호(千俊鎬),51,5,56,1
37665,이달곤(李達坤),최기상(崔基相),51,5,56,1
37666,이달곤(李達坤),최승재(崔承宰),62,57,119,0
37667,이달곤(李達坤),최연숙(崔姸淑),36,28,64,0
37668,이달곤(李達坤),최영희(崔英姬),27,30,57,0
37669,이달곤(李達坤),최인호(崔仁昊),52,6,58,1
37670,이달곤(李達坤),최재형(崔在亨),25,13,38,0
37671,이달곤(李達坤),최종윤(崔鍾允),51,9,60,1
37672,이달곤(李達坤),최춘식(崔春植),70,74,144,0
37673,이달곤(李達坤),최형두(崔炯斗),74,93,167,0
37674,이달곤(李達坤),최혜영(崔惠英),51,6,57,1
37675,이달곤(李達坤),추경호(秋慶鎬),65,76,141,0
37676,이달곤(李達坤),태영호(太永浩),63,87,150,0
37677,이달곤(李達坤),하영제(河榮帝),70,108,178,1
37678,이달곤(李達坤),하태경(河泰慶),60,39,99,0
37679,이달곤(李達坤),한기호(韓起鎬),60,56,116,0
37680,이달곤(李達坤),한무경(韓茂景),65,89,154,0
37681,이달곤(李達坤),한병도(韓秉道),51,7,58,1
37682,이달곤(李達坤),한정애(韓貞愛),51,5,56,1
37683,이달곤(李達坤),한준호(韓俊鎬),52,7,59,1
37684,이달곤(李達坤),허숙정(許淑湞),0,0,0,1
37685,이달곤(李達坤),허영(許榮),52,6,58,1
37686,이달곤(李達坤),허은아(許垠娥),61,42,103,0
37687,이달곤(李達坤),허종식(許琮植),51,8,59,1
37688,이달곤(李達坤),홍기원(洪起元),52,6,58,1
37689,이달곤(李達坤),홍문표(洪文杓),70,52,122,0
37690,이달곤(李達坤),홍석준(洪碩晙),63,57,120,0
37691,이달곤(李達坤),홍성국(洪性國),52,6,58,1
37692,이달곤(李達坤),홍영표(洪永杓),52,5,57,1
37693,이달곤(李達坤),홍익표(洪翼杓),51,5,56,1
37694,이달곤(李達坤),홍정민(洪貞敏),54,7,61,1
37695,이달곤(李達坤),황보승희(皇甫承希),63,62,125,1
37696,이달곤(李達坤),황운하(黃雲夏),51,6,57,1
37697,이달곤(李達坤),황희(黃熙),50,6,56,1
37698,이동주(李東洲),이만희(李晩熙),49,4,53,1
37699,이동주(李東洲),이명수(李明洙),49,9,58,1
37700,이동주(李東洲),이병훈(李炳勳),99,142,241,0
37701,이동주(李東洲),이상민(李相珉),76,34,110,0
37702,이동주(李東洲),이상헌(李相憲),90,85,175,0
37703,이동주(李東洲),이성만(李成萬),107,177,284,1
37704,이동주(李東洲),이소영(李素永),90,86,176,0
37705,이동주(李東洲),이수진(李壽珍),107,200,307,0
37706,이동주(李東洲),이수진(李秀眞),100,141,241,0
37707,이동주(李東洲),이양수(李亮壽),49,6,55,1
37708,이동주(李東洲),이용(李鏞),49,4,53,1
37709,이동주(李東洲),이용빈(李龍彬),122,232,354,0
37710,이동주(李東洲),이용선(李庸瑄),99,119,218,0
37711,이동주(李東洲),이용우(李龍雨),99,100,199,0
37712,이동주(李東洲),이용호(李容鎬),30,15,45,1
37713,이동주(李東洲),이원욱(李元旭),92,121,213,0
37714,이동주(李東洲),이원택(李源澤),105,70,175,0
37715,이동주(李東洲),이은주(李恩周),28,38,66,1
37716,이동주(李東洲),이인선(李仁善),25,4,29,1
37717,이동주(李東洲),이인영(李仁榮),79,46,125,0
37718,이동주(李東洲),이장섭(李將燮),114,118,232,0
37719,이동주(李東洲),이재명(李在明),40,24,64,0
37720,이동주(李東洲),이재정(李在汀),82,76,158,0
37721,이동주(李東洲),이정문(李楨文),107,171,278,0
37722,이동주(李東洲),이종배(李鍾培),50,6,56,1
37723,이동주(李東洲),이종성(李鍾成),49,4,53,1
37724,이동주(李東洲),이주환(李周桓),49,5,54,1
37725,이동주(李東洲),이채익(李埰益),50,5,55,1
37726,이동주(李東洲),이철규(李喆圭),49,7,56,1
37727,이동주(李東洲),이탄희(李誕熙),93,91,184,0
37728,이동주(李東洲),이태규(李泰珪),28,5,33,1
37729,이동주(李東洲),이학영(李學永),119,225,344,0
37730,이동주(李東洲),이해식(李海植),107,129,236,0
37731,이동주(李東洲),이헌승(李憲昇),50,5,55,1
37732,이동주(李東洲),이형석(李炯錫),99,143,242,0
37733,이동주(李東洲),인재근(印在謹),115,135,250,0
37734,이동주(李東洲),임병헌(林炳憲),25,4,29,1
37735,이동주(李東洲),임오경(林五卿),102,142,244,0
37736,이동주(李東洲),임이자(林利子),49,4,53,1
37737,이동주(李東洲),임종성(林鍾聲),110,171,281,0
37738,이동주(李東洲),임호선(林昊宣),110,220,330,0
37739,이동주(李東洲),장경태(張耿態),101,131,232,0
37740,이동주(李東洲),장동혁(張東赫),25,4,29,1
37741,이동주(李東洲),장제원(張濟元),49,4,53,1
37742,이동주(李東洲),장철민(張喆敏),101,147,248,0
37743,이동주(李東洲),장혜영(張惠英),18,26,44,1
37744,이동주(李東洲),전봉민(田奉珉),35,5,40,1
37745,이동주(李東洲),전용기(田溶冀),109,146,255,0
37746,이동주(李東洲),전재수(田載秀),87,74,161,0
37747,이동주(李東洲),전주혜(全珠惠),50,6,56,1
37748,이동주(李東洲),전해철(全海澈),80,85,165,0
37749,이동주(李東洲),전혜숙(全惠淑),94,103,197,0
37750,이동주(李東洲),정경희(丁慶姬),49,4,53,1
37751,이동주(李東洲),정동만(鄭東萬),49,4,53,1
37752,이동주(李東洲),정성호(鄭成湖),90,142,232,0
37753,이동주(李東洲),정우택(鄭宇澤),25,4,29,1
37754,이동주(李東洲),정운천(鄭雲天),49,5,54,1
37755,이동주(李東洲),정일영(鄭日永),111,153,264,0
37756,이동주(李東洲),정점식(鄭点植),49,4,53,1
37757,이동주(李東洲),정진석(鄭鎭碩),49,5,54,1
37758,이동주(李東洲),정청래(鄭淸來),87,54,141,0
37759,이동주(李東洲),정춘숙(鄭春淑),90,107,197,0
37760,이동주(李東洲),정태호(鄭泰浩),97,115,212,0
37761,이동주(李東洲),정필모(鄭必模),92,103,195,0
37762,이동주(李東洲),정희용(鄭熙溶),50,6,56,1
37763,이동주(李東洲),조경태(趙慶泰),53,11,64,1
37764,이동주(李東洲),조명희(曺明姬),49,7,56,1
37765,이동주(李東洲),조수진(趙修眞),49,4,53,1
37766,이동주(李東洲),조승래(趙承來),92,64,156,0
37767,이동주(李東洲),조오섭(曺五燮),116,312,428,0
37768,이동주(李東洲),조은희(趙恩禧),25,4,29,1
37769,이동주(李東洲),조응천(趙應天),77,53,130,0
37770,이동주(李東洲),조정식(趙正湜),83,65,148,0
37771,이동주(李東洲),조정훈(趙廷訓),11,22,33,1
37772,이동주(李東洲),조해진(曺海珍),50,5,55,1
37773,이동주(李東洲),주철현(朱哲鉉),100,151,251,0
37774,이동주(李東洲),주호영(朱豪英),49,4,53,1
37775,이동주(李東洲),지성호(池成浩),49,4,53,1
37776,이동주(李東洲),진선미(陳善美),81,98,179,0
37777,이동주(李東洲),진성준(陳聲準),111,207,318,0
37778,이동주(李東洲),천준호(千俊鎬),103,100,203,0
37779,이동주(李東洲),최기상(崔基相),90,192,282,0
37780,이동주(李東洲),최승재(崔承宰),51,10,61,1
37781,이동주(李東洲),최연숙(崔姸淑),33,12,45,1
37782,이동주(李東洲),최영희(崔英姬),25,4,29,1
37783,이동주(李東洲),최인호(崔仁昊),97,133,230,0
37784,이동주(李東洲),최재형(崔在亨),25,4,29,1
37785,이동주(李東洲),최종윤(崔鍾允),97,151,248,0
37786,이동주(李東洲),최춘식(崔春植),50,4,54,1
37787,이동주(李東洲),최형두(崔炯斗),51,7,58,1
37788,이동주(李東洲),최혜영(崔惠英),107,156,263,0
37789,이동주(李東洲),추경호(秋慶鎬),49,3,52,1
37790,이동주(李東洲),태영호(太永浩),49,6,55,1
37791,이동주(李東洲),하영제(河榮帝),40,4,44,1
37792,이동주(李東洲),하태경(河泰慶),49,5,54,1
37793,이동주(李東洲),한기호(韓起鎬),49,6,55,1
37794,이동주(李東洲),한무경(韓茂景),50,5,55,1
37795,이동주(李東洲),한병도(韓秉道),101,100,201,0
37796,이동주(李東洲),한정애(韓貞愛),81,73,154,0
37797,이동주(李東洲),한준호(韓俊鎬),97,145,242,0
37798,이동주(李東洲),허숙정(許淑湞),1,1,2,0
37799,이동주(李東洲),허영(許榮),119,163,282,0
37800,이동주(李東洲),허은아(許垠娥),49,5,54,1
37801,이동주(李東洲),허종식(許琮植),105,166,271,0
37802,이동주(李東洲),홍기원(洪起元),91,152,243,0
37803,이동주(李東洲),홍문표(洪文杓),54,13,67,1
37804,이동주(李東洲),홍석준(洪碩晙),49,4,53,1
37805,이동주(李東洲),홍성국(洪性國),107,187,294,0
37806,이동주(李東洲),홍영표(洪永杓),81,77,158,0
37807,이동주(李東洲),홍익표(洪翼杓),92,118,210,0
37808,이동주(李東洲),홍정민(洪貞敏),102,116,218,0
37809,이동주(李東洲),황보승희(皇甫承希),46,2,48,1
37810,이동주(李東洲),황운하(黃雲夏),103,125,228,0
37811,이동주(李東洲),황희(黃熙),83,91,174,0
37812,이만희(李晩熙),이명수(李明洙),96,105,201,0
37813,이만희(李晩熙),이병훈(李炳勳),53,4,57,1
37814,이만희(李晩熙),이상민(李相珉),50,4,54,1
37815,이만희(李晩熙),이상헌(李相憲),50,5,55,1
37816,이만희(李晩熙),이성만(李成萬),40,0,40,1
37817,이만희(李晩熙),이소영(李素永),51,4,55,1
37818,이만희(李晩熙),이수진(李壽珍),50,4,54,1
37819,이만희(李晩熙),이수진(李秀眞),50,4,54,1
37820,이만희(李晩熙),이양수(李亮壽),86,92,178,0
37821,이만희(李晩熙),이용(李鏞),75,74,149,0
37822,이만희(李晩熙),이용빈(李龍彬),52,4,56,1
37823,이만희(李晩熙),이용선(李庸瑄),49,5,54,1
37824,이만희(李晩熙),이용우(李龍雨),50,4,54,1
37825,이만희(李晩熙),이용호(李容鎬),29,20,49,0
37826,이만희(李晩熙),이원욱(李元旭),50,5,55,1
37827,이만희(李晩熙),이원택(李源澤),50,4,54,1
37828,이만희(李晩熙),이은주(李恩周),4,2,6,1
37829,이만희(李晩熙),이인선(李仁善),32,33,65,0
37830,이만희(李晩熙),이인영(李仁榮),49,4,53,1
37831,이만희(李晩熙),이장섭(李將燮),50,4,54,1
37832,이만희(李晩熙),이재명(李在明),25,4,29,1
37833,이만희(李晩熙),이재정(李在汀),49,4,53,1
37834,이만희(李晩熙),이정문(李楨文),49,4,53,1
37835,이만희(李晩熙),이종배(李鍾培),72,50,122,0
37836,이만희(李晩熙),이종성(李鍾成),81,88,169,0
37837,이만희(李晩熙),이주환(李周桓),77,52,129,0
37838,이만희(李晩熙),이채익(李埰益),70,66,136,0
37839,이만희(李晩熙),이철규(李喆圭),81,78,159,0
37840,이만희(李晩熙),이탄희(李誕熙),49,4,53,1
37841,이만희(李晩熙),이태규(李泰珪),43,44,87,0
37842,이만희(李晩熙),이학영(李學永),49,4,53,1
37843,이만희(李晩熙),이해식(李海植),51,4,55,1
37844,이만희(李晩熙),이헌승(李憲昇),71,50,121,0
37845,이만희(李晩熙),이형석(李炯錫),52,4,56,1
37846,이만희(李晩熙),인재근(印在謹),50,4,54,1
37847,이만희(李晩熙),임병헌(林炳憲),33,18,51,0
37848,이만희(李晩熙),임오경(林五卿),49,5,54,1
37849,이만희(李晩熙),임이자(林利子),93,80,173,0
37850,이만희(李晩熙),임종성(林鍾聲),52,5,57,1
37851,이만희(李晩熙),임호선(林昊宣),51,6,57,1
37852,이만희(李晩熙),장경태(張耿態),49,4,53,1
37853,이만희(李晩熙),장동혁(張東赫),31,19,50,0
37854,이만희(李晩熙),장제원(張濟元),65,36,101,0
37855,이만희(李晩熙),장철민(張喆敏),50,4,54,1
37856,이만희(李晩熙),장혜영(張惠英),6,2,8,1
37857,이만희(李晩熙),전봉민(田奉珉),51,40,91,0
37858,이만희(李晩熙),전용기(田溶冀),49,4,53,1
37859,이만희(李晩熙),전재수(田載秀),49,4,53,1
37860,이만희(李晩熙),전주혜(全珠惠),72,71,143,0
37861,이만희(李晩熙),전해철(全海澈),49,4,53,1
37862,이만희(李晩熙),전혜숙(全惠淑),49,5,54,1
37863,이만희(李晩熙),정경희(丁慶姬),84,71,155,0
37864,이만희(李晩熙),정동만(鄭東萬),72,53,125,0
37865,이만희(李晩熙),정성호(鄭成湖),50,5,55,1
37866,이만희(李晩熙),정우택(鄭宇澤),35,37,72,0
37867,이만희(李晩熙),정운천(鄭雲天),83,59,142,0
37868,이만희(李晩熙),정일영(鄭日永),49,4,53,1
37869,이만희(李晩熙),정점식(鄭点植),79,60,139,0
37870,이만희(李晩熙),정진석(鄭鎭碩),73,72,145,0
37871,이만희(李晩熙),정청래(鄭淸來),49,4,53,1
37872,이만희(李晩熙),정춘숙(鄭春淑),49,4,53,1
37873,이만희(李晩熙),정태호(鄭泰浩),49,4,53,1
37874,이만희(李晩熙),정필모(鄭必模),49,4,53,1
37875,이만희(李晩熙),정희용(鄭熙溶),84,73,157,0
37876,이만희(李晩熙),조경태(趙慶泰),68,42,110,0
37877,이만희(李晩熙),조명희(曺明姬),89,95,184,0
37878,이만희(李晩熙),조수진(趙修眞),75,73,148,0
37879,이만희(李晩熙),조승래(趙承來),50,6,56,1
37880,이만희(李晩熙),조오섭(曺五燮),52,4,56,1
37881,이만희(李晩熙),조은희(趙恩禧),37,42,79,0
37882,이만희(李晩熙),조응천(趙應天),49,3,52,1
37883,이만희(李晩熙),조정식(趙正湜),49,3,52,1
37884,이만희(李晩熙),조정훈(趙廷訓),0,1,1,1
37885,이만희(李晩熙),조해진(曺海珍),62,34,96,0
37886,이만희(李晩熙),주철현(朱哲鉉),57,4,61,1
37887,이만희(李晩熙),주호영(朱豪英),61,40,101,0
37888,이만희(李晩熙),지성호(池成浩),77,65,142,0
37889,이만희(李晩熙),진선미(陳善美),50,4,54,1
37890,이만희(李晩熙),진성준(陳聲準),49,4,53,1
37891,이만희(李晩熙),천준호(千俊鎬),49,3,52,1
37892,이만희(李晩熙),최기상(崔基相),50,4,54,1
37893,이만희(李晩熙),최승재(崔承宰),75,58,133,0
37894,이만희(李晩熙),최연숙(崔姸淑),39,30,69,0
37895,이만희(李晩熙),최영희(崔英姬),33,21,54,0
37896,이만희(李晩熙),최인호(崔仁昊),51,4,55,1
37897,이만희(李晩熙),최재형(崔在亨),32,16,48,0
37898,이만희(李晩熙),최종윤(崔鍾允),50,5,55,1
37899,이만희(李晩熙),최춘식(崔春植),89,97,186,0
37900,이만희(李晩熙),최형두(崔炯斗),85,66,151,0
37901,이만희(李晩熙),최혜영(崔惠英),50,4,54,1
37902,이만희(李晩熙),추경호(秋慶鎬),97,69,166,0
37903,이만희(李晩熙),태영호(太永浩),82,71,153,0
37904,이만희(李晩熙),하영제(河榮帝),72,73,145,1
37905,이만희(李晩熙),하태경(河泰慶),66,45,111,0
37906,이만희(李晩熙),한기호(韓起鎬),66,44,110,0
37907,이만희(李晩熙),한무경(韓茂景),85,82,167,0
37908,이만희(李晩熙),한병도(韓秉道),51,4,55,1
37909,이만희(李晩熙),한정애(韓貞愛),50,4,54,1
37910,이만희(李晩熙),한준호(韓俊鎬),50,4,54,1
37911,이만희(李晩熙),허숙정(許淑湞),0,0,0,1
37912,이만희(李晩熙),허영(許榮),53,4,57,1
37913,이만희(李晩熙),허은아(許垠娥),75,56,131,0
37914,이만희(李晩熙),허종식(許琮植),51,6,57,1
37915,이만희(李晩熙),홍기원(洪起元),49,4,53,1
37916,이만희(李晩熙),홍문표(洪文杓),69,41,110,0
37917,이만희(李晩熙),홍석준(洪碩晙),70,67,137,0
37918,이만희(李晩熙),홍성국(洪性國),51,4,55,1
37919,이만희(李晩熙),홍영표(洪永杓),50,4,54,1
37920,이만희(李晩熙),홍익표(洪翼杓),50,4,54,1
37921,이만희(李晩熙),홍정민(洪貞敏),51,5,56,1
37922,이만희(李晩熙),황보승희(皇甫承希),75,80,155,1
37923,이만희(李晩熙),황운하(黃雲夏),50,4,54,1
37924,이만희(李晩熙),황희(黃熙),49,4,53,1
37925,이명수(李明洙),이병훈(李炳勳),52,20,72,1
37926,이명수(李明洙),이상민(李相珉),50,14,64,1
37927,이명수(李明洙),이상헌(李相憲),51,11,62,1
37928,이명수(李明洙),이성만(李成萬),41,11,52,1
37929,이명수(李明洙),이소영(李素永),52,6,58,1
37930,이명수(李明洙),이수진(李壽珍),52,24,76,1
37931,이명수(李明洙),이수진(李秀眞),52,15,67,1
37932,이명수(李明洙),이양수(李亮壽),82,82,164,0
37933,이명수(李明洙),이용(李鏞),87,156,243,0
37934,이명수(李明洙),이용빈(李龍彬),50,18,68,1
37935,이명수(李明洙),이용선(李庸瑄),51,19,70,1
37936,이명수(李明洙),이용우(李龍雨),52,9,61,1
37937,이명수(李明洙),이용호(李容鎬),40,44,84,0
37938,이명수(李明洙),이원욱(李元旭),52,17,69,1
37939,이명수(李明洙),이원택(李源澤),50,10,60,1
37940,이명수(李明洙),이은주(李恩周),6,17,23,1
37941,이명수(李明洙),이인선(李仁善),42,96,138,0
37942,이명수(李明洙),이인영(李仁榮),50,6,56,1
37943,이명수(李明洙),이장섭(李將燮),51,10,61,1
37944,이명수(李明洙),이재명(李在明),25,6,31,1
37945,이명수(李明洙),이재정(李在汀),50,8,58,1
37946,이명수(李明洙),이정문(李楨文),51,14,65,1
37947,이명수(李明洙),이종배(李鍾培),117,185,302,0
37948,이명수(李明洙),이종성(李鍾成),126,193,319,0
37949,이명수(李明洙),이주환(李周桓),102,161,263,0
37950,이명수(李明洙),이채익(李埰益),104,178,282,0
37951,이명수(李明洙),이철규(李喆圭),78,72,150,0
37952,이명수(李明洙),이탄희(李誕熙),50,11,61,1
37953,이명수(李明洙),이태규(李泰珪),69,93,162,0
37954,이명수(李明洙),이학영(李學永),49,8,57,1
37955,이명수(李明洙),이해식(李海植),53,14,67,1
37956,이명수(李明洙),이헌승(李憲昇),74,128,202,0
37957,이명수(李明洙),이형석(李炯錫),51,16,67,1
37958,이명수(李明洙),인재근(印在謹),50,20,70,1
37959,이명수(李明洙),임병헌(林炳憲),36,75,111,0
37960,이명수(李明洙),임오경(林五卿),50,14,64,1
37961,이명수(李明洙),임이자(林利子),109,112,221,0
37962,이명수(李明洙),임종성(林鍾聲),53,17,70,1
37963,이명수(李明洙),임호선(林昊宣),54,24,78,1
37964,이명수(李明洙),장경태(張耿態),52,27,79,1
37965,이명수(李明洙),장동혁(張東赫),30,49,79,0
37966,이명수(李明洙),장제원(張濟元),73,76,149,0
37967,이명수(李明洙),장철민(張喆敏),50,18,68,1
37968,이명수(李明洙),장혜영(張惠英),8,24,32,1
37969,이명수(李明洙),전봉민(田奉珉),62,81,143,0
37970,이명수(李明洙),전용기(田溶冀),51,12,63,1
37971,이명수(李明洙),전재수(田載秀),50,7,57,1
37972,이명수(李明洙),전주혜(全珠惠),76,82,158,0
37973,이명수(李明洙),전해철(全海澈),52,7,59,1
37974,이명수(李明洙),전혜숙(全惠淑),52,14,66,1
37975,이명수(李明洙),정경희(丁慶姬),78,78,156,0
37976,이명수(李明洙),정동만(鄭東萬),84,120,204,0
37977,이명수(李明洙),정성호(鄭成湖),51,22,73,1
37978,이명수(李明洙),정우택(鄭宇澤),41,98,139,0
37979,이명수(李明洙),정운천(鄭雲天),85,144,229,0
37980,이명수(李明洙),정일영(鄭日永),57,12,69,1
37981,이명수(李明洙),정점식(鄭点植),74,72,146,0
37982,이명수(李明洙),정진석(鄭鎭碩),86,96,182,0
37983,이명수(李明洙),정청래(鄭淸來),50,6,56,1
37984,이명수(李明洙),정춘숙(鄭春淑),51,14,65,1
37985,이명수(李明洙),정태호(鄭泰浩),50,13,63,1
37986,이명수(李明洙),정필모(鄭必模),50,11,61,1
37987,이명수(李明洙),정희용(鄭熙溶),113,171,284,0
37988,이명수(李明洙),조경태(趙慶泰),93,131,224,0
37989,이명수(李明洙),조명희(曺明姬),105,219,324,0
37990,이명수(李明洙),조수진(趙修眞),85,110,195,0
37991,이명수(李明洙),조승래(趙承來),53,19,72,1
37992,이명수(李明洙),조오섭(曺五燮),51,19,70,1
37993,이명수(李明洙),조은희(趙恩禧),37,59,96,0
37994,이명수(李明洙),조응천(趙應天),50,10,60,1
37995,이명수(李明洙),조정식(趙正湜),53,5,58,1
37996,이명수(李明洙),조정훈(趙廷訓),3,33,36,1
37997,이명수(李明洙),조해진(曺海珍),69,68,137,0
37998,이명수(李明洙),주철현(朱哲鉉),51,14,65,1
37999,이명수(李明洙),주호영(朱豪英),72,90,162,0
38000,이명수(李明洙),지성호(池成浩),118,168,286,0
38001,이명수(李明洙),진선미(陳善美),51,7,58,1
38002,이명수(李明洙),진성준(陳聲準),51,17,68,1
38003,이명수(李明洙),천준호(千俊鎬),49,17,66,1
38004,이명수(李明洙),최기상(崔基相),49,8,57,1
38005,이명수(李明洙),최승재(崔承宰),97,133,230,0
38006,이명수(李明洙),최연숙(崔姸淑),57,80,137,0
38007,이명수(李明洙),최영희(崔英姬),32,51,83,0
38008,이명수(李明洙),최인호(崔仁昊),62,12,74,1
38009,이명수(李明洙),최재형(崔在亨),32,30,62,0
38010,이명수(李明洙),최종윤(崔鍾允),50,18,68,1
38011,이명수(李明洙),최춘식(崔春植),97,186,283,0
38012,이명수(李明洙),최형두(崔炯斗),121,167,288,0
38013,이명수(李明洙),최혜영(崔惠英),50,13,63,1
38014,이명수(李明洙),추경호(秋慶鎬),149,176,325,0
38015,이명수(李明洙),태영호(太永浩),133,254,387,0
38016,이명수(李明洙),하영제(河榮帝),86,151,237,1
38017,이명수(李明洙),하태경(河泰慶),71,73,144,0
38018,이명수(李明洙),한기호(韓起鎬),74,94,168,0
38019,이명수(李明洙),한무경(韓茂景),112,131,243,0
38020,이명수(李明洙),한병도(韓秉道),59,17,76,1
38021,이명수(李明洙),한정애(韓貞愛),51,9,60,1
38022,이명수(李明洙),한준호(韓俊鎬),51,9,60,1
38023,이명수(李明洙),허숙정(許淑湞),0,0,0,1
38024,이명수(李明洙),허영(許榮),55,17,72,1
38025,이명수(李明洙),허은아(許垠娥),89,101,190,0
38026,이명수(李明洙),허종식(許琮植),53,17,70,1
38027,이명수(李明洙),홍기원(洪起元),50,10,60,1
38028,이명수(李明洙),홍문표(洪文杓),111,186,297,0
38029,이명수(李明洙),홍석준(洪碩晙),80,90,170,0
38030,이명수(李明洙),홍성국(洪性國),53,18,71,1
38031,이명수(李明洙),홍영표(洪永杓),50,14,64,1
38032,이명수(李明洙),홍익표(洪翼杓),50,10,60,1
38033,이명수(李明洙),홍정민(洪貞敏),51,13,64,1
38034,이명수(李明洙),황보승희(皇甫承希),91,132,223,1
38035,이명수(李明洙),황운하(黃雲夏),52,14,66,1
38036,이명수(李明洙),황희(黃熙),49,7,56,1
38037,이병훈(李炳勳),이상민(李相珉),78,42,120,0
38038,이병훈(李炳勳),이상헌(李相憲),166,225,391,0
38039,이병훈(李炳勳),이성만(李成萬),111,132,243,1
38040,이병훈(李炳勳),이소영(李素永),85,64,149,0
38041,이병훈(李炳勳),이수진(李壽珍),130,179,309,0
38042,이병훈(李炳勳),이수진(李秀眞),133,166,299,0
38043,이병훈(李炳勳),이양수(李亮壽),54,9,63,1
38044,이병훈(李炳勳),이용(李鏞),52,7,59,1
38045,이병훈(李炳勳),이용빈(李龍彬),161,259,420,0
38046,이병훈(李炳勳),이용선(李庸瑄),115,125,240,0
38047,이병훈(李炳勳),이용우(李龍雨),123,163,286,0
38048,이병훈(李炳勳),이용호(李容鎬),36,23,59,1
38049,이병훈(李炳勳),이원욱(李元旭),113,134,247,0
38050,이병훈(李炳勳),이원택(李源澤),105,98,203,0
38051,이병훈(李炳勳),이은주(李恩周),20,29,49,1
38052,이병훈(李炳勳),이인선(李仁善),27,4,31,1
38053,이병훈(李炳勳),이인영(李仁榮),76,52,128,0
38054,이병훈(李炳勳),이장섭(李將燮),133,179,312,0
38055,이병훈(李炳勳),이재명(李在明),40,25,65,0
38056,이병훈(李炳勳),이재정(李在汀),94,66,160,0
38057,이병훈(李炳勳),이정문(李楨文),115,133,248,0
38058,이병훈(李炳勳),이종배(李鍾培),52,11,63,1
38059,이병훈(李炳勳),이종성(李鍾成),53,7,60,1
38060,이병훈(李炳勳),이주환(李周桓),51,8,59,1
38061,이병훈(李炳勳),이채익(李埰益),52,14,66,1
38062,이병훈(李炳勳),이철규(李喆圭),56,10,66,1
38063,이병훈(李炳勳),이탄희(李誕熙),95,92,187,0
38064,이병훈(李炳勳),이태규(李泰珪),30,7,37,1
38065,이병훈(李炳勳),이학영(李學永),102,138,240,0
38066,이병훈(李炳勳),이해식(李海植),120,122,242,0
38067,이병훈(李炳勳),이헌승(李憲昇),51,6,57,1
38068,이병훈(李炳勳),이형석(李炯錫),151,209,360,0
38069,이병훈(李炳勳),인재근(印在謹),109,119,228,0
38070,이병훈(李炳勳),임병헌(林炳憲),27,6,33,1
38071,이병훈(李炳勳),임오경(林五卿),142,207,349,0
38072,이병훈(李炳勳),임이자(林利子),51,6,57,1
38073,이병훈(李炳勳),임종성(林鍾聲),100,137,237,0
38074,이병훈(李炳勳),임호선(林昊宣),141,248,389,0
38075,이병훈(李炳勳),장경태(張耿態),121,169,290,0
38076,이병훈(李炳勳),장동혁(張東赫),26,4,30,1
38077,이병훈(李炳勳),장제원(張濟元),50,6,56,1
38078,이병훈(李炳勳),장철민(張喆敏),99,113,212,0
38079,이병훈(李炳勳),장혜영(張惠英),16,19,35,1
38080,이병훈(李炳勳),전봉민(田奉珉),36,6,42,1
38081,이병훈(李炳勳),전용기(田溶冀),133,215,348,0
38082,이병훈(李炳勳),전재수(田載秀),134,188,322,0
38083,이병훈(李炳勳),전주혜(全珠惠),55,7,62,1
38084,이병훈(李炳勳),전해철(全海澈),80,64,144,0
38085,이병훈(李炳勳),전혜숙(全惠淑),117,169,286,0
38086,이병훈(李炳勳),정경희(丁慶姬),52,5,57,1
38087,이병훈(李炳勳),정동만(鄭東萬),50,7,57,1
38088,이병훈(李炳勳),정성호(鄭成湖),99,121,220,0
38089,이병훈(李炳勳),정우택(鄭宇澤),26,4,30,1
38090,이병훈(李炳勳),정운천(鄭雲天),52,8,60,1
38091,이병훈(李炳勳),정일영(鄭日永),105,131,236,0
38092,이병훈(李炳勳),정점식(鄭点植),52,5,57,1
38093,이병훈(李炳勳),정진석(鄭鎭碩),52,10,62,1
38094,이병훈(李炳勳),정청래(鄭淸來),110,103,213,0
38095,이병훈(李炳勳),정춘숙(鄭春淑),95,124,219,0
38096,이병훈(李炳勳),정태호(鄭泰浩),96,149,245,0
38097,이병훈(李炳勳),정필모(鄭必模),100,117,217,0
38098,이병훈(李炳勳),정희용(鄭熙溶),53,9,62,1
38099,이병훈(李炳勳),조경태(趙慶泰),51,11,62,1
38100,이병훈(李炳勳),조명희(曺明姬),53,7,60,1
38101,이병훈(李炳勳),조수진(趙修眞),50,5,55,1
38102,이병훈(李炳勳),조승래(趙承來),100,92,192,0
38103,이병훈(李炳勳),조오섭(曺五燮),147,271,418,0
38104,이병훈(李炳勳),조은희(趙恩禧),28,5,33,1
38105,이병훈(李炳勳),조응천(趙應天),78,54,132,0
38106,이병훈(李炳勳),조정식(趙正湜),77,54,131,0
38107,이병훈(李炳勳),조정훈(趙廷訓),4,14,18,1
38108,이병훈(李炳勳),조해진(曺海珍),53,6,59,1
38109,이병훈(李炳勳),주철현(朱哲鉉),138,202,340,0
38110,이병훈(李炳勳),주호영(朱豪英),51,6,57,1
38111,이병훈(李炳勳),지성호(池成浩),51,6,57,1
38112,이병훈(李炳勳),진선미(陳善美),90,70,160,0
38113,이병훈(李炳勳),진성준(陳聲準),110,127,237,0
38114,이병훈(李炳勳),천준호(千俊鎬),103,80,183,0
38115,이병훈(李炳勳),최기상(崔基相),92,85,177,0
38116,이병훈(李炳勳),최승재(崔承宰),53,11,64,1
38117,이병훈(李炳勳),최연숙(崔姸淑),34,14,48,1
38118,이병훈(李炳勳),최영희(崔英姬),26,6,32,1
38119,이병훈(李炳勳),최인호(崔仁昊),106,119,225,0
38120,이병훈(李炳勳),최재형(崔在亨),26,4,30,1
38121,이병훈(李炳勳),최종윤(崔鍾允),108,168,276,0
38122,이병훈(李炳勳),최춘식(崔春植),52,7,59,1
38123,이병훈(李炳勳),최형두(崔炯斗),54,11,65,1
38124,이병훈(李炳勳),최혜영(崔惠英),106,137,243,0
38125,이병훈(李炳勳),추경호(秋慶鎬),50,5,55,1
38126,이병훈(李炳勳),태영호(太永浩),51,6,57,1
38127,이병훈(李炳勳),하영제(河榮帝),45,9,54,1
38128,이병훈(李炳勳),하태경(河泰慶),54,9,63,1
38129,이병훈(李炳勳),한기호(韓起鎬),52,8,60,1
38130,이병훈(李炳勳),한무경(韓茂景),51,8,59,1
38131,이병훈(李炳勳),한병도(韓秉道),121,151,272,0
38132,이병훈(李炳勳),한정애(韓貞愛),81,64,145,0
38133,이병훈(李炳勳),한준호(韓俊鎬),122,171,293,0
38134,이병훈(李炳勳),허숙정(許淑湞),1,1,2,0
38135,이병훈(李炳勳),허영(許榮),130,220,350,0
38136,이병훈(李炳勳),허은아(許垠娥),52,7,59,1
38137,이병훈(李炳勳),허종식(許琮植),104,130,234,0
38138,이병훈(李炳勳),홍기원(洪起元),101,135,236,0
38139,이병훈(李炳勳),홍문표(洪文杓),51,28,79,1
38140,이병훈(李炳勳),홍석준(洪碩晙),51,7,58,1
38141,이병훈(李炳勳),홍성국(洪性國),153,241,394,0
38142,이병훈(李炳勳),홍영표(洪永杓),94,80,174,0
38143,이병훈(李炳勳),홍익표(洪翼杓),111,150,261,0
38144,이병훈(李炳勳),홍정민(洪貞敏),127,161,288,0
38145,이병훈(李炳勳),황보승희(皇甫承希),49,8,57,1
38146,이병훈(李炳勳),황운하(黃雲夏),119,162,281,0
38147,이병훈(李炳勳),황희(黃熙),82,49,131,0
38148,이상민(李相珉),이상헌(李相憲),81,47,128,0
38149,이상민(李相珉),이성만(李成萬),69,38,107,1
38150,이상민(李相珉),이소영(李素永),76,36,112,0
38151,이상민(李相珉),이수진(李壽珍),83,52,135,0
38152,이상민(李相珉),이수진(李秀眞),80,43,123,0
38153,이상민(李相珉),이양수(李亮壽),51,5,56,1
38154,이상민(李相珉),이용(李鏞),49,4,53,1
38155,이상민(李相珉),이용빈(李龍彬),84,56,140,0
38156,이상민(李相珉),이용선(李庸瑄),79,43,122,0
38157,이상민(李相珉),이용우(李龍雨),80,35,115,0
38158,이상민(李相珉),이용호(李容鎬),31,11,42,1
38159,이상민(李相珉),이원욱(李元旭),83,53,136,0
38160,이상민(李相珉),이원택(李源澤),77,37,114,0
38161,이상민(李相珉),이은주(李恩周),12,18,30,1
38162,이상민(李相珉),이인선(李仁善),25,5,30,1
38163,이상민(李相珉),이인영(李仁榮),76,37,113,0
38164,이상민(李相珉),이장섭(李將燮),80,41,121,0
38165,이상민(李相珉),이재명(李在明),39,18,57,0
38166,이상민(李相珉),이재정(李在汀),78,43,121,0
38167,이상민(李相珉),이정문(李楨文),80,49,129,0
38168,이상민(李相珉),이종배(李鍾培),51,5,56,1
38169,이상민(李相珉),이종성(李鍾成),49,4,53,1
38170,이상민(李相珉),이주환(李周桓),49,4,53,1
38171,이상민(李相珉),이채익(李埰益),51,5,56,1
38172,이상민(李相珉),이철규(李喆圭),51,4,55,1
38173,이상민(李相珉),이탄희(李誕熙),78,37,115,0
38174,이상민(李相珉),이태규(李泰珪),28,4,32,1
38175,이상민(李相珉),이학영(李學永),77,39,116,0
38176,이상민(李相珉),이해식(李海植),80,36,116,0
38177,이상민(李相珉),이헌승(李憲昇),50,4,54,1
38178,이상민(李相珉),이형석(李炯錫),82,40,122,0
38179,이상민(李相珉),인재근(印在謹),92,45,137,0
38180,이상민(李相珉),임병헌(林炳憲),26,4,30,1
38181,이상민(李相珉),임오경(林五卿),78,37,115,0
38182,이상민(李相珉),임이자(林利子),50,4,54,1
38183,이상민(李相珉),임종성(林鍾聲),85,47,132,0
38184,이상민(李相珉),임호선(林昊宣),80,55,135,0
38185,이상민(李相珉),장경태(張耿態),79,45,124,0
38186,이상민(李相珉),장동혁(張東赫),25,4,29,1
38187,이상민(李相珉),장제원(張濟元),49,4,53,1
38188,이상민(李相珉),장철민(張喆敏),87,77,164,0
38189,이상민(李相珉),장혜영(張惠英),12,22,34,1
38190,이상민(李相珉),전봉민(田奉珉),35,5,40,1
38191,이상민(李相珉),전용기(田溶冀),80,41,121,0
38192,이상민(李相珉),전재수(田載秀),76,36,112,0
38193,이상민(李相珉),전주혜(全珠惠),51,4,55,1
38194,이상민(李相珉),전해철(全海澈),79,39,118,0
38195,이상민(李相珉),전혜숙(全惠淑),79,44,123,0
38196,이상민(李相珉),정경희(丁慶姬),49,4,53,1
38197,이상민(李相珉),정동만(鄭東萬),49,4,53,1
38198,이상민(李相珉),정성호(鄭成湖),78,42,120,0
38199,이상민(李相珉),정우택(鄭宇澤),25,5,30,1
38200,이상민(李相珉),정운천(鄭雲天),50,4,54,1
38201,이상민(李相珉),정일영(鄭日永),76,44,120,0
38202,이상민(李相珉),정점식(鄭点植),51,4,55,1
38203,이상민(李相珉),정진석(鄭鎭碩),50,5,55,1
38204,이상민(李相珉),정청래(鄭淸來),78,44,122,0
38205,이상민(李相珉),정춘숙(鄭春淑),88,50,138,0
38206,이상민(李相珉),정태호(鄭泰浩),77,36,113,0
38207,이상민(李相珉),정필모(鄭必模),76,35,111,0
38208,이상민(李相珉),정희용(鄭熙溶),50,7,57,1
38209,이상민(李相珉),조경태(趙慶泰),49,4,53,1
38210,이상민(李相珉),조명희(曺明姬),50,5,55,1
38211,이상민(李相珉),조수진(趙修眞),49,4,53,1
38212,이상민(李相珉),조승래(趙承來),83,73,156,0
38213,이상민(李相珉),조오섭(曺五燮),85,61,146,0
38214,이상민(李相珉),조은희(趙恩禧),25,5,30,1
38215,이상민(李相珉),조응천(趙應天),73,34,107,0
38216,이상민(李相珉),조정식(趙正湜),76,33,109,0
38217,이상민(李相珉),조정훈(趙廷訓),1,6,7,1
38218,이상민(李相珉),조해진(曺海珍),51,5,56,1
38219,이상민(李相珉),주철현(朱哲鉉),73,38,111,0
38220,이상민(李相珉),주호영(朱豪英),50,4,54,1
38221,이상민(李相珉),지성호(池成浩),50,7,57,1
38222,이상민(李相珉),진선미(陳善美),81,42,123,0
38223,이상민(李相珉),진성준(陳聲準),78,35,113,0
38224,이상민(李相珉),천준호(千俊鎬),75,31,106,0
38225,이상민(李相珉),최기상(崔基相),74,34,108,0
38226,이상민(李相珉),최승재(崔承宰),50,4,54,1
38227,이상민(李相珉),최연숙(崔姸淑),30,5,35,1
38228,이상민(李相珉),최영희(崔英姬),25,4,29,1
38229,이상민(李相珉),최인호(崔仁昊),78,38,116,0
38230,이상민(李相珉),최재형(崔在亨),26,4,30,1
38231,이상민(李相珉),최종윤(崔鍾允),84,47,131,0
38232,이상민(李相珉),최춘식(崔春植),50,4,54,1
38233,이상민(李相珉),최형두(崔炯斗),51,6,57,1
38234,이상민(李相珉),최혜영(崔惠英),78,43,121,0
38235,이상민(李相珉),추경호(秋慶鎬),49,3,52,1
38236,이상민(李相珉),태영호(太永浩),50,4,54,1
38237,이상민(李相珉),하영제(河榮帝),41,2,43,1
38238,이상민(李相珉),하태경(河泰慶),51,5,56,1
38239,이상민(李相珉),한기호(韓起鎬),51,4,55,1
38240,이상민(李相珉),한무경(韓茂景),49,5,54,1
38241,이상민(李相珉),한병도(韓秉道),85,54,139,0
38242,이상민(李相珉),한정애(韓貞愛),74,40,114,0
38243,이상민(李相珉),한준호(韓俊鎬),94,55,149,0
38244,이상민(李相珉),허숙정(許淑湞),1,1,2,0
38245,이상민(李相珉),허영(許榮),80,37,117,0
38246,이상민(李相珉),허은아(許垠娥),49,5,54,1
38247,이상민(李相珉),허종식(許琮植),78,36,114,0
38248,이상민(李相珉),홍기원(洪起元),77,36,113,0
38249,이상민(李相珉),홍문표(洪文杓),50,4,54,1
38250,이상민(李相珉),홍석준(洪碩晙),50,6,56,1
38251,이상민(李相珉),홍성국(洪性國),90,58,148,0
38252,이상민(李相珉),홍영표(洪永杓),79,42,121,0
38253,이상민(李相珉),홍익표(洪翼杓),83,47,130,0
38254,이상민(李相珉),홍정민(洪貞敏),76,41,117,0
38255,이상민(李相珉),황보승희(皇甫承希),46,2,48,1
38256,이상민(李相珉),황운하(黃雲夏),96,90,186,0
38257,이상민(李相珉),황희(黃熙),73,33,106,0
38258,이상헌(李相憲),이성만(李成萬),120,125,245,1
38259,이상헌(李相憲),이소영(李素永),81,53,134,0
38260,이상헌(李相憲),이수진(李壽珍),111,129,240,0
38261,이상헌(李相憲),이수진(李秀眞),113,123,236,0
38262,이상헌(李相憲),이양수(李亮壽),51,4,55,1
38263,이상헌(李相憲),이용(李鏞),50,7,57,1
38264,이상헌(李相憲),이용빈(李龍彬),137,210,347,0
38265,이상헌(李相憲),이용선(李庸瑄),103,73,176,0
38266,이상헌(李相憲),이용우(李龍雨),87,89,176,0
38267,이상헌(李相憲),이용호(李容鎬),54,69,123,1
38268,이상헌(李相憲),이원욱(李元旭),94,83,177,0
38269,이상헌(李相憲),이원택(李源澤),111,114,225,0
38270,이상헌(李相憲),이은주(李恩周),25,29,54,1
38271,이상헌(李相憲),이인선(李仁善),25,5,30,1
38272,이상헌(李相憲),이인영(李仁榮),75,52,127,0
38273,이상헌(李相憲),이장섭(李將燮),99,78,177,0
38274,이상헌(李相憲),이재명(李在明),41,19,60,0
38275,이상헌(李相憲),이재정(李在汀),91,48,139,0
38276,이상헌(李相憲),이정문(李楨文),109,102,211,0
38277,이상헌(李相憲),이종배(李鍾培),51,9,60,1
38278,이상헌(李相憲),이종성(李鍾成),51,10,61,1
38279,이상헌(李相憲),이주환(李周桓),50,7,57,1
38280,이상헌(李相憲),이채익(李埰益),54,22,76,1
38281,이상헌(李相憲),이철규(李喆圭),52,8,60,1
38282,이상헌(李相憲),이탄희(李誕熙),93,60,153,0
38283,이상헌(李相憲),이태규(李泰珪),28,10,38,1
38284,이상헌(李相憲),이학영(李學永),95,104,199,0
38285,이상헌(李相憲),이해식(李海植),97,95,192,0
38286,이상헌(李相憲),이헌승(李憲昇),50,8,58,1
38287,이상헌(李相憲),이형석(李炯錫),105,83,188,0
38288,이상헌(李相憲),인재근(印在謹),94,104,198,0
38289,이상헌(李相憲),임병헌(林炳憲),25,7,32,1
38290,이상헌(李相憲),임오경(林五卿),127,175,302,0
38291,이상헌(李相憲),임이자(林利子),50,5,55,1
38292,이상헌(李相憲),임종성(林鍾聲),90,97,187,0
38293,이상헌(李相憲),임호선(林昊宣),115,136,251,0
38294,이상헌(李相憲),장경태(張耿態),109,169,278,0
38295,이상헌(李相憲),장동혁(張東赫),25,4,29,1
38296,이상헌(李相憲),장제원(張濟元),49,4,53,1
38297,이상헌(李相憲),장철민(張喆敏),105,156,261,0
38298,이상헌(李相憲),장혜영(張惠英),18,25,43,1
38299,이상헌(李相憲),전봉민(田奉珉),35,5,40,1
38300,이상헌(李相憲),전용기(田溶冀),120,162,282,0
38301,이상헌(李相憲),전재수(田載秀),98,114,212,0
38302,이상헌(李相憲),전주혜(全珠惠),52,5,57,1
38303,이상헌(李相憲),전해철(全海澈),75,48,123,0
38304,이상헌(李相憲),전혜숙(全惠淑),100,107,207,0
38305,이상헌(李相憲),정경희(丁慶姬),50,4,54,1
38306,이상헌(李相憲),정동만(鄭東萬),49,5,54,1
38307,이상헌(李相憲),정성호(鄭成湖),103,102,205,0
38308,이상헌(李相憲),정우택(鄭宇澤),25,6,31,1
38309,이상헌(李相憲),정운천(鄭雲天),50,11,61,1
38310,이상헌(李相憲),정일영(鄭日永),111,141,252,0
38311,이상헌(李相憲),정점식(鄭点植),51,4,55,1
38312,이상헌(李相憲),정진석(鄭鎭碩),51,7,58,1
38313,이상헌(李相憲),정청래(鄭淸來),111,80,191,0
38314,이상헌(李相憲),정춘숙(鄭春淑),101,101,202,0
38315,이상헌(李相憲),정태호(鄭泰浩),83,94,177,0
38316,이상헌(李相憲),정필모(鄭必模),86,81,167,0
38317,이상헌(李相憲),정희용(鄭熙溶),51,7,58,1
38318,이상헌(李相憲),조경태(趙慶泰),52,8,60,1
38319,이상헌(李相憲),조명희(曺明姬),51,10,61,1
38320,이상헌(李相憲),조수진(趙修眞),50,7,57,1
38321,이상헌(李相憲),조승래(趙承來),126,144,270,0
38322,이상헌(李相憲),조오섭(曺五燮),111,207,318,0
38323,이상헌(李相憲),조은희(趙恩禧),25,6,31,1
38324,이상헌(李相憲),조응천(趙應天),89,64,153,0
38325,이상헌(李相憲),조정식(趙正湜),84,36,120,0
38326,이상헌(李相憲),조정훈(趙廷訓),2,41,43,1
38327,이상헌(李相憲),조해진(曺海珍),51,6,57,1
38328,이상헌(李相憲),주철현(朱哲鉉),112,123,235,0
38329,이상헌(李相憲),주호영(朱豪英),49,4,53,1
38330,이상헌(李相憲),지성호(池成浩),50,5,55,1
38331,이상헌(李相憲),진선미(陳善美),81,38,119,0
38332,이상헌(李相憲),진성준(陳聲準),88,68,156,0
38333,이상헌(李相憲),천준호(千俊鎬),80,52,132,0
38334,이상헌(李相憲),최기상(崔基相),87,79,166,0
38335,이상헌(李相憲),최승재(崔承宰),53,18,71,1
38336,이상헌(李相憲),최연숙(崔姸淑),32,19,51,1
38337,이상헌(李相憲),최영희(崔英姬),25,6,31,1
38338,이상헌(李相憲),최인호(崔仁昊),107,141,248,0
38339,이상헌(李相憲),최재형(崔在亨),25,6,31,1
38340,이상헌(李相憲),최종윤(崔鍾允),129,170,299,0
38341,이상헌(李相憲),최춘식(崔春植),49,6,55,1
38342,이상헌(李相憲),최형두(崔炯斗),51,20,71,1
38343,이상헌(李相憲),최혜영(崔惠英),118,130,248,0
38344,이상헌(李相憲),추경호(秋慶鎬),52,5,57,1
38345,이상헌(李相憲),태영호(太永浩),51,21,72,1
38346,이상헌(李相憲),하영제(河榮帝),44,3,47,1
38347,이상헌(李相憲),하태경(河泰慶),51,6,57,1
38348,이상헌(李相憲),한기호(韓起鎬),51,7,58,1
38349,이상헌(李相憲),한무경(韓茂景),50,5,55,1
38350,이상헌(李相憲),한병도(韓秉道),130,216,346,0
38351,이상헌(李相憲),한정애(韓貞愛),83,59,142,0
38352,이상헌(李相憲),한준호(韓俊鎬),114,195,309,0
38353,이상헌(李相憲),허숙정(許淑湞),1,1,2,0
38354,이상헌(李相憲),허영(許榮),113,105,218,0
38355,이상헌(李相憲),허은아(許垠娥),50,6,56,1
38356,이상헌(李相憲),허종식(許琮植),106,106,212,0
38357,이상헌(李相憲),홍기원(洪起元),85,67,152,0
38358,이상헌(李相憲),홍문표(洪文杓),53,11,64,1
38359,이상헌(李相憲),홍석준(洪碩晙),50,4,54,1
38360,이상헌(李相憲),홍성국(洪性國),120,118,238,0
38361,이상헌(李相憲),홍영표(洪永杓),86,56,142,0
38362,이상헌(李相憲),홍익표(洪翼杓),90,75,165,0
38363,이상헌(李相憲),홍정민(洪貞敏),125,150,275,0
38364,이상헌(李相憲),황보승희(皇甫承希),48,4,52,1
38365,이상헌(李相憲),황운하(黃雲夏),115,151,266,0
38366,이상헌(李相憲),황희(黃熙),80,38,118,0
38367,이성만(李成萬),이소영(李素永),82,55,137,1
38368,이성만(李成萬),이수진(李壽珍),139,242,381,1
38369,이성만(李成萬),이수진(李秀眞),140,152,292,1
38370,이성만(李成萬),이양수(李亮壽),41,0,41,1
38371,이성만(李成萬),이용(李鏞),40,0,40,1
38372,이성만(李成萬),이용빈(李龍彬),128,237,365,1
38373,이성만(李成萬),이용선(李庸瑄),94,90,184,1
38374,이성만(李成萬),이용우(李龍雨),105,89,194,1
38375,이성만(李成萬),이용호(李容鎬),23,15,38,1
38376,이성만(李成萬),이원욱(李元旭),95,105,200,1
38377,이성만(李成萬),이원택(李源澤),110,125,235,1
38378,이성만(李成萬),이은주(李恩周),24,44,68,1
38379,이성만(李成萬),이인선(李仁善),16,0,16,1
38380,이성만(李成萬),이인영(李仁榮),70,50,120,1
38381,이성만(李成萬),이장섭(李將燮),93,75,168,1
38382,이성만(李成萬),이재명(李在明),30,11,41,1
38383,이성만(李成萬),이재정(李在汀),83,71,154,1
38384,이성만(李成萬),이정문(李楨文),95,105,200,1
38385,이성만(李成萬),이종배(李鍾培),41,4,45,1
38386,이성만(李成萬),이종성(李鍾成),41,2,43,1
38387,이성만(李成萬),이주환(李周桓),40,1,41,1
38388,이성만(李成萬),이채익(李埰益),42,5,47,1
38389,이성만(李成萬),이철규(李喆圭),42,1,43,1
38390,이성만(李成萬),이탄희(李誕熙),98,98,196,1
38391,이성만(李成萬),이태규(李泰珪),20,1,21,1
38392,이성만(李成萬),이학영(李學永),108,134,242,1
38393,이성만(李成萬),이해식(李海植),99,101,200,1
38394,이성만(李成萬),이헌승(李憲昇),41,1,42,1
38395,이성만(李成萬),이형석(李炯錫),120,167,287,1
38396,이성만(李成萬),인재근(印在謹),96,133,229,1
38397,이성만(李成萬),임병헌(林炳憲),16,1,17,1
38398,이성만(李成萬),임오경(林五卿),106,118,224,1
38399,이성만(李成萬),임이자(林利子),40,0,40,1
38400,이성만(李成萬),임종성(林鍾聲),113,146,259,1
38401,이성만(李成萬),임호선(林昊宣),138,163,301,1
38402,이성만(李成萬),장경태(張耿態),108,148,256,1
38403,이성만(李成萬),장동혁(張東赫),16,0,16,1
38404,이성만(李成萬),장제원(張濟元),40,0,40,1
38405,이성만(李成萬),장철민(張喆敏),123,131,254,1
38406,이성만(李成萬),장혜영(張惠英),15,27,42,1
38407,이성만(李成萬),전봉민(田奉珉),26,1,27,1
38408,이성만(李成萬),전용기(田溶冀),96,139,235,1
38409,이성만(李成萬),전재수(田載秀),78,68,146,1
38410,이성만(李成萬),전주혜(全珠惠),42,1,43,1
38411,이성만(李成萬),전해철(全海澈),66,48,114,1
38412,이성만(李成萬),전혜숙(全惠淑),129,151,280,1
38413,이성만(李成萬),정경희(丁慶姬),40,0,40,1
38414,이성만(李成萬),정동만(鄭東萬),40,1,41,1
38415,이성만(李成萬),정성호(鄭成湖),97,140,237,1
38416,이성만(李成萬),정우택(鄭宇澤),18,1,19,1
38417,이성만(李成萬),정운천(鄭雲天),43,1,44,1
38418,이성만(李成萬),정일영(鄭日永),147,199,346,1
38419,이성만(李成萬),정점식(鄭点植),42,0,42,1
38420,이성만(李成萬),정진석(鄭鎭碩),41,2,43,1
38421,이성만(李成萬),정청래(鄭淸來),106,115,221,1
38422,이성만(李成萬),정춘숙(鄭春淑),98,113,211,1
38423,이성만(李成萬),정태호(鄭泰浩),98,92,190,1
38424,이성만(李成萬),정필모(鄭必模),77,68,145,1
38425,이성만(李成萬),정희용(鄭熙溶),42,2,44,1
38426,이성만(李成萬),조경태(趙慶泰),41,0,41,1
38427,이성만(李成萬),조명희(曺明姬),40,3,43,1
38428,이성만(李成萬),조수진(趙修眞),41,2,43,1
38429,이성만(李成萬),조승래(趙承來),116,82,198,1
38430,이성만(李成萬),조오섭(曺五燮),113,174,287,1
38431,이성만(李成萬),조은희(趙恩禧),16,4,20,1
38432,이성만(李成萬),조응천(趙應天),80,38,118,1
38433,이성만(李成萬),조정식(趙正湜),70,42,112,1
38434,이성만(李成萬),조정훈(趙廷訓),9,22,31,1
38435,이성만(李成萬),조해진(曺海珍),42,1,43,1
38436,이성만(李成萬),주철현(朱哲鉉),131,142,273,1
38437,이성만(李成萬),주호영(朱豪英),40,0,40,1
38438,이성만(李成萬),지성호(池成浩),40,1,41,1
38439,이성만(李成萬),진선미(陳善美),73,54,127,1
38440,이성만(李成萬),진성준(陳聲準),89,83,172,1
38441,이성만(李成萬),천준호(千俊鎬),79,56,135,1
38442,이성만(李成萬),최기상(崔基相),82,74,156,1
38443,이성만(李成萬),최승재(崔承宰),42,3,45,1
38444,이성만(李成萬),최연숙(崔姸淑),24,16,40,1
38445,이성만(李成萬),최영희(崔英姬),16,1,17,1
38446,이성만(李成萬),최인호(崔仁昊),83,84,167,1
38447,이성만(李成萬),최재형(崔在亨),16,0,16,1
38448,이성만(李成萬),최종윤(崔鍾允),107,161,268,1
38449,이성만(李成萬),최춘식(崔春植),41,2,43,1
38450,이성만(李成萬),최형두(崔炯斗),43,3,46,1
38451,이성만(李成萬),최혜영(崔惠英),121,179,300,1
38452,이성만(李成萬),추경호(秋慶鎬),40,2,42,1
38453,이성만(李成萬),태영호(太永浩),40,1,41,1
38454,이성만(李成萬),하영제(河榮帝),42,0,42,0
38455,이성만(李成萬),하태경(河泰慶),40,2,42,1
38456,이성만(李成萬),한기호(韓起鎬),41,2,43,1
38457,이성만(李成萬),한무경(韓茂景),40,1,41,1
38458,이성만(李成萬),한병도(韓秉道),117,107,224,1
38459,이성만(李成萬),한정애(韓貞愛),77,125,202,1
38460,이성만(李成萬),한준호(韓俊鎬),106,120,226,1
38461,이성만(李成萬),허숙정(許淑湞),1,1,2,1
38462,이성만(李成萬),허영(許榮),111,99,210,1
38463,이성만(李成萬),허은아(許垠娥),40,2,42,1
38464,이성만(李成萬),허종식(許琮植),162,235,397,1
38465,이성만(李成萬),홍기원(洪起元),91,84,175,1
38466,이성만(李成萬),홍문표(洪文杓),41,2,43,1
38467,이성만(李成萬),홍석준(洪碩晙),41,0,41,1
38468,이성만(李成萬),홍성국(洪性國),154,193,347,1
38469,이성만(李成萬),홍영표(洪永杓),94,99,193,1
38470,이성만(李成萬),홍익표(洪翼杓),89,65,154,1
38471,이성만(李成萬),홍정민(洪貞敏),101,113,214,1
38472,이성만(李成萬),황보승희(皇甫承希),43,1,44,0
38473,이성만(李成萬),황운하(黃雲夏),144,139,283,1
38474,이성만(李成萬),황희(黃熙),71,38,109,1
38475,이소영(李素永),이수진(李壽珍),108,88,196,0
38476,이소영(李素永),이수진(李秀眞),95,60,155,0
38477,이소영(李素永),이양수(李亮壽),54,4,58,1
38478,이소영(李素永),이용(李鏞),51,8,59,1
38479,이소영(李素永),이용빈(李龍彬),120,136,256,0
38480,이소영(李素永),이용선(李庸瑄),91,70,161,0
38481,이소영(李素永),이용우(李龍雨),103,104,207,0
38482,이소영(李素永),이용호(李容鎬),30,9,39,1
38483,이소영(李素永),이원욱(李元旭),89,76,165,0
38484,이소영(李素永),이원택(李源澤),93,58,151,0
38485,이소영(李素永),이은주(李恩周),24,33,57,1
38486,이소영(李素永),이인선(李仁善),25,4,29,1
38487,이소영(李素永),이인영(李仁榮),74,34,108,0
38488,이소영(李素永),이장섭(李將燮),81,46,127,0
38489,이소영(李素永),이재명(李在明),40,23,63,0
38490,이소영(李素永),이재정(李在汀),92,54,146,0
38491,이소영(李素永),이정문(李楨文),94,80,174,0
38492,이소영(李素永),이종배(李鍾培),51,5,56,1
38493,이소영(李素永),이종성(李鍾成),50,4,54,1
38494,이소영(李素永),이주환(李周桓),50,5,55,1
38495,이소영(李素永),이채익(李埰益),51,5,56,1
38496,이소영(李素永),이철규(李喆圭),52,5,57,1
38497,이소영(李素永),이탄희(李誕熙),97,66,163,0
38498,이소영(李素永),이태규(李泰珪),28,6,34,1
38499,이소영(李素永),이학영(李學永),101,109,210,0
38500,이소영(李素永),이해식(李海植),106,77,183,0
38501,이소영(李素永),이헌승(李憲昇),51,4,55,1
38502,이소영(李素永),이형석(李炯錫),101,69,170,0
38503,이소영(李素永),인재근(印在謹),87,59,146,0
38504,이소영(李素永),임병헌(林炳憲),27,4,31,1
38505,이소영(李素永),임오경(林五卿),89,58,147,0
38506,이소영(李素永),임이자(林利子),49,4,53,1
38507,이소영(李素永),임종성(林鍾聲),92,69,161,0
38508,이소영(李素永),임호선(林昊宣),103,79,182,0
38509,이소영(李素永),장경태(張耿態),111,85,196,0
38510,이소영(李素永),장동혁(張東赫),25,4,29,1
38511,이소영(李素永),장제원(張濟元),49,4,53,1
38512,이소영(李素永),장철민(張喆敏),92,108,200,0
38513,이소영(李素永),장혜영(張惠英),22,26,48,1
38514,이소영(李素永),전봉민(田奉珉),35,5,40,1
38515,이소영(李素永),전용기(田溶冀),103,128,231,0
38516,이소영(李素永),전재수(田載秀),79,49,128,0
38517,이소영(李素永),전주혜(全珠惠),52,5,57,1
38518,이소영(李素永),전해철(全海澈),76,48,124,0
38519,이소영(李素永),전혜숙(全惠淑),86,53,139,0
38520,이소영(李素永),정경희(丁慶姬),51,4,55,1
38521,이소영(李素永),정동만(鄭東萬),50,4,54,1
38522,이소영(李素永),정성호(鄭成湖),91,94,185,0
38523,이소영(李素永),정우택(鄭宇澤),27,6,33,1
38524,이소영(李素永),정운천(鄭雲天),50,4,54,1
38525,이소영(李素永),정일영(鄭日永),85,63,148,0
38526,이소영(李素永),정점식(鄭点植),50,4,54,1
38527,이소영(李素永),정진석(鄭鎭碩),51,5,56,1
38528,이소영(李素永),정청래(鄭淸來),84,40,124,0
38529,이소영(李素永),정춘숙(鄭春淑),102,96,198,0
38530,이소영(李素永),정태호(鄭泰浩),81,60,141,0
38531,이소영(李素永),정필모(鄭必模),92,75,167,0
38532,이소영(李素永),정희용(鄭熙溶),51,8,59,1
38533,이소영(李素永),조경태(趙慶泰),50,4,54,1
38534,이소영(李素永),조명희(曺明姬),50,7,57,1
38535,이소영(李素永),조수진(趙修眞),51,4,55,1
38536,이소영(李素永),조승래(趙承來),85,44,129,0
38537,이소영(李素永),조오섭(曺五燮),106,117,223,0
38538,이소영(李素永),조은희(趙恩禧),27,5,32,1
38539,이소영(李素永),조응천(趙應天),77,43,120,0
38540,이소영(李素永),조정식(趙正湜),73,31,104,0
38541,이소영(李素永),조정훈(趙廷訓),4,9,13,1
38542,이소영(李素永),조해진(曺海珍),52,5,57,1
38543,이소영(李素永),주철현(朱哲鉉),93,74,167,0
38544,이소영(李素永),주호영(朱豪英),51,4,55,1
38545,이소영(李素永),지성호(池成浩),50,4,54,1
38546,이소영(李素永),진선미(陳善美),79,46,125,0
38547,이소영(李素永),진성준(陳聲準),101,61,162,0
38548,이소영(李素永),천준호(千俊鎬),90,55,145,0
38549,이소영(李素永),최기상(崔基相),83,64,147,0
38550,이소영(李素永),최승재(崔承宰),50,5,55,1
38551,이소영(李素永),최연숙(崔姸淑),31,9,40,1
38552,이소영(李素永),최영희(崔英姬),25,7,32,1
38553,이소영(李素永),최인호(崔仁昊),83,76,159,0
38554,이소영(李素永),최재형(崔在亨),25,5,30,1
38555,이소영(李素永),최종윤(崔鍾允),90,80,170,0
38556,이소영(李素永),최춘식(崔春植),50,4,54,1
38557,이소영(李素永),최형두(崔炯斗),50,5,55,1
38558,이소영(李素永),최혜영(崔惠英),93,87,180,0
38559,이소영(李素永),추경호(秋慶鎬),49,3,52,1
38560,이소영(李素永),태영호(太永浩),49,5,54,1
38561,이소영(李素永),하영제(河榮帝),42,1,43,1
38562,이소영(李素永),하태경(河泰慶),49,4,53,1
38563,이소영(李素永),한기호(韓起鎬),51,4,55,1
38564,이소영(李素永),한무경(韓茂景),49,5,54,1
38565,이소영(李素永),한병도(韓秉道),104,54,158,0
38566,이소영(李素永),한정애(韓貞愛),73,43,116,0
38567,이소영(李素永),한준호(韓俊鎬),91,89,180,0
38568,이소영(李素永),허숙정(許淑湞),1,2,3,0
38569,이소영(李素永),허영(許榮),117,134,251,0
38570,이소영(李素永),허은아(許垠娥),49,5,54,1
38571,이소영(李素永),허종식(許琮植),90,77,167,0
38572,이소영(李素永),홍기원(洪起元),98,69,167,0
38573,이소영(李素永),홍문표(洪文杓),50,4,54,1
38574,이소영(李素永),홍석준(洪碩晙),50,4,54,1
38575,이소영(李素永),홍성국(洪性國),99,92,191,0
38576,이소영(李素永),홍영표(洪永杓),77,44,121,0
38577,이소영(李素永),홍익표(洪翼杓),83,62,145,0
38578,이소영(李素永),홍정민(洪貞敏),110,104,214,0
38579,이소영(李素永),황보승희(皇甫承希),48,4,52,1
38580,이소영(李素永),황운하(黃雲夏),99,72,171,0
38581,이소영(李素永),황희(黃熙),85,53,138,0
38582,이수진(李壽珍),이수진(李秀眞),140,199,339,0
38583,이수진(李壽珍),이양수(李亮壽),52,4,56,1
38584,이수진(李壽珍),이용(李鏞),49,4,53,1
38585,이수진(李壽珍),이용빈(李龍彬),159,321,480,0
38586,이수진(李壽珍),이용선(李庸瑄),106,159,265,0
38587,이수진(李壽珍),이용우(李龍雨),138,172,310,0
38588,이수진(李壽珍),이용호(李容鎬),42,35,77,1
38589,이수진(李壽珍),이원욱(李元旭),109,134,243,0
38590,이수진(李壽珍),이원택(李源澤),119,118,237,0
38591,이수진(李壽珍),이은주(李恩周),47,195,242,1
38592,이수진(李壽珍),이인선(李仁善),25,5,30,1
38593,이수진(李壽珍),이인영(李仁榮),81,54,135,0
38594,이수진(李壽珍),이장섭(李將燮),96,91,187,0
38595,이수진(李壽珍),이재명(李在明),41,31,72,0
38596,이수진(李壽珍),이재정(李在汀),102,88,190,0
38597,이수진(李壽珍),이정문(李楨文),103,132,235,0
38598,이수진(李壽珍),이종배(李鍾培),50,7,57,1
38599,이수진(李壽珍),이종성(李鍾成),49,5,54,1
38600,이수진(李壽珍),이주환(李周桓),49,5,54,1
38601,이수진(李壽珍),이채익(李埰益),55,7,62,1
38602,이수진(李壽珍),이철규(李喆圭),52,5,57,1
38603,이수진(李壽珍),이탄희(李誕熙),138,168,306,0
38604,이수진(李壽珍),이태규(李泰珪),31,12,43,1
38605,이수진(李壽珍),이학영(李學永),115,138,253,0
38606,이수진(李壽珍),이해식(李海植),132,141,273,0
38607,이수진(李壽珍),이헌승(李憲昇),51,5,56,1
38608,이수진(李壽珍),이형석(李炯錫),115,175,290,0
38609,이수진(李壽珍),인재근(印在謹),113,149,262,0
38610,이수진(李壽珍),임병헌(林炳憲),25,6,31,1
38611,이수진(李壽珍),임오경(林五卿),106,114,220,0
38612,이수진(李壽珍),임이자(林利子),49,4,53,1
38613,이수진(李壽珍),임종성(林鍾聲),162,235,397,0
38614,이수진(李壽珍),임호선(林昊宣),124,201,325,0
38615,이수진(李壽珍),장경태(張耿態),132,257,389,0
38616,이수진(李壽珍),장동혁(張東赫),25,4,29,1
38617,이수진(李壽珍),장제원(張濟元),49,4,53,1
38618,이수진(李壽珍),장철민(張喆敏),154,165,319,0
38619,이수진(李壽珍),장혜영(張惠英),47,173,220,1
38620,이수진(李壽珍),전봉민(田奉珉),35,5,40,1
38621,이수진(李壽珍),전용기(田溶冀),110,132,242,0
38622,이수진(李壽珍),전재수(田載秀),90,71,161,0
38623,이수진(李壽珍),전주혜(全珠惠),51,8,59,1
38624,이수진(李壽珍),전해철(全海澈),81,81,162,0
38625,이수진(李壽珍),전혜숙(全惠淑),143,161,304,0
38626,이수진(李壽珍),정경희(丁慶姬),49,4,53,1
38627,이수진(李壽珍),정동만(鄭東萬),49,4,53,1
38628,이수진(李壽珍),정성호(鄭成湖),101,127,228,0
38629,이수진(李壽珍),정우택(鄭宇澤),25,4,29,1
38630,이수진(李壽珍),정운천(鄭雲天),49,6,55,1
38631,이수진(李壽珍),정일영(鄭日永),111,165,276,0
38632,이수진(李壽珍),정점식(鄭点植),50,4,54,1
38633,이수진(李壽珍),정진석(鄭鎭碩),50,5,55,1
38634,이수진(李壽珍),정청래(鄭淸來),110,130,240,0
38635,이수진(李壽珍),정춘숙(鄭春淑),124,148,272,0
38636,이수진(李壽珍),정태호(鄭泰浩),91,113,204,0
38637,이수진(李壽珍),정필모(鄭必模),112,164,276,0
38638,이수진(李壽珍),정희용(鄭熙溶),50,6,56,1
38639,이수진(李壽珍),조경태(趙慶泰),49,4,53,1
38640,이수진(李壽珍),조명희(曺明姬),49,7,56,1
38641,이수진(李壽珍),조수진(趙修眞),50,5,55,1
38642,이수진(李壽珍),조승래(趙承來),99,73,172,0
38643,이수진(李壽珍),조오섭(曺五燮),127,205,332,0
38644,이수진(李壽珍),조은희(趙恩禧),25,5,30,1
38645,이수진(李壽珍),조응천(趙應天),78,34,112,0
38646,이수진(李壽珍),조정식(趙正湜),81,66,147,0
38647,이수진(李壽珍),조정훈(趙廷訓),14,40,54,1
38648,이수진(李壽珍),조해진(曺海珍),52,6,58,1
38649,이수진(李壽珍),주철현(朱哲鉉),130,170,300,0
38650,이수진(李壽珍),주호영(朱豪英),50,5,55,1
38651,이수진(李壽珍),지성호(池成浩),49,4,53,1
38652,이수진(李壽珍),진선미(陳善美),97,94,191,0
38653,이수진(李壽珍),진성준(陳聲準),122,200,322,0
38654,이수진(李壽珍),천준호(千俊鎬),110,101,211,0
38655,이수진(李壽珍),최기상(崔基相),95,96,191,0
38656,이수진(李壽珍),최승재(崔承宰),49,10,59,1
38657,이수진(李壽珍),최연숙(崔姸淑),37,27,64,1
38658,이수진(李壽珍),최영희(崔英姬),25,6,31,1
38659,이수진(李壽珍),최인호(崔仁昊),90,80,170,0
38660,이수진(李壽珍),최재형(崔在亨),25,4,29,1
38661,이수진(李壽珍),최종윤(崔鍾允),139,166,305,0
38662,이수진(李壽珍),최춘식(崔春植),50,14,64,1
38663,이수진(李壽珍),최형두(崔炯斗),51,6,57,1
38664,이수진(李壽珍),최혜영(崔惠英),147,217,364,0
38665,이수진(李壽珍),추경호(秋慶鎬),49,4,53,1
38666,이수진(李壽珍),태영호(太永浩),49,6,55,1
38667,이수진(李壽珍),하영제(河榮帝),42,3,45,1
38668,이수진(李壽珍),하태경(河泰慶),51,5,56,1
38669,이수진(李壽珍),한기호(韓起鎬),51,4,55,1
38670,이수진(李壽珍),한무경(韓茂景),49,5,54,1
38671,이수진(李壽珍),한병도(韓秉道),114,127,241,0
38672,이수진(李壽珍),한정애(韓貞愛),90,95,185,0
38673,이수진(李壽珍),한준호(韓俊鎬),111,134,245,0
38674,이수진(李壽珍),허숙정(許淑湞),1,2,3,0
38675,이수진(李壽珍),허영(許榮),144,161,305,0
38676,이수진(李壽珍),허은아(許垠娥),49,5,54,1
38677,이수진(李壽珍),허종식(許琮植),122,163,285,0
38678,이수진(李壽珍),홍기원(洪起元),119,133,252,0
38679,이수진(李壽珍),홍문표(洪文杓),50,7,57,1
38680,이수진(李壽珍),홍석준(洪碩晙),52,4,56,1
38681,이수진(李壽珍),홍성국(洪性國),148,190,338,0
38682,이수진(李壽珍),홍영표(洪永杓),93,75,168,0
38683,이수진(李壽珍),홍익표(洪翼杓),103,94,197,0
38684,이수진(李壽珍),홍정민(洪貞敏),124,180,304,0
38685,이수진(李壽珍),황보승희(皇甫承希),47,2,49,1
38686,이수진(李壽珍),황운하(黃雲夏),182,234,416,0
38687,이수진(李壽珍),황희(黃熙),83,50,133,0
38688,이수진(李秀眞),이양수(李亮壽),53,4,57,1
38689,이수진(李秀眞),이용(李鏞),49,4,53,1
38690,이수진(李秀眞),이용빈(李龍彬),144,202,346,0
38691,이수진(李秀眞),이용선(李庸瑄),119,128,247,0
38692,이수진(李秀眞),이용우(李龍雨),161,172,333,0
38693,이수진(李秀眞),이용호(李容鎬),34,18,52,1
38694,이수진(李秀眞),이원욱(李元旭),96,78,174,0
38695,이수진(李秀眞),이원택(李源澤),129,127,256,0
38696,이수진(李秀眞),이은주(李恩周),26,31,57,1
38697,이수진(李秀眞),이인선(李仁善),25,5,30,1
38698,이수진(李秀眞),이인영(李仁榮),80,44,124,0
38699,이수진(李秀眞),이장섭(李將燮),97,93,190,0
38700,이수진(李秀眞),이재명(李在明),40,20,60,0
38701,이수진(李秀眞),이재정(李在汀),93,59,152,0
38702,이수진(李秀眞),이정문(李楨文),106,83,189,0
38703,이수진(李秀眞),이종배(李鍾培),50,7,57,1
38704,이수진(李秀眞),이종성(李鍾成),49,5,54,1
38705,이수진(李秀眞),이주환(李周桓),49,5,54,1
38706,이수진(李秀眞),이채익(李埰益),52,7,59,1
38707,이수진(李秀眞),이철규(李喆圭),52,6,58,1
38708,이수진(李秀眞),이탄희(李誕熙),110,88,198,0
38709,이수진(李秀眞),이태규(李泰珪),29,7,36,1
38710,이수진(李秀眞),이학영(李學永),110,107,217,0
38711,이수진(李秀眞),이해식(李海植),129,118,247,0
38712,이수진(李秀眞),이헌승(李憲昇),50,5,55,1
38713,이수진(李秀眞),이형석(李炯錫),136,120,256,0
38714,이수진(李秀眞),인재근(印在謹),107,106,213,0
38715,이수진(李秀眞),임병헌(林炳憲),25,5,30,1
38716,이수진(李秀眞),임오경(林五卿),195,255,450,0
38717,이수진(李秀眞),임이자(林利子),49,5,54,1
38718,이수진(李秀眞),임종성(林鍾聲),101,108,209,0
38719,이수진(李秀眞),임호선(林昊宣),180,281,461,0
38720,이수진(李秀眞),장경태(張耿態),168,241,409,0
38721,이수진(李秀眞),장동혁(張東赫),25,4,29,1
38722,이수진(李秀眞),장제원(張濟元),49,4,53,1
38723,이수진(李秀眞),장철민(張喆敏),158,153,311,0
38724,이수진(李秀眞),장혜영(張惠英),24,24,48,1
38725,이수진(李秀眞),전봉민(田奉珉),35,6,41,1
38726,이수진(李秀眞),전용기(田溶冀),136,110,246,0
38727,이수진(李秀眞),전재수(田載秀),88,59,147,0
38728,이수진(李秀眞),전주혜(全珠惠),51,7,58,1
38729,이수진(李秀眞),전해철(全海澈),81,58,139,0
38730,이수진(李秀眞),전혜숙(全惠淑),102,105,207,0
38731,이수진(李秀眞),정경희(丁慶姬),49,6,55,1
38732,이수진(李秀眞),정동만(鄭東萬),50,5,55,1
38733,이수진(李秀眞),정성호(鄭成湖),82,70,152,0
38734,이수진(李秀眞),정우택(鄭宇澤),25,5,30,1
38735,이수진(李秀眞),정운천(鄭雲天),50,5,55,1
38736,이수진(李秀眞),정일영(鄭日永),99,132,231,0
38737,이수진(李秀眞),정점식(鄭点植),50,4,54,1
38738,이수진(李秀眞),정진석(鄭鎭碩),50,7,57,1
38739,이수진(李秀眞),정청래(鄭淸來),157,194,351,0
38740,이수진(李秀眞),정춘숙(鄭春淑),104,97,201,0
38741,이수진(李秀眞),정태호(鄭泰浩),109,111,220,0
38742,이수진(李秀眞),정필모(鄭必模),112,137,249,0
38743,이수진(李秀眞),정희용(鄭熙溶),51,8,59,1
38744,이수진(李秀眞),조경태(趙慶泰),50,5,55,1
38745,이수진(李秀眞),조명희(曺明姬),49,6,55,1
38746,이수진(李秀眞),조수진(趙修眞),49,5,54,1
38747,이수진(李秀眞),조승래(趙承來),102,76,178,0
38748,이수진(李秀眞),조오섭(曺五燮),120,174,294,0
38749,이수진(李秀眞),조은희(趙恩禧),25,4,29,1
38750,이수진(李秀眞),조응천(趙應天),80,39,119,0
38751,이수진(李秀眞),조정식(趙正湜),79,47,126,0
38752,이수진(李秀眞),조정훈(趙廷訓),7,17,24,1
38753,이수진(李秀眞),조해진(曺海珍),52,5,57,1
38754,이수진(李秀眞),주철현(朱哲鉉),135,147,282,0
38755,이수진(李秀眞),주호영(朱豪英),50,4,54,1
38756,이수진(李秀眞),지성호(池成浩),49,4,53,1
38757,이수진(李秀眞),진선미(陳善美),98,78,176,0
38758,이수진(李秀眞),진성준(陳聲準),131,166,297,0
38759,이수진(李秀眞),천준호(千俊鎬),106,89,195,0
38760,이수진(李秀眞),최기상(崔基相),99,74,173,0
38761,이수진(李秀眞),최승재(崔承宰),49,6,55,1
38762,이수진(李秀眞),최연숙(崔姸淑),33,13,46,1
38763,이수진(李秀眞),최영희(崔英姬),25,4,29,1
38764,이수진(李秀眞),최인호(崔仁昊),93,59,152,0
38765,이수진(李秀眞),최재형(崔在亨),25,5,30,1
38766,이수진(李秀眞),최종윤(崔鍾允),115,117,232,0
38767,이수진(李秀眞),최춘식(崔春植),49,6,55,1
38768,이수진(李秀眞),최형두(崔炯斗),50,12,62,1
38769,이수진(李秀眞),최혜영(崔惠英),184,230,414,0
38770,이수진(李秀眞),추경호(秋慶鎬),49,3,52,1
38771,이수진(李秀眞),태영호(太永浩),49,5,54,1
38772,이수진(李秀眞),하영제(河榮帝),41,2,43,1
38773,이수진(李秀眞),하태경(河泰慶),50,5,55,1
38774,이수진(李秀眞),한기호(韓起鎬),51,5,56,1
38775,이수진(李秀眞),한무경(韓茂景),49,7,56,1
38776,이수진(李秀眞),한병도(韓秉道),135,124,259,0
38777,이수진(李秀眞),한정애(韓貞愛),85,61,146,0
38778,이수진(李秀眞),한준호(韓俊鎬),149,152,301,0
38779,이수진(李秀眞),허숙정(許淑湞),1,1,2,0
38780,이수진(李秀眞),허영(許榮),140,131,271,0
38781,이수진(李秀眞),허은아(許垠娥),49,5,54,1
38782,이수진(李秀眞),허종식(許琮植),122,129,251,0
38783,이수진(李秀眞),홍기원(洪起元),116,118,234,0
38784,이수진(李秀眞),홍문표(洪文杓),50,9,59,1
38785,이수진(李秀眞),홍석준(洪碩晙),50,4,54,1
38786,이수진(李秀眞),홍성국(洪性國),193,232,425,0
38787,이수진(李秀眞),홍영표(洪永杓),89,66,155,0
38788,이수진(李秀眞),홍익표(洪翼杓),98,81,179,0
38789,이수진(李秀眞),홍정민(洪貞敏),141,144,285,0
38790,이수진(李秀眞),황보승희(皇甫承希),47,3,50,1
38791,이수진(李秀眞),황운하(黃雲夏),164,206,370,0
38792,이수진(李秀眞),황희(黃熙),88,58,146,0
38793,이양수(李亮壽),이용(李鏞),79,88,167,0
38794,이양수(李亮壽),이용빈(李龍彬),53,7,60,1
38795,이양수(李亮壽),이용선(李庸瑄),52,6,58,1
38796,이양수(李亮壽),이용우(李龍雨),51,6,57,1
38797,이양수(李亮壽),이용호(李容鎬),31,22,53,0
38798,이양수(李亮壽),이원욱(李元旭),54,4,58,1
38799,이양수(李亮壽),이원택(李源澤),51,4,55,1
38800,이양수(李亮壽),이은주(李恩周),5,6,11,1
38801,이양수(李亮壽),이인선(李仁善),29,30,59,0
38802,이양수(李亮壽),이인영(李仁榮),50,4,54,1
38803,이양수(李亮壽),이장섭(李將燮),50,4,54,1
38804,이양수(李亮壽),이재명(李在明),25,4,29,1
38805,이양수(李亮壽),이재정(李在汀),51,4,55,1
38806,이양수(李亮壽),이정문(李楨文),52,7,59,1
38807,이양수(李亮壽),이종배(李鍾培),92,77,169,0
38808,이양수(李亮壽),이종성(李鍾成),80,94,174,0
38809,이양수(李亮壽),이주환(李周桓),91,106,197,0
38810,이양수(李亮壽),이채익(李埰益),76,70,146,0
38811,이양수(李亮壽),이철규(李喆圭),95,94,189,0
38812,이양수(李亮壽),이탄희(李誕熙),50,4,54,1
38813,이양수(李亮壽),이태규(李泰珪),36,45,81,0
38814,이양수(李亮壽),이학영(李學永),49,6,55,1
38815,이양수(李亮壽),이해식(李海植),51,4,55,1
38816,이양수(李亮壽),이헌승(李憲昇),91,69,160,0
38817,이양수(李亮壽),이형석(李炯錫),51,4,55,1
38818,이양수(李亮壽),인재근(印在謹),51,5,56,1
38819,이양수(李亮壽),임병헌(林炳憲),34,31,65,0
38820,이양수(李亮壽),임오경(林五卿),51,5,56,1
38821,이양수(李亮壽),임이자(林利子),85,70,155,0
38822,이양수(李亮壽),임종성(林鍾聲),52,4,56,1
38823,이양수(李亮壽),임호선(林昊宣),55,6,61,1
38824,이양수(李亮壽),장경태(張耿態),51,4,55,1
38825,이양수(李亮壽),장동혁(張東赫),29,26,55,0
38826,이양수(李亮壽),장제원(張濟元),62,35,97,0
38827,이양수(李亮壽),장철민(張喆敏),51,7,58,1
38828,이양수(李亮壽),장혜영(張惠英),7,6,13,1
38829,이양수(李亮壽),전봉민(田奉珉),58,48,106,0
38830,이양수(李亮壽),전용기(田溶冀),50,6,56,1
38831,이양수(李亮壽),전재수(田載秀),51,5,56,1
38832,이양수(李亮壽),전주혜(全珠惠),79,98,177,0
38833,이양수(李亮壽),전해철(全海澈),51,4,55,1
38834,이양수(李亮壽),전혜숙(全惠淑),50,4,54,1
38835,이양수(李亮壽),정경희(丁慶姬),82,89,171,0
38836,이양수(李亮壽),정동만(鄭東萬),70,48,118,0
38837,이양수(李亮壽),정성호(鄭成湖),54,4,58,1
38838,이양수(李亮壽),정우택(鄭宇澤),33,30,63,0
38839,이양수(李亮壽),정운천(鄭雲天),98,65,163,0
38840,이양수(李亮壽),정일영(鄭日永),51,5,56,1
38841,이양수(李亮壽),정점식(鄭点植),74,49,123,0
38842,이양수(李亮壽),정진석(鄭鎭碩),76,74,150,0
38843,이양수(李亮壽),정청래(鄭淸來),51,4,55,1
38844,이양수(李亮壽),정춘숙(鄭春淑),52,4,56,1
38845,이양수(李亮壽),정태호(鄭泰浩),51,4,55,1
38846,이양수(李亮壽),정필모(鄭必模),51,4,55,1
38847,이양수(李亮壽),정희용(鄭熙溶),91,91,182,0
38848,이양수(李亮壽),조경태(趙慶泰),72,53,125,0
38849,이양수(李亮壽),조명희(曺明姬),94,129,223,0
38850,이양수(李亮壽),조수진(趙修眞),85,87,172,0
38851,이양수(李亮壽),조승래(趙承來),52,5,57,1
38852,이양수(李亮壽),조오섭(曺五燮),52,5,57,1
38853,이양수(李亮壽),조은희(趙恩禧),34,29,63,0
38854,이양수(李亮壽),조응천(趙應天),50,3,53,1
38855,이양수(李亮壽),조정식(趙正湜),49,3,52,1
38856,이양수(李亮壽),조정훈(趙廷訓),1,2,3,1
38857,이양수(李亮壽),조해진(曺海珍),72,50,122,0
38858,이양수(李亮壽),주철현(朱哲鉉),57,9,66,1
38859,이양수(李亮壽),주호영(朱豪英),70,44,114,0
38860,이양수(李亮壽),지성호(池成浩),79,88,167,0
38861,이양수(李亮壽),진선미(陳善美),51,4,55,1
38862,이양수(李亮壽),진성준(陳聲準),52,5,57,1
38863,이양수(李亮壽),천준호(千俊鎬),50,3,53,1
38864,이양수(李亮壽),최기상(崔基相),51,6,57,1
38865,이양수(李亮壽),최승재(崔承宰),82,81,163,0
38866,이양수(李亮壽),최연숙(崔姸淑),36,34,70,0
38867,이양수(李亮壽),최영희(崔英姬),35,24,59,0
38868,이양수(李亮壽),최인호(崔仁昊),52,4,56,1
38869,이양수(李亮壽),최재형(崔在亨),27,15,42,0
38870,이양수(李亮壽),최종윤(崔鍾允),52,6,58,1
38871,이양수(李亮壽),최춘식(崔春植),85,93,178,0
38872,이양수(李亮壽),최형두(崔炯斗),86,63,149,0
38873,이양수(李亮壽),최혜영(崔惠英),50,5,55,1
38874,이양수(李亮壽),추경호(秋慶鎬),93,84,177,0
38875,이양수(李亮壽),태영호(太永浩),80,91,171,0
38876,이양수(李亮壽),하영제(河榮帝),76,91,167,1
38877,이양수(李亮壽),하태경(河泰慶),67,52,119,0
38878,이양수(李亮壽),한기호(韓起鎬),80,63,143,0
38879,이양수(李亮壽),한무경(韓茂景),81,86,167,0
38880,이양수(李亮壽),한병도(韓秉道),51,4,55,1
38881,이양수(李亮壽),한정애(韓貞愛),50,5,55,1
38882,이양수(李亮壽),한준호(韓俊鎬),53,4,57,1
38883,이양수(李亮壽),허숙정(許淑湞),0,0,0,1
38884,이양수(李亮壽),허영(許榮),59,10,69,1
38885,이양수(李亮壽),허은아(許垠娥),71,61,132,0
38886,이양수(李亮壽),허종식(許琮植),52,7,59,1
38887,이양수(李亮壽),홍기원(洪起元),51,5,56,1
38888,이양수(李亮壽),홍문표(洪文杓),84,64,148,0
38889,이양수(李亮壽),홍석준(洪碩晙),73,65,138,0
38890,이양수(李亮壽),홍성국(洪性國),53,4,57,1
38891,이양수(李亮壽),홍영표(洪永杓),51,4,55,1
38892,이양수(李亮壽),홍익표(洪翼杓),52,4,56,1
38893,이양수(李亮壽),홍정민(洪貞敏),53,4,57,1
38894,이양수(李亮壽),황보승희(皇甫承希),82,89,171,1
38895,이양수(李亮壽),황운하(黃雲夏),52,6,58,1
38896,이양수(李亮壽),황희(黃熙),50,5,55,1
38897,이용(李鏞),이용빈(李龍彬),51,7,58,1
38898,이용(李鏞),이용선(李庸瑄),49,4,53,1
38899,이용(李鏞),이용우(李龍雨),49,6,55,1
38900,이용(李鏞),이용호(李容鎬),35,28,63,0
38901,이용(李鏞),이원욱(李元旭),50,5,55,1
38902,이용(李鏞),이원택(李源澤),49,6,55,1
38903,이용(李鏞),이은주(李恩周),4,6,10,1
38904,이용(李鏞),이인선(李仁善),31,55,86,0
38905,이용(李鏞),이인영(李仁榮),49,4,53,1
38906,이용(李鏞),이장섭(李將燮),49,4,53,1
38907,이용(李鏞),이재명(李在明),25,4,29,1
38908,이용(李鏞),이재정(李在汀),49,4,53,1
38909,이용(李鏞),이정문(李楨文),49,7,56,1
38910,이용(李鏞),이종배(李鍾培),102,134,236,0
38911,이용(李鏞),이종성(李鍾成),97,141,238,0
38912,이용(李鏞),이주환(李周桓),105,188,293,0
38913,이용(李鏞),이채익(李埰益),74,108,182,0
38914,이용(李鏞),이철규(李喆圭),75,74,149,0
38915,이용(李鏞),이탄희(李誕熙),49,4,53,1
38916,이용(李鏞),이태규(李泰珪),38,45,83,0
38917,이용(李鏞),이학영(李學永),49,4,53,1
38918,이용(李鏞),이해식(李海植),49,4,53,1
38919,이용(李鏞),이헌승(李憲昇),68,106,174,0
38920,이용(李鏞),이형석(李炯錫),50,4,54,1
38921,이용(李鏞),인재근(印在謹),50,5,55,1
38922,이용(李鏞),임병헌(林炳憲),32,33,65,0
38923,이용(李鏞),임오경(林五卿),49,5,54,1
38924,이용(李鏞),임이자(林利子),92,104,196,0
38925,이용(李鏞),임종성(林鍾聲),50,6,56,1
38926,이용(李鏞),임호선(林昊宣),50,5,55,1
38927,이용(李鏞),장경태(張耿態),49,4,53,1
38928,이용(李鏞),장동혁(張東赫),33,43,76,0
38929,이용(李鏞),장제원(張濟元),72,48,120,0
38930,이용(李鏞),장철민(張喆敏),50,7,57,1
38931,이용(李鏞),장혜영(張惠英),6,3,9,1
38932,이용(李鏞),전봉민(田奉珉),54,84,138,0
38933,이용(李鏞),전용기(田溶冀),49,5,54,1
38934,이용(李鏞),전재수(田載秀),49,5,54,1
38935,이용(李鏞),전주혜(全珠惠),89,121,210,0
38936,이용(李鏞),전해철(全海澈),49,4,53,1
38937,이용(李鏞),전혜숙(全惠淑),49,5,54,1
38938,이용(李鏞),정경희(丁慶姬),75,104,179,0
38939,이용(李鏞),정동만(鄭東萬),78,83,161,0
38940,이용(李鏞),정성호(鄭成湖),50,4,54,1
38941,이용(李鏞),정우택(鄭宇澤),35,43,78,0
38942,이용(李鏞),정운천(鄭雲天),88,106,194,0
38943,이용(李鏞),정일영(鄭日永),49,4,53,1
38944,이용(李鏞),정점식(鄭点植),68,53,121,0
38945,이용(李鏞),정진석(鄭鎭碩),85,97,182,0
38946,이용(李鏞),정청래(鄭淸來),49,5,54,1
38947,이용(李鏞),정춘숙(鄭春淑),49,4,53,1
38948,이용(李鏞),정태호(鄭泰浩),49,5,54,1
38949,이용(李鏞),정필모(鄭必模),49,4,53,1
38950,이용(李鏞),정희용(鄭熙溶),95,172,267,0
38951,이용(李鏞),조경태(趙慶泰),78,84,162,0
38952,이용(李鏞),조명희(曺明姬),87,140,227,0
38953,이용(李鏞),조수진(趙修眞),87,127,214,0
38954,이용(李鏞),조승래(趙承來),50,4,54,1
38955,이용(李鏞),조오섭(曺五燮),49,4,53,1
38956,이용(李鏞),조은희(趙恩禧),35,50,85,0
38957,이용(李鏞),조응천(趙應天),49,3,52,1
38958,이용(李鏞),조정식(趙正湜),49,3,52,1
38959,이용(李鏞),조정훈(趙廷訓),0,7,7,1
38960,이용(李鏞),조해진(曺海珍),63,34,97,0
38961,이용(李鏞),주철현(朱哲鉉),51,7,58,1
38962,이용(李鏞),주호영(朱豪英),80,86,166,0
38963,이용(李鏞),지성호(池成浩),96,134,230,0
38964,이용(李鏞),진선미(陳善美),49,4,53,1
38965,이용(李鏞),진성준(陳聲準),49,4,53,1
38966,이용(李鏞),천준호(千俊鎬),49,3,52,1
38967,이용(李鏞),최기상(崔基相),50,4,54,1
38968,이용(李鏞),최승재(崔承宰),85,117,202,0
38969,이용(李鏞),최연숙(崔姸淑),32,37,69,0
38970,이용(李鏞),최영희(崔英姬),38,58,96,0
38971,이용(李鏞),최인호(崔仁昊),50,4,54,1
38972,이용(李鏞),최재형(崔在亨),27,15,42,0
38973,이용(李鏞),최종윤(崔鍾允),50,4,54,1
38974,이용(李鏞),최춘식(崔春植),83,118,201,0
38975,이용(李鏞),최형두(崔炯斗),95,123,218,0
38976,이용(李鏞),최혜영(崔惠英),50,8,58,1
38977,이용(李鏞),추경호(秋慶鎬),110,174,284,0
38978,이용(李鏞),태영호(太永浩),101,153,254,0
38979,이용(李鏞),하영제(河榮帝),74,106,180,1
38980,이용(李鏞),하태경(河泰慶),65,51,116,0
38981,이용(李鏞),한기호(韓起鎬),71,59,130,0
38982,이용(李鏞),한무경(韓茂景),95,142,237,0
38983,이용(李鏞),한병도(韓秉道),50,6,56,1
38984,이용(李鏞),한정애(韓貞愛),49,4,53,1
38985,이용(李鏞),한준호(韓俊鎬),50,4,54,1
38986,이용(李鏞),허숙정(許淑湞),0,0,0,1
38987,이용(李鏞),허영(許榮),51,4,55,1
38988,이용(李鏞),허은아(許垠娥),87,75,162,0
38989,이용(李鏞),허종식(許琮植),49,19,68,1
38990,이용(李鏞),홍기원(洪起元),49,5,54,1
38991,이용(李鏞),홍문표(洪文杓),81,123,204,0
38992,이용(李鏞),홍석준(洪碩晙),72,69,141,0
38993,이용(李鏞),홍성국(洪性國),49,5,54,1
38994,이용(李鏞),홍영표(洪永杓),49,4,53,1
38995,이용(李鏞),홍익표(洪翼杓),50,4,54,1
38996,이용(李鏞),홍정민(洪貞敏),50,4,54,1
38997,이용(李鏞),황보승희(皇甫承希),83,99,182,1
38998,이용(李鏞),황운하(黃雲夏),49,5,54,1
38999,이용(李鏞),황희(黃熙),49,5,54,1
39000,이용빈(李龍彬),이용선(李庸瑄),144,257,401,0
39001,이용빈(李龍彬),이용우(李龍雨),152,189,341,0
39002,이용빈(李龍彬),이용호(李容鎬),52,87,139,1
39003,이용빈(李龍彬),이원욱(李元旭),133,246,379,0
39004,이용빈(李龍彬),이원택(李源澤),114,142,256,0
39005,이용빈(李龍彬),이은주(李恩周),43,107,150,1
39006,이용빈(李龍彬),이인선(李仁善),25,4,29,1
39007,이용빈(李龍彬),이인영(李仁榮),78,76,154,0
39008,이용빈(李龍彬),이장섭(李將燮),123,133,256,0
39009,이용빈(李龍彬),이재명(李在明),41,24,65,0
39010,이용빈(李龍彬),이재정(李在汀),92,106,198,0
39011,이용빈(李龍彬),이정문(李楨文),155,284,439,0
39012,이용빈(李龍彬),이종배(李鍾培),52,7,59,1
39013,이용빈(李龍彬),이종성(李鍾成),53,10,63,1
39014,이용빈(李龍彬),이주환(李周桓),52,6,58,1
39015,이용빈(李龍彬),이채익(李埰益),53,12,65,1
39016,이용빈(李龍彬),이철규(李喆圭),53,5,58,1
39017,이용빈(李龍彬),이탄희(李誕熙),124,158,282,0
39018,이용빈(李龍彬),이태규(李泰珪),29,7,36,1
39019,이용빈(李龍彬),이학영(李學永),138,183,321,0
39020,이용빈(李龍彬),이해식(李海植),142,195,337,0
39021,이용빈(李龍彬),이헌승(李憲昇),50,5,55,1
39022,이용빈(李龍彬),이형석(李炯錫),187,276,463,0
39023,이용빈(李龍彬),인재근(印在謹),167,199,366,0
39024,이용빈(李龍彬),임병헌(林炳憲),25,5,30,1
39025,이용빈(李龍彬),임오경(林五卿),118,153,271,0
39026,이용빈(李龍彬),임이자(林利子),52,5,57,1
39027,이용빈(李龍彬),임종성(林鍾聲),129,195,324,0
39028,이용빈(李龍彬),임호선(林昊宣),172,286,458,0
39029,이용빈(李龍彬),장경태(張耿態),149,298,447,0
39030,이용빈(李龍彬),장동혁(張東赫),25,4,29,1
39031,이용빈(李龍彬),장제원(張濟元),49,4,53,1
39032,이용빈(李龍彬),장철민(張喆敏),119,138,257,0
39033,이용빈(李龍彬),장혜영(張惠英),31,81,112,1
39034,이용빈(李龍彬),전봉민(田奉珉),35,5,40,1
39035,이용빈(李龍彬),전용기(田溶冀),146,211,357,0
39036,이용빈(李龍彬),전재수(田載秀),101,109,210,0
39037,이용빈(李龍彬),전주혜(全珠惠),53,6,59,1
39038,이용빈(李龍彬),전해철(全海澈),83,72,155,0
39039,이용빈(李龍彬),전혜숙(全惠淑),123,182,305,0
39040,이용빈(李龍彬),정경희(丁慶姬),51,4,55,1
39041,이용빈(李龍彬),정동만(鄭東萬),49,6,55,1
39042,이용빈(李龍彬),정성호(鄭成湖),104,142,246,0
39043,이용빈(李龍彬),정우택(鄭宇澤),26,5,31,1
39044,이용빈(李龍彬),정운천(鄭雲天),53,10,63,1
39045,이용빈(李龍彬),정일영(鄭日永),123,224,347,0
39046,이용빈(李龍彬),정점식(鄭点植),51,5,56,1
39047,이용빈(李龍彬),정진석(鄭鎭碩),51,5,56,1
39048,이용빈(李龍彬),정청래(鄭淸來),107,96,203,0
39049,이용빈(李龍彬),정춘숙(鄭春淑),155,178,333,0
39050,이용빈(李龍彬),정태호(鄭泰浩),107,133,240,0
39051,이용빈(李龍彬),정필모(鄭必模),132,195,327,0
39052,이용빈(李龍彬),정희용(鄭熙溶),52,9,61,1
39053,이용빈(李龍彬),조경태(趙慶泰),52,5,57,1
39054,이용빈(李龍彬),조명희(曺明姬),53,7,60,1
39055,이용빈(李龍彬),조수진(趙修眞),52,8,60,1
39056,이용빈(李龍彬),조승래(趙承來),145,160,305,0
39057,이용빈(李龍彬),조오섭(曺五燮),193,413,606,0
39058,이용빈(李龍彬),조은희(趙恩禧),26,5,31,1
39059,이용빈(李龍彬),조응천(趙應天),81,57,138,0
39060,이용빈(李龍彬),조정식(趙正湜),89,91,180,0
39061,이용빈(李龍彬),조정훈(趙廷訓),7,17,24,1
39062,이용빈(李龍彬),조해진(曺海珍),52,6,58,1
39063,이용빈(李龍彬),주철현(朱哲鉉),149,232,381,0
39064,이용빈(李龍彬),주호영(朱豪英),49,4,53,1
39065,이용빈(李龍彬),지성호(池成浩),53,7,60,1
39066,이용빈(李龍彬),진선미(陳善美),91,83,174,0
39067,이용빈(李龍彬),진성준(陳聲準),150,216,366,0
39068,이용빈(李龍彬),천준호(千俊鎬),108,107,215,0
39069,이용빈(李龍彬),최기상(崔基相),89,96,185,0
39070,이용빈(李龍彬),최승재(崔承宰),52,13,65,1
39071,이용빈(李龍彬),최연숙(崔姸淑),39,21,60,1
39072,이용빈(李龍彬),최영희(崔英姬),25,5,30,1
39073,이용빈(李龍彬),최인호(崔仁昊),113,164,277,0
39074,이용빈(李龍彬),최재형(崔在亨),25,4,29,1
39075,이용빈(李龍彬),최종윤(崔鍾允),169,284,453,0
39076,이용빈(李龍彬),최춘식(崔春植),49,5,54,1
39077,이용빈(李龍彬),최형두(崔炯斗),51,6,57,1
39078,이용빈(李龍彬),최혜영(崔惠英),163,223,386,0
39079,이용빈(李龍彬),추경호(秋慶鎬),52,5,57,1
39080,이용빈(李龍彬),태영호(太永浩),50,8,58,1
39081,이용빈(李龍彬),하영제(河榮帝),45,5,50,1
39082,이용빈(李龍彬),하태경(河泰慶),52,8,60,1
39083,이용빈(李龍彬),한기호(韓起鎬),53,4,57,1
39084,이용빈(李龍彬),한무경(韓茂景),50,6,56,1
39085,이용빈(李龍彬),한병도(韓秉道),153,268,421,0
39086,이용빈(李龍彬),한정애(韓貞愛),86,84,170,0
39087,이용빈(李龍彬),한준호(韓俊鎬),148,267,415,0
39088,이용빈(李龍彬),허숙정(許淑湞),1,4,5,0
39089,이용빈(李龍彬),허영(許榮),168,221,389,0
39090,이용빈(李龍彬),허은아(許垠娥),49,6,55,1
39091,이용빈(李龍彬),허종식(許琮植),164,241,405,0
39092,이용빈(李龍彬),홍기원(洪起元),122,176,298,0
39093,이용빈(李龍彬),홍문표(洪文杓),53,10,63,1
39094,이용빈(李龍彬),홍석준(洪碩晙),52,6,58,1
39095,이용빈(李龍彬),홍성국(洪性國),195,317,512,0
39096,이용빈(李龍彬),홍영표(洪永杓),89,82,171,0
39097,이용빈(李龍彬),홍익표(洪翼杓),117,143,260,0
39098,이용빈(李龍彬),홍정민(洪貞敏),194,314,508,0
39099,이용빈(李龍彬),황보승희(皇甫承希),49,6,55,1
39100,이용빈(李龍彬),황운하(黃雲夏),159,246,405,0
39101,이용빈(李龍彬),황희(黃熙),90,82,172,0
39102,이용선(李庸瑄),이용우(李龍雨),112,93,205,0
39103,이용선(李庸瑄),이용호(李容鎬),33,25,58,1
39104,이용선(李庸瑄),이원욱(李元旭),98,88,186,0
39105,이용선(李庸瑄),이원택(李源澤),97,69,166,0
39106,이용선(李庸瑄),이은주(李恩周),22,62,84,1
39107,이용선(李庸瑄),이인선(李仁善),25,4,29,1
39108,이용선(李庸瑄),이인영(李仁榮),77,42,119,0
39109,이용선(李庸瑄),이장섭(李將燮),94,79,173,0
39110,이용선(李庸瑄),이재명(李在明),40,23,63,0
39111,이용선(李庸瑄),이재정(李在汀),84,66,150,0
39112,이용선(李庸瑄),이정문(李楨文),108,113,221,0
39113,이용선(李庸瑄),이종배(李鍾培),50,8,58,1
39114,이용선(李庸瑄),이종성(李鍾成),49,8,57,1
39115,이용선(李庸瑄),이주환(李周桓),49,5,54,1
39116,이용선(李庸瑄),이채익(李埰益),52,9,61,1
39117,이용선(李庸瑄),이철규(李喆圭),50,6,56,1
39118,이용선(李庸瑄),이탄희(李誕熙),92,89,181,0
39119,이용선(李庸瑄),이태규(李泰珪),29,6,35,1
39120,이용선(李庸瑄),이학영(李學永),95,110,205,0
39121,이용선(李庸瑄),이해식(李海植),115,107,222,0
39122,이용선(李庸瑄),이헌승(李憲昇),50,5,55,1
39123,이용선(李庸瑄),이형석(李炯錫),101,122,223,0
39124,이용선(李庸瑄),인재근(印在謹),104,82,186,0
39125,이용선(李庸瑄),임병헌(林炳憲),25,4,29,1
39126,이용선(李庸瑄),임오경(林五卿),93,87,180,0
39127,이용선(李庸瑄),임이자(林利子),49,4,53,1
39128,이용선(李庸瑄),임종성(林鍾聲),103,120,223,0
39129,이용선(李庸瑄),임호선(林昊宣),119,124,243,0
39130,이용선(李庸瑄),장경태(張耿態),119,160,279,0
39131,이용선(李庸瑄),장동혁(張東赫),25,4,29,1
39132,이용선(李庸瑄),장제원(張濟元),49,4,53,1
39133,이용선(李庸瑄),장철민(張喆敏),97,82,179,0
39134,이용선(李庸瑄),장혜영(張惠英),20,50,70,1
39135,이용선(李庸瑄),전봉민(田奉珉),35,5,40,1
39136,이용선(李庸瑄),전용기(田溶冀),91,82,173,0
39137,이용선(李庸瑄),전재수(田載秀),87,48,135,0
39138,이용선(李庸瑄),전주혜(全珠惠),51,5,56,1
39139,이용선(李庸瑄),전해철(全海澈),83,71,154,0
39140,이용선(李庸瑄),전혜숙(全惠淑),88,87,175,0
39141,이용선(李庸瑄),정경희(丁慶姬),49,4,53,1
39142,이용선(李庸瑄),정동만(鄭東萬),49,5,54,1
39143,이용선(李庸瑄),정성호(鄭成湖),84,78,162,0
39144,이용선(李庸瑄),정우택(鄭宇澤),25,4,29,1
39145,이용선(李庸瑄),정운천(鄭雲天),49,5,54,1
39146,이용선(李庸瑄),정일영(鄭日永),103,98,201,0
39147,이용선(李庸瑄),정점식(鄭点植),50,4,54,1
39148,이용선(李庸瑄),정진석(鄭鎭碩),50,5,55,1
39149,이용선(李庸瑄),정청래(鄭淸來),86,61,147,0
39150,이용선(李庸瑄),정춘숙(鄭春淑),109,101,210,0
39151,이용선(李庸瑄),정태호(鄭泰浩),92,96,188,0
39152,이용선(李庸瑄),정필모(鄭必模),101,96,197,0
39153,이용선(李庸瑄),정희용(鄭熙溶),50,6,56,1
39154,이용선(李庸瑄),조경태(趙慶泰),49,7,56,1
39155,이용선(李庸瑄),조명희(曺明姬),49,10,59,1
39156,이용선(李庸瑄),조수진(趙修眞),50,4,54,1
39157,이용선(李庸瑄),조승래(趙承來),91,71,162,0
39158,이용선(李庸瑄),조오섭(曺五燮),109,134,243,0
39159,이용선(李庸瑄),조은희(趙恩禧),25,5,30,1
39160,이용선(李庸瑄),조응천(趙應天),72,33,105,0
39161,이용선(李庸瑄),조정식(趙正湜),75,45,120,0
39162,이용선(李庸瑄),조정훈(趙廷訓),6,11,17,1
39163,이용선(李庸瑄),조해진(曺海珍),52,5,57,1
39164,이용선(李庸瑄),주철현(朱哲鉉),96,101,197,0
39165,이용선(李庸瑄),주호영(朱豪英),49,4,53,1
39166,이용선(李庸瑄),지성호(池成浩),49,5,54,1
39167,이용선(李庸瑄),진선미(陳善美),91,57,148,0
39168,이용선(李庸瑄),진성준(陳聲準),103,125,228,0
39169,이용선(李庸瑄),천준호(千俊鎬),113,95,208,0
39170,이용선(李庸瑄),최기상(崔基相),82,57,139,0
39171,이용선(李庸瑄),최승재(崔承宰),49,7,56,1
39172,이용선(李庸瑄),최연숙(崔姸淑),31,18,49,1
39173,이용선(李庸瑄),최영희(崔英姬),25,4,29,1
39174,이용선(李庸瑄),최인호(崔仁昊),89,85,174,0
39175,이용선(李庸瑄),최재형(崔在亨),25,4,29,1
39176,이용선(李庸瑄),최종윤(崔鍾允),101,80,181,0
39177,이용선(李庸瑄),최춘식(崔春植),49,14,63,1
39178,이용선(李庸瑄),최형두(崔炯斗),50,5,55,1
39179,이용선(李庸瑄),최혜영(崔惠英),103,115,218,0
39180,이용선(李庸瑄),추경호(秋慶鎬),49,5,54,1
39181,이용선(李庸瑄),태영호(太永浩),49,7,56,1
39182,이용선(李庸瑄),하영제(河榮帝),42,5,47,1
39183,이용선(李庸瑄),하태경(河泰慶),50,8,58,1
39184,이용선(李庸瑄),한기호(韓起鎬),50,4,54,1
39185,이용선(李庸瑄),한무경(韓茂景),51,6,57,1
39186,이용선(李庸瑄),한병도(韓秉道),109,118,227,0
39187,이용선(李庸瑄),한정애(韓貞愛),82,52,134,0
39188,이용선(李庸瑄),한준호(韓俊鎬),106,113,219,0
39189,이용선(李庸瑄),허숙정(許淑湞),1,2,3,0
39190,이용선(李庸瑄),허영(許榮),126,125,251,0
39191,이용선(李庸瑄),허은아(許垠娥),49,5,54,1
39192,이용선(李庸瑄),허종식(許琮植),113,110,223,0
39193,이용선(李庸瑄),홍기원(洪起元),103,105,208,0
39194,이용선(李庸瑄),홍문표(洪文杓),51,5,56,1
39195,이용선(李庸瑄),홍석준(洪碩晙),50,4,54,1
39196,이용선(李庸瑄),홍성국(洪性國),114,150,264,0
39197,이용선(李庸瑄),홍영표(洪永杓),88,59,147,0
39198,이용선(李庸瑄),홍익표(洪翼杓),94,94,188,0
39199,이용선(李庸瑄),홍정민(洪貞敏),122,166,288,0
39200,이용선(李庸瑄),황보승희(皇甫承希),47,2,49,1
39201,이용선(李庸瑄),황운하(黃雲夏),109,137,246,0
39202,이용선(李庸瑄),황희(黃熙),81,91,172,0
39203,이용우(李龍雨),이용호(李容鎬),30,20,50,1
39204,이용우(李龍雨),이원욱(李元旭),96,83,179,0
39205,이용우(李龍雨),이원택(李源澤),137,124,261,0
39206,이용우(李龍雨),이은주(李恩周),31,26,57,1
39207,이용우(李龍雨),이인선(李仁善),25,5,30,1
39208,이용우(李龍雨),이인영(李仁榮),78,38,116,0
39209,이용우(李龍雨),이장섭(李將燮),92,59,151,0
39210,이용우(李龍雨),이재명(李在明),39,20,59,0
39211,이용우(李龍雨),이재정(李在汀),84,51,135,0
39212,이용우(李龍雨),이정문(李楨文),93,81,174,0
39213,이용우(李龍雨),이종배(李鍾培),50,6,56,1
39214,이용우(李龍雨),이종성(李鍾成),49,11,60,1
39215,이용우(李龍雨),이주환(李周桓),49,5,54,1
39216,이용우(李龍雨),이채익(李埰益),51,10,61,1
39217,이용우(李龍雨),이철규(李喆圭),50,9,59,1
39218,이용우(李龍雨),이탄희(李誕熙),103,82,185,0
39219,이용우(李龍雨),이태규(李泰珪),30,6,36,1
39220,이용우(李龍雨),이학영(李學永),92,69,161,0
39221,이용우(李龍雨),이해식(李海植),112,81,193,0
39222,이용우(李龍雨),이헌승(李憲昇),51,6,57,1
39223,이용우(李龍雨),이형석(李炯錫),118,102,220,0
39224,이용우(李龍雨),인재근(印在謹),105,83,188,0
39225,이용우(李龍雨),임병헌(林炳憲),25,5,30,1
39226,이용우(李龍雨),임오경(林五卿),130,131,261,0
39227,이용우(李龍雨),임이자(林利子),49,4,53,1
39228,이용우(李龍雨),임종성(林鍾聲),106,73,179,0
39229,이용우(李龍雨),임호선(林昊宣),167,210,377,0
39230,이용우(李龍雨),장경태(張耿態),149,155,304,0
39231,이용우(李龍雨),장동혁(張東赫),25,5,30,1
39232,이용우(李龍雨),장제원(張濟元),49,4,53,1
39233,이용우(李龍雨),장철민(張喆敏),122,128,250,0
39234,이용우(李龍雨),장혜영(張惠英),23,22,45,1
39235,이용우(李龍雨),전봉민(田奉珉),36,6,42,1
39236,이용우(李龍雨),전용기(田溶冀),96,96,192,0
39237,이용우(李龍雨),전재수(田載秀),89,64,153,0
39238,이용우(李龍雨),전주혜(全珠惠),50,5,55,1
39239,이용우(李龍雨),전해철(全海澈),78,53,131,0
39240,이용우(李龍雨),전혜숙(全惠淑),101,79,180,0
39241,이용우(李龍雨),정경희(丁慶姬),49,9,58,1
39242,이용우(李龍雨),정동만(鄭東萬),49,4,53,1
39243,이용우(李龍雨),정성호(鄭成湖),85,68,153,0
39244,이용우(李龍雨),정우택(鄭宇澤),25,4,29,1
39245,이용우(李龍雨),정운천(鄭雲天),49,5,54,1
39246,이용우(李龍雨),정일영(鄭日永),106,114,220,0
39247,이용우(李龍雨),정점식(鄭点植),49,4,53,1
39248,이용우(李龍雨),정진석(鄭鎭碩),49,5,54,1
39249,이용우(李龍雨),정청래(鄭淸來),121,101,222,0
39250,이용우(李龍雨),정춘숙(鄭春淑),94,82,176,0
39251,이용우(李龍雨),정태호(鄭泰浩),88,75,163,0
39252,이용우(李龍雨),정필모(鄭必模),113,136,249,0
39253,이용우(李龍雨),정희용(鄭熙溶),50,6,56,1
39254,이용우(李龍雨),조경태(趙慶泰),49,4,53,1
39255,이용우(李龍雨),조명희(曺明姬),50,15,65,1
39256,이용우(李龍雨),조수진(趙修眞),49,10,59,1
39257,이용우(李龍雨),조승래(趙承來),92,64,156,0
39258,이용우(李龍雨),조오섭(曺五燮),98,112,210,0
39259,이용우(李龍雨),조은희(趙恩禧),25,5,30,1
39260,이용우(李龍雨),조응천(趙應天),78,51,129,0
39261,이용우(李龍雨),조정식(趙正湜),80,48,128,0
39262,이용우(李龍雨),조정훈(趙廷訓),5,13,18,1
39263,이용우(李龍雨),조해진(曺海珍),51,5,56,1
39264,이용우(李龍雨),주철현(朱哲鉉),137,145,282,0
39265,이용우(李龍雨),주호영(朱豪英),50,4,54,1
39266,이용우(李龍雨),지성호(池成浩),49,4,53,1
39267,이용우(李龍雨),진선미(陳善美),89,60,149,0
39268,이용우(李龍雨),진성준(陳聲準),143,121,264,0
39269,이용우(李龍雨),천준호(千俊鎬),103,71,174,0
39270,이용우(李龍雨),최기상(崔基相),87,73,160,0
39271,이용우(李龍雨),최승재(崔承宰),50,10,60,1
39272,이용우(李龍雨),최연숙(崔姸淑),33,17,50,1
39273,이용우(李龍雨),최영희(崔英姬),25,5,30,1
39274,이용우(李龍雨),최인호(崔仁昊),85,73,158,0
39275,이용우(李龍雨),최재형(崔在亨),25,4,29,1
39276,이용우(李龍雨),최종윤(崔鍾允),105,97,202,0
39277,이용우(李龍雨),최춘식(崔春植),49,11,60,1
39278,이용우(李龍雨),최형두(崔炯斗),51,6,57,1
39279,이용우(李龍雨),최혜영(崔惠英),137,137,274,0
39280,이용우(李龍雨),추경호(秋慶鎬),49,3,52,1
39281,이용우(李龍雨),태영호(太永浩),49,5,54,1
39282,이용우(李龍雨),하영제(河榮帝),40,2,42,1
39283,이용우(李龍雨),하태경(河泰慶),50,4,54,1
39284,이용우(李龍雨),한기호(韓起鎬),49,4,53,1
39285,이용우(李龍雨),한무경(韓茂景),50,5,55,1
39286,이용우(李龍雨),한병도(韓秉道),100,68,168,0
39287,이용우(李龍雨),한정애(韓貞愛),86,57,143,0
39288,이용우(李龍雨),한준호(韓俊鎬),151,158,309,0
39289,이용우(李龍雨),허숙정(許淑湞),1,2,3,0
39290,이용우(李龍雨),허영(許榮),124,126,250,0
39291,이용우(李龍雨),허은아(許垠娥),49,6,55,1
39292,이용우(李龍雨),허종식(許琮植),121,102,223,0
39293,이용우(李龍雨),홍기원(洪起元),122,125,247,0
39294,이용우(李龍雨),홍문표(洪文杓),49,9,58,1
39295,이용우(李龍雨),홍석준(洪碩晙),49,4,53,1
39296,이용우(李龍雨),홍성국(洪性國),179,208,387,0
39297,이용우(李龍雨),홍영표(洪永杓),86,52,138,0
39298,이용우(李龍雨),홍익표(洪翼杓),88,66,154,0
39299,이용우(李龍雨),홍정민(洪貞敏),178,210,388,0
39300,이용우(李龍雨),황보승희(皇甫承希),45,8,53,1
39301,이용우(李龍雨),황운하(黃雲夏),144,183,327,0
39302,이용우(李龍雨),황희(黃熙),85,55,140,0
39303,이용호(李容鎬),이원욱(李元旭),36,18,54,1
39304,이용호(李容鎬),이원택(李源澤),49,36,85,1
39305,이용호(李容鎬),이은주(李恩周),7,10,17,1
39306,이용호(李容鎬),이인선(李仁善),31,13,44,0
39307,이용호(李容鎬),이인영(李仁榮),29,5,34,1
39308,이용호(李容鎬),이장섭(李將燮),31,26,57,1
39309,이용호(李容鎬),이재명(李在明),26,5,31,1
39310,이용호(李容鎬),이재정(李在汀),30,13,43,1
39311,이용호(李容鎬),이정문(李楨文),32,24,56,1
39312,이용호(李容鎬),이종배(李鍾培),32,35,67,0
39313,이용호(李容鎬),이종성(李鍾成),33,30,63,0
39314,이용호(李容鎬),이주환(李周桓),30,29,59,0
39315,이용호(李容鎬),이채익(李埰益),34,45,79,0
39316,이용호(李容鎬),이철규(李喆圭),45,29,74,0
39317,이용호(李容鎬),이탄희(李誕熙),30,10,40,1
39318,이용호(李容鎬),이태규(李泰珪),36,24,60,0
39319,이용호(李容鎬),이학영(李學永),35,11,46,1
39320,이용호(李容鎬),이해식(李海植),33,17,50,1
39321,이용호(李容鎬),이헌승(李憲昇),28,36,64,0
39322,이용호(李容鎬),이형석(李炯錫),32,23,55,1
39323,이용호(李容鎬),인재근(印在謹),33,25,58,1
39324,이용호(李容鎬),임병헌(林炳憲),40,21,61,0
39325,이용호(李容鎬),임오경(林五卿),39,16,55,1
39326,이용호(李容鎬),임이자(林利子),31,26,57,0
39327,이용호(李容鎬),임종성(林鍾聲),36,31,67,1
39328,이용호(李容鎬),임호선(林昊宣),37,23,60,1
39329,이용호(李容鎬),장경태(張耿態),32,19,51,1
39330,이용호(李容鎬),장동혁(張東赫),34,38,72,0
39331,이용호(李容鎬),장제원(張濟元),28,13,41,0
39332,이용호(李容鎬),장철민(張喆敏),42,26,68,1
39333,이용호(李容鎬),장혜영(張惠英),4,16,20,1
39334,이용호(李容鎬),전봉민(田奉珉),30,18,48,0
39335,이용호(李容鎬),전용기(田溶冀),35,24,59,1
39336,이용호(李容鎬),전재수(田載秀),29,9,38,1
39337,이용호(李容鎬),전주혜(全珠惠),32,22,54,0
39338,이용호(李容鎬),전해철(全海澈),29,9,38,1
39339,이용호(李容鎬),전혜숙(全惠淑),37,21,58,1
39340,이용호(李容鎬),정경희(丁慶姬),29,15,44,0
39341,이용호(李容鎬),정동만(鄭東萬),26,22,48,0
39342,이용호(李容鎬),정성호(鄭成湖),40,42,82,1
39343,이용호(李容鎬),정우택(鄭宇澤),28,34,62,0
39344,이용호(李容鎬),정운천(鄭雲天),32,36,68,0
39345,이용호(李容鎬),정일영(鄭日永),31,12,43,1
39346,이용호(李容鎬),정점식(鄭点植),41,15,56,0
39347,이용호(李容鎬),정진석(鄭鎭碩),30,13,43,0
39348,이용호(李容鎬),정청래(鄭淸來),30,14,44,1
39349,이용호(李容鎬),정춘숙(鄭春淑),36,21,57,1
39350,이용호(李容鎬),정태호(鄭泰浩),31,10,41,1
39351,이용호(李容鎬),정필모(鄭必模),31,19,50,1
39352,이용호(李容鎬),정희용(鄭熙溶),45,28,73,0
39353,이용호(李容鎬),조경태(趙慶泰),32,27,59,0
39354,이용호(李容鎬),조명희(曺明姬),42,27,69,0
39355,이용호(李容鎬),조수진(趙修眞),31,30,61,0
39356,이용호(李容鎬),조승래(趙承來),35,19,54,1
39357,이용호(李容鎬),조오섭(曺五燮),36,32,68,1
39358,이용호(李容鎬),조은희(趙恩禧),28,25,53,0
39359,이용호(李容鎬),조응천(趙應天),27,13,40,1
39360,이용호(李容鎬),조정식(趙正湜),28,7,35,1
39361,이용호(李容鎬),조정훈(趙廷訓),3,15,18,1
39362,이용호(李容鎬),조해진(曺海珍),31,14,45,0
39363,이용호(李容鎬),주철현(朱哲鉉),34,9,43,1
39364,이용호(李容鎬),주호영(朱豪英),28,20,48,0
39365,이용호(李容鎬),지성호(池成浩),32,25,57,0
39366,이용호(李容鎬),진선미(陳善美),29,8,37,1
39367,이용호(李容鎬),진성준(陳聲準),32,18,50,1
39368,이용호(李容鎬),천준호(千俊鎬),33,12,45,1
39369,이용호(李容鎬),최기상(崔基相),29,10,39,1
39370,이용호(李容鎬),최승재(崔承宰),29,23,52,0
39371,이용호(李容鎬),최연숙(崔姸淑),36,34,70,0
39372,이용호(李容鎬),최영희(崔英姬),32,43,75,0
39373,이용호(李容鎬),최인호(崔仁昊),37,25,62,1
39374,이용호(李容鎬),최재형(崔在亨),27,18,45,0
39375,이용호(李容鎬),최종윤(崔鍾允),35,32,67,1
39376,이용호(李容鎬),최춘식(崔春植),30,36,66,0
39377,이용호(李容鎬),최형두(崔炯斗),45,26,71,0
39378,이용호(李容鎬),최혜영(崔惠英),31,18,49,1
39379,이용호(李容鎬),추경호(秋慶鎬),29,23,52,0
39380,이용호(李容鎬),태영호(太永浩),37,36,73,0
39381,이용호(李容鎬),하영제(河榮帝),22,21,43,1
39382,이용호(李容鎬),하태경(河泰慶),27,18,45,0
39383,이용호(李容鎬),한기호(韓起鎬),29,14,43,0
39384,이용호(李容鎬),한무경(韓茂景),28,12,40,0
39385,이용호(李容鎬),한병도(韓秉道),72,75,147,1
39386,이용호(李容鎬),한정애(韓貞愛),28,11,39,1
39387,이용호(李容鎬),한준호(韓俊鎬),31,22,53,1
39388,이용호(李容鎬),허숙정(許淑湞),0,0,0,1
39389,이용호(李容鎬),허영(許榮),38,22,60,1
39390,이용호(李容鎬),허은아(許垠娥),28,17,45,0
39391,이용호(李容鎬),허종식(許琮植),38,31,69,1
39392,이용호(李容鎬),홍기원(洪起元),35,15,50,1
39393,이용호(李容鎬),홍문표(洪文杓),29,36,65,0
39394,이용호(李容鎬),홍석준(洪碩晙),30,16,46,0
39395,이용호(李容鎬),홍성국(洪性國),34,37,71,1
39396,이용호(李容鎬),홍영표(洪永杓),29,15,44,1
39397,이용호(李容鎬),홍익표(洪翼杓),32,19,51,1
39398,이용호(李容鎬),홍정민(洪貞敏),36,23,59,1
39399,이용호(李容鎬),황보승희(皇甫承希),36,25,61,1
39400,이용호(李容鎬),황운하(黃雲夏),46,49,95,1
39401,이용호(李容鎬),황희(黃熙),28,7,35,1
39402,이원욱(李元旭),이원택(李源澤),81,58,139,0
39403,이원욱(李元旭),이은주(李恩周),13,11,24,1
39404,이원욱(李元旭),이인선(李仁善),25,4,29,1
39405,이원욱(李元旭),이인영(李仁榮),76,48,124,0
39406,이원욱(李元旭),이장섭(李將燮),101,79,180,0
39407,이원욱(李元旭),이재명(李在明),38,26,64,0
39408,이원욱(李元旭),이재정(李在汀),88,67,155,0
39409,이원욱(李元旭),이정문(李楨文),111,149,260,0
39410,이원욱(李元旭),이종배(李鍾培),51,7,58,1
39411,이원욱(李元旭),이종성(李鍾成),51,4,55,1
39412,이원욱(李元旭),이주환(李周桓),51,4,55,1
39413,이원욱(李元旭),이채익(李埰益),50,6,56,1
39414,이원욱(李元旭),이철규(李喆圭),53,5,58,1
39415,이원욱(李元旭),이탄희(李誕熙),88,70,158,0
39416,이원욱(李元旭),이태규(李泰珪),29,5,34,1
39417,이원욱(李元旭),이학영(李學永),92,93,185,0
39418,이원욱(李元旭),이해식(李海植),96,78,174,0
39419,이원욱(李元旭),이헌승(李憲昇),52,8,60,1
39420,이원욱(李元旭),이형석(李炯錫),109,129,238,0
39421,이원욱(李元旭),인재근(印在謹),103,109,212,0
39422,이원욱(李元旭),임병헌(林炳憲),26,4,30,1
39423,이원욱(李元旭),임오경(林五卿),99,92,191,0
39424,이원욱(李元旭),임이자(林利子),51,8,59,1
39425,이원욱(李元旭),임종성(林鍾聲),126,115,241,0
39426,이원욱(李元旭),임호선(林昊宣),114,141,255,0
39427,이원욱(李元旭),장경태(張耿態),101,106,207,0
39428,이원욱(李元旭),장동혁(張東赫),25,4,29,1
39429,이원욱(李元旭),장제원(張濟元),49,4,53,1
39430,이원욱(李元旭),장철민(張喆敏),99,136,235,0
39431,이원욱(李元旭),장혜영(張惠英),10,14,24,1
39432,이원욱(李元旭),전봉민(田奉珉),35,4,39,1
39433,이원욱(李元旭),전용기(田溶冀),115,149,264,0
39434,이원욱(李元旭),전재수(田載秀),88,71,159,0
39435,이원욱(李元旭),전주혜(全珠惠),51,5,56,1
39436,이원욱(李元旭),전해철(全海澈),84,71,155,0
39437,이원욱(李元旭),전혜숙(全惠淑),101,104,205,0
39438,이원욱(李元旭),정경희(丁慶姬),52,6,58,1
39439,이원욱(李元旭),정동만(鄭東萬),49,4,53,1
39440,이원욱(李元旭),정성호(鄭成湖),94,94,188,0
39441,이원욱(李元旭),정우택(鄭宇澤),26,6,32,1
39442,이원욱(李元旭),정운천(鄭雲天),50,6,56,1
39443,이원욱(李元旭),정일영(鄭日永),90,126,216,0
39444,이원욱(李元旭),정점식(鄭点植),50,4,54,1
39445,이원욱(李元旭),정진석(鄭鎭碩),52,5,57,1
39446,이원욱(李元旭),정청래(鄭淸來),88,59,147,0
39447,이원욱(李元旭),정춘숙(鄭春淑),104,112,216,0
39448,이원욱(李元旭),정태호(鄭泰浩),88,95,183,0
39449,이원욱(李元旭),정필모(鄭必模),99,97,196,0
39450,이원욱(李元旭),정희용(鄭熙溶),50,5,55,1
39451,이원욱(李元旭),조경태(趙慶泰),51,4,55,1
39452,이원욱(李元旭),조명희(曺明姬),52,6,58,1
39453,이원욱(李元旭),조수진(趙修眞),52,4,56,1
39454,이원욱(李元旭),조승래(趙承來),119,142,261,0
39455,이원욱(李元旭),조오섭(曺五燮),93,154,247,0
39456,이원욱(李元旭),조은희(趙恩禧),26,4,30,1
39457,이원욱(李元旭),조응천(趙應天),82,53,135,0
39458,이원욱(李元旭),조정식(趙正湜),80,65,145,0
39459,이원욱(李元旭),조정훈(趙廷訓),6,12,18,1
39460,이원욱(李元旭),조해진(曺海珍),52,5,57,1
39461,이원욱(李元旭),주철현(朱哲鉉),90,80,170,0
39462,이원욱(李元旭),주호영(朱豪英),51,6,57,1
39463,이원욱(李元旭),지성호(池成浩),50,4,54,1
39464,이원욱(李元旭),진선미(陳善美),83,49,132,0
39465,이원욱(李元旭),진성준(陳聲準),90,62,152,0
39466,이원욱(李元旭),천준호(千俊鎬),85,50,135,0
39467,이원욱(李元旭),최기상(崔基相),82,72,154,0
39468,이원욱(李元旭),최승재(崔承宰),52,5,57,1
39469,이원욱(李元旭),최연숙(崔姸淑),32,6,38,1
39470,이원욱(李元旭),최영희(崔英姬),26,5,31,1
39471,이원욱(李元旭),최인호(崔仁昊),89,97,186,0
39472,이원욱(李元旭),최재형(崔在亨),25,5,30,1
39473,이원욱(李元旭),최종윤(崔鍾允),105,176,281,0
39474,이원욱(李元旭),최춘식(崔春植),49,4,53,1
39475,이원욱(李元旭),최형두(崔炯斗),52,7,59,1
39476,이원욱(李元旭),최혜영(崔惠英),101,140,241,0
39477,이원욱(李元旭),추경호(秋慶鎬),49,3,52,1
39478,이원욱(李元旭),태영호(太永浩),50,7,57,1
39479,이원욱(李元旭),하영제(河榮帝),42,5,47,1
39480,이원욱(李元旭),하태경(河泰慶),49,4,53,1
39481,이원욱(李元旭),한기호(韓起鎬),52,4,56,1
39482,이원욱(李元旭),한무경(韓茂景),50,4,54,1
39483,이원욱(李元旭),한병도(韓秉道),114,128,242,0
39484,이원욱(李元旭),한정애(韓貞愛),89,117,206,0
39485,이원욱(李元旭),한준호(韓俊鎬),108,154,262,0
39486,이원욱(李元旭),허숙정(許淑湞),1,2,3,0
39487,이원욱(李元旭),허영(許榮),114,132,246,0
39488,이원욱(李元旭),허은아(許垠娥),51,6,57,1
39489,이원욱(李元旭),허종식(許琮植),88,94,182,0
39490,이원욱(李元旭),홍기원(洪起元),100,129,229,0
39491,이원욱(李元旭),홍문표(洪文杓),50,7,57,1
39492,이원욱(李元旭),홍석준(洪碩晙),51,6,57,1
39493,이원욱(李元旭),홍성국(洪性國),137,184,321,0
39494,이원욱(李元旭),홍영표(洪永杓),84,71,155,0
39495,이원욱(李元旭),홍익표(洪翼杓),110,110,220,0
39496,이원욱(李元旭),홍정민(洪貞敏),106,150,256,0
39497,이원욱(李元旭),황보승희(皇甫承希),51,3,54,1
39498,이원욱(李元旭),황운하(黃雲夏),90,91,181,0
39499,이원욱(李元旭),황희(黃熙),85,55,140,0
39500,이원택(李源澤),이은주(李恩周),15,27,42,1
39501,이원택(李源澤),이인선(李仁善),25,4,29,1
39502,이원택(李源澤),이인영(李仁榮),81,55,136,0
39503,이원택(李源澤),이장섭(李將燮),84,74,158,0
39504,이원택(李源澤),이재명(李在明),40,18,58,0
39505,이원택(李源澤),이재정(李在汀),88,53,141,0
39506,이원택(李源澤),이정문(李楨文),87,72,159,0
39507,이원택(李源澤),이종배(李鍾培),49,5,54,1
39508,이원택(李源澤),이종성(李鍾成),49,5,54,1
39509,이원택(李源澤),이주환(李周桓),49,4,53,1
39510,이원택(李源澤),이채익(李埰益),51,8,59,1
39511,이원택(李源澤),이철규(李喆圭),52,7,59,1
39512,이원택(李源澤),이탄희(李誕熙),96,61,157,0
39513,이원택(李源澤),이태규(李泰珪),28,4,32,1
39514,이원택(李源澤),이학영(李學永),109,87,196,0
39515,이원택(李源澤),이해식(李海植),111,86,197,0
39516,이원택(李源澤),이헌승(李憲昇),50,4,54,1
39517,이원택(李源澤),이형석(李炯錫),98,82,180,0
39518,이원택(李源澤),인재근(印在謹),95,89,184,0
39519,이원택(李源澤),임병헌(林炳憲),25,4,29,1
39520,이원택(李源澤),임오경(林五卿),130,126,256,0
39521,이원택(李源澤),임이자(林利子),49,4,53,1
39522,이원택(李源澤),임종성(林鍾聲),98,90,188,0
39523,이원택(李源澤),임호선(林昊宣),160,183,343,0
39524,이원택(李源澤),장경태(張耿態),155,179,334,0
39525,이원택(李源澤),장동혁(張東赫),25,4,29,1
39526,이원택(李源澤),장제원(張濟元),49,4,53,1
39527,이원택(李源澤),장철민(張喆敏),124,122,246,0
39528,이원택(李源澤),장혜영(張惠英),13,12,25,1
39529,이원택(李源澤),전봉민(田奉珉),34,4,38,1
39530,이원택(李源澤),전용기(田溶冀),101,105,206,0
39531,이원택(李源澤),전재수(田載秀),96,77,173,0
39532,이원택(李源澤),전주혜(全珠惠),50,5,55,1
39533,이원택(李源澤),전해철(全海澈),77,47,124,0
39534,이원택(李源澤),전혜숙(全惠淑),107,91,198,0
39535,이원택(李源澤),정경희(丁慶姬),49,4,53,1
39536,이원택(李源澤),정동만(鄭東萬),49,5,54,1
39537,이원택(李源澤),정성호(鄭成湖),84,78,162,0
39538,이원택(李源澤),정우택(鄭宇澤),25,4,29,1
39539,이원택(李源澤),정운천(鄭雲天),52,12,64,1
39540,이원택(李源澤),정일영(鄭日永),95,79,174,0
39541,이원택(李源澤),정점식(鄭点植),51,4,55,1
39542,이원택(李源澤),정진석(鄭鎭碩),50,6,56,1
39543,이원택(李源澤),정청래(鄭淸來),141,135,276,0
39544,이원택(李源澤),정춘숙(鄭春淑),92,91,183,0
39545,이원택(李源澤),정태호(鄭泰浩),86,67,153,0
39546,이원택(李源澤),정필모(鄭必模),95,67,162,0
39547,이원택(李源澤),정희용(鄭熙溶),50,4,54,1
39548,이원택(李源澤),조경태(趙慶泰),51,6,57,1
39549,이원택(李源澤),조명희(曺明姬),49,6,55,1
39550,이원택(李源澤),조수진(趙修眞),49,6,55,1
39551,이원택(李源澤),조승래(趙承來),86,54,140,0
39552,이원택(李源澤),조오섭(曺五燮),103,140,243,0
39553,이원택(李源澤),조은희(趙恩禧),25,4,29,1
39554,이원택(李源澤),조응천(趙應天),75,30,105,0
39555,이원택(李源澤),조정식(趙正湜),75,50,125,0
39556,이원택(李源澤),조정훈(趙廷訓),5,7,12,1
39557,이원택(李源澤),조해진(曺海珍),50,4,54,1
39558,이원택(李源澤),주철현(朱哲鉉),171,211,382,0
39559,이원택(李源澤),주호영(朱豪英),49,4,53,1
39560,이원택(李源澤),지성호(池成浩),49,4,53,1
39561,이원택(李源澤),진선미(陳善美),78,54,132,0
39562,이원택(李源澤),진성준(陳聲準),93,90,183,0
39563,이원택(李源澤),천준호(千俊鎬),91,56,147,0
39564,이원택(李源澤),최기상(崔基相),86,66,152,0
39565,이원택(李源澤),최승재(崔承宰),49,4,53,1
39566,이원택(李源澤),최연숙(崔姸淑),33,9,42,1
39567,이원택(李源澤),최영희(崔英姬),25,4,29,1
39568,이원택(李源澤),최인호(崔仁昊),103,90,193,0
39569,이원택(李源澤),최재형(崔在亨),25,4,29,1
39570,이원택(李源澤),최종윤(崔鍾允),103,109,212,0
39571,이원택(李源澤),최춘식(崔春植),51,4,55,1
39572,이원택(李源澤),최형두(崔炯斗),50,4,54,1
39573,이원택(李源澤),최혜영(崔惠英),137,151,288,0
39574,이원택(李源澤),추경호(秋慶鎬),49,5,54,1
39575,이원택(李源澤),태영호(太永浩),50,9,59,1
39576,이원택(李源澤),하영제(河榮帝),41,4,45,1
39577,이원택(李源澤),하태경(河泰慶),49,4,53,1
39578,이원택(李源澤),한기호(韓起鎬),51,5,56,1
39579,이원택(李源澤),한무경(韓茂景),49,4,53,1
39580,이원택(李源澤),한병도(韓秉道),123,150,273,0
39581,이원택(李源澤),한정애(韓貞愛),80,55,135,0
39582,이원택(李源澤),한준호(韓俊鎬),134,133,267,0
39583,이원택(李源澤),허숙정(許淑湞),1,2,3,0
39584,이원택(李源澤),허영(許榮),126,133,259,0
39585,이원택(李源澤),허은아(許垠娥),49,5,54,1
39586,이원택(李源澤),허종식(許琮植),93,65,158,0
39587,이원택(李源澤),홍기원(洪起元),86,64,150,0
39588,이원택(李源澤),홍문표(洪文杓),53,12,65,1
39589,이원택(李源澤),홍석준(洪碩晙),50,4,54,1
39590,이원택(李源澤),홍성국(洪性國),157,178,335,0
39591,이원택(李源澤),홍영표(洪永杓),83,51,134,0
39592,이원택(李源澤),홍익표(洪翼杓),84,72,156,0
39593,이원택(李源澤),홍정민(洪貞敏),94,117,211,0
39594,이원택(李源澤),황보승희(皇甫承希),47,2,49,1
39595,이원택(李源澤),황운하(黃雲夏),128,140,268,0
39596,이원택(李源澤),황희(黃熙),78,42,120,0
39597,이은주(李恩周),이인선(李仁善),0,0,0,1
39598,이은주(李恩周),이인영(李仁榮),13,10,23,1
39599,이은주(李恩周),이장섭(李將燮),15,21,36,1
39600,이은주(李恩周),이재명(李在明),5,4,9,1
39601,이은주(李恩周),이재정(李在汀),19,20,39,1
39602,이은주(李恩周),이정문(李楨文),19,22,41,1
39603,이은주(李恩周),이종배(李鍾培),5,3,8,1
39604,이은주(李恩周),이종성(李鍾成),5,5,10,1
39605,이은주(李恩周),이주환(李周桓),4,3,7,1
39606,이은주(李恩周),이채익(李埰益),8,6,14,1
39607,이은주(李恩周),이철규(李喆圭),5,4,9,1
39608,이은주(李恩周),이탄희(李誕熙),25,52,77,1
39609,이은주(李恩周),이태규(李泰珪),6,7,13,1
39610,이은주(李恩周),이학영(李學永),15,33,48,1
39611,이은주(李恩周),이해식(李海植),22,34,56,1
39612,이은주(李恩周),이헌승(李憲昇),6,3,9,1
39613,이은주(李恩周),이형석(李炯錫),20,34,54,1
39614,이은주(李恩周),인재근(印在謹),21,61,82,1
39615,이은주(李恩周),임병헌(林炳憲),0,1,1,1
39616,이은주(李恩周),임오경(林五卿),18,23,41,1
39617,이은주(李恩周),임이자(林利子),4,3,7,1
39618,이은주(李恩周),임종성(林鍾聲),22,40,62,1
39619,이은주(李恩周),임호선(林昊宣),27,45,72,1
39620,이은주(李恩周),장경태(張耿態),34,55,89,1
39621,이은주(李恩周),장동혁(張東赫),0,0,0,1
39622,이은주(李恩周),장제원(張濟元),4,2,6,1
39623,이은주(李恩周),장철민(張喆敏),22,40,62,1
39624,이은주(李恩周),장혜영(張惠英),85,339,424,0
39625,이은주(李恩周),전봉민(田奉珉),1,2,3,1
39626,이은주(李恩周),전용기(田溶冀),23,35,58,1
39627,이은주(李恩周),전재수(田載秀),12,15,27,1
39628,이은주(李恩周),전주혜(全珠惠),6,3,9,1
39629,이은주(李恩周),전해철(全海澈),11,21,32,1
39630,이은주(李恩周),전혜숙(全惠淑),16,31,47,1
39631,이은주(李恩周),정경희(丁慶姬),4,2,6,1
39632,이은주(李恩周),정동만(鄭東萬),4,3,7,1
39633,이은주(李恩周),정성호(鄭成湖),22,37,59,1
39634,이은주(李恩周),정우택(鄭宇澤),0,0,0,1
39635,이은주(李恩周),정운천(鄭雲天),5,4,9,1
39636,이은주(李恩周),정일영(鄭日永),14,18,32,1
39637,이은주(李恩周),정점식(鄭点植),6,2,8,1
39638,이은주(李恩周),정진석(鄭鎭碩),5,3,8,1
39639,이은주(李恩周),정청래(鄭淸來),13,26,39,1
39640,이은주(李恩周),정춘숙(鄭春淑),28,60,88,1
39641,이은주(李恩周),정태호(鄭泰浩),13,41,54,1
39642,이은주(李恩周),정필모(鄭必模),20,24,44,1
39643,이은주(李恩周),정희용(鄭熙溶),7,4,11,1
39644,이은주(李恩周),조경태(趙慶泰),5,2,7,1
39645,이은주(李恩周),조명희(曺明姬),5,4,9,1
39646,이은주(李恩周),조수진(趙修眞),5,6,11,1
39647,이은주(李恩周),조승래(趙承來),13,17,30,1
39648,이은주(李恩周),조오섭(曺五燮),32,86,118,1
39649,이은주(李恩周),조은희(趙恩禧),3,1,4,1
39650,이은주(李恩周),조응천(趙應天),12,6,18,1
39651,이은주(李恩周),조정식(趙正湜),10,7,17,1
39652,이은주(李恩周),조정훈(趙廷訓),9,47,56,1
39653,이은주(李恩周),조해진(曺海珍),7,5,12,1
39654,이은주(李恩周),주철현(朱哲鉉),17,19,36,1
39655,이은주(李恩周),주호영(朱豪英),4,3,7,1
39656,이은주(李恩周),지성호(池成浩),5,3,8,1
39657,이은주(李恩周),진선미(陳善美),14,15,29,1
39658,이은주(李恩周),진성준(陳聲準),18,34,52,1
39659,이은주(李恩周),천준호(千俊鎬),18,38,56,1
39660,이은주(李恩周),최기상(崔基相),13,14,27,1
39661,이은주(李恩周),최승재(崔承宰),6,7,13,1
39662,이은주(李恩周),최연숙(崔姸淑),8,24,32,1
39663,이은주(李恩周),최영희(崔英姬),1,1,2,1
39664,이은주(李恩周),최인호(崔仁昊),13,8,21,1
39665,이은주(李恩周),최재형(崔在亨),0,0,0,1
39666,이은주(李恩周),최종윤(崔鍾允),23,37,60,1
39667,이은주(李恩周),최춘식(崔春植),8,14,22,1
39668,이은주(李恩周),최형두(崔炯斗),7,3,10,1
39669,이은주(李恩周),최혜영(崔惠英),55,126,181,1
39670,이은주(李恩周),추경호(秋慶鎬),5,3,8,1
39671,이은주(李恩周),태영호(太永浩),4,7,11,1
39672,이은주(李恩周),하영제(河榮帝),5,4,9,1
39673,이은주(李恩周),하태경(河泰慶),5,5,10,1
39674,이은주(李恩周),한기호(韓起鎬),5,2,7,1
39675,이은주(李恩周),한무경(韓茂景),4,4,8,1
39676,이은주(李恩周),한병도(韓秉道),23,20,43,1
39677,이은주(李恩周),한정애(韓貞愛),12,26,38,1
39678,이은주(李恩周),한준호(韓俊鎬),21,23,44,1
39679,이은주(李恩周),허숙정(許淑湞),1,1,2,1
39680,이은주(李恩周),허영(許榮),24,27,51,1
39681,이은주(李恩周),허은아(許垠娥),4,3,7,1
39682,이은주(李恩周),허종식(許琮植),32,68,100,1
39683,이은주(李恩周),홍기원(洪起元),18,27,45,1
39684,이은주(李恩周),홍문표(洪文杓),6,4,10,1
39685,이은주(李恩周),홍석준(洪碩晙),5,3,8,1
39686,이은주(李恩周),홍성국(洪性國),20,35,55,1
39687,이은주(李恩周),홍영표(洪永杓),13,25,38,1
39688,이은주(李恩周),홍익표(洪翼杓),13,19,32,1
39689,이은주(李恩周),홍정민(洪貞敏),27,29,56,1
39690,이은주(李恩周),황보승희(皇甫承希),6,6,12,1
39691,이은주(李恩周),황운하(黃雲夏),30,27,57,1
39692,이은주(李恩周),황희(黃熙),10,11,21,1
39693,이인선(李仁善),이인영(李仁榮),25,4,29,1
39694,이인선(李仁善),이장섭(李將燮),25,5,30,1
39695,이인선(李仁善),이재명(李在明),25,4,29,1
39696,이인선(李仁善),이재정(李在汀),25,4,29,1
39697,이인선(李仁善),이정문(李楨文),25,7,32,1
39698,이인선(李仁善),이종배(李鍾培),30,54,84,0
39699,이인선(李仁善),이종성(李鍾成),30,85,115,0
39700,이인선(李仁善),이주환(李周桓),27,75,102,0
39701,이인선(李仁善),이채익(李埰益),33,59,92,0
39702,이인선(李仁善),이철규(李喆圭),42,28,70,0
39703,이인선(李仁善),이탄희(李誕熙),25,4,29,1
39704,이인선(李仁善),이태규(李泰珪),38,42,80,0
39705,이인선(李仁善),이학영(李學永),25,4,29,1
39706,이인선(李仁善),이해식(李海植),25,4,29,1
39707,이인선(李仁善),이헌승(李憲昇),25,71,96,0
39708,이인선(李仁善),이형석(李炯錫),25,4,29,1
39709,이인선(李仁善),인재근(印在謹),25,6,31,1
39710,이인선(李仁善),임병헌(林炳憲),35,54,89,0
39711,이인선(李仁善),임오경(林五卿),25,4,29,1
39712,이인선(李仁善),임이자(林利子),28,35,63,0
39713,이인선(李仁善),임종성(林鍾聲),25,6,31,1
39714,이인선(李仁善),임호선(林昊宣),25,4,29,1
39715,이인선(李仁善),장경태(張耿態),25,5,30,1
39716,이인선(李仁善),장동혁(張東赫),32,49,81,0
39717,이인선(李仁善),장제원(張濟元),27,9,36,0
39718,이인선(李仁善),장철민(張喆敏),25,4,29,1
39719,이인선(李仁善),장혜영(張惠英),0,0,0,1
39720,이인선(李仁善),전봉민(田奉珉),34,41,75,0
39721,이인선(李仁善),전용기(田溶冀),25,4,29,1
39722,이인선(李仁善),전재수(田載秀),25,4,29,1
39723,이인선(李仁善),전주혜(全珠惠),31,36,67,0
39724,이인선(李仁善),전해철(全海澈),25,4,29,1
39725,이인선(李仁善),전혜숙(全惠淑),25,4,29,1
39726,이인선(李仁善),정경희(丁慶姬),32,30,62,0
39727,이인선(李仁善),정동만(鄭東萬),29,79,108,0
39728,이인선(李仁善),정성호(鄭成湖),27,4,31,1
39729,이인선(李仁善),정우택(鄭宇澤),35,84,119,0
39730,이인선(李仁善),정운천(鄭雲天),47,32,79,0
39731,이인선(李仁善),정일영(鄭日永),25,4,29,1
39732,이인선(李仁善),정점식(鄭点植),28,16,44,0
39733,이인선(李仁善),정진석(鄭鎭碩),27,16,43,0
39734,이인선(李仁善),정청래(鄭淸來),25,4,29,1
39735,이인선(李仁善),정춘숙(鄭春淑),25,5,30,1
39736,이인선(李仁善),정태호(鄭泰浩),25,5,30,1
39737,이인선(李仁善),정필모(鄭必模),25,4,29,1
39738,이인선(李仁善),정희용(鄭熙溶),32,107,139,0
39739,이인선(李仁善),조경태(趙慶泰),29,27,56,0
39740,이인선(李仁善),조명희(曺明姬),37,36,73,0
39741,이인선(李仁善),조수진(趙修眞),28,41,69,0
39742,이인선(李仁善),조승래(趙承來),25,4,29,1
39743,이인선(李仁善),조오섭(曺五燮),26,4,30,1
39744,이인선(李仁善),조은희(趙恩禧),40,51,91,0
39745,이인선(李仁善),조응천(趙應天),25,3,28,1
39746,이인선(李仁善),조정식(趙正湜),25,3,28,1
39747,이인선(李仁善),조정훈(趙廷訓),1,11,12,1
39748,이인선(李仁善),조해진(曺海珍),30,24,54,0
39749,이인선(李仁善),주철현(朱哲鉉),26,4,30,1
39750,이인선(李仁善),주호영(朱豪英),31,32,63,0
39751,이인선(李仁善),지성호(池成浩),33,99,132,0
39752,이인선(李仁善),진선미(陳善美),25,4,29,1
39753,이인선(李仁善),진성준(陳聲準),25,4,29,1
39754,이인선(李仁善),천준호(千俊鎬),25,3,28,1
39755,이인선(李仁善),최기상(崔基相),25,4,29,1
39756,이인선(李仁善),최승재(崔承宰),40,49,89,0
39757,이인선(李仁善),최연숙(崔姸淑),34,37,71,0
39758,이인선(李仁善),최영희(崔英姬),35,50,85,0
39759,이인선(李仁善),최인호(崔仁昊),25,4,29,1
39760,이인선(李仁善),최재형(崔在亨),30,19,49,0
39761,이인선(李仁善),최종윤(崔鍾允),25,4,29,1
39762,이인선(李仁善),최춘식(崔春植),29,70,99,0
39763,이인선(李仁善),최형두(崔炯斗),29,24,53,0
39764,이인선(李仁善),최혜영(崔惠英),25,4,29,1
39765,이인선(李仁善),추경호(秋慶鎬),25,8,33,0
39766,이인선(李仁善),태영호(太永浩),36,88,124,0
39767,이인선(李仁善),하영제(河榮帝),25,39,64,1
39768,이인선(李仁善),하태경(河泰慶),26,28,54,0
39769,이인선(李仁善),한기호(韓起鎬),28,20,48,0
39770,이인선(李仁善),한무경(韓茂景),36,33,69,0
39771,이인선(李仁善),한병도(韓秉道),25,4,29,1
39772,이인선(李仁善),한정애(韓貞愛),25,4,29,1
39773,이인선(李仁善),한준호(韓俊鎬),25,4,29,1
39774,이인선(李仁善),허숙정(許淑湞),0,0,0,1
39775,이인선(李仁善),허영(許榮),25,4,29,1
39776,이인선(李仁善),허은아(許垠娥),31,20,51,0
39777,이인선(李仁善),허종식(許琮植),25,5,30,1
39778,이인선(李仁善),홍기원(洪起元),25,4,29,1
39779,이인선(李仁善),홍문표(洪文杓),26,29,55,0
39780,이인선(李仁善),홍석준(洪碩晙),27,25,52,0
39781,이인선(李仁善),홍성국(洪性國),25,4,29,1
39782,이인선(李仁善),홍영표(洪永杓),25,4,29,1
39783,이인선(李仁善),홍익표(洪翼杓),25,4,29,1
39784,이인선(李仁善),홍정민(洪貞敏),25,5,30,1
39785,이인선(李仁善),황보승희(皇甫承希),23,43,66,1
39786,이인선(李仁善),황운하(黃雲夏),25,5,30,1
39787,이인선(李仁善),황희(黃熙),25,6,31,1
39788,이인영(李仁榮),이장섭(李將燮),78,43,121,0
39789,이인영(李仁榮),이재명(李在明),39,19,58,0
39790,이인영(李仁榮),이재정(李在汀),79,46,125,0
39791,이인영(李仁榮),이정문(李楨文),72,57,129,0
39792,이인영(李仁榮),이종배(李鍾培),50,5,55,1
39793,이인영(李仁榮),이종성(李鍾成),49,4,53,1
39794,이인영(李仁榮),이주환(李周桓),49,4,53,1
39795,이인영(李仁榮),이채익(李埰益),51,5,56,1
39796,이인영(李仁榮),이철규(李喆圭),50,4,54,1
39797,이인영(李仁榮),이탄희(李誕熙),76,45,121,0
39798,이인영(李仁榮),이태규(李泰珪),28,4,32,1
39799,이인영(李仁榮),이학영(李學永),74,62,136,0
39800,이인영(李仁榮),이해식(李海植),75,41,116,0
39801,이인영(李仁榮),이헌승(李憲昇),50,4,54,1
39802,이인영(李仁榮),이형석(李炯錫),74,57,131,0
39803,이인영(李仁榮),인재근(印在謹),92,99,191,0
39804,이인영(李仁榮),임병헌(林炳憲),25,4,29,1
39805,이인영(李仁榮),임오경(林五卿),78,43,121,0
39806,이인영(李仁榮),임이자(林利子),49,4,53,1
39807,이인영(李仁榮),임종성(林鍾聲),85,66,151,0
39808,이인영(李仁榮),임호선(林昊宣),77,50,127,0
39809,이인영(李仁榮),장경태(張耿態),77,54,131,0
39810,이인영(李仁榮),장동혁(張東赫),25,4,29,1
39811,이인영(李仁榮),장제원(張濟元),49,4,53,1
39812,이인영(李仁榮),장철민(張喆敏),76,46,122,0
39813,이인영(李仁榮),장혜영(張惠英),10,5,15,1
39814,이인영(李仁榮),전봉민(田奉珉),35,5,40,1
39815,이인영(李仁榮),전용기(田溶冀),75,46,121,0
39816,이인영(李仁榮),전재수(田載秀),78,39,117,0
39817,이인영(李仁榮),전주혜(全珠惠),51,4,55,1
39818,이인영(李仁榮),전해철(全海澈),79,66,145,0
39819,이인영(李仁榮),전혜숙(全惠淑),82,55,137,0
39820,이인영(李仁榮),정경희(丁慶姬),49,4,53,1
39821,이인영(李仁榮),정동만(鄭東萬),49,4,53,1
39822,이인영(李仁榮),정성호(鄭成湖),78,43,121,0
39823,이인영(李仁榮),정우택(鄭宇澤),25,4,29,1
39824,이인영(李仁榮),정운천(鄭雲天),49,4,53,1
39825,이인영(李仁榮),정일영(鄭日永),77,54,131,0
39826,이인영(李仁榮),정점식(鄭点植),50,4,54,1
39827,이인영(李仁榮),정진석(鄭鎭碩),50,6,56,1
39828,이인영(李仁榮),정청래(鄭淸來),74,43,117,0
39829,이인영(李仁榮),정춘숙(鄭春淑),78,49,127,0
39830,이인영(李仁榮),정태호(鄭泰浩),79,69,148,0
39831,이인영(李仁榮),정필모(鄭必模),78,50,128,0
39832,이인영(李仁榮),정희용(鄭熙溶),50,5,55,1
39833,이인영(李仁榮),조경태(趙慶泰),49,4,53,1
39834,이인영(李仁榮),조명희(曺明姬),49,4,53,1
39835,이인영(李仁榮),조수진(趙修眞),49,4,53,1
39836,이인영(李仁榮),조승래(趙承來),80,65,145,0
39837,이인영(李仁榮),조오섭(曺五燮),91,118,209,0
39838,이인영(李仁榮),조은희(趙恩禧),25,4,29,1
39839,이인영(李仁榮),조응천(趙應天),72,37,109,0
39840,이인영(李仁榮),조정식(趙正湜),74,37,111,0
39841,이인영(李仁榮),조정훈(趙廷訓),0,2,2,1
39842,이인영(李仁榮),조해진(曺海珍),51,5,56,1
39843,이인영(李仁榮),주철현(朱哲鉉),76,56,132,0
39844,이인영(李仁榮),주호영(朱豪英),49,4,53,1
39845,이인영(李仁榮),지성호(池成浩),49,4,53,1
39846,이인영(李仁榮),진선미(陳善美),76,35,111,0
39847,이인영(李仁榮),진성준(陳聲準),77,57,134,0
39848,이인영(李仁榮),천준호(千俊鎬),76,39,115,0
39849,이인영(李仁榮),최기상(崔基相),76,43,119,0
39850,이인영(李仁榮),최승재(崔承宰),49,4,53,1
39851,이인영(李仁榮),최연숙(崔姸淑),29,9,38,1
39852,이인영(李仁榮),최영희(崔英姬),25,5,30,1
39853,이인영(李仁榮),최인호(崔仁昊),75,44,119,0
39854,이인영(李仁榮),최재형(崔在亨),25,4,29,1
39855,이인영(李仁榮),최종윤(崔鍾允),96,142,238,0
39856,이인영(李仁榮),최춘식(崔春植),49,4,53,1
39857,이인영(李仁榮),최형두(崔炯斗),50,5,55,1
39858,이인영(李仁榮),최혜영(崔惠英),75,57,132,0
39859,이인영(李仁榮),추경호(秋慶鎬),49,3,52,1
39860,이인영(李仁榮),태영호(太永浩),49,4,53,1
39861,이인영(李仁榮),하영제(河榮帝),41,1,42,1
39862,이인영(李仁榮),하태경(河泰慶),49,4,53,1
39863,이인영(李仁榮),한기호(韓起鎬),50,4,54,1
39864,이인영(李仁榮),한무경(韓茂景),49,4,53,1
39865,이인영(李仁榮),한병도(韓秉道),82,50,132,0
39866,이인영(李仁榮),한정애(韓貞愛),75,42,117,0
39867,이인영(李仁榮),한준호(韓俊鎬),77,73,150,0
39868,이인영(李仁榮),허숙정(許淑湞),1,1,2,0
39869,이인영(李仁榮),허영(許榮),86,60,146,0
39870,이인영(李仁榮),허은아(許垠娥),49,4,53,1
39871,이인영(李仁榮),허종식(許琮植),78,45,123,0
39872,이인영(李仁榮),홍기원(洪起元),77,51,128,0
39873,이인영(李仁榮),홍문표(洪文杓),50,4,54,1
39874,이인영(李仁榮),홍석준(洪碩晙),50,4,54,1
39875,이인영(李仁榮),홍성국(洪性國),76,63,139,0
39876,이인영(李仁榮),홍영표(洪永杓),77,53,130,0
39877,이인영(李仁榮),홍익표(洪翼杓),78,52,130,0
39878,이인영(李仁榮),홍정민(洪貞敏),75,49,124,0
39879,이인영(李仁榮),황보승희(皇甫承希),45,1,46,1
39880,이인영(李仁榮),황운하(黃雲夏),85,63,148,0
39881,이인영(李仁榮),황희(黃熙),75,41,116,0
39882,이장섭(李將燮),이재명(李在明),41,20,61,0
39883,이장섭(李將燮),이재정(李在汀),85,59,144,0
39884,이장섭(李將燮),이정문(李楨文),92,87,179,0
39885,이장섭(李將燮),이종배(李鍾培),50,9,59,1
39886,이장섭(李將燮),이종성(李鍾成),49,7,56,1
39887,이장섭(李將燮),이주환(李周桓),49,4,53,1
39888,이장섭(李將燮),이채익(李埰益),51,7,58,1
39889,이장섭(李將燮),이철규(李喆圭),51,4,55,1
39890,이장섭(李將燮),이탄희(李誕熙),95,87,182,0
39891,이장섭(李將燮),이태규(李泰珪),28,4,32,1
39892,이장섭(李將燮),이학영(李學永),123,207,330,0
39893,이장섭(李將燮),이해식(李海植),96,83,179,0
39894,이장섭(李將燮),이헌승(李憲昇),50,4,54,1
39895,이장섭(李將燮),이형석(李炯錫),102,101,203,0
39896,이장섭(李將燮),인재근(印在謹),129,117,246,0
39897,이장섭(李將燮),임병헌(林炳憲),25,4,29,1
39898,이장섭(李將燮),임오경(林五卿),87,75,162,0
39899,이장섭(李將燮),임이자(林利子),49,4,53,1
39900,이장섭(李將燮),임종성(林鍾聲),103,95,198,0
39901,이장섭(李將燮),임호선(林昊宣),157,325,482,0
39902,이장섭(李將燮),장경태(張耿態),84,72,156,0
39903,이장섭(李將燮),장동혁(張東赫),25,4,29,1
39904,이장섭(李將燮),장제원(張濟元),49,4,53,1
39905,이장섭(李將燮),장철민(張喆敏),88,60,148,0
39906,이장섭(李將燮),장혜영(張惠英),12,15,27,1
39907,이장섭(李將燮),전봉민(田奉珉),35,5,40,1
39908,이장섭(李將燮),전용기(田溶冀),124,176,300,0
39909,이장섭(李將燮),전재수(田載秀),109,121,230,0
39910,이장섭(李將燮),전주혜(全珠惠),51,4,55,1
39911,이장섭(李將燮),전해철(全海澈),78,48,126,0
39912,이장섭(李將燮),전혜숙(全惠淑),92,95,187,0
39913,이장섭(李將燮),정경희(丁慶姬),49,4,53,1
39914,이장섭(李將燮),정동만(鄭東萬),49,4,53,1
39915,이장섭(李將燮),정성호(鄭成湖),80,63,143,0
39916,이장섭(李將燮),정우택(鄭宇澤),26,5,31,1
39917,이장섭(李將燮),정운천(鄭雲天),49,5,54,1
39918,이장섭(李將燮),정일영(鄭日永),89,67,156,0
39919,이장섭(李將燮),정점식(鄭点植),50,5,55,1
39920,이장섭(李將燮),정진석(鄭鎭碩),50,5,55,1
39921,이장섭(李將燮),정청래(鄭淸來),94,81,175,0
39922,이장섭(李將燮),정춘숙(鄭春淑),96,82,178,0
39923,이장섭(李將燮),정태호(鄭泰浩),93,112,205,0
39924,이장섭(李將燮),정필모(鄭必模),93,95,188,0
39925,이장섭(李將燮),정희용(鄭熙溶),50,5,55,1
39926,이장섭(李將燮),조경태(趙慶泰),49,4,53,1
39927,이장섭(李將燮),조명희(曺明姬),49,5,54,1
39928,이장섭(李將燮),조수진(趙修眞),50,5,55,1
39929,이장섭(李將燮),조승래(趙承來),94,69,163,0
39930,이장섭(李將燮),조오섭(曺五燮),112,138,250,0
39931,이장섭(李將燮),조은희(趙恩禧),25,5,30,1
39932,이장섭(李將燮),조응천(趙應天),76,40,116,0
39933,이장섭(李將燮),조정식(趙正湜),83,60,143,0
39934,이장섭(李將燮),조정훈(趙廷訓),2,6,8,1
39935,이장섭(李將燮),조해진(曺海珍),51,5,56,1
39936,이장섭(李將燮),주철현(朱哲鉉),94,77,171,0
39937,이장섭(李將燮),주호영(朱豪英),49,4,53,1
39938,이장섭(李將燮),지성호(池成浩),49,5,54,1
39939,이장섭(李將燮),진선미(陳善美),85,58,143,0
39940,이장섭(李將燮),진성준(陳聲準),94,86,180,0
39941,이장섭(李將燮),천준호(千俊鎬),86,58,144,0
39942,이장섭(李將燮),최기상(崔基相),85,81,166,0
39943,이장섭(李將燮),최승재(崔承宰),50,6,56,1
39944,이장섭(李將燮),최연숙(崔姸淑),32,14,46,1
39945,이장섭(李將燮),최영희(崔英姬),25,5,30,1
39946,이장섭(李將燮),최인호(崔仁昊),100,126,226,0
39947,이장섭(李將燮),최재형(崔在亨),25,4,29,1
39948,이장섭(李將燮),최종윤(崔鍾允),98,80,178,0
39949,이장섭(李將燮),최춘식(崔春植),49,5,54,1
39950,이장섭(李將燮),최형두(崔炯斗),50,4,54,1
39951,이장섭(李將燮),최혜영(崔惠英),112,125,237,0
39952,이장섭(李將燮),추경호(秋慶鎬),49,3,52,1
39953,이장섭(李將燮),태영호(太永浩),49,4,53,1
39954,이장섭(李將燮),하영제(河榮帝),41,1,42,1
39955,이장섭(李將燮),하태경(河泰慶),49,4,53,1
39956,이장섭(李將燮),한기호(韓起鎬),50,4,54,1
39957,이장섭(李將燮),한무경(韓茂景),49,4,53,1
39958,이장섭(李將燮),한병도(韓秉道),116,103,219,0
39959,이장섭(李將燮),한정애(韓貞愛),85,60,145,0
39960,이장섭(李將燮),한준호(韓俊鎬),100,109,209,0
39961,이장섭(李將燮),허숙정(許淑湞),1,2,3,0
39962,이장섭(李將燮),허영(許榮),106,117,223,0
39963,이장섭(李將燮),허은아(許垠娥),49,5,54,1
39964,이장섭(李將燮),허종식(許琮植),83,67,150,0
39965,이장섭(李將燮),홍기원(洪起元),94,75,169,0
39966,이장섭(李將燮),홍문표(洪文杓),50,4,54,1
39967,이장섭(李將燮),홍석준(洪碩晙),50,4,54,1
39968,이장섭(李將燮),홍성국(洪性國),122,172,294,0
39969,이장섭(李將燮),홍영표(洪永杓),81,59,140,0
39970,이장섭(李將燮),홍익표(洪翼杓),117,134,251,0
39971,이장섭(李將燮),홍정민(洪貞敏),104,92,196,0
39972,이장섭(李將燮),황보승희(皇甫承希),48,1,49,1
39973,이장섭(李將燮),황운하(黃雲夏),105,90,195,0
39974,이장섭(李將燮),황희(黃熙),81,49,130,0
39975,이재명(李在明),이재정(李在汀),40,26,66,0
39976,이재명(李在明),이정문(李楨文),40,20,60,0
39977,이재명(李在明),이종배(李鍾培),26,6,32,1
39978,이재명(李在明),이종성(李鍾成),25,4,29,1
39979,이재명(李在明),이주환(李周桓),25,4,29,1
39980,이재명(李在明),이채익(李埰益),26,5,31,1
39981,이재명(李在明),이철규(李喆圭),25,4,29,1
39982,이재명(李在明),이탄희(李誕熙),40,23,63,0
39983,이재명(李在明),이태규(李泰珪),25,4,29,1
39984,이재명(李在明),이학영(李學永),41,21,62,0
39985,이재명(李在明),이해식(李海植),40,22,62,0
39986,이재명(李在明),이헌승(李憲昇),25,4,29,1
39987,이재명(李在明),이형석(李炯錫),40,22,62,0
39988,이재명(李在明),인재근(印在謹),40,23,63,0
39989,이재명(李在明),임병헌(林炳憲),25,4,29,1
39990,이재명(李在明),임오경(林五卿),40,25,65,0
39991,이재명(李在明),임이자(林利子),25,4,29,1
39992,이재명(李在明),임종성(林鍾聲),40,25,65,0
39993,이재명(李在明),임호선(林昊宣),40,26,66,0
39994,이재명(李在明),장경태(張耿態),40,25,65,0
39995,이재명(李在明),장동혁(張東赫),25,4,29,1
39996,이재명(李在明),장제원(張濟元),25,4,29,1
39997,이재명(李在明),장철민(張喆敏),39,20,59,0
39998,이재명(李在明),장혜영(張惠英),5,6,11,1
39999,이재명(李在明),전봉민(田奉珉),26,5,31,1
40000,이재명(李在明),전용기(田溶冀),39,21,60,0
40001,이재명(李在明),전재수(田載秀),38,19,57,0
40002,이재명(李在明),전주혜(全珠惠),26,4,30,1
40003,이재명(李在明),전해철(全海澈),39,23,62,0
40004,이재명(李在明),전혜숙(全惠淑),39,19,58,0
40005,이재명(李在明),정경희(丁慶姬),25,4,29,1
40006,이재명(李在明),정동만(鄭東萬),25,4,29,1
40007,이재명(李在明),정성호(鄭成湖),39,27,66,0
40008,이재명(李在明),정우택(鄭宇澤),25,4,29,1
40009,이재명(李在明),정운천(鄭雲天),25,4,29,1
40010,이재명(李在明),정일영(鄭日永),41,21,62,0
40011,이재명(李在明),정점식(鄭点植),25,4,29,1
40012,이재명(李在明),정진석(鄭鎭碩),25,4,29,1
40013,이재명(李在明),정청래(鄭淸來),40,17,57,0
40014,이재명(李在明),정춘숙(鄭春淑),39,21,60,0
40015,이재명(李在明),정태호(鄭泰浩),39,23,62,0
40016,이재명(李在明),정필모(鄭必模),40,24,64,0
40017,이재명(李在明),정희용(鄭熙溶),26,5,31,1
40018,이재명(李在明),조경태(趙慶泰),25,4,29,1
40019,이재명(李在明),조명희(曺明姬),25,4,29,1
40020,이재명(李在明),조수진(趙修眞),25,4,29,1
40021,이재명(李在明),조승래(趙承來),40,18,58,0
40022,이재명(李在明),조오섭(曺五燮),40,22,62,0
40023,이재명(李在明),조은희(趙恩禧),25,4,29,1
40024,이재명(李在明),조응천(趙應天),38,14,52,0
40025,이재명(李在明),조정식(趙正湜),40,23,63,0
40026,이재명(李在明),조정훈(趙廷訓),0,1,1,1
40027,이재명(李在明),조해진(曺海珍),26,5,31,1
40028,이재명(李在明),주철현(朱哲鉉),41,27,68,0
40029,이재명(李在明),주호영(朱豪英),25,4,29,1
40030,이재명(李在明),지성호(池成浩),25,4,29,1
40031,이재명(李在明),진선미(陳善美),39,18,57,0
40032,이재명(李在明),진성준(陳聲準),40,23,63,0
40033,이재명(李在明),천준호(千俊鎬),40,17,57,0
40034,이재명(李在明),최기상(崔基相),41,23,64,0
40035,이재명(李在明),최승재(崔承宰),25,4,29,1
40036,이재명(李在明),최연숙(崔姸淑),26,5,31,1
40037,이재명(李在明),최영희(崔英姬),25,4,29,1
40038,이재명(李在明),최인호(崔仁昊),40,18,58,0
40039,이재명(李在明),최재형(崔在亨),25,4,29,1
40040,이재명(李在明),최종윤(崔鍾允),39,24,63,0
40041,이재명(李在明),최춘식(崔春植),25,4,29,1
40042,이재명(李在明),최형두(崔炯斗),25,4,29,1
40043,이재명(李在明),최혜영(崔惠英),41,24,65,0
40044,이재명(李在明),추경호(秋慶鎬),25,3,28,1
40045,이재명(李在明),태영호(太永浩),25,4,29,1
40046,이재명(李在明),하영제(河榮帝),16,1,17,1
40047,이재명(李在明),하태경(河泰慶),25,4,29,1
40048,이재명(李在明),한기호(韓起鎬),25,4,29,1
40049,이재명(李在明),한무경(韓茂景),25,4,29,1
40050,이재명(李在明),한병도(韓秉道),40,18,58,0
40051,이재명(李在明),한정애(韓貞愛),41,19,60,0
40052,이재명(李在明),한준호(韓俊鎬),40,23,63,0
40053,이재명(李在明),허숙정(許淑湞),1,1,2,0
40054,이재명(李在明),허영(許榮),41,21,62,0
40055,이재명(李在明),허은아(許垠娥),25,4,29,1
40056,이재명(李在明),허종식(許琮植),41,21,62,0
40057,이재명(李在明),홍기원(洪起元),40,20,60,0
40058,이재명(李在明),홍문표(洪文杓),25,4,29,1
40059,이재명(李在明),홍석준(洪碩晙),25,4,29,1
40060,이재명(李在明),홍성국(洪性國),40,20,60,0
40061,이재명(李在明),홍영표(洪永杓),39,17,56,0
40062,이재명(李在明),홍익표(洪翼杓),40,23,63,0
40063,이재명(李在明),홍정민(洪貞敏),41,24,65,0
40064,이재명(李在明),황보승희(皇甫承希),20,1,21,1
40065,이재명(李在明),황운하(黃雲夏),41,22,63,0
40066,이재명(李在明),황희(黃熙),40,20,60,0
40067,이재정(李在汀),이정문(李楨文),93,48,141,0
40068,이재정(李在汀),이종배(李鍾培),50,6,56,1
40069,이재정(李在汀),이종성(李鍾成),49,4,53,1
40070,이재정(李在汀),이주환(李周桓),49,4,53,1
40071,이재정(李在汀),이채익(李埰益),52,6,58,1
40072,이재정(李在汀),이철규(李喆圭),50,4,54,1
40073,이재정(李在汀),이탄희(李誕熙),100,80,180,0
40074,이재정(李在汀),이태규(李泰珪),28,4,32,1
40075,이재정(李在汀),이학영(李學永),83,74,157,0
40076,이재정(李在汀),이해식(李海植),85,52,137,0
40077,이재정(李在汀),이헌승(李憲昇),50,4,54,1
40078,이재정(李在汀),이형석(李炯錫),87,65,152,0
40079,이재정(李在汀),인재근(印在謹),86,81,167,0
40080,이재정(李在汀),임병헌(林炳憲),25,4,29,1
40081,이재정(李在汀),임오경(林五卿),93,61,154,0
40082,이재정(李在汀),임이자(林利子),49,4,53,1
40083,이재정(李在汀),임종성(林鍾聲),89,65,154,0
40084,이재정(李在汀),임호선(林昊宣),94,83,177,0
40085,이재정(李在汀),장경태(張耿態),101,68,169,0
40086,이재정(李在汀),장동혁(張東赫),25,4,29,1
40087,이재정(李在汀),장제원(張濟元),49,4,53,1
40088,이재정(李在汀),장철민(張喆敏),80,49,129,0
40089,이재정(李在汀),장혜영(張惠英),13,15,28,1
40090,이재정(李在汀),전봉민(田奉珉),35,5,40,1
40091,이재정(李在汀),전용기(田溶冀),92,58,150,0
40092,이재정(李在汀),전재수(田載秀),77,47,124,0
40093,이재정(李在汀),전주혜(全珠惠),51,4,55,1
40094,이재정(李在汀),전해철(全海澈),75,52,127,0
40095,이재정(李在汀),전혜숙(全惠淑),92,74,166,0
40096,이재정(李在汀),정경희(丁慶姬),49,4,53,1
40097,이재정(李在汀),정동만(鄭東萬),49,4,53,1
40098,이재정(李在汀),정성호(鄭成湖),78,50,128,0
40099,이재정(李在汀),정우택(鄭宇澤),25,4,29,1
40100,이재정(李在汀),정운천(鄭雲天),49,4,53,1
40101,이재정(李在汀),정일영(鄭日永),82,55,137,0
40102,이재정(李在汀),정점식(鄭点植),50,4,54,1
40103,이재정(李在汀),정진석(鄭鎭碩),50,5,55,1
40104,이재정(李在汀),정청래(鄭淸來),93,44,137,0
40105,이재정(李在汀),정춘숙(鄭春淑),85,58,143,0
40106,이재정(李在汀),정태호(鄭泰浩),82,69,151,0
40107,이재정(李在汀),정필모(鄭必模),81,63,144,0
40108,이재정(李在汀),정희용(鄭熙溶),50,5,55,1
40109,이재정(李在汀),조경태(趙慶泰),53,5,58,1
40110,이재정(李在汀),조명희(曺明姬),49,5,54,1
40111,이재정(李在汀),조수진(趙修眞),49,4,53,1
40112,이재정(李在汀),조승래(趙承來),88,53,141,0
40113,이재정(李在汀),조오섭(曺五燮),89,91,180,0
40114,이재정(李在汀),조은희(趙恩禧),25,4,29,1
40115,이재정(李在汀),조응천(趙應天),73,32,105,0
40116,이재정(李在汀),조정식(趙正湜),80,41,121,0
40117,이재정(李在汀),조정훈(趙廷訓),2,5,7,1
40118,이재정(李在汀),조해진(曺海珍),52,5,57,1
40119,이재정(李在汀),주철현(朱哲鉉),87,58,145,0
40120,이재정(李在汀),주호영(朱豪英),49,4,53,1
40121,이재정(李在汀),지성호(池成浩),49,5,54,1
40122,이재정(李在汀),진선미(陳善美),81,46,127,0
40123,이재정(李在汀),진성준(陳聲準),94,66,160,0
40124,이재정(李在汀),천준호(千俊鎬),84,48,132,0
40125,이재정(李在汀),최기상(崔基相),78,45,123,0
40126,이재정(李在汀),최승재(崔承宰),49,4,53,1
40127,이재정(李在汀),최연숙(崔姸淑),30,7,37,1
40128,이재정(李在汀),최영희(崔英姬),25,4,29,1
40129,이재정(李在汀),최인호(崔仁昊),79,49,128,0
40130,이재정(李在汀),최재형(崔在亨),25,4,29,1
40131,이재정(李在汀),최종윤(崔鍾允),92,78,170,0
40132,이재정(李在汀),최춘식(崔春植),49,4,53,1
40133,이재정(李在汀),최형두(崔炯斗),50,4,54,1
40134,이재정(李在汀),최혜영(崔惠英),102,109,211,0
40135,이재정(李在汀),추경호(秋慶鎬),49,3,52,1
40136,이재정(李在汀),태영호(太永浩),49,5,54,1
40137,이재정(李在汀),하영제(河榮帝),41,1,42,1
40138,이재정(李在汀),하태경(河泰慶),50,5,55,1
40139,이재정(李在汀),한기호(韓起鎬),50,4,54,1
40140,이재정(李在汀),한무경(韓茂景),49,4,53,1
40141,이재정(李在汀),한병도(韓秉道),88,56,144,0
40142,이재정(李在汀),한정애(韓貞愛),73,39,112,0
40143,이재정(李在汀),한준호(韓俊鎬),86,64,150,0
40144,이재정(李在汀),허숙정(許淑湞),1,2,3,0
40145,이재정(李在汀),허영(許榮),89,66,155,0
40146,이재정(李在汀),허은아(許垠娥),49,4,53,1
40147,이재정(李在汀),허종식(許琮植),80,67,147,0
40148,이재정(李在汀),홍기원(洪起元),85,49,134,0
40149,이재정(李在汀),홍문표(洪文杓),52,5,57,1
40150,이재정(李在汀),홍석준(洪碩晙),50,4,54,1
40151,이재정(李在汀),홍성국(洪性國),92,68,160,0
40152,이재정(李在汀),홍영표(洪永杓),77,41,118,0
40153,이재정(李在汀),홍익표(洪翼杓),87,75,162,0
40154,이재정(李在汀),홍정민(洪貞敏),97,68,165,0
40155,이재정(李在汀),황보승희(皇甫承希),46,1,47,1
40156,이재정(李在汀),황운하(黃雲夏),90,70,160,0
40157,이재정(李在汀),황희(黃熙),79,42,121,0
40158,이정문(李楨文),이종배(李鍾培),49,6,55,1
40159,이정문(李楨文),이종성(李鍾成),49,7,56,1
40160,이정문(李楨文),이주환(李周桓),49,4,53,1
40161,이정문(李楨文),이채익(李埰益),50,4,54,1
40162,이정문(李楨文),이철규(李喆圭),51,4,55,1
40163,이정문(李楨文),이탄희(李誕熙),106,84,190,0
40164,이정문(李楨文),이태규(李泰珪),28,4,32,1
40165,이정문(李楨文),이학영(李學永),113,130,243,0
40166,이정문(李楨文),이해식(李海植),115,112,227,0
40167,이정문(李楨文),이헌승(李憲昇),50,8,58,1
40168,이정문(李楨文),이형석(李炯錫),125,119,244,0
40169,이정문(李楨文),인재근(印在謹),119,131,250,0
40170,이정문(李楨文),임병헌(林炳憲),25,5,30,1
40171,이정문(李楨文),임오경(林五卿),106,106,212,0
40172,이정문(李楨文),임이자(林利子),49,4,53,1
40173,이정문(李楨文),임종성(林鍾聲),122,163,285,0
40174,이정문(李楨文),임호선(林昊宣),135,204,339,0
40175,이정문(李楨文),장경태(張耿態),122,165,287,0
40176,이정문(李楨文),장동혁(張東赫),25,7,32,1
40177,이정문(李楨文),장제원(張濟元),49,5,54,1
40178,이정문(李楨文),장철민(張喆敏),97,127,224,0
40179,이정문(李楨文),장혜영(張惠英),15,21,36,1
40180,이정문(李楨文),전봉민(田奉珉),34,4,38,1
40181,이정문(李楨文),전용기(田溶冀),111,122,233,0
40182,이정문(李楨文),전재수(田載秀),84,68,152,0
40183,이정문(李楨文),전주혜(全珠惠),50,9,59,1
40184,이정문(李楨文),전해철(全海澈),76,61,137,0
40185,이정문(李楨文),전혜숙(全惠淑),95,76,171,0
40186,이정문(李楨文),정경희(丁慶姬),49,4,53,1
40187,이정문(李楨文),정동만(鄭東萬),49,4,53,1
40188,이정문(李楨文),정성호(鄭成湖),88,80,168,0
40189,이정문(李楨文),정우택(鄭宇澤),25,4,29,1
40190,이정문(李楨文),정운천(鄭雲天),49,7,56,1
40191,이정문(李楨文),정일영(鄭日永),91,83,174,0
40192,이정문(李楨文),정점식(鄭点植),51,7,58,1
40193,이정문(李楨文),정진석(鄭鎭碩),50,10,60,1
40194,이정문(李楨文),정청래(鄭淸來),89,48,137,0
40195,이정문(李楨文),정춘숙(鄭春淑),120,142,262,0
40196,이정문(李楨文),정태호(鄭泰浩),85,74,159,0
40197,이정문(李楨文),정필모(鄭必模),106,122,228,0
40198,이정문(李楨文),정희용(鄭熙溶),49,4,53,1
40199,이정문(李楨文),조경태(趙慶泰),52,5,57,1
40200,이정문(李楨文),조명희(曺明姬),49,5,54,1
40201,이정문(李楨文),조수진(趙修眞),49,7,56,1
40202,이정문(李楨文),조승래(趙承來),132,154,286,0
40203,이정문(李楨文),조오섭(曺五燮),130,203,333,0
40204,이정문(李楨文),조은희(趙恩禧),26,5,31,1
40205,이정문(李楨文),조응천(趙應天),81,35,116,0
40206,이정문(李楨文),조정식(趙正湜),88,68,156,0
40207,이정문(李楨文),조정훈(趙廷訓),3,7,10,1
40208,이정문(李楨文),조해진(曺海珍),52,4,56,1
40209,이정문(李楨文),주철현(朱哲鉉),102,118,220,0
40210,이정문(李楨文),주호영(朱豪英),50,5,55,1
40211,이정문(李楨文),지성호(池成浩),49,4,53,1
40212,이정문(李楨文),진선미(陳善美),80,50,130,0
40213,이정문(李楨文),진성준(陳聲準),123,106,229,0
40214,이정문(李楨文),천준호(千俊鎬),98,68,166,0
40215,이정문(李楨文),최기상(崔基相),93,103,196,0
40216,이정문(李楨文),최승재(崔承宰),50,11,61,1
40217,이정문(李楨文),최연숙(崔姸淑),30,10,40,1
40218,이정문(李楨文),최영희(崔英姬),25,4,29,1
40219,이정문(李楨文),최인호(崔仁昊),104,111,215,0
40220,이정문(李楨文),최재형(崔在亨),25,4,29,1
40221,이정문(李楨文),최종윤(崔鍾允),104,143,247,0
40222,이정문(李楨文),최춘식(崔春植),49,4,53,1
40223,이정문(李楨文),최형두(崔炯斗),51,8,59,1
40224,이정문(李楨文),최혜영(崔惠英),116,127,243,0
40225,이정문(李楨文),추경호(秋慶鎬),49,3,52,1
40226,이정문(李楨文),태영호(太永浩),49,9,58,1
40227,이정문(李楨文),하영제(河榮帝),41,3,44,1
40228,이정문(李楨文),하태경(河泰慶),49,9,58,1
40229,이정문(李楨文),한기호(韓起鎬),50,4,54,1
40230,이정문(李楨文),한무경(韓茂景),49,6,55,1
40231,이정문(李楨文),한병도(韓秉道),121,88,209,0
40232,이정문(李楨文),한정애(韓貞愛),80,74,154,0
40233,이정문(李楨文),한준호(韓俊鎬),118,157,275,0
40234,이정문(李楨文),허숙정(許淑湞),1,2,3,0
40235,이정문(李楨文),허영(許榮),114,144,258,0
40236,이정문(李楨文),허은아(許垠娥),49,4,53,1
40237,이정문(李楨文),허종식(許琮植),102,99,201,0
40238,이정문(李楨文),홍기원(洪起元),97,95,192,0
40239,이정문(李楨文),홍문표(洪文杓),54,10,64,1
40240,이정문(李楨文),홍석준(洪碩晙),50,4,54,1
40241,이정문(李楨文),홍성국(洪性國),120,153,273,0
40242,이정문(李楨文),홍영표(洪永杓),82,54,136,0
40243,이정문(李楨文),홍익표(洪翼杓),102,114,216,0
40244,이정문(李楨文),홍정민(洪貞敏),115,128,243,0
40245,이정문(李楨文),황보승희(皇甫承希),46,2,48,1
40246,이정문(李楨文),황운하(黃雲夏),116,178,294,0
40247,이정문(李楨文),황희(黃熙),83,66,149,0
40248,이종배(李鍾培),이종성(李鍾成),149,205,354,0
40249,이종배(李鍾培),이주환(李周桓),140,187,327,0
40250,이종배(李鍾培),이채익(李埰益),84,127,211,0
40251,이종배(李鍾培),이철규(李喆圭),81,93,174,0
40252,이종배(李鍾培),이탄희(李誕熙),50,6,56,1
40253,이종배(李鍾培),이태규(李泰珪),46,64,110,0
40254,이종배(李鍾培),이학영(李學永),50,6,56,1
40255,이종배(李鍾培),이해식(李海植),50,5,55,1
40256,이종배(李鍾培),이헌승(李憲昇),72,105,177,0
40257,이종배(李鍾培),이형석(李炯錫),51,5,56,1
40258,이종배(李鍾培),인재근(印在謹),51,6,57,1
40259,이종배(李鍾培),임병헌(林炳憲),32,36,68,0
40260,이종배(李鍾培),임오경(林五卿),50,7,57,1
40261,이종배(李鍾培),임이자(林利子),122,152,274,0
40262,이종배(李鍾培),임종성(林鍾聲),53,7,60,1
40263,이종배(李鍾培),임호선(林昊宣),51,9,60,1
40264,이종배(李鍾培),장경태(張耿態),50,5,55,1
40265,이종배(李鍾培),장동혁(張東赫),27,34,61,0
40266,이종배(李鍾培),장제원(張濟元),73,71,144,0
40267,이종배(李鍾培),장철민(張喆敏),51,6,57,1
40268,이종배(李鍾培),장혜영(張惠英),6,6,12,1
40269,이종배(李鍾培),전봉민(田奉珉),58,68,126,0
40270,이종배(李鍾培),전용기(田溶冀),49,5,54,1
40271,이종배(李鍾培),전재수(田載秀),49,5,54,1
40272,이종배(李鍾培),전주혜(全珠惠),81,76,157,0
40273,이종배(李鍾培),전해철(全海澈),51,8,59,1
40274,이종배(李鍾培),전혜숙(全惠淑),50,7,57,1
40275,이종배(李鍾培),정경희(丁慶姬),70,73,143,0
40276,이종배(李鍾培),정동만(鄭東萬),78,92,170,0
40277,이종배(李鍾培),정성호(鄭成湖),54,6,60,1
40278,이종배(李鍾培),정우택(鄭宇澤),48,100,148,0
40279,이종배(李鍾培),정운천(鄭雲天),106,157,263,0
40280,이종배(李鍾培),정일영(鄭日永),50,6,56,1
40281,이종배(李鍾培),정점식(鄭点植),69,45,114,0
40282,이종배(李鍾培),정진석(鄭鎭碩),102,108,210,0
40283,이종배(李鍾培),정청래(鄭淸來),50,6,56,1
40284,이종배(李鍾培),정춘숙(鄭春淑),50,7,57,1
40285,이종배(李鍾培),정태호(鄭泰浩),50,7,57,1
40286,이종배(李鍾培),정필모(鄭必模),50,5,55,1
40287,이종배(李鍾培),정희용(鄭熙溶),93,118,211,0
40288,이종배(李鍾培),조경태(趙慶泰),92,116,208,0
40289,이종배(李鍾培),조명희(曺明姬),112,155,267,0
40290,이종배(李鍾培),조수진(趙修眞),108,124,232,0
40291,이종배(李鍾培),조승래(趙承來),51,7,58,1
40292,이종배(李鍾培),조오섭(曺五燮),53,8,61,1
40293,이종배(李鍾培),조은희(趙恩禧),37,30,67,0
40294,이종배(李鍾培),조응천(趙應天),49,3,52,1
40295,이종배(李鍾培),조정식(趙正湜),50,4,54,1
40296,이종배(李鍾培),조정훈(趙廷訓),2,7,9,1
40297,이종배(李鍾培),조해진(曺海珍),64,50,114,0
40298,이종배(李鍾培),주철현(朱哲鉉),52,7,59,1
40299,이종배(李鍾培),주호영(朱豪英),78,101,179,0
40300,이종배(李鍾培),지성호(池成浩),100,120,220,0
40301,이종배(李鍾培),진선미(陳善美),50,5,55,1
40302,이종배(李鍾培),진성준(陳聲準),52,5,57,1
40303,이종배(李鍾培),천준호(千俊鎬),50,5,55,1
40304,이종배(李鍾培),최기상(崔基相),51,6,57,1
40305,이종배(李鍾培),최승재(崔承宰),113,133,246,0
40306,이종배(李鍾培),최연숙(崔姸淑),39,41,80,0
40307,이종배(李鍾培),최영희(崔英姬),35,73,108,0
40308,이종배(李鍾培),최인호(崔仁昊),51,8,59,1
40309,이종배(李鍾培),최재형(崔在亨),28,18,46,0
40310,이종배(李鍾培),최종윤(崔鍾允),51,6,57,1
40311,이종배(李鍾培),최춘식(崔春植),99,149,248,0
40312,이종배(李鍾培),최형두(崔炯斗),99,140,239,0
40313,이종배(李鍾培),최혜영(崔惠英),51,10,61,1
40314,이종배(李鍾培),추경호(秋慶鎬),163,249,412,0
40315,이종배(李鍾培),태영호(太永浩),136,277,413,0
40316,이종배(李鍾培),하영제(河榮帝),75,69,144,1
40317,이종배(李鍾培),하태경(河泰慶),70,52,122,0
40318,이종배(李鍾培),한기호(韓起鎬),72,50,122,0
40319,이종배(李鍾培),한무경(韓茂景),87,110,197,0
40320,이종배(李鍾培),한병도(韓秉道),51,6,57,1
40321,이종배(李鍾培),한정애(韓貞愛),50,7,57,1
40322,이종배(李鍾培),한준호(韓俊鎬),51,5,56,1
40323,이종배(李鍾培),허숙정(許淑湞),0,0,0,1
40324,이종배(李鍾培),허영(許榮),52,7,59,1
40325,이종배(李鍾培),허은아(許垠娥),92,73,165,0
40326,이종배(李鍾培),허종식(許琮植),51,8,59,1
40327,이종배(李鍾培),홍기원(洪起元),50,5,55,1
40328,이종배(李鍾培),홍문표(洪文杓),87,137,224,0
40329,이종배(李鍾培),홍석준(洪碩晙),95,65,160,0
40330,이종배(李鍾培),홍성국(洪性國),50,7,57,1
40331,이종배(李鍾培),홍영표(洪永杓),51,5,56,1
40332,이종배(李鍾培),홍익표(洪翼杓),51,6,57,1
40333,이종배(李鍾培),홍정민(洪貞敏),51,5,56,1
40334,이종배(李鍾培),황보승희(皇甫承希),80,107,187,1
40335,이종배(李鍾培),황운하(黃雲夏),50,7,57,1
40336,이종배(李鍾培),황희(黃熙),50,6,56,1
40337,이종성(李鍾成),이주환(李周桓),127,213,340,0
40338,이종성(李鍾成),이채익(李埰益),75,133,208,0
40339,이종성(李鍾成),이철규(李喆圭),91,83,174,0
40340,이종성(李鍾成),이탄희(李誕熙),49,6,55,1
40341,이종성(李鍾成),이태규(李泰珪),48,65,113,0
40342,이종성(李鍾成),이학영(李學永),50,4,54,1
40343,이종성(李鍾成),이해식(李海植),49,5,54,1
40344,이종성(李鍾成),이헌승(李憲昇),73,153,226,0
40345,이종성(李鍾成),이형석(李炯錫),50,4,54,1
40346,이종성(李鍾成),인재근(印在謹),50,6,56,1
40347,이종성(李鍾成),임병헌(林炳憲),39,87,126,0
40348,이종성(李鍾成),임오경(林五卿),49,4,53,1
40349,이종성(李鍾成),임이자(林利子),166,220,386,0
40350,이종성(李鍾成),임종성(林鍾聲),52,4,56,1
40351,이종성(李鍾成),임호선(林昊宣),51,12,63,1
40352,이종성(李鍾成),장경태(張耿態),50,4,54,1
40353,이종성(李鍾成),장동혁(張東赫),33,44,77,0
40354,이종성(李鍾成),장제원(張濟元),61,45,106,0
40355,이종성(李鍾成),장철민(張喆敏),50,7,57,1
40356,이종성(李鍾成),장혜영(張惠英),8,9,17,1
40357,이종성(李鍾成),전봉민(田奉珉),83,194,277,0
40358,이종성(李鍾成),전용기(田溶冀),49,4,53,1
40359,이종성(李鍾成),전재수(田載秀),49,4,53,1
40360,이종성(李鍾成),전주혜(全珠惠),88,118,206,0
40361,이종성(李鍾成),전해철(全海澈),50,4,54,1
40362,이종성(李鍾成),전혜숙(全惠淑),49,10,59,1
40363,이종성(李鍾成),정경희(丁慶姬),86,122,208,0
40364,이종성(李鍾成),정동만(鄭東萬),91,154,245,0
40365,이종성(李鍾成),정성호(鄭成湖),52,4,56,1
40366,이종성(李鍾成),정우택(鄭宇澤),45,110,155,0
40367,이종성(李鍾成),정운천(鄭雲天),153,277,430,0
40368,이종성(李鍾成),정일영(鄭日永),49,6,55,1
40369,이종성(李鍾成),정점식(鄭点植),94,86,180,0
40370,이종성(李鍾成),정진석(鄭鎭碩),100,111,211,0
40371,이종성(李鍾成),정청래(鄭淸來),50,5,55,1
40372,이종성(李鍾成),정춘숙(鄭春淑),49,6,55,1
40373,이종성(李鍾成),정태호(鄭泰浩),49,5,54,1
40374,이종성(李鍾成),정필모(鄭必模),49,4,53,1
40375,이종성(李鍾成),정희용(鄭熙溶),106,147,253,0
40376,이종성(李鍾成),조경태(趙慶泰),85,96,181,0
40377,이종성(李鍾成),조명희(曺明姬),117,277,394,0
40378,이종성(李鍾成),조수진(趙修眞),91,157,248,0
40379,이종성(李鍾成),조승래(趙承來),49,8,57,1
40380,이종성(李鍾成),조오섭(曺五燮),50,5,55,1
40381,이종성(李鍾成),조은희(趙恩禧),36,59,95,0
40382,이종성(李鍾成),조응천(趙應天),49,4,53,1
40383,이종성(李鍾成),조정식(趙正湜),49,4,53,1
40384,이종성(李鍾成),조정훈(趙廷訓),5,48,53,1
40385,이종성(李鍾成),조해진(曺海珍),63,61,124,0
40386,이종성(李鍾成),주철현(朱哲鉉),51,5,56,1
40387,이종성(李鍾成),주호영(朱豪英),68,60,128,0
40388,이종성(李鍾成),지성호(池成浩),124,268,392,0
40389,이종성(李鍾成),진선미(陳善美),49,4,53,1
40390,이종성(李鍾成),진성준(陳聲準),49,4,53,1
40391,이종성(李鍾成),천준호(千俊鎬),49,5,54,1
40392,이종성(李鍾成),최기상(崔基相),50,4,54,1
40393,이종성(李鍾成),최승재(崔承宰),109,177,286,0
40394,이종성(李鍾成),최연숙(崔姸淑),42,61,103,0
40395,이종성(李鍾成),최영희(崔英姬),39,92,131,0
40396,이종성(李鍾成),최인호(崔仁昊),50,4,54,1
40397,이종성(李鍾成),최재형(崔在亨),27,42,69,0
40398,이종성(李鍾成),최종윤(崔鍾允),50,6,56,1
40399,이종성(李鍾成),최춘식(崔春植),100,192,292,0
40400,이종성(李鍾成),최형두(崔炯斗),120,177,297,0
40401,이종성(李鍾成),최혜영(崔惠英),51,11,62,1
40402,이종성(李鍾成),추경호(秋慶鎬),142,214,356,0
40403,이종성(李鍾成),태영호(太永浩),120,233,353,0
40404,이종성(李鍾成),하영제(河榮帝),104,164,268,1
40405,이종성(李鍾成),하태경(河泰慶),66,62,128,0
40406,이종성(李鍾成),한기호(韓起鎬),72,77,149,0
40407,이종성(李鍾成),한무경(韓茂景),102,172,274,0
40408,이종성(李鍾成),한병도(韓秉道),51,4,55,1
40409,이종성(李鍾成),한정애(韓貞愛),49,8,57,1
40410,이종성(李鍾成),한준호(韓俊鎬),49,5,54,1
40411,이종성(李鍾成),허숙정(許淑湞),0,0,0,1
40412,이종성(李鍾成),허영(許榮),51,4,55,1
40413,이종성(李鍾成),허은아(許垠娥),89,113,202,0
40414,이종성(李鍾成),허종식(許琮植),50,10,60,1
40415,이종성(李鍾成),홍기원(洪起元),49,4,53,1
40416,이종성(李鍾成),홍문표(洪文杓),73,107,180,0
40417,이종성(李鍾成),홍석준(洪碩晙),79,88,167,0
40418,이종성(李鍾成),홍성국(洪性國),49,4,53,1
40419,이종성(李鍾成),홍영표(洪永杓),49,6,55,1
40420,이종성(李鍾成),홍익표(洪翼杓),50,5,55,1
40421,이종성(李鍾成),홍정민(洪貞敏),50,8,58,1
40422,이종성(李鍾成),황보승희(皇甫承希),97,176,273,1
40423,이종성(李鍾成),황운하(黃雲夏),49,4,53,1
40424,이종성(李鍾成),황희(黃熙),49,11,60,1
40425,이주환(李周桓),이채익(李埰益),84,99,183,0
40426,이주환(李周桓),이철규(李喆圭),88,93,181,0
40427,이주환(李周桓),이탄희(李誕熙),49,5,54,1
40428,이주환(李周桓),이태규(李泰珪),43,50,93,0
40429,이주환(李周桓),이학영(李學永),49,5,54,1
40430,이주환(李周桓),이해식(李海植),50,5,55,1
40431,이주환(李周桓),이헌승(李憲昇),115,263,378,0
40432,이주환(李周桓),이형석(李炯錫),50,4,54,1
40433,이주환(李周桓),인재근(印在謹),50,4,54,1
40434,이주환(李周桓),임병헌(林炳憲),32,37,69,0
40435,이주환(李周桓),임오경(林五卿),49,6,55,1
40436,이주환(李周桓),임이자(林利子),118,140,258,0
40437,이주환(李周桓),임종성(林鍾聲),50,6,56,1
40438,이주환(李周桓),임호선(林昊宣),50,5,55,1
40439,이주환(李周桓),장경태(張耿態),49,6,55,1
40440,이주환(李周桓),장동혁(張東赫),36,68,104,0
40441,이주환(李周桓),장제원(張濟元),77,62,139,0
40442,이주환(李周桓),장철민(張喆敏),50,4,54,1
40443,이주환(李周桓),장혜영(張惠英),6,4,10,1
40444,이주환(李周桓),전봉민(田奉珉),113,287,400,0
40445,이주환(李周桓),전용기(田溶冀),49,5,54,1
40446,이주환(李周桓),전재수(田載秀),50,7,57,1
40447,이주환(李周桓),전주혜(全珠惠),87,108,195,0
40448,이주환(李周桓),전해철(全海澈),50,4,54,1
40449,이주환(李周桓),전혜숙(全惠淑),49,9,58,1
40450,이주환(李周桓),정경희(丁慶姬),74,78,152,0
40451,이주환(李周桓),정동만(鄭東萬),124,232,356,0
40452,이주환(李周桓),정성호(鄭成湖),53,6,59,1
40453,이주환(李周桓),정우택(鄭宇澤),45,88,133,0
40454,이주환(李周桓),정운천(鄭雲天),88,145,233,0
40455,이주환(李周桓),정일영(鄭日永),49,5,54,1
40456,이주환(李周桓),정점식(鄭点植),70,52,122,0
40457,이주환(李周桓),정진석(鄭鎭碩),82,93,175,0
40458,이주환(李周桓),정청래(鄭淸來),49,4,53,1
40459,이주환(李周桓),정춘숙(鄭春淑),49,4,53,1
40460,이주환(李周桓),정태호(鄭泰浩),49,4,53,1
40461,이주환(李周桓),정필모(鄭必模),49,5,54,1
40462,이주환(李周桓),정희용(鄭熙溶),98,147,245,0
40463,이주환(李周桓),조경태(趙慶泰),100,122,222,0
40464,이주환(李周桓),조명희(曺明姬),132,196,328,0
40465,이주환(李周桓),조수진(趙修眞),88,98,186,0
40466,이주환(李周桓),조승래(趙承來),49,4,53,1
40467,이주환(李周桓),조오섭(曺五燮),49,5,54,1
40468,이주환(李周桓),조은희(趙恩禧),35,45,80,0
40469,이주환(李周桓),조응천(趙應天),49,4,53,1
40470,이주환(李周桓),조정식(趙正湜),49,3,52,1
40471,이주환(李周桓),조정훈(趙廷訓),1,5,6,1
40472,이주환(李周桓),조해진(曺海珍),64,47,111,0
40473,이주환(李周桓),주철현(朱哲鉉),50,5,55,1
40474,이주환(李周桓),주호영(朱豪英),74,67,141,0
40475,이주환(李周桓),지성호(池成浩),135,216,351,0
40476,이주환(李周桓),진선미(陳善美),49,5,54,1
40477,이주환(李周桓),진성준(陳聲準),51,4,55,1
40478,이주환(李周桓),천준호(千俊鎬),49,3,52,1
40479,이주환(李周桓),최기상(崔基相),50,5,55,1
40480,이주환(李周桓),최승재(崔承宰),126,162,288,0
40481,이주환(李周桓),최연숙(崔姸淑),35,35,70,0
40482,이주환(李周桓),최영희(崔英姬),39,122,161,0
40483,이주환(李周桓),최인호(崔仁昊),52,7,59,1
40484,이주환(李周桓),최재형(崔在亨),27,15,42,0
40485,이주환(李周桓),최종윤(崔鍾允),50,5,55,1
40486,이주환(李周桓),최춘식(崔春植),113,155,268,0
40487,이주환(李周桓),최형두(崔炯斗),112,118,230,0
40488,이주환(李周桓),최혜영(崔惠英),51,6,57,1
40489,이주환(李周桓),추경호(秋慶鎬),135,180,315,0
40490,이주환(李周桓),태영호(太永浩),118,204,322,0
40491,이주환(李周桓),하영제(河榮帝),117,196,313,1
40492,이주환(李周桓),하태경(河泰慶),73,75,148,0
40493,이주환(李周桓),한기호(韓起鎬),71,61,132,0
40494,이주환(李周桓),한무경(韓茂景),115,174,289,0
40495,이주환(李周桓),한병도(韓秉道),50,4,54,1
40496,이주환(李周桓),한정애(韓貞愛),49,4,53,1
40497,이주환(李周桓),한준호(韓俊鎬),50,4,54,1
40498,이주환(李周桓),허숙정(許淑湞),0,0,0,1
40499,이주환(李周桓),허영(許榮),51,5,56,1
40500,이주환(李周桓),허은아(許垠娥),83,85,168,0
40501,이주환(李周桓),허종식(許琮植),52,17,69,1
40502,이주환(李周桓),홍기원(洪起元),49,5,54,1
40503,이주환(李周桓),홍문표(洪文杓),97,129,226,0
40504,이주환(李周桓),홍석준(洪碩晙),77,74,151,0
40505,이주환(李周桓),홍성국(洪性國),49,5,54,1
40506,이주환(李周桓),홍영표(洪永杓),49,6,55,1
40507,이주환(李周桓),홍익표(洪翼杓),50,5,55,1
40508,이주환(李周桓),홍정민(洪貞敏),50,8,58,1
40509,이주환(李周桓),황보승희(皇甫承希),113,178,291,1
40510,이주환(李周桓),황운하(黃雲夏),50,5,55,1
40511,이주환(李周桓),황희(黃熙),49,5,54,1
40512,이채익(李埰益),이철규(李喆圭),71,50,121,0
40513,이채익(李埰益),이탄희(李誕熙),51,6,57,1
40514,이채익(李埰益),이태규(李泰珪),43,48,91,0
40515,이채익(李埰益),이학영(李學永),51,6,57,1
40516,이채익(李埰益),이해식(李海植),52,7,59,1
40517,이채익(李埰益),이헌승(李憲昇),72,134,206,0
40518,이채익(李埰益),이형석(李炯錫),50,6,56,1
40519,이채익(李埰益),인재근(印在謹),50,8,58,1
40520,이채익(李埰益),임병헌(林炳憲),34,46,80,0
40521,이채익(李埰益),임오경(林五卿),52,11,63,1
40522,이채익(李埰益),임이자(林利子),88,109,197,0
40523,이채익(李埰益),임종성(林鍾聲),51,6,57,1
40524,이채익(李埰益),임호선(林昊宣),51,6,57,1
40525,이채익(李埰益),장경태(張耿態),52,5,57,1
40526,이채익(李埰益),장동혁(張東赫),35,30,65,0
40527,이채익(李埰益),장제원(張濟元),67,51,118,0
40528,이채익(李埰益),장철민(張喆敏),51,5,56,1
40529,이채익(李埰益),장혜영(張惠英),7,10,17,1
40530,이채익(李埰益),전봉민(田奉珉),59,85,144,0
40531,이채익(李埰益),전용기(田溶冀),50,4,54,1
40532,이채익(李埰益),전재수(田載秀),50,5,55,1
40533,이채익(李埰益),전주혜(全珠惠),81,96,177,0
40534,이채익(李埰益),전해철(全海澈),51,5,56,1
40535,이채익(李埰益),전혜숙(全惠淑),52,9,61,1
40536,이채익(李埰益),정경희(丁慶姬),72,64,136,0
40537,이채익(李埰益),정동만(鄭東萬),79,109,188,0
40538,이채익(李埰益),정성호(鄭成湖),55,11,66,1
40539,이채익(李埰益),정우택(鄭宇澤),48,88,136,0
40540,이채익(李埰益),정운천(鄭雲天),81,112,193,0
40541,이채익(李埰益),정일영(鄭日永),50,7,57,1
40542,이채익(李埰益),정점식(鄭点植),70,49,119,0
40543,이채익(李埰益),정진석(鄭鎭碩),79,89,168,0
40544,이채익(李埰益),정청래(鄭淸來),50,6,56,1
40545,이채익(李埰益),정춘숙(鄭春淑),51,7,58,1
40546,이채익(李埰益),정태호(鄭泰浩),51,6,57,1
40547,이채익(李埰益),정필모(鄭必模),52,5,57,1
40548,이채익(李埰益),정희용(鄭熙溶),93,135,228,0
40549,이채익(李埰益),조경태(趙慶泰),83,114,197,0
40550,이채익(李埰益),조명희(曺明姬),98,146,244,0
40551,이채익(李埰益),조수진(趙修眞),86,81,167,0
40552,이채익(李埰益),조승래(趙承來),51,6,57,1
40553,이채익(李埰益),조오섭(曺五燮),51,10,61,1
40554,이채익(李埰益),조은희(趙恩禧),35,45,80,0
40555,이채익(李埰益),조응천(趙應天),50,3,53,1
40556,이채익(李埰益),조정식(趙正湜),50,4,54,1
40557,이채익(李埰益),조정훈(趙廷訓),1,9,10,1
40558,이채익(李埰益),조해진(曺海珍),65,52,117,0
40559,이채익(李埰益),주철현(朱哲鉉),51,5,56,1
40560,이채익(李埰益),주호영(朱豪英),70,55,125,0
40561,이채익(李埰益),지성호(池成浩),84,128,212,0
40562,이채익(李埰益),진선미(陳善美),51,5,56,1
40563,이채익(李埰益),진성준(陳聲準),52,5,57,1
40564,이채익(李埰益),천준호(千俊鎬),51,5,56,1
40565,이채익(李埰益),최기상(崔基相),50,5,55,1
40566,이채익(李埰益),최승재(崔承宰),68,69,137,0
40567,이채익(李埰益),최연숙(崔姸淑),34,39,73,0
40568,이채익(李埰益),최영희(崔英姬),32,68,100,0
40569,이채익(李埰益),최인호(崔仁昊),51,7,58,1
40570,이채익(李埰益),최재형(崔在亨),27,19,46,0
40571,이채익(李埰益),최종윤(崔鍾允),52,8,60,1
40572,이채익(李埰益),최춘식(崔春植),80,143,223,0
40573,이채익(李埰益),최형두(崔炯斗),81,124,205,0
40574,이채익(李埰益),최혜영(崔惠英),52,10,62,1
40575,이채익(李埰益),추경호(秋慶鎬),97,144,241,0
40576,이채익(李埰益),태영호(太永浩),107,175,282,0
40577,이채익(李埰益),하영제(河榮帝),75,117,192,1
40578,이채익(李埰益),하태경(河泰慶),62,54,116,0
40579,이채익(李埰益),한기호(韓起鎬),64,71,135,0
40580,이채익(李埰益),한무경(韓茂景),77,112,189,0
40581,이채익(李埰益),한병도(韓秉道),52,9,61,1
40582,이채익(李埰益),한정애(韓貞愛),51,6,57,1
40583,이채익(李埰益),한준호(韓俊鎬),51,7,58,1
40584,이채익(李埰益),허숙정(許淑湞),0,0,0,1
40585,이채익(李埰益),허영(許榮),52,9,61,1
40586,이채익(李埰益),허은아(許垠娥),71,74,145,0
40587,이채익(李埰益),허종식(許琮植),51,11,62,1
40588,이채익(李埰益),홍기원(洪起元),52,7,59,1
40589,이채익(李埰益),홍문표(洪文杓),92,128,220,0
40590,이채익(李埰益),홍석준(洪碩晙),64,63,127,0
40591,이채익(李埰益),홍성국(洪性國),52,16,68,1
40592,이채익(李埰益),홍영표(洪永杓),51,7,58,1
40593,이채익(李埰益),홍익표(洪翼杓),51,10,61,1
40594,이채익(李埰益),홍정민(洪貞敏),51,6,57,1
40595,이채익(李埰益),황보승희(皇甫承希),81,103,184,1
40596,이채익(李埰益),황운하(黃雲夏),52,10,62,1
40597,이채익(李埰益),황희(黃熙),50,7,57,1
40598,이철규(李喆圭),이탄희(李誕熙),51,6,57,1
40599,이철규(李喆圭),이태규(李泰珪),36,32,68,0
40600,이철규(李喆圭),이학영(李學永),50,5,55,1
40601,이철규(李喆圭),이해식(李海植),52,7,59,1
40602,이철규(李喆圭),이헌승(李憲昇),69,62,131,0
40603,이철규(李喆圭),이형석(李炯錫),50,4,54,1
40604,이철규(李喆圭),인재근(印在謹),50,5,55,1
40605,이철규(李喆圭),임병헌(林炳憲),41,25,66,0
40606,이철규(李喆圭),임오경(林五卿),50,6,56,1
40607,이철규(李喆圭),임이자(林利子),90,78,168,0
40608,이철규(李喆圭),임종성(林鍾聲),54,7,61,1
40609,이철규(李喆圭),임호선(林昊宣),54,10,64,1
40610,이철규(李喆圭),장경태(張耿態),51,5,56,1
40611,이철규(李喆圭),장동혁(張東赫),30,23,53,0
40612,이철규(李喆圭),장제원(張濟元),69,41,110,0
40613,이철규(李喆圭),장철민(張喆敏),51,4,55,1
40614,이철규(李喆圭),장혜영(張惠英),6,4,10,1
40615,이철규(李喆圭),전봉민(田奉珉),50,38,88,0
40616,이철규(李喆圭),전용기(田溶冀),53,10,63,1
40617,이철규(李喆圭),전재수(田載秀),50,6,56,1
40618,이철규(李喆圭),전주혜(全珠惠),75,61,136,0
40619,이철규(李喆圭),전해철(全海澈),50,4,54,1
40620,이철규(李喆圭),전혜숙(全惠淑),51,6,57,1
40621,이철규(李喆圭),정경희(丁慶姬),73,68,141,0
40622,이철규(李喆圭),정동만(鄭東萬),78,63,141,0
40623,이철규(李喆圭),정성호(鄭成湖),52,9,61,1
40624,이철규(李喆圭),정우택(鄭宇澤),29,19,48,0
40625,이철규(李喆圭),정운천(鄭雲天),128,128,256,0
40626,이철규(李喆圭),정일영(鄭日永),50,5,55,1
40627,이철규(李喆圭),정점식(鄭点植),83,55,138,0
40628,이철규(李喆圭),정진석(鄭鎭碩),92,95,187,0
40629,이철규(李喆圭),정청래(鄭淸來),52,4,56,1
40630,이철규(李喆圭),정춘숙(鄭春淑),51,5,56,1
40631,이철규(李喆圭),정태호(鄭泰浩),51,4,55,1
40632,이철규(李喆圭),정필모(鄭必模),50,5,55,1
40633,이철규(李喆圭),정희용(鄭熙溶),104,109,213,0
40634,이철규(李喆圭),조경태(趙慶泰),71,53,124,0
40635,이철규(李喆圭),조명희(曺明姬),89,80,169,0
40636,이철규(李喆圭),조수진(趙修眞),84,81,165,0
40637,이철규(李喆圭),조승래(趙承來),52,5,57,1
40638,이철규(李喆圭),조오섭(曺五燮),52,5,57,1
40639,이철규(李喆圭),조은희(趙恩禧),31,24,55,0
40640,이철규(李喆圭),조응천(趙應天),50,4,54,1
40641,이철규(李喆圭),조정식(趙正湜),49,5,54,1
40642,이철규(李喆圭),조정훈(趙廷訓),1,5,6,1
40643,이철규(李喆圭),조해진(曺海珍),70,32,102,0
40644,이철규(李喆圭),주철현(朱哲鉉),52,5,57,1
40645,이철규(李喆圭),주호영(朱豪英),65,49,114,0
40646,이철규(李喆圭),지성호(池成浩),82,65,147,0
40647,이철규(李喆圭),진선미(陳善美),50,5,55,1
40648,이철규(李喆圭),진성준(陳聲準),50,4,54,1
40649,이철규(李喆圭),천준호(千俊鎬),50,3,53,1
40650,이철규(李喆圭),최기상(崔基相),50,5,55,1
40651,이철규(李喆圭),최승재(崔承宰),94,103,197,0
40652,이철규(李喆圭),최연숙(崔姸淑),36,51,87,0
40653,이철규(李喆圭),최영희(崔英姬),32,36,68,0
40654,이철규(李喆圭),최인호(崔仁昊),52,4,56,1
40655,이철규(李喆圭),최재형(崔在亨),28,13,41,0
40656,이철규(李喆圭),최종윤(崔鍾允),52,5,57,1
40657,이철규(李喆圭),최춘식(崔春植),77,90,167,0
40658,이철규(李喆圭),최형두(崔炯斗),100,73,173,0
40659,이철규(李喆圭),최혜영(崔惠英),50,6,56,1
40660,이철규(李喆圭),추경호(秋慶鎬),101,96,197,0
40661,이철규(李喆圭),태영호(太永浩),104,109,213,0
40662,이철규(李喆圭),하영제(河榮帝),67,60,127,1
40663,이철규(李喆圭),하태경(河泰慶),69,43,112,0
40664,이철규(李喆圭),한기호(韓起鎬),87,79,166,0
40665,이철규(李喆圭),한무경(韓茂景),106,100,206,0
40666,이철규(李喆圭),한병도(韓秉道),54,10,64,1
40667,이철규(李喆圭),한정애(韓貞愛),50,4,54,1
40668,이철규(李喆圭),한준호(韓俊鎬),50,4,54,1
40669,이철규(李喆圭),허숙정(許淑湞),0,0,0,1
40670,이철규(李喆圭),허영(許榮),59,19,78,1
40671,이철규(李喆圭),허은아(許垠娥),70,52,122,0
40672,이철규(李喆圭),허종식(許琮植),53,9,62,1
40673,이철규(李喆圭),홍기원(洪起元),51,5,56,1
40674,이철규(李喆圭),홍문표(洪文杓),77,61,138,0
40675,이철규(李喆圭),홍석준(洪碩晙),76,55,131,0
40676,이철규(李喆圭),홍성국(洪性國),51,6,57,1
40677,이철규(李喆圭),홍영표(洪永杓),51,5,56,1
40678,이철규(李喆圭),홍익표(洪翼杓),53,10,63,1
40679,이철규(李喆圭),홍정민(洪貞敏),53,6,59,1
40680,이철규(李喆圭),황보승희(皇甫承希),86,78,164,1
40681,이철규(李喆圭),황운하(黃雲夏),51,5,56,1
40682,이철규(李喆圭),황희(黃熙),49,10,59,1
40683,이탄희(李誕熙),이태규(李泰珪),28,5,33,1
40684,이탄희(李誕熙),이학영(李學永),109,80,189,0
40685,이탄희(李誕熙),이해식(李海植),99,83,182,0
40686,이탄희(李誕熙),이헌승(李憲昇),52,4,56,1
40687,이탄희(李誕熙),이형석(李炯錫),106,107,213,0
40688,이탄희(李誕熙),인재근(印在謹),98,95,193,0
40689,이탄희(李誕熙),임병헌(林炳憲),25,4,29,1
40690,이탄희(李誕熙),임오경(林五卿),85,68,153,0
40691,이탄희(李誕熙),임이자(林利子),49,4,53,1
40692,이탄희(李誕熙),임종성(林鍾聲),99,84,183,0
40693,이탄희(李誕熙),임호선(林昊宣),124,142,266,0
40694,이탄희(李誕熙),장경태(張耿態),111,115,226,0
40695,이탄희(李誕熙),장동혁(張東赫),25,4,29,1
40696,이탄희(李誕熙),장제원(張濟元),49,4,53,1
40697,이탄희(李誕熙),장철민(張喆敏),96,59,155,0
40698,이탄희(李誕熙),장혜영(張惠英),29,58,87,1
40699,이탄희(李誕熙),전봉민(田奉珉),35,5,40,1
40700,이탄희(李誕熙),전용기(田溶冀),102,120,222,0
40701,이탄희(李誕熙),전재수(田載秀),85,56,141,0
40702,이탄희(李誕熙),전주혜(全珠惠),51,6,57,1
40703,이탄희(李誕熙),전해철(全海澈),78,48,126,0
40704,이탄희(李誕熙),전혜숙(全惠淑),113,96,209,0
40705,이탄희(李誕熙),정경희(丁慶姬),49,4,53,1
40706,이탄희(李誕熙),정동만(鄭東萬),49,4,53,1
40707,이탄희(李誕熙),정성호(鄭成湖),81,54,135,0
40708,이탄희(李誕熙),정우택(鄭宇澤),25,4,29,1
40709,이탄희(李誕熙),정운천(鄭雲天),49,5,54,1
40710,이탄희(李誕熙),정일영(鄭日永),100,77,177,0
40711,이탄희(李誕熙),정점식(鄭点植),50,5,55,1
40712,이탄희(李誕熙),정진석(鄭鎭碩),50,5,55,1
40713,이탄희(李誕熙),정청래(鄭淸來),101,69,170,0
40714,이탄희(李誕熙),정춘숙(鄭春淑),106,97,203,0
40715,이탄희(李誕熙),정태호(鄭泰浩),87,82,169,0
40716,이탄희(李誕熙),정필모(鄭必模),94,102,196,0
40717,이탄희(李誕熙),정희용(鄭熙溶),50,6,56,1
40718,이탄희(李誕熙),조경태(趙慶泰),49,4,53,1
40719,이탄희(李誕熙),조명희(曺明姬),49,7,56,1
40720,이탄희(李誕熙),조수진(趙修眞),49,5,54,1
40721,이탄희(李誕熙),조승래(趙承來),100,78,178,0
40722,이탄희(李誕熙),조오섭(曺五燮),100,88,188,0
40723,이탄희(李誕熙),조은희(趙恩禧),25,5,30,1
40724,이탄희(李誕熙),조응천(趙應天),85,39,124,0
40725,이탄희(李誕熙),조정식(趙正湜),77,40,117,0
40726,이탄희(李誕熙),조정훈(趙廷訓),6,22,28,1
40727,이탄희(李誕熙),조해진(曺海珍),51,6,57,1
40728,이탄희(李誕熙),주철현(朱哲鉉),97,69,166,0
40729,이탄희(李誕熙),주호영(朱豪英),49,4,53,1
40730,이탄희(李誕熙),지성호(池成浩),49,4,53,1
40731,이탄희(李誕熙),진선미(陳善美),90,65,155,0
40732,이탄희(李誕熙),진성준(陳聲準),103,82,185,0
40733,이탄희(李誕熙),천준호(千俊鎬),89,59,148,0
40734,이탄희(李誕熙),최기상(崔基相),89,66,155,0
40735,이탄희(李誕熙),최승재(崔承宰),50,9,59,1
40736,이탄희(李誕熙),최연숙(崔姸淑),32,21,53,1
40737,이탄희(李誕熙),최영희(崔英姬),25,4,29,1
40738,이탄희(李誕熙),최인호(崔仁昊),103,81,184,0
40739,이탄희(李誕熙),최재형(崔在亨),25,4,29,1
40740,이탄희(李誕熙),최종윤(崔鍾允),95,88,183,0
40741,이탄희(李誕熙),최춘식(崔春植),49,4,53,1
40742,이탄희(李誕熙),최형두(崔炯斗),50,7,57,1
40743,이탄희(李誕熙),최혜영(崔惠英),128,161,289,0
40744,이탄희(李誕熙),추경호(秋慶鎬),49,4,53,1
40745,이탄희(李誕熙),태영호(太永浩),49,6,55,1
40746,이탄희(李誕熙),하영제(河榮帝),41,2,43,1
40747,이탄희(李誕熙),하태경(河泰慶),49,5,54,1
40748,이탄희(李誕熙),한기호(韓起鎬),50,5,55,1
40749,이탄희(李誕熙),한무경(韓茂景),49,5,54,1
40750,이탄희(李誕熙),한병도(韓秉道),113,67,180,0
40751,이탄희(李誕熙),한정애(韓貞愛),89,52,141,0
40752,이탄희(李誕熙),한준호(韓俊鎬),95,91,186,0
40753,이탄희(李誕熙),허숙정(許淑湞),1,2,3,0
40754,이탄희(李誕熙),허영(許榮),109,86,195,0
40755,이탄희(李誕熙),허은아(許垠娥),49,5,54,1
40756,이탄희(李誕熙),허종식(許琮植),102,89,191,0
40757,이탄희(李誕熙),홍기원(洪起元),95,77,172,0
40758,이탄희(李誕熙),홍문표(洪文杓),50,6,56,1
40759,이탄희(李誕熙),홍석준(洪碩晙),50,4,54,1
40760,이탄희(李誕熙),홍성국(洪性國),114,107,221,0
40761,이탄희(李誕熙),홍영표(洪永杓),91,57,148,0
40762,이탄희(李誕熙),홍익표(洪翼杓),91,76,167,0
40763,이탄희(李誕熙),홍정민(洪貞敏),112,93,205,0
40764,이탄희(李誕熙),황보승희(皇甫承希),46,2,48,1
40765,이탄희(李誕熙),황운하(黃雲夏),116,123,239,0
40766,이탄희(李誕熙),황희(黃熙),79,46,125,0
40767,이태규(李泰珪),이학영(李學永),28,6,34,1
40768,이태규(李泰珪),이해식(李海植),30,5,35,1
40769,이태규(李泰珪),이헌승(李憲昇),32,53,85,0
40770,이태규(李泰珪),이형석(李炯錫),29,4,33,1
40771,이태규(李泰珪),인재근(印在謹),32,10,42,1
40772,이태규(李泰珪),임병헌(林炳憲),33,37,70,0
40773,이태규(李泰珪),임오경(林五卿),28,5,33,1
40774,이태규(李泰珪),임이자(林利子),51,52,103,0
40775,이태규(李泰珪),임종성(林鍾聲),29,6,35,1
40776,이태규(李泰珪),임호선(林昊宣),30,4,34,1
40777,이태규(李泰珪),장경태(張耿態),28,10,38,1
40778,이태규(李泰珪),장동혁(張東赫),31,18,49,0
40779,이태규(李泰珪),장제원(張濟元),36,26,62,0
40780,이태규(李泰珪),장철민(張喆敏),29,8,37,1
40781,이태규(李泰珪),장혜영(張惠英),4,4,8,1
40782,이태규(李泰珪),전봉민(田奉珉),35,37,72,0
40783,이태규(李泰珪),전용기(田溶冀),28,5,33,1
40784,이태규(李泰珪),전재수(田載秀),28,4,32,1
40785,이태규(李泰珪),전주혜(全珠惠),42,56,98,0
40786,이태규(李泰珪),전해철(全海澈),28,4,32,1
40787,이태규(李泰珪),전혜숙(全惠淑),29,11,40,1
40788,이태규(李泰珪),정경희(丁慶姬),58,64,122,0
40789,이태규(李泰珪),정동만(鄭東萬),38,30,68,0
40790,이태규(李泰珪),정성호(鄭成湖),31,6,37,1
40791,이태규(李泰珪),정우택(鄭宇澤),37,49,86,0
40792,이태규(李泰珪),정운천(鄭雲天),42,37,79,0
40793,이태규(李泰珪),정일영(鄭日永),28,5,33,1
40794,이태규(李泰珪),정점식(鄭点植),35,26,61,0
40795,이태규(李泰珪),정진석(鄭鎭碩),44,34,78,0
40796,이태규(李泰珪),정청래(鄭淸來),28,4,32,1
40797,이태규(李泰珪),정춘숙(鄭春淑),29,6,35,1
40798,이태규(李泰珪),정태호(鄭泰浩),28,5,33,1
40799,이태규(李泰珪),정필모(鄭必模),29,5,34,1
40800,이태규(李泰珪),정희용(鄭熙溶),48,47,95,0
40801,이태규(李泰珪),조경태(趙慶泰),50,64,114,0
40802,이태규(李泰珪),조명희(曺明姬),59,74,133,0
40803,이태규(李泰珪),조수진(趙修眞),45,55,100,0
40804,이태규(李泰珪),조승래(趙承來),28,5,33,1
40805,이태규(李泰珪),조오섭(曺五燮),30,10,40,1
40806,이태규(李泰珪),조은희(趙恩禧),36,44,80,0
40807,이태규(李泰珪),조응천(趙應天),28,4,32,1
40808,이태규(李泰珪),조정식(趙正湜),28,4,32,1
40809,이태규(李泰珪),조정훈(趙廷訓),4,23,27,1
40810,이태규(李泰珪),조해진(曺海珍),40,24,64,0
40811,이태규(李泰珪),주철현(朱哲鉉),28,4,32,1
40812,이태규(李泰珪),주호영(朱豪英),35,23,58,0
40813,이태규(李泰珪),지성호(池成浩),57,76,133,0
40814,이태규(李泰珪),진선미(陳善美),28,5,33,1
40815,이태규(李泰珪),진성준(陳聲準),28,4,32,1
40816,이태규(李泰珪),천준호(千俊鎬),28,3,31,1
40817,이태규(李泰珪),최기상(崔基相),28,5,33,1
40818,이태규(李泰珪),최승재(崔承宰),48,57,105,0
40819,이태규(李泰珪),최연숙(崔姸淑),73,113,186,0
40820,이태규(李泰珪),최영희(崔英姬),28,32,60,0
40821,이태규(李泰珪),최인호(崔仁昊),28,4,32,1
40822,이태규(李泰珪),최재형(崔在亨),30,21,51,0
40823,이태규(李泰珪),최종윤(崔鍾允),29,7,36,1
40824,이태규(李泰珪),최춘식(崔春植),42,43,85,0
40825,이태규(李泰珪),최형두(崔炯斗),40,47,87,0
40826,이태규(李泰珪),최혜영(崔惠英),30,8,38,1
40827,이태규(李泰珪),추경호(秋慶鎬),45,47,92,0
40828,이태규(李泰珪),태영호(太永浩),53,103,156,0
40829,이태규(李泰珪),하영제(河榮帝),36,39,75,1
40830,이태규(李泰珪),하태경(河泰慶),40,36,76,0
40831,이태규(李泰珪),한기호(韓起鎬),36,29,65,0
40832,이태규(李泰珪),한무경(韓茂景),51,76,127,0
40833,이태규(李泰珪),한병도(韓秉道),28,5,33,1
40834,이태규(李泰珪),한정애(韓貞愛),28,5,33,1
40835,이태규(李泰珪),한준호(韓俊鎬),28,4,32,1
40836,이태규(李泰珪),허숙정(許淑湞),0,0,0,1
40837,이태규(李泰珪),허영(許榮),29,5,34,1
40838,이태규(李泰珪),허은아(許垠娥),49,59,108,0
40839,이태규(李泰珪),허종식(許琮植),30,5,35,1
40840,이태규(李泰珪),홍기원(洪起元),29,5,34,1
40841,이태규(李泰珪),홍문표(洪文杓),40,38,78,0
40842,이태규(李泰珪),홍석준(洪碩晙),40,35,75,0
40843,이태규(李泰珪),홍성국(洪性國),31,6,37,1
40844,이태규(李泰珪),홍영표(洪永杓),29,6,35,1
40845,이태규(李泰珪),홍익표(洪翼杓),28,5,33,1
40846,이태규(李泰珪),홍정민(洪貞敏),29,5,34,1
40847,이태규(李泰珪),황보승희(皇甫承希),43,45,88,1
40848,이태규(李泰珪),황운하(黃雲夏),30,5,35,1
40849,이태규(李泰珪),황희(黃熙),28,7,35,1
40850,이학영(李學永),이해식(李海植),114,138,252,0
40851,이학영(李學永),이헌승(李憲昇),52,5,57,1
40852,이학영(李學永),이형석(李炯錫),106,129,235,0
40853,이학영(李學永),인재근(印在謹),102,128,230,0
40854,이학영(李學永),임병헌(林炳憲),25,4,29,1
40855,이학영(李學永),임오경(林五卿),94,93,187,0
40856,이학영(李學永),임이자(林利子),49,4,53,1
40857,이학영(李學永),임종성(林鍾聲),114,148,262,0
40858,이학영(李學永),임호선(林昊宣),169,355,524,0
40859,이학영(李學永),장경태(張耿態),111,112,223,0
40860,이학영(李學永),장동혁(張東赫),25,4,29,1
40861,이학영(李學永),장제원(張濟元),49,4,53,1
40862,이학영(李學永),장철민(張喆敏),93,124,217,0
40863,이학영(李學永),장혜영(張惠英),15,24,39,1
40864,이학영(李學永),전봉민(田奉珉),35,5,40,1
40865,이학영(李學永),전용기(田溶冀),121,166,287,0
40866,이학영(李學永),전재수(田載秀),109,87,196,0
40867,이학영(李學永),전주혜(全珠惠),50,6,56,1
40868,이학영(李學永),전해철(全海澈),83,68,151,0
40869,이학영(李學永),전혜숙(全惠淑),94,80,174,0
40870,이학영(李學永),정경희(丁慶姬),49,4,53,1
40871,이학영(李學永),정동만(鄭東萬),49,4,53,1
40872,이학영(李學永),정성호(鄭成湖),96,122,218,0
40873,이학영(李學永),정우택(鄭宇澤),26,4,30,1
40874,이학영(李學永),정운천(鄭雲天),50,5,55,1
40875,이학영(李學永),정일영(鄭日永),92,116,208,0
40876,이학영(李學永),정점식(鄭点植),49,4,53,1
40877,이학영(李學永),정진석(鄭鎭碩),49,7,56,1
40878,이학영(李學永),정청래(鄭淸來),92,51,143,0
40879,이학영(李學永),정춘숙(鄭春淑),111,133,244,0
40880,이학영(李學永),정태호(鄭泰浩),97,149,246,0
40881,이학영(李學永),정필모(鄭必模),113,123,236,0
40882,이학영(李學永),정희용(鄭熙溶),50,6,56,1
40883,이학영(李學永),조경태(趙慶泰),49,8,57,1
40884,이학영(李學永),조명희(曺明姬),49,7,56,1
40885,이학영(李學永),조수진(趙修眞),49,4,53,1
40886,이학영(李學永),조승래(趙承來),105,84,189,0
40887,이학영(李學永),조오섭(曺五燮),112,211,323,0
40888,이학영(李學永),조은희(趙恩禧),25,5,30,1
40889,이학영(李學永),조응천(趙應天),92,58,150,0
40890,이학영(李學永),조정식(趙正湜),82,72,154,0
40891,이학영(李學永),조정훈(趙廷訓),8,6,14,1
40892,이학영(李學永),조해진(曺海珍),50,5,55,1
40893,이학영(李學永),주철현(朱哲鉉),104,105,209,0
40894,이학영(李學永),주호영(朱豪英),49,4,53,1
40895,이학영(李學永),지성호(池成浩),49,4,53,1
40896,이학영(李學永),진선미(陳善美),93,102,195,0
40897,이학영(李學永),진성준(陳聲準),120,114,234,0
40898,이학영(李學永),천준호(千俊鎬),105,76,181,0
40899,이학영(李學永),최기상(崔基相),96,119,215,0
40900,이학영(李學永),최승재(崔承宰),50,9,59,1
40901,이학영(李學永),최연숙(崔姸淑),32,11,43,1
40902,이학영(李學永),최영희(崔英姬),25,4,29,1
40903,이학영(李學永),최인호(崔仁昊),121,144,265,0
40904,이학영(李學永),최재형(崔在亨),25,4,29,1
40905,이학영(李學永),최종윤(崔鍾允),109,121,230,0
40906,이학영(李學永),최춘식(崔春植),49,4,53,1
40907,이학영(李學永),최형두(崔炯斗),49,7,56,1
40908,이학영(李學永),최혜영(崔惠英),108,180,288,0
40909,이학영(李學永),추경호(秋慶鎬),49,3,52,1
40910,이학영(李學永),태영호(太永浩),49,6,55,1
40911,이학영(李學永),하영제(河榮帝),41,4,45,1
40912,이학영(李學永),하태경(河泰慶),49,4,53,1
40913,이학영(李學永),한기호(韓起鎬),49,4,53,1
40914,이학영(李學永),한무경(韓茂景),49,5,54,1
40915,이학영(李學永),한병도(韓秉道),108,128,236,0
40916,이학영(李學永),한정애(韓貞愛),83,89,172,0
40917,이학영(李學永),한준호(韓俊鎬),117,150,267,0
40918,이학영(李學永),허숙정(許淑湞),1,1,2,0
40919,이학영(李學永),허영(許榮),133,162,295,0
40920,이학영(李學永),허은아(許垠娥),49,6,55,1
40921,이학영(李學永),허종식(許琮植),119,112,231,0
40922,이학영(李學永),홍기원(洪起元),105,83,188,0
40923,이학영(李學永),홍문표(洪文杓),52,13,65,1
40924,이학영(李學永),홍석준(洪碩晙),49,4,53,1
40925,이학영(李學永),홍성국(洪性國),125,172,297,0
40926,이학영(李學永),홍영표(洪永杓),81,73,154,0
40927,이학영(李學永),홍익표(洪翼杓),102,124,226,0
40928,이학영(李學永),홍정민(洪貞敏),106,110,216,0
40929,이학영(李學永),황보승희(皇甫承希),45,3,48,1
40930,이학영(李學永),황운하(黃雲夏),117,118,235,0
40931,이학영(李學永),황희(黃熙),83,42,125,0
40932,이해식(李海植),이헌승(李憲昇),51,5,56,1
40933,이해식(李海植),이형석(李炯錫),138,175,313,0
40934,이해식(李海植),인재근(印在謹),121,146,267,0
40935,이해식(李海植),임병헌(林炳憲),25,4,29,1
40936,이해식(李海植),임오경(林五卿),109,94,203,0
40937,이해식(李海植),임이자(林利子),49,4,53,1
40938,이해식(李海植),임종성(林鍾聲),112,98,210,0
40939,이해식(李海植),임호선(林昊宣),164,188,352,0
40940,이해식(李海植),장경태(張耿態),122,108,230,0
40941,이해식(李海植),장동혁(張東赫),25,4,29,1
40942,이해식(李海植),장제원(張濟元),49,4,53,1
40943,이해식(李海植),장철민(張喆敏),91,70,161,0
40944,이해식(李海植),장혜영(張惠英),19,19,38,1
40945,이해식(李海植),전봉민(田奉珉),35,5,40,1
40946,이해식(李海植),전용기(田溶冀),102,78,180,0
40947,이해식(李海植),전재수(田載秀),88,56,144,0
40948,이해식(李海植),전주혜(全珠惠),51,5,56,1
40949,이해식(李海植),전해철(全海澈),77,52,129,0
40950,이해식(李海植),전혜숙(全惠淑),99,94,193,0
40951,이해식(李海植),정경희(丁慶姬),50,4,54,1
40952,이해식(李海植),정동만(鄭東萬),51,4,55,1
40953,이해식(李海植),정성호(鄭成湖),92,78,170,0
40954,이해식(李海植),정우택(鄭宇澤),25,4,29,1
40955,이해식(李海植),정운천(鄭雲天),50,4,54,1
40956,이해식(李海植),정일영(鄭日永),105,94,199,0
40957,이해식(李海植),정점식(鄭点植),50,4,54,1
40958,이해식(李海植),정진석(鄭鎭碩),50,5,55,1
40959,이해식(李海植),정청래(鄭淸來),84,55,139,0
40960,이해식(李海植),정춘숙(鄭春淑),97,71,168,0
40961,이해식(李海植),정태호(鄭泰浩),88,80,168,0
40962,이해식(李海植),정필모(鄭必模),98,87,185,0
40963,이해식(李海植),정희용(鄭熙溶),51,6,57,1
40964,이해식(李海植),조경태(趙慶泰),49,4,53,1
40965,이해식(李海植),조명희(曺明姬),50,7,57,1
40966,이해식(李海植),조수진(趙修眞),50,4,54,1
40967,이해식(李海植),조승래(趙承來),94,53,147,0
40968,이해식(李海植),조오섭(曺五燮),122,138,260,0
40969,이해식(李海植),조은희(趙恩禧),25,4,29,1
40970,이해식(李海植),조응천(趙應天),80,40,120,0
40971,이해식(李海植),조정식(趙正湜),78,49,127,0
40972,이해식(李海植),조정훈(趙廷訓),6,9,15,1
40973,이해식(李海植),조해진(曺海珍),51,6,57,1
40974,이해식(李海植),주철현(朱哲鉉),112,108,220,0
40975,이해식(李海植),주호영(朱豪英),49,4,53,1
40976,이해식(李海植),지성호(池成浩),49,5,54,1
40977,이해식(李海植),진선미(陳善美),91,75,166,0
40978,이해식(李海植),진성준(陳聲準),114,125,239,0
40979,이해식(李海植),천준호(千俊鎬),100,71,171,0
40980,이해식(李海植),최기상(崔基相),88,75,163,0
40981,이해식(李海植),최승재(崔承宰),49,6,55,1
40982,이해식(李海植),최연숙(崔姸淑),31,13,44,1
40983,이해식(李海植),최영희(崔英姬),25,4,29,1
40984,이해식(李海植),최인호(崔仁昊),95,79,174,0
40985,이해식(李海植),최재형(崔在亨),25,4,29,1
40986,이해식(李海植),최종윤(崔鍾允),114,112,226,0
40987,이해식(李海植),최춘식(崔春植),51,6,57,1
40988,이해식(李海植),최형두(崔炯斗),51,9,60,1
40989,이해식(李海植),최혜영(崔惠英),120,106,226,0
40990,이해식(李海植),추경호(秋慶鎬),50,4,54,1
40991,이해식(李海植),태영호(太永浩),49,6,55,1
40992,이해식(李海植),하영제(河榮帝),41,4,45,1
40993,이해식(李海植),하태경(河泰慶),50,4,54,1
40994,이해식(李海植),한기호(韓起鎬),50,7,57,1
40995,이해식(李海植),한무경(韓茂景),49,5,54,1
40996,이해식(李海植),한병도(韓秉道),145,143,288,0
40997,이해식(李海植),한정애(韓貞愛),85,52,137,0
40998,이해식(李海植),한준호(韓俊鎬),103,91,194,0
40999,이해식(李海植),허숙정(許淑湞),1,2,3,0
41000,이해식(李海植),허영(許榮),138,165,303,0
41001,이해식(李海植),허은아(許垠娥),49,5,54,1
41002,이해식(李海植),허종식(許琮植),108,101,209,0
41003,이해식(李海植),홍기원(洪起元),108,87,195,0
41004,이해식(李海植),홍문표(洪文杓),53,6,59,1
41005,이해식(李海植),홍석준(洪碩晙),50,4,54,1
41006,이해식(李海植),홍성국(洪性國),124,148,272,0
41007,이해식(李海植),홍영표(洪永杓),89,54,143,0
41008,이해식(李海植),홍익표(洪翼杓),93,74,167,0
41009,이해식(李海植),홍정민(洪貞敏),120,94,214,0
41010,이해식(李海植),황보승희(皇甫承希),46,2,48,1
41011,이해식(李海植),황운하(黃雲夏),131,118,249,0
41012,이해식(李海植),황희(黃熙),82,42,124,0
41013,이헌승(李憲昇),이형석(李炯錫),50,4,54,1
41014,이헌승(李憲昇),인재근(印在謹),49,7,56,1
41015,이헌승(李憲昇),임병헌(林炳憲),29,53,82,0
41016,이헌승(李憲昇),임오경(林五卿),50,4,54,1
41017,이헌승(李憲昇),임이자(林利子),79,88,167,0
41018,이헌승(李憲昇),임종성(林鍾聲),51,8,59,1
41019,이헌승(李憲昇),임호선(林昊宣),50,4,54,1
41020,이헌승(李憲昇),장경태(張耿態),50,4,54,1
41021,이헌승(李憲昇),장동혁(張東赫),28,62,90,0
41022,이헌승(李憲昇),장제원(張濟元),67,48,115,0
41023,이헌승(李憲昇),장철민(張喆敏),50,5,55,1
41024,이헌승(李憲昇),장혜영(張惠英),6,4,10,1
41025,이헌승(李憲昇),전봉민(田奉珉),82,252,334,0
41026,이헌승(李憲昇),전용기(田溶冀),52,4,56,1
41027,이헌승(李憲昇),전재수(田載秀),51,7,58,1
41028,이헌승(李憲昇),전주혜(全珠惠),68,66,134,0
41029,이헌승(李憲昇),전해철(全海澈),51,5,56,1
41030,이헌승(李憲昇),전혜숙(全惠淑),50,6,56,1
41031,이헌승(李憲昇),정경희(丁慶姬),68,66,134,0
41032,이헌승(李憲昇),정동만(鄭東萬),93,205,298,0
41033,이헌승(李憲昇),정성호(鄭成湖),53,9,62,1
41034,이헌승(李憲昇),정우택(鄭宇澤),36,102,138,0
41035,이헌승(李憲昇),정운천(鄭雲天),74,166,240,0
41036,이헌승(李憲昇),정일영(鄭日永),50,7,57,1
41037,이헌승(李憲昇),정점식(鄭点植),66,48,114,0
41038,이헌승(李憲昇),정진석(鄭鎭碩),63,52,115,0
41039,이헌승(李憲昇),정청래(鄭淸來),49,4,53,1
41040,이헌승(李憲昇),정춘숙(鄭春淑),50,5,55,1
41041,이헌승(李憲昇),정태호(鄭泰浩),50,5,55,1
41042,이헌승(李憲昇),정필모(鄭必模),51,4,55,1
41043,이헌승(李憲昇),정희용(鄭熙溶),74,101,175,0
41044,이헌승(李憲昇),조경태(趙慶泰),73,114,187,0
41045,이헌승(李憲昇),조명희(曺明姬),76,117,193,0
41046,이헌승(李憲昇),조수진(趙修眞),74,94,168,0
41047,이헌승(李憲昇),조승래(趙承來),50,6,56,1
41048,이헌승(李憲昇),조오섭(曺五燮),50,5,55,1
41049,이헌승(李憲昇),조은희(趙恩禧),29,58,87,0
41050,이헌승(李憲昇),조응천(趙應天),51,5,56,1
41051,이헌승(李憲昇),조정식(趙正湜),49,3,52,1
41052,이헌승(李憲昇),조정훈(趙廷訓),1,0,1,1
41053,이헌승(李憲昇),조해진(曺海珍),63,46,109,0
41054,이헌승(李憲昇),주철현(朱哲鉉),55,4,59,1
41055,이헌승(李憲昇),주호영(朱豪英),67,53,120,0
41056,이헌승(李憲昇),지성호(池成浩),77,129,206,0
41057,이헌승(李憲昇),진선미(陳善美),50,4,54,1
41058,이헌승(李憲昇),진성준(陳聲準),52,5,57,1
41059,이헌승(李憲昇),천준호(千俊鎬),50,3,53,1
41060,이헌승(李憲昇),최기상(崔基相),49,4,53,1
41061,이헌승(李憲昇),최승재(崔承宰),66,70,136,0
41062,이헌승(李憲昇),최연숙(崔姸淑),32,51,83,0
41063,이헌승(李憲昇),최영희(崔英姬),31,113,144,0
41064,이헌승(李憲昇),최인호(崔仁昊),52,7,59,1
41065,이헌승(李憲昇),최재형(崔在亨),25,14,39,0
41066,이헌승(李憲昇),최종윤(崔鍾允),50,5,55,1
41067,이헌승(李憲昇),최춘식(崔春植),71,120,191,0
41068,이헌승(李憲昇),최형두(崔炯斗),80,69,149,0
41069,이헌승(李憲昇),최혜영(崔惠英),49,6,55,1
41070,이헌승(李憲昇),추경호(秋慶鎬),92,59,151,0
41071,이헌승(李憲昇),태영호(太永浩),70,124,194,0
41072,이헌승(李憲昇),하영제(河榮帝),75,135,210,1
41073,이헌승(李憲昇),하태경(河泰慶),70,69,139,0
41074,이헌승(李憲昇),한기호(韓起鎬),67,63,130,0
41075,이헌승(李憲昇),한무경(韓茂景),69,114,183,0
41076,이헌승(李憲昇),한병도(韓秉道),49,4,53,1
41077,이헌승(李憲昇),한정애(韓貞愛),53,6,59,1
41078,이헌승(李憲昇),한준호(韓俊鎬),57,7,64,1
41079,이헌승(李憲昇),허숙정(許淑湞),0,0,0,1
41080,이헌승(李憲昇),허영(許榮),52,4,56,1
41081,이헌승(李憲昇),허은아(許垠娥),68,39,107,0
41082,이헌승(李憲昇),허종식(許琮植),52,10,62,1
41083,이헌승(李憲昇),홍기원(洪起元),51,4,55,1
41084,이헌승(李憲昇),홍문표(洪文杓),62,106,168,0
41085,이헌승(李憲昇),홍석준(洪碩晙),74,90,164,0
41086,이헌승(李憲昇),홍성국(洪性國),50,5,55,1
41087,이헌승(李憲昇),홍영표(洪永杓),50,6,56,1
41088,이헌승(李憲昇),홍익표(洪翼杓),50,4,54,1
41089,이헌승(李憲昇),홍정민(洪貞敏),50,4,54,1
41090,이헌승(李憲昇),황보승희(皇甫承希),87,126,213,1
41091,이헌승(李憲昇),황운하(黃雲夏),53,6,59,1
41092,이헌승(李憲昇),황희(黃熙),49,5,54,1
41093,이형석(李炯錫),인재근(印在謹),133,133,266,0
41094,이형석(李炯錫),임병헌(林炳憲),25,4,29,1
41095,이형석(李炯錫),임오경(林五卿),109,98,207,0
41096,이형석(李炯錫),임이자(林利子),49,4,53,1
41097,이형석(李炯錫),임종성(林鍾聲),107,98,205,0
41098,이형석(李炯錫),임호선(林昊宣),168,239,407,0
41099,이형석(李炯錫),장경태(張耿態),106,145,251,0
41100,이형석(李炯錫),장동혁(張東赫),25,4,29,1
41101,이형석(李炯錫),장제원(張濟元),49,4,53,1
41102,이형석(李炯錫),장철민(張喆敏),94,82,176,0
41103,이형석(李炯錫),장혜영(張惠英),16,24,40,1
41104,이형석(李炯錫),전봉민(田奉珉),35,5,40,1
41105,이형석(李炯錫),전용기(田溶冀),125,143,268,0
41106,이형석(李炯錫),전재수(田載秀),95,68,163,0
41107,이형석(李炯錫),전주혜(全珠惠),51,5,56,1
41108,이형석(李炯錫),전해철(全海澈),80,58,138,0
41109,이형석(李炯錫),전혜숙(全惠淑),112,130,242,0
41110,이형석(李炯錫),정경희(丁慶姬),50,4,54,1
41111,이형석(李炯錫),정동만(鄭東萬),49,4,53,1
41112,이형석(李炯錫),정성호(鄭成湖),87,74,161,0
41113,이형석(李炯錫),정우택(鄭宇澤),26,5,31,1
41114,이형석(李炯錫),정운천(鄭雲天),50,5,55,1
41115,이형석(李炯錫),정일영(鄭日永),117,104,221,0
41116,이형석(李炯錫),정점식(鄭点植),49,4,53,1
41117,이형석(李炯錫),정진석(鄭鎭碩),51,7,58,1
41118,이형석(李炯錫),정청래(鄭淸來),95,75,170,0
41119,이형석(李炯錫),정춘숙(鄭春淑),93,77,170,0
41120,이형석(李炯錫),정태호(鄭泰浩),93,94,187,0
41121,이형석(李炯錫),정필모(鄭必模),105,123,228,0
41122,이형석(李炯錫),정희용(鄭熙溶),50,5,55,1
41123,이형석(李炯錫),조경태(趙慶泰),50,5,55,1
41124,이형석(李炯錫),조명희(曺明姬),50,8,58,1
41125,이형석(李炯錫),조수진(趙修眞),52,4,56,1
41126,이형석(李炯錫),조승래(趙承來),109,62,171,0
41127,이형석(李炯錫),조오섭(曺五燮),178,253,431,0
41128,이형석(李炯錫),조은희(趙恩禧),26,6,32,1
41129,이형석(李炯錫),조응천(趙應天),81,53,134,0
41130,이형석(李炯錫),조정식(趙正湜),85,47,132,0
41131,이형석(李炯錫),조정훈(趙廷訓),5,9,14,1
41132,이형석(李炯錫),조해진(曺海珍),51,5,56,1
41133,이형석(李炯錫),주철현(朱哲鉉),111,134,245,0
41134,이형석(李炯錫),주호영(朱豪英),49,4,53,1
41135,이형석(李炯錫),지성호(池成浩),50,4,54,1
41136,이형석(李炯錫),진선미(陳善美),90,56,146,0
41137,이형석(李炯錫),진성준(陳聲準),116,113,229,0
41138,이형석(李炯錫),천준호(千俊鎬),100,83,183,0
41139,이형석(李炯錫),최기상(崔基相),95,139,234,0
41140,이형석(李炯錫),최승재(崔承宰),52,5,57,1
41141,이형석(李炯錫),최연숙(崔姸淑),37,18,55,1
41142,이형석(李炯錫),최영희(崔英姬),25,5,30,1
41143,이형석(李炯錫),최인호(崔仁昊),82,74,156,0
41144,이형석(李炯錫),최재형(崔在亨),25,5,30,1
41145,이형석(李炯錫),최종윤(崔鍾允),113,123,236,0
41146,이형석(李炯錫),최춘식(崔春植),51,13,64,1
41147,이형석(李炯錫),최형두(崔炯斗),50,5,55,1
41148,이형석(李炯錫),최혜영(崔惠英),103,111,214,0
41149,이형석(李炯錫),추경호(秋慶鎬),49,3,52,1
41150,이형석(李炯錫),태영호(太永浩),49,4,53,1
41151,이형석(李炯錫),하영제(河榮帝),42,3,45,1
41152,이형석(李炯錫),하태경(河泰慶),51,5,56,1
41153,이형석(李炯錫),한기호(韓起鎬),51,4,55,1
41154,이형석(李炯錫),한무경(韓茂景),49,4,53,1
41155,이형석(李炯錫),한병도(韓秉道),157,150,307,0
41156,이형석(李炯錫),한정애(韓貞愛),84,75,159,0
41157,이형석(李炯錫),한준호(韓俊鎬),113,138,251,0
41158,이형석(李炯錫),허숙정(許淑湞),1,2,3,0
41159,이형석(李炯錫),허영(許榮),145,164,309,0
41160,이형석(李炯錫),허은아(許垠娥),49,5,54,1
41161,이형석(李炯錫),허종식(許琮植),117,116,233,0
41162,이형석(李炯錫),홍기원(洪起元),102,123,225,0
41163,이형석(李炯錫),홍문표(洪文杓),49,6,55,1
41164,이형석(李炯錫),홍석준(洪碩晙),49,4,53,1
41165,이형석(李炯錫),홍성국(洪性國),130,136,266,0
41166,이형석(李炯錫),홍영표(洪永杓),99,57,156,0
41167,이형석(李炯錫),홍익표(洪翼杓),117,100,217,0
41168,이형석(李炯錫),홍정민(洪貞敏),114,125,239,0
41169,이형석(李炯錫),황보승희(皇甫承希),50,3,53,1
41170,이형석(李炯錫),황운하(黃雲夏),109,115,224,0
41171,이형석(李炯錫),황희(黃熙),86,48,134,0
41172,인재근(印在謹),임병헌(林炳憲),25,5,30,1
41173,인재근(印在謹),임오경(林五卿),92,79,171,0
41174,인재근(印在謹),임이자(林利子),49,6,55,1
41175,인재근(印在謹),임종성(林鍾聲),125,156,281,0
41176,인재근(印在謹),임호선(林昊宣),116,151,267,0
41177,인재근(印在謹),장경태(張耿態),108,82,190,0
41178,인재근(印在謹),장동혁(張東赫),25,4,29,1
41179,인재근(印在謹),장제원(張濟元),49,4,53,1
41180,인재근(印在謹),장철민(張喆敏),89,69,158,0
41181,인재근(印在謹),장혜영(張惠英),17,23,40,1
41182,인재근(印在謹),전봉민(田奉珉),35,7,42,1
41183,인재근(印在謹),전용기(田溶冀),96,93,189,0
41184,인재근(印在謹),전재수(田載秀),88,76,164,0
41185,인재근(印在謹),전주혜(全珠惠),51,5,56,1
41186,인재근(印在謹),전해철(全海澈),76,76,152,0
41187,인재근(印在謹),전혜숙(全惠淑),101,114,215,0
41188,인재근(印在謹),정경희(丁慶姬),50,5,55,1
41189,인재근(印在謹),정동만(鄭東萬),49,5,54,1
41190,인재근(印在謹),정성호(鄭成湖),83,70,153,0
41191,인재근(印在謹),정우택(鄭宇澤),26,6,32,1
41192,인재근(印在謹),정운천(鄭雲天),51,6,57,1
41193,인재근(印在謹),정일영(鄭日永),86,89,175,0
41194,인재근(印在謹),정점식(鄭点植),49,4,53,1
41195,인재근(印在謹),정진석(鄭鎭碩),49,5,54,1
41196,인재근(印在謹),정청래(鄭淸來),90,50,140,0
41197,인재근(印在謹),정춘숙(鄭春淑),127,173,300,0
41198,인재근(印在謹),정태호(鄭泰浩),90,110,200,0
41199,인재근(印在謹),정필모(鄭必模),87,76,163,0
41200,인재근(印在謹),정희용(鄭熙溶),50,6,56,1
41201,인재근(印在謹),조경태(趙慶泰),50,4,54,1
41202,인재근(印在謹),조명희(曺明姬),50,8,58,1
41203,인재근(印在謹),조수진(趙修眞),51,6,57,1
41204,인재근(印在謹),조승래(趙承來),106,105,211,0
41205,인재근(印在謹),조오섭(曺五燮),153,270,423,0
41206,인재근(印在謹),조은희(趙恩禧),26,5,31,1
41207,인재근(印在謹),조응천(趙應天),81,47,128,0
41208,인재근(印在謹),조정식(趙正湜),80,58,138,0
41209,인재근(印在謹),조정훈(趙廷訓),5,6,11,1
41210,인재근(印在謹),조해진(曺海珍),51,8,59,1
41211,인재근(印在謹),주철현(朱哲鉉),103,117,220,0
41212,인재근(印在謹),주호영(朱豪英),49,4,53,1
41213,인재근(印在謹),지성호(池成浩),50,5,55,1
41214,인재근(印在謹),진선미(陳善美),89,69,158,0
41215,인재근(印在謹),진성준(陳聲準),101,96,197,0
41216,인재근(印在謹),천준호(千俊鎬),85,56,141,0
41217,인재근(印在謹),최기상(崔基相),84,61,145,0
41218,인재근(印在謹),최승재(崔承宰),50,8,58,1
41219,인재근(印在謹),최연숙(崔姸淑),44,30,74,1
41220,인재근(印在謹),최영희(崔英姬),25,6,31,1
41221,인재근(印在謹),최인호(崔仁昊),89,73,162,0
41222,인재근(印在謹),최재형(崔在亨),25,6,31,1
41223,인재근(印在謹),최종윤(崔鍾允),168,273,441,0
41224,인재근(印在謹),최춘식(崔春植),49,9,58,1
41225,인재근(印在謹),최형두(崔炯斗),49,7,56,1
41226,인재근(印在謹),최혜영(崔惠英),180,266,446,0
41227,인재근(印在謹),추경호(秋慶鎬),49,3,52,1
41228,인재근(印在謹),태영호(太永浩),49,5,54,1
41229,인재근(印在謹),하영제(河榮帝),42,4,46,1
41230,인재근(印在謹),하태경(河泰慶),49,6,55,1
41231,인재근(印在謹),한기호(韓起鎬),50,6,56,1
41232,인재근(印在謹),한무경(韓茂景),53,7,60,1
41233,인재근(印在謹),한병도(韓秉道),111,105,216,0
41234,인재근(印在謹),한정애(韓貞愛),86,80,166,0
41235,인재근(印在謹),한준호(韓俊鎬),110,123,233,0
41236,인재근(印在謹),허숙정(許淑湞),1,1,2,0
41237,인재근(印在謹),허영(許榮),126,142,268,0
41238,인재근(印在謹),허은아(許垠娥),49,6,55,1
41239,인재근(印在謹),허종식(許琮植),116,121,237,0
41240,인재근(印在謹),홍기원(洪起元),88,84,172,0
41241,인재근(印在謹),홍문표(洪文杓),50,7,57,1
41242,인재근(印在謹),홍석준(洪碩晙),50,4,54,1
41243,인재근(印在謹),홍성국(洪性國),134,150,284,0
41244,인재근(印在謹),홍영표(洪永杓),78,70,148,0
41245,인재근(印在謹),홍익표(洪翼杓),98,85,183,0
41246,인재근(印在謹),홍정민(洪貞敏),101,83,184,0
41247,인재근(印在謹),황보승희(皇甫承希),46,5,51,1
41248,인재근(印在謹),황운하(黃雲夏),115,133,248,0
41249,인재근(印在謹),황희(黃熙),83,47,130,0
41250,임병헌(林炳憲),임오경(林五卿),26,4,30,1
41251,임병헌(林炳憲),임이자(林利子),29,33,62,0
41252,임병헌(林炳憲),임종성(林鍾聲),25,5,30,1
41253,임병헌(林炳憲),임호선(林昊宣),25,4,29,1
41254,임병헌(林炳憲),장경태(張耿態),25,4,29,1
41255,임병헌(林炳憲),장동혁(張東赫),28,44,72,0
41256,임병헌(林炳憲),장제원(張濟元),26,10,36,0
41257,임병헌(林炳憲),장철민(張喆敏),26,4,30,1
41258,임병헌(林炳憲),장혜영(張惠英),1,2,3,1
41259,임병헌(林炳憲),전봉민(田奉珉),30,22,52,0
41260,임병헌(林炳憲),전용기(田溶冀),26,5,31,1
41261,임병헌(林炳憲),전재수(田載秀),25,4,29,1
41262,임병헌(林炳憲),전주혜(全珠惠),33,33,66,0
41263,임병헌(林炳憲),전해철(全海澈),26,4,30,1
41264,임병헌(林炳憲),전혜숙(全惠淑),25,4,29,1
41265,임병헌(林炳憲),정경희(丁慶姬),34,41,75,0
41266,임병헌(林炳憲),정동만(鄭東萬),29,17,46,0
41267,임병헌(林炳憲),정성호(鄭成湖),29,4,33,1
41268,임병헌(林炳憲),정우택(鄭宇澤),34,45,79,0
41269,임병헌(林炳憲),정운천(鄭雲天),33,27,60,0
41270,임병헌(林炳憲),정일영(鄭日永),25,4,29,1
41271,임병헌(林炳憲),정점식(鄭点植),37,13,50,0
41272,임병헌(林炳憲),정진석(鄭鎭碩),28,15,43,0
41273,임병헌(林炳憲),정청래(鄭淸來),25,4,29,1
41274,임병헌(林炳憲),정춘숙(鄭春淑),25,5,30,1
41275,임병헌(林炳憲),정태호(鄭泰浩),25,5,30,1
41276,임병헌(林炳憲),정필모(鄭必模),25,4,29,1
41277,임병헌(林炳憲),정희용(鄭熙溶),43,45,88,0
41278,임병헌(林炳憲),조경태(趙慶泰),30,27,57,0
41279,임병헌(林炳憲),조명희(曺明姬),52,88,140,0
41280,임병헌(林炳憲),조수진(趙修眞),30,39,69,0
41281,임병헌(林炳憲),조승래(趙承來),26,3,29,1
41282,임병헌(林炳憲),조오섭(曺五燮),27,4,31,1
41283,임병헌(林炳憲),조은희(趙恩禧),37,42,79,0
41284,임병헌(林炳憲),조응천(趙應天),25,3,28,1
41285,임병헌(林炳憲),조정식(趙正湜),25,3,28,1
41286,임병헌(林炳憲),조정훈(趙廷訓),2,6,8,1
41287,임병헌(林炳憲),조해진(曺海珍),30,34,64,0
41288,임병헌(林炳憲),주철현(朱哲鉉),26,4,30,1
41289,임병헌(林炳憲),주호영(朱豪英),32,24,56,0
41290,임병헌(林炳憲),지성호(池成浩),33,82,115,0
41291,임병헌(林炳憲),진선미(陳善美),25,4,29,1
41292,임병헌(林炳憲),진성준(陳聲準),25,4,29,1
41293,임병헌(林炳憲),천준호(千俊鎬),25,3,28,1
41294,임병헌(林炳憲),최기상(崔基相),25,4,29,1
41295,임병헌(林炳憲),최승재(崔承宰),31,35,66,0
41296,임병헌(林炳憲),최연숙(崔姸淑),33,42,75,0
41297,임병헌(林炳憲),최영희(崔英姬),32,57,89,0
41298,임병헌(林炳憲),최인호(崔仁昊),26,4,30,1
41299,임병헌(林炳憲),최재형(崔在亨),27,16,43,0
41300,임병헌(林炳憲),최종윤(崔鍾允),25,4,29,1
41301,임병헌(林炳憲),최춘식(崔春植),35,56,91,0
41302,임병헌(林炳憲),최형두(崔炯斗),48,38,86,0
41303,임병헌(林炳憲),최혜영(崔惠英),25,10,35,1
41304,임병헌(林炳憲),추경호(秋慶鎬),26,10,36,0
41305,임병헌(林炳憲),태영호(太永浩),36,69,105,0
41306,임병헌(林炳憲),하영제(河榮帝),25,45,70,1
41307,임병헌(林炳憲),하태경(河泰慶),26,32,58,0
41308,임병헌(林炳憲),한기호(韓起鎬),29,49,78,0
41309,임병헌(林炳憲),한무경(韓茂景),29,51,80,0
41310,임병헌(林炳憲),한병도(韓秉道),25,4,29,1
41311,임병헌(林炳憲),한정애(韓貞愛),25,4,29,1
41312,임병헌(林炳憲),한준호(韓俊鎬),27,4,31,1
41313,임병헌(林炳憲),허숙정(許淑湞),0,0,0,1
41314,임병헌(林炳憲),허영(許榮),27,4,31,1
41315,임병헌(林炳憲),허은아(許垠娥),29,14,43,0
41316,임병헌(林炳憲),허종식(許琮植),26,6,32,1
41317,임병헌(林炳憲),홍기원(洪起元),25,4,29,1
41318,임병헌(林炳憲),홍문표(洪文杓),30,30,60,0
41319,임병헌(林炳憲),홍석준(洪碩晙),31,42,73,0
41320,임병헌(林炳憲),홍성국(洪性國),25,4,29,1
41321,임병헌(林炳憲),홍영표(洪永杓),25,4,29,1
41322,임병헌(林炳憲),홍익표(洪翼杓),25,4,29,1
41323,임병헌(林炳憲),홍정민(洪貞敏),25,4,29,1
41324,임병헌(林炳憲),황보승희(皇甫承希),38,43,81,1
41325,임병헌(林炳憲),황운하(黃雲夏),26,5,31,1
41326,임병헌(林炳憲),황희(黃熙),25,6,31,1
41327,임오경(林五卿),임이자(林利子),49,4,53,1
41328,임오경(林五卿),임종성(林鍾聲),100,112,212,0
41329,임오경(林五卿),임호선(林昊宣),180,212,392,0
41330,임오경(林五卿),장경태(張耿態),156,218,374,0
41331,임오경(林五卿),장동혁(張東赫),25,4,29,1
41332,임오경(林五卿),장제원(張濟元),49,4,53,1
41333,임오경(林五卿),장철민(張喆敏),182,187,369,0
41334,임오경(林五卿),장혜영(張惠英),17,14,31,1
41335,임오경(林五卿),전봉민(田奉珉),35,5,40,1
41336,임오경(林五卿),전용기(田溶冀),135,162,297,0
41337,임오경(林五卿),전재수(田載秀),90,68,158,0
41338,임오경(林五卿),전주혜(全珠惠),51,6,57,1
41339,임오경(林五卿),전해철(全海澈),79,54,133,0
41340,임오경(林五卿),전혜숙(全惠淑),99,105,204,0
41341,임오경(林五卿),정경희(丁慶姬),49,4,53,1
41342,임오경(林五卿),정동만(鄭東萬),49,4,53,1
41343,임오경(林五卿),정성호(鄭成湖),84,88,172,0
41344,임오경(林五卿),정우택(鄭宇澤),25,5,30,1
41345,임오경(林五卿),정운천(鄭雲天),49,5,54,1
41346,임오경(林五卿),정일영(鄭日永),89,75,164,0
41347,임오경(林五卿),정점식(鄭点植),50,4,54,1
41348,임오경(林五卿),정진석(鄭鎭碩),50,7,57,1
41349,임오경(林五卿),정청래(鄭淸來),170,214,384,0
41350,임오경(林五卿),정춘숙(鄭春淑),88,79,167,0
41351,임오경(林五卿),정태호(鄭泰浩),85,82,167,0
41352,임오경(林五卿),정필모(鄭必模),93,67,160,0
41353,임오경(林五卿),정희용(鄭熙溶),50,6,56,1
41354,임오경(林五卿),조경태(趙慶泰),49,5,54,1
41355,임오경(林五卿),조명희(曺明姬),50,7,57,1
41356,임오경(林五卿),조수진(趙修眞),49,4,53,1
41357,임오경(林五卿),조승래(趙承來),101,70,171,0
41358,임오경(林五卿),조오섭(曺五燮),98,132,230,0
41359,임오경(林五卿),조은희(趙恩禧),25,4,29,1
41360,임오경(林五卿),조응천(趙應天),75,38,113,0
41361,임오경(林五卿),조정식(趙正湜),77,52,129,0
41362,임오경(林五卿),조정훈(趙廷訓),3,12,15,1
41363,임오경(林五卿),조해진(曺海珍),52,5,57,1
41364,임오경(林五卿),주철현(朱哲鉉),135,130,265,0
41365,임오경(林五卿),주호영(朱豪英),49,4,53,1
41366,임오경(林五卿),지성호(池成浩),49,4,53,1
41367,임오경(林五卿),진선미(陳善美),87,64,151,0
41368,임오경(林五卿),진성준(陳聲準),106,99,205,0
41369,임오경(林五卿),천준호(千俊鎬),93,73,166,0
41370,임오경(林五卿),최기상(崔基相),86,72,158,0
41371,임오경(林五卿),최승재(崔承宰),50,8,58,1
41372,임오경(林五卿),최연숙(崔姸淑),30,12,42,1
41373,임오경(林五卿),최영희(崔英姬),25,7,32,1
41374,임오경(林五卿),최인호(崔仁昊),102,95,197,0
41375,임오경(林五卿),최재형(崔在亨),25,5,30,1
41376,임오경(林五卿),최종윤(崔鍾允),109,125,234,0
41377,임오경(林五卿),최춘식(崔春植),50,10,60,1
41378,임오경(林五卿),최형두(崔炯斗),51,9,60,1
41379,임오경(林五卿),최혜영(崔惠英),171,206,377,0
41380,임오경(林五卿),추경호(秋慶鎬),49,3,52,1
41381,임오경(林五卿),태영호(太永浩),49,5,54,1
41382,임오경(林五卿),하영제(河榮帝),41,1,42,1
41383,임오경(林五卿),하태경(河泰慶),49,4,53,1
41384,임오경(林五卿),한기호(韓起鎬),50,6,56,1
41385,임오경(林五卿),한무경(韓茂景),49,6,55,1
41386,임오경(林五卿),한병도(韓秉道),133,116,249,0
41387,임오경(林五卿),한정애(韓貞愛),78,55,133,0
41388,임오경(林五卿),한준호(韓俊鎬),158,168,326,0
41389,임오경(林五卿),허숙정(許淑湞),1,1,2,0
41390,임오경(林五卿),허영(許榮),122,128,250,0
41391,임오경(林五卿),허은아(許垠娥),49,5,54,1
41392,임오경(林五卿),허종식(許琮植),97,91,188,0
41393,임오경(林五卿),홍기원(洪起元),99,100,199,0
41394,임오경(林五卿),홍문표(洪文杓),50,6,56,1
41395,임오경(林五卿),홍석준(洪碩晙),50,4,54,1
41396,임오경(林五卿),홍성국(洪性國),158,188,346,0
41397,임오경(林五卿),홍영표(洪永杓),88,62,150,0
41398,임오경(林五卿),홍익표(洪翼杓),94,83,177,0
41399,임오경(林五卿),홍정민(洪貞敏),107,118,225,0
41400,임오경(林五卿),황보승희(皇甫承希),46,3,49,1
41401,임오경(林五卿),황운하(黃雲夏),112,132,244,0
41402,임오경(林五卿),황희(黃熙),86,64,150,0
41403,임이자(林利子),임종성(林鍾聲),49,5,54,1
41404,임이자(林利子),임호선(林昊宣),49,6,55,1
41405,임이자(林利子),장경태(張耿態),49,4,53,1
41406,임이자(林利子),장동혁(張東赫),34,41,75,0
41407,임이자(林利子),장제원(張濟元),63,39,102,0
41408,임이자(林利子),장철민(張喆敏),49,4,53,1
41409,임이자(林利子),장혜영(張惠英),5,5,10,1
41410,임이자(林利子),전봉민(田奉珉),62,80,142,0
41411,임이자(林利子),전용기(田溶冀),49,6,55,1
41412,임이자(林利子),전재수(田載秀),49,4,53,1
41413,임이자(林利子),전주혜(全珠惠),79,66,145,0
41414,임이자(林利子),전해철(全海澈),50,4,54,1
41415,임이자(林利子),전혜숙(全惠淑),49,5,54,1
41416,임이자(林利子),정경희(丁慶姬),78,69,147,0
41417,임이자(林利子),정동만(鄭東萬),77,74,151,0
41418,임이자(林利子),정성호(鄭成湖),52,4,56,1
41419,임이자(林利子),정우택(鄭宇澤),33,49,82,0
41420,임이자(林利子),정운천(鄭雲天),116,129,245,0
41421,임이자(林利子),정일영(鄭日永),49,4,53,1
41422,임이자(林利子),정점식(鄭点植),98,85,183,0
41423,임이자(林利子),정진석(鄭鎭碩),111,116,227,0
41424,임이자(林利子),정청래(鄭淸來),49,4,53,1
41425,임이자(林利子),정춘숙(鄭春淑),49,5,54,1
41426,임이자(林利子),정태호(鄭泰浩),49,4,53,1
41427,임이자(林利子),정필모(鄭必模),49,4,53,1
41428,임이자(林利子),정희용(鄭熙溶),126,206,332,0
41429,임이자(林利子),조경태(趙慶泰),88,77,165,0
41430,임이자(林利子),조명희(曺明姬),95,121,216,0
41431,임이자(林利子),조수진(趙修眞),88,106,194,0
41432,임이자(林利子),조승래(趙承來),50,5,55,1
41433,임이자(林利子),조오섭(曺五燮),50,4,54,1
41434,임이자(林利子),조은희(趙恩禧),30,35,65,0
41435,임이자(林利子),조응천(趙應天),49,3,52,1
41436,임이자(林利子),조정식(趙正湜),49,3,52,1
41437,임이자(林利子),조정훈(趙廷訓),3,12,15,1
41438,임이자(林利子),조해진(曺海珍),69,37,106,0
41439,임이자(林利子),주철현(朱哲鉉),50,4,54,1
41440,임이자(林利子),주호영(朱豪英),73,89,162,0
41441,임이자(林利子),지성호(池成浩),110,158,268,0
41442,임이자(林利子),진선미(陳善美),49,4,53,1
41443,임이자(林利子),진성준(陳聲準),49,4,53,1
41444,임이자(林利子),천준호(千俊鎬),49,3,52,1
41445,임이자(林利子),최기상(崔基相),49,4,53,1
41446,임이자(林利子),최승재(崔承宰),88,97,185,0
41447,임이자(林利子),최연숙(崔姸淑),34,34,68,0
41448,임이자(林利子),최영희(崔英姬),40,73,113,0
41449,임이자(林利子),최인호(崔仁昊),50,4,54,1
41450,임이자(林利子),최재형(崔在亨),28,15,43,0
41451,임이자(林利子),최종윤(崔鍾允),49,4,53,1
41452,임이자(林利子),최춘식(崔春植),86,111,197,0
41453,임이자(林利子),최형두(崔炯斗),98,92,190,0
41454,임이자(林利子),최혜영(崔惠英),50,6,56,1
41455,임이자(林利子),추경호(秋慶鎬),144,140,284,0
41456,임이자(林利子),태영호(太永浩),101,162,263,0
41457,임이자(林利子),하영제(河榮帝),91,99,190,1
41458,임이자(林利子),하태경(河泰慶),66,46,112,0
41459,임이자(林利子),한기호(韓起鎬),79,58,137,0
41460,임이자(林利子),한무경(韓茂景),128,176,304,0
41461,임이자(林利子),한병도(韓秉道),49,4,53,1
41462,임이자(林利子),한정애(韓貞愛),49,4,53,1
41463,임이자(林利子),한준호(韓俊鎬),50,4,54,1
41464,임이자(林利子),허숙정(許淑湞),0,0,0,1
41465,임이자(林利子),허영(許榮),49,10,59,1
41466,임이자(林利子),허은아(許垠娥),117,122,239,0
41467,임이자(林利子),허종식(許琮植),50,5,55,1
41468,임이자(林利子),홍기원(洪起元),49,4,53,1
41469,임이자(林利子),홍문표(洪文杓),80,83,163,0
41470,임이자(林利子),홍석준(洪碩晙),78,75,153,0
41471,임이자(林利子),홍성국(洪性國),49,4,53,1
41472,임이자(林利子),홍영표(洪永杓),50,4,54,1
41473,임이자(林利子),홍익표(洪翼杓),49,4,53,1
41474,임이자(林利子),홍정민(洪貞敏),50,4,54,1
41475,임이자(林利子),황보승희(皇甫承希),75,103,178,1
41476,임이자(林利子),황운하(黃雲夏),49,6,55,1
41477,임이자(林利子),황희(黃熙),49,5,54,1
41478,임종성(林鍾聲),임호선(林昊宣),132,203,335,0
41479,임종성(林鍾聲),장경태(張耿態),121,149,270,0
41480,임종성(林鍾聲),장동혁(張東赫),25,5,30,1
41481,임종성(林鍾聲),장제원(張濟元),49,4,53,1
41482,임종성(林鍾聲),장철민(張喆敏),114,131,245,0
41483,임종성(林鍾聲),장혜영(張惠英),15,20,35,1
41484,임종성(林鍾聲),전봉민(田奉珉),35,6,41,1
41485,임종성(林鍾聲),전용기(田溶冀),121,137,258,0
41486,임종성(林鍾聲),전재수(田載秀),104,101,205,0
41487,임종성(林鍾聲),전주혜(全珠惠),52,6,58,1
41488,임종성(林鍾聲),전해철(全海澈),83,78,161,0
41489,임종성(林鍾聲),전혜숙(全惠淑),107,101,208,0
41490,임종성(林鍾聲),정경희(丁慶姬),51,5,56,1
41491,임종성(林鍾聲),정동만(鄭東萬),49,5,54,1
41492,임종성(林鍾聲),정성호(鄭成湖),110,169,279,0
41493,임종성(林鍾聲),정우택(鄭宇澤),27,5,32,1
41494,임종성(林鍾聲),정운천(鄭雲天),50,7,57,1
41495,임종성(林鍾聲),정일영(鄭日永),106,133,239,0
41496,임종성(林鍾聲),정점식(鄭点植),51,5,56,1
41497,임종성(林鍾聲),정진석(鄭鎭碩),53,8,61,1
41498,임종성(林鍾聲),정청래(鄭淸來),94,68,162,0
41499,임종성(林鍾聲),정춘숙(鄭春淑),153,299,452,0
41500,임종성(林鍾聲),정태호(鄭泰浩),100,105,205,0
41501,임종성(林鍾聲),정필모(鄭必模),99,96,195,0
41502,임종성(林鍾聲),정희용(鄭熙溶),50,8,58,1
41503,임종성(林鍾聲),조경태(趙慶泰),50,4,54,1
41504,임종성(林鍾聲),조명희(曺明姬),50,6,56,1
41505,임종성(林鍾聲),조수진(趙修眞),53,6,59,1
41506,임종성(林鍾聲),조승래(趙承來),103,75,178,0
41507,임종성(林鍾聲),조오섭(曺五燮),108,172,280,0
41508,임종성(林鍾聲),조은희(趙恩禧),26,4,30,1
41509,임종성(林鍾聲),조응천(趙應天),83,42,125,0
41510,임종성(林鍾聲),조정식(趙正湜),87,62,149,0
41511,임종성(林鍾聲),조정훈(趙廷訓),6,10,16,1
41512,임종성(林鍾聲),조해진(曺海珍),51,6,57,1
41513,임종성(林鍾聲),주철현(朱哲鉉),108,140,248,0
41514,임종성(林鍾聲),주호영(朱豪英),49,6,55,1
41515,임종성(林鍾聲),지성호(池成浩),50,5,55,1
41516,임종성(林鍾聲),진선미(陳善美),87,69,156,0
41517,임종성(林鍾聲),진성준(陳聲準),111,112,223,0
41518,임종성(林鍾聲),천준호(千俊鎬),98,70,168,0
41519,임종성(林鍾聲),최기상(崔基相),90,106,196,0
41520,임종성(林鍾聲),최승재(崔承宰),54,9,63,1
41521,임종성(林鍾聲),최연숙(崔姸淑),32,16,48,1
41522,임종성(林鍾聲),최영희(崔英姬),25,5,30,1
41523,임종성(林鍾聲),최인호(崔仁昊),110,129,239,0
41524,임종성(林鍾聲),최재형(崔在亨),25,5,30,1
41525,임종성(林鍾聲),최종윤(崔鍾允),132,149,281,0
41526,임종성(林鍾聲),최춘식(崔春植),50,10,60,1
41527,임종성(林鍾聲),최형두(崔炯斗),52,8,60,1
41528,임종성(林鍾聲),최혜영(崔惠英),112,140,252,0
41529,임종성(林鍾聲),추경호(秋慶鎬),51,5,56,1
41530,임종성(林鍾聲),태영호(太永浩),50,11,61,1
41531,임종성(林鍾聲),하영제(河榮帝),44,3,47,1
41532,임종성(林鍾聲),하태경(河泰慶),51,4,55,1
41533,임종성(林鍾聲),한기호(韓起鎬),52,6,58,1
41534,임종성(林鍾聲),한무경(韓茂景),52,6,58,1
41535,임종성(林鍾聲),한병도(韓秉道),111,95,206,0
41536,임종성(林鍾聲),한정애(韓貞愛),88,100,188,0
41537,임종성(林鍾聲),한준호(韓俊鎬),130,145,275,0
41538,임종성(林鍾聲),허숙정(許淑湞),1,1,2,0
41539,임종성(林鍾聲),허영(許榮),132,137,269,0
41540,임종성(林鍾聲),허은아(許垠娥),49,5,54,1
41541,임종성(林鍾聲),허종식(許琮植),121,191,312,0
41542,임종성(林鍾聲),홍기원(洪起元),108,111,219,0
41543,임종성(林鍾聲),홍문표(洪文杓),50,5,55,1
41544,임종성(林鍾聲),홍석준(洪碩晙),52,4,56,1
41545,임종성(林鍾聲),홍성국(洪性國),138,189,327,0
41546,임종성(林鍾聲),홍영표(洪永杓),84,67,151,0
41547,임종성(林鍾聲),홍익표(洪翼杓),109,136,245,0
41548,임종성(林鍾聲),홍정민(洪貞敏),113,119,232,0
41549,임종성(林鍾聲),황보승희(皇甫承希),53,4,57,1
41550,임종성(林鍾聲),황운하(黃雲夏),115,173,288,0
41551,임종성(林鍾聲),황희(黃熙),85,55,140,0
41552,임호선(林昊宣),장경태(張耿態),180,251,431,0
41553,임호선(林昊宣),장동혁(張東赫),25,4,29,1
41554,임호선(林昊宣),장제원(張濟元),49,4,53,1
41555,임호선(林昊宣),장철민(張喆敏),148,219,367,0
41556,임호선(林昊宣),장혜영(張惠英),16,37,53,1
41557,임호선(林昊宣),전봉민(田奉珉),35,6,41,1
41558,임호선(林昊宣),전용기(田溶冀),140,236,376,0
41559,임호선(林昊宣),전재수(田載秀),107,151,258,0
41560,임호선(林昊宣),전주혜(全珠惠),53,7,60,1
41561,임호선(林昊宣),전해철(全海澈),78,70,148,0
41562,임호선(林昊宣),전혜숙(全惠淑),100,120,220,0
41563,임호선(林昊宣),정경희(丁慶姬),52,6,58,1
41564,임호선(林昊宣),정동만(鄭東萬),49,4,53,1
41565,임호선(林昊宣),정성호(鄭成湖),89,123,212,0
41566,임호선(林昊宣),정우택(鄭宇澤),27,5,32,1
41567,임호선(林昊宣),정운천(鄭雲天),51,8,59,1
41568,임호선(林昊宣),정일영(鄭日永),127,164,291,0
41569,임호선(林昊宣),정점식(鄭点植),50,4,54,1
41570,임호선(林昊宣),정진석(鄭鎭碩),51,9,60,1
41571,임호선(林昊宣),정청래(鄭淸來),144,132,276,0
41572,임호선(林昊宣),정춘숙(鄭春淑),106,125,231,0
41573,임호선(林昊宣),정태호(鄭泰浩),113,182,295,0
41574,임호선(林昊宣),정필모(鄭必模),113,204,317,0
41575,임호선(林昊宣),정희용(鄭熙溶),52,9,61,1
41576,임호선(林昊宣),조경태(趙慶泰),50,5,55,1
41577,임호선(林昊宣),조명희(曺明姬),50,7,57,1
41578,임호선(林昊宣),조수진(趙修眞),52,6,58,1
41579,임호선(林昊宣),조승래(趙承來),123,138,261,0
41580,임호선(林昊宣),조오섭(曺五燮),131,231,362,0
41581,임호선(林昊宣),조은희(趙恩禧),26,5,31,1
41582,임호선(林昊宣),조응천(趙應天),87,81,168,0
41583,임호선(林昊宣),조정식(趙正湜),90,108,198,0
41584,임호선(林昊宣),조정훈(趙廷訓),11,21,32,1
41585,임호선(林昊宣),조해진(曺海珍),52,5,57,1
41586,임호선(林昊宣),주철현(朱哲鉉),164,224,388,0
41587,임호선(林昊宣),주호영(朱豪英),50,4,54,1
41588,임호선(林昊宣),지성호(池成浩),50,6,56,1
41589,임호선(林昊宣),진선미(陳善美),97,101,198,0
41590,임호선(林昊宣),진성준(陳聲準),131,156,287,0
41591,임호선(林昊宣),천준호(千俊鎬),110,97,207,0
41592,임호선(林昊宣),최기상(崔基相),107,197,304,0
41593,임호선(林昊宣),최승재(崔承宰),54,9,63,1
41594,임호선(林昊宣),최연숙(崔姸淑),34,11,45,1
41595,임호선(林昊宣),최영희(崔英姬),25,6,31,1
41596,임호선(林昊宣),최인호(崔仁昊),109,207,316,0
41597,임호선(林昊宣),최재형(崔在亨),25,4,29,1
41598,임호선(林昊宣),최종윤(崔鍾允),128,162,290,0
41599,임호선(林昊宣),최춘식(崔春植),50,17,67,1
41600,임호선(林昊宣),최형두(崔炯斗),50,5,55,1
41601,임호선(林昊宣),최혜영(崔惠英),193,322,515,0
41602,임호선(林昊宣),추경호(秋慶鎬),50,5,55,1
41603,임호선(林昊宣),태영호(太永浩),49,6,55,1
41604,임호선(林昊宣),하영제(河榮帝),42,4,46,1
41605,임호선(林昊宣),하태경(河泰慶),52,5,57,1
41606,임호선(林昊宣),한기호(韓起鎬),52,8,60,1
41607,임호선(林昊宣),한무경(韓茂景),49,4,53,1
41608,임호선(林昊宣),한병도(韓秉道),178,199,377,0
41609,임호선(林昊宣),한정애(韓貞愛),89,118,207,0
41610,임호선(林昊宣),한준호(韓俊鎬),158,233,391,0
41611,임호선(林昊宣),허숙정(許淑湞),1,1,2,0
41612,임호선(林昊宣),허영(許榮),163,275,438,0
41613,임호선(林昊宣),허은아(許垠娥),50,6,56,1
41614,임호선(林昊宣),허종식(許琮植),120,171,291,0
41615,임호선(林昊宣),홍기원(洪起元),129,168,297,0
41616,임호선(林昊宣),홍문표(洪文杓),50,6,56,1
41617,임호선(林昊宣),홍석준(洪碩晙),50,6,56,1
41618,임호선(林昊宣),홍성국(洪性國),223,379,602,0
41619,임호선(林昊宣),홍영표(洪永杓),90,78,168,0
41620,임호선(林昊宣),홍익표(洪翼杓),128,154,282,0
41621,임호선(林昊宣),홍정민(洪貞敏),139,164,303,0
41622,임호선(林昊宣),황보승희(皇甫承希),49,1,50,1
41623,임호선(林昊宣),황운하(黃雲夏),152,217,369,0
41624,임호선(林昊宣),황희(黃熙),93,56,149,0
41625,장경태(張耿態),장동혁(張東赫),25,4,29,1
41626,장경태(張耿態),장제원(張濟元),49,4,53,1
41627,장경태(張耿態),장철민(張喆敏),145,155,300,0
41628,장경태(張耿態),장혜영(張惠英),26,55,81,1
41629,장경태(張耿態),전봉민(田奉珉),35,5,40,1
41630,장경태(張耿態),전용기(田溶冀),146,176,322,0
41631,장경태(張耿態),전재수(田載秀),87,54,141,0
41632,장경태(張耿態),전주혜(全珠惠),51,5,56,1
41633,장경태(張耿態),전해철(全海澈),82,59,141,0
41634,장경태(張耿態),전혜숙(全惠淑),109,131,240,0
41635,장경태(張耿態),정경희(丁慶姬),49,4,53,1
41636,장경태(張耿態),정동만(鄭東萬),49,4,53,1
41637,장경태(張耿態),정성호(鄭成湖),86,104,190,0
41638,장경태(張耿態),정우택(鄭宇澤),25,4,29,1
41639,장경태(張耿態),정운천(鄭雲天),49,5,54,1
41640,장경태(張耿態),정일영(鄭日永),98,141,239,0
41641,장경태(張耿態),정점식(鄭点植),51,5,56,1
41642,장경태(張耿態),정진석(鄭鎭碩),50,5,55,1
41643,장경태(張耿態),정청래(鄭淸來),155,177,332,0
41644,장경태(張耿態),정춘숙(鄭春淑),112,138,250,0
41645,장경태(張耿態),정태호(鄭泰浩),86,99,185,0
41646,장경태(張耿態),정필모(鄭必模),99,140,239,0
41647,장경태(張耿態),정희용(鄭熙溶),50,6,56,1
41648,장경태(張耿態),조경태(趙慶泰),51,5,56,1
41649,장경태(張耿態),조명희(曺明姬),49,7,56,1
41650,장경태(張耿態),조수진(趙修眞),49,4,53,1
41651,장경태(張耿態),조승래(趙承來),97,107,204,0
41652,장경태(張耿態),조오섭(曺五燮),136,181,317,0
41653,장경태(張耿態),조은희(趙恩禧),26,5,31,1
41654,장경태(張耿態),조응천(趙應天),101,48,149,0
41655,장경태(張耿態),조정식(趙正湜),76,48,124,0
41656,장경태(張耿態),조정훈(趙廷訓),11,24,35,1
41657,장경태(張耿態),조해진(曺海珍),52,5,57,1
41658,장경태(張耿態),주철현(朱哲鉉),149,193,342,0
41659,장경태(張耿態),주호영(朱豪英),50,4,54,1
41660,장경태(張耿態),지성호(池成浩),50,4,54,1
41661,장경태(張耿態),진선미(陳善美),96,64,160,0
41662,장경태(張耿態),진성준(陳聲準),128,148,276,0
41663,장경태(張耿態),천준호(千俊鎬),120,123,243,0
41664,장경태(張耿態),최기상(崔基相),92,84,176,0
41665,장경태(張耿態),최승재(崔承宰),50,9,59,1
41666,장경태(張耿態),최연숙(崔姸淑),32,15,47,1
41667,장경태(張耿態),최영희(崔英姬),25,5,30,1
41668,장경태(張耿態),최인호(崔仁昊),99,83,182,0
41669,장경태(張耿態),최재형(崔在亨),25,4,29,1
41670,장경태(張耿態),최종윤(崔鍾允),111,145,256,0
41671,장경태(張耿態),최춘식(崔春植),50,15,65,1
41672,장경태(張耿態),최형두(崔炯斗),50,9,59,1
41673,장경태(張耿態),최혜영(崔惠英),184,241,425,0
41674,장경태(張耿態),추경호(秋慶鎬),50,4,54,1
41675,장경태(張耿態),태영호(太永浩),49,10,59,1
41676,장경태(張耿態),하영제(河榮帝),41,1,42,1
41677,장경태(張耿態),하태경(河泰慶),50,6,56,1
41678,장경태(張耿態),한기호(韓起鎬),51,4,55,1
41679,장경태(張耿態),한무경(韓茂景),50,5,55,1
41680,장경태(張耿態),한병도(韓秉道),124,150,274,0
41681,장경태(張耿態),한정애(韓貞愛),76,50,126,0
41682,장경태(張耿態),한준호(韓俊鎬),157,231,388,0
41683,장경태(張耿態),허숙정(許淑湞),1,1,2,0
41684,장경태(張耿態),허영(許榮),152,153,305,0
41685,장경태(張耿態),허은아(許垠娥),49,5,54,1
41686,장경태(張耿態),허종식(許琮植),108,133,241,0
41687,장경태(張耿態),홍기원(洪起元),127,138,265,0
41688,장경태(張耿態),홍문표(洪文杓),51,8,59,1
41689,장경태(張耿態),홍석준(洪碩晙),50,4,54,1
41690,장경태(張耿態),홍성국(洪性國),160,188,348,0
41691,장경태(張耿態),홍영표(洪永杓),83,75,158,0
41692,장경태(張耿態),홍익표(洪翼杓),92,99,191,0
41693,장경태(張耿態),홍정민(洪貞敏),137,196,333,0
41694,장경태(張耿態),황보승희(皇甫承希),46,3,49,1
41695,장경태(張耿態),황운하(黃雲夏),139,275,414,0
41696,장경태(張耿態),황희(黃熙),85,51,136,0
41697,장동혁(張東赫),장제원(張濟元),26,11,37,0
41698,장동혁(張東赫),장철민(張喆敏),25,4,29,1
41699,장동혁(張東赫),장혜영(張惠英),0,0,0,1
41700,장동혁(張東赫),전봉민(田奉珉),31,45,76,0
41701,장동혁(張東赫),전용기(田溶冀),25,4,29,1
41702,장동혁(張東赫),전재수(田載秀),25,4,29,1
41703,장동혁(張東赫),전주혜(全珠惠),36,57,93,0
41704,장동혁(張東赫),전해철(全海澈),25,5,30,1
41705,장동혁(張東赫),전혜숙(全惠淑),25,4,29,1
41706,장동혁(張東赫),정경희(丁慶姬),29,32,61,0
41707,장동혁(張東赫),정동만(鄭東萬),30,30,60,0
41708,장동혁(張東赫),정성호(鄭成湖),25,5,30,1
41709,장동혁(張東赫),정우택(鄭宇澤),33,49,82,0
41710,장동혁(張東赫),정운천(鄭雲天),31,40,71,0
41711,장동혁(張東赫),정일영(鄭日永),25,4,29,1
41712,장동혁(張東赫),정점식(鄭点植),31,34,65,0
41713,장동혁(張東赫),정진석(鄭鎭碩),27,15,42,0
41714,장동혁(張東赫),정청래(鄭淸來),25,4,29,1
41715,장동혁(張東赫),정춘숙(鄭春淑),25,4,29,1
41716,장동혁(張東赫),정태호(鄭泰浩),25,4,29,1
41717,장동혁(張東赫),정필모(鄭必模),25,4,29,1
41718,장동혁(張東赫),정희용(鄭熙溶),32,61,93,0
41719,장동혁(張東赫),조경태(趙慶泰),27,16,43,0
41720,장동혁(張東赫),조명희(曺明姬),30,39,69,0
41721,장동혁(張東赫),조수진(趙修眞),34,84,118,0
41722,장동혁(張東赫),조승래(趙承來),25,3,28,1
41723,장동혁(張東赫),조오섭(曺五燮),25,4,29,1
41724,장동혁(張東赫),조은희(趙恩禧),31,39,70,0
41725,장동혁(張東赫),조응천(趙應天),25,3,28,1
41726,장동혁(張東赫),조정식(趙正湜),25,3,28,1
41727,장동혁(張東赫),조정훈(趙廷訓),3,9,12,1
41728,장동혁(張東赫),조해진(曺海珍),28,11,39,0
41729,장동혁(張東赫),주철현(朱哲鉉),26,4,30,1
41730,장동혁(張東赫),주호영(朱豪英),29,37,66,0
41731,장동혁(張東赫),지성호(池成浩),31,61,92,0
41732,장동혁(張東赫),진선미(陳善美),25,4,29,1
41733,장동혁(張東赫),진성준(陳聲準),25,4,29,1
41734,장동혁(張東赫),천준호(千俊鎬),25,3,28,1
41735,장동혁(張東赫),최기상(崔基相),25,4,29,1
41736,장동혁(張東赫),최승재(崔承宰),30,36,66,0
41737,장동혁(張東赫),최연숙(崔姸淑),28,29,57,0
41738,장동혁(張東赫),최영희(崔英姬),33,63,96,0
41739,장동혁(張東赫),최인호(崔仁昊),25,4,29,1
41740,장동혁(張東赫),최재형(崔在亨),28,18,46,0
41741,장동혁(張東赫),최종윤(崔鍾允),25,4,29,1
41742,장동혁(張東赫),최춘식(崔春植),31,53,84,0
41743,장동혁(張東赫),최형두(崔炯斗),27,15,42,0
41744,장동혁(張東赫),최혜영(崔惠英),25,4,29,1
41745,장동혁(張東赫),추경호(秋慶鎬),25,8,33,0
41746,장동혁(張東赫),태영호(太永浩),32,56,88,0
41747,장동혁(張東赫),하영제(河榮帝),24,32,56,1
41748,장동혁(張東赫),하태경(河泰慶),26,18,44,0
41749,장동혁(張東赫),한기호(韓起鎬),27,14,41,0
41750,장동혁(張東赫),한무경(韓茂景),28,54,82,0
41751,장동혁(張東赫),한병도(韓秉道),25,4,29,1
41752,장동혁(張東赫),한정애(韓貞愛),25,4,29,1
41753,장동혁(張東赫),한준호(韓俊鎬),25,4,29,1
41754,장동혁(張東赫),허숙정(許淑湞),0,0,0,1
41755,장동혁(張東赫),허영(許榮),25,4,29,1
41756,장동혁(張東赫),허은아(許垠娥),28,26,54,0
41757,장동혁(張東赫),허종식(許琮植),25,4,29,1
41758,장동혁(張東赫),홍기원(洪起元),25,4,29,1
41759,장동혁(張東赫),홍문표(洪文杓),25,45,70,0
41760,장동혁(張東赫),홍석준(洪碩晙),29,31,60,0
41761,장동혁(張東赫),홍성국(洪性國),25,4,29,1
41762,장동혁(張東赫),홍영표(洪永杓),25,4,29,1
41763,장동혁(張東赫),홍익표(洪翼杓),25,4,29,1
41764,장동혁(張東赫),홍정민(洪貞敏),25,4,29,1
41765,장동혁(張東赫),황보승희(皇甫承希),24,39,63,1
41766,장동혁(張東赫),황운하(黃雲夏),25,4,29,1
41767,장동혁(張東赫),황희(黃熙),25,5,30,1
41768,장제원(張濟元),장철민(張喆敏),49,4,53,1
41769,장제원(張濟元),장혜영(張惠英),4,2,6,1
41770,장제원(張濟元),전봉민(田奉珉),55,48,103,0
41771,장제원(張濟元),전용기(田溶冀),49,4,53,1
41772,장제원(張濟元),전재수(田載秀),50,6,56,1
41773,장제원(張濟元),전주혜(全珠惠),63,45,108,0
41774,장제원(張濟元),전해철(全海澈),49,4,53,1
41775,장제원(張濟元),전혜숙(全惠淑),49,4,53,1
41776,장제원(張濟元),정경희(丁慶姬),61,32,93,0
41777,장제원(張濟元),정동만(鄭東萬),68,47,115,0
41778,장제원(張濟元),정성호(鄭成湖),49,5,54,1
41779,장제원(張濟元),정우택(鄭宇澤),28,13,41,0
41780,장제원(張濟元),정운천(鄭雲天),64,43,107,0
41781,장제원(張濟元),정일영(鄭日永),49,4,53,1
41782,장제원(張濟元),정점식(鄭点植),59,38,97,0
41783,장제원(張濟元),정진석(鄭鎭碩),65,44,109,0
41784,장제원(張濟元),정청래(鄭淸來),49,4,53,1
41785,장제원(張濟元),정춘숙(鄭春淑),49,4,53,1
41786,장제원(張濟元),정태호(鄭泰浩),49,4,53,1
41787,장제원(張濟元),정필모(鄭必模),49,4,53,1
41788,장제원(張濟元),정희용(鄭熙溶),66,49,115,0
41789,장제원(張濟元),조경태(趙慶泰),73,60,133,0
41790,장제원(張濟元),조명희(曺明姬),59,40,99,0
41791,장제원(張濟元),조수진(趙修眞),70,56,126,0
41792,장제원(張濟元),조승래(趙承來),49,3,52,1
41793,장제원(張濟元),조오섭(曺五燮),49,5,54,1
41794,장제원(張濟元),조은희(趙恩禧),28,17,45,0
41795,장제원(張濟元),조응천(趙應天),49,3,52,1
41796,장제원(張濟元),조정식(趙正湜),49,3,52,1
41797,장제원(張濟元),조정훈(趙廷訓),0,0,0,1
41798,장제원(張濟元),조해진(曺海珍),58,34,92,0
41799,장제원(張濟元),주철현(朱哲鉉),49,5,54,1
41800,장제원(張濟元),주호영(朱豪英),64,39,103,0
41801,장제원(張濟元),지성호(池成浩),73,47,120,0
41802,장제원(張濟元),진선미(陳善美),49,4,53,1
41803,장제원(張濟元),진성준(陳聲準),49,5,54,1
41804,장제원(張濟元),천준호(千俊鎬),49,3,52,1
41805,장제원(張濟元),최기상(崔基相),49,4,53,1
41806,장제원(張濟元),최승재(崔承宰),61,36,97,0
41807,장제원(張濟元),최연숙(崔姸淑),35,24,59,0
41808,장제원(張濟元),최영희(崔英姬),26,10,36,0
41809,장제원(張濟元),최인호(崔仁昊),51,7,58,1
41810,장제원(張濟元),최재형(崔在亨),25,11,36,0
41811,장제원(張濟元),최종윤(崔鍾允),49,4,53,1
41812,장제원(張濟元),최춘식(崔春植),65,50,115,0
41813,장제원(張濟元),최형두(崔炯斗),67,45,112,0
41814,장제원(張濟元),최혜영(崔惠英),49,5,54,1
41815,장제원(張濟元),추경호(秋慶鎬),68,50,118,0
41816,장제원(張濟元),태영호(太永浩),72,74,146,0
41817,장제원(張濟元),하영제(河榮帝),51,36,87,1
41818,장제원(張濟元),하태경(河泰慶),65,44,109,0
41819,장제원(張濟元),한기호(韓起鎬),60,40,100,0
41820,장제원(張濟元),한무경(韓茂景),65,45,110,0
41821,장제원(張濟元),한병도(韓秉道),49,4,53,1
41822,장제원(張濟元),한정애(韓貞愛),49,4,53,1
41823,장제원(張濟元),한준호(韓俊鎬),49,4,53,1
41824,장제원(張濟元),허숙정(許淑湞),0,0,0,1
41825,장제원(張濟元),허영(許榮),49,4,53,1
41826,장제원(張濟元),허은아(許垠娥),63,35,98,0
41827,장제원(張濟元),허종식(許琮植),49,4,53,1
41828,장제원(張濟元),홍기원(洪起元),49,4,53,1
41829,장제원(張濟元),홍문표(洪文杓),66,57,123,0
41830,장제원(張濟元),홍석준(洪碩晙),61,41,102,0
41831,장제원(張濟元),홍성국(洪性國),50,6,56,1
41832,장제원(張濟元),홍영표(洪永杓),49,4,53,1
41833,장제원(張濟元),홍익표(洪翼杓),49,4,53,1
41834,장제원(張濟元),홍정민(洪貞敏),49,4,53,1
41835,장제원(張濟元),황보승희(皇甫承希),65,51,116,1
41836,장제원(張濟元),황운하(黃雲夏),49,5,54,1
41837,장제원(張濟元),황희(黃熙),49,4,53,1
41838,장철민(張喆敏),장혜영(張惠英),16,40,56,1
41839,장철민(張喆敏),전봉민(田奉珉),35,5,40,1
41840,장철민(張喆敏),전용기(田溶冀),114,118,232,0
41841,장철민(張喆敏),전재수(田載秀),88,87,175,0
41842,장철민(張喆敏),전주혜(全珠惠),52,5,57,1
41843,장철민(張喆敏),전해철(全海澈),78,57,135,0
41844,장철민(張喆敏),전혜숙(全惠淑),107,82,189,0
41845,장철민(張喆敏),정경희(丁慶姬),50,4,54,1
41846,장철민(張喆敏),정동만(鄭東萬),50,4,54,1
41847,장철민(張喆敏),정성호(鄭成湖),91,93,184,0
41848,장철민(張喆敏),정우택(鄭宇澤),26,6,32,1
41849,장철민(張喆敏),정운천(鄭雲天),50,5,55,1
41850,장철민(張喆敏),정일영(鄭日永),94,150,244,0
41851,장철민(張喆敏),정점식(鄭点植),50,4,54,1
41852,장철민(張喆敏),정진석(鄭鎭碩),52,6,58,1
41853,장철민(張喆敏),정청래(鄭淸來),127,95,222,0
41854,장철민(張喆敏),정춘숙(鄭春淑),100,87,187,0
41855,장철민(張喆敏),정태호(鄭泰浩),94,88,182,0
41856,장철민(張喆敏),정필모(鄭必模),86,82,168,0
41857,장철민(張喆敏),정희용(鄭熙溶),50,7,57,1
41858,장철민(張喆敏),조경태(趙慶泰),50,5,55,1
41859,장철민(張喆敏),조명희(曺明姬),51,5,56,1
41860,장철민(張喆敏),조수진(趙修眞),52,5,57,1
41861,장철민(張喆敏),조승래(趙承來),120,133,253,0
41862,장철민(張喆敏),조오섭(曺五燮),105,176,281,0
41863,장철민(張喆敏),조은희(趙恩禧),26,4,30,1
41864,장철민(張喆敏),조응천(趙應天),76,52,128,0
41865,장철민(張喆敏),조정식(趙正湜),77,51,128,0
41866,장철민(張喆敏),조정훈(趙廷訓),7,20,27,1
41867,장철민(張喆敏),조해진(曺海珍),51,6,57,1
41868,장철민(張喆敏),주철현(朱哲鉉),125,110,235,0
41869,장철민(張喆敏),주호영(朱豪英),49,4,53,1
41870,장철민(張喆敏),지성호(池成浩),50,4,54,1
41871,장철민(張喆敏),진선미(陳善美),91,55,146,0
41872,장철민(張喆敏),진성준(陳聲準),92,97,189,0
41873,장철민(張喆敏),천준호(千俊鎬),86,58,144,0
41874,장철민(張喆敏),최기상(崔基相),88,84,172,0
41875,장철민(張喆敏),최승재(崔承宰),50,5,55,1
41876,장철민(張喆敏),최연숙(崔姸淑),31,6,37,1
41877,장철민(張喆敏),최영희(崔英姬),25,6,31,1
41878,장철민(張喆敏),최인호(崔仁昊),89,118,207,0
41879,장철민(張喆敏),최재형(崔在亨),25,5,30,1
41880,장철민(張喆敏),최종윤(崔鍾允),124,173,297,0
41881,장철민(張喆敏),최춘식(崔春植),49,4,53,1
41882,장철민(張喆敏),최형두(崔炯斗),50,7,57,1
41883,장철민(張喆敏),최혜영(崔惠英),147,162,309,0
41884,장철민(張喆敏),추경호(秋慶鎬),49,4,53,1
41885,장철민(張喆敏),태영호(太永浩),49,5,54,1
41886,장철민(張喆敏),하영제(河榮帝),42,2,44,1
41887,장철민(張喆敏),하태경(河泰慶),50,4,54,1
41888,장철민(張喆敏),한기호(韓起鎬),51,4,55,1
41889,장철민(張喆敏),한무경(韓茂景),49,5,54,1
41890,장철민(張喆敏),한병도(韓秉道),120,114,234,0
41891,장철민(張喆敏),한정애(韓貞愛),95,113,208,0
41892,장철민(張喆敏),한준호(韓俊鎬),144,226,370,0
41893,장철민(張喆敏),허숙정(許淑湞),1,1,2,0
41894,장철민(張喆敏),허영(許榮),108,177,285,0
41895,장철민(張喆敏),허은아(許垠娥),49,4,53,1
41896,장철민(張喆敏),허종식(許琮植),99,105,204,0
41897,장철민(張喆敏),홍기원(洪起元),95,115,210,0
41898,장철민(張喆敏),홍문표(洪文杓),51,7,58,1
41899,장철민(張喆敏),홍석준(洪碩晙),50,5,55,1
41900,장철민(張喆敏),홍성국(洪性國),145,193,338,0
41901,장철민(張喆敏),홍영표(洪永杓),98,90,188,0
41902,장철민(張喆敏),홍익표(洪翼杓),90,71,161,0
41903,장철민(張喆敏),홍정민(洪貞敏),99,117,216,0
41904,장철민(張喆敏),황보승희(皇甫承希),50,5,55,1
41905,장철민(張喆敏),황운하(黃雲夏),138,186,324,0
41906,장철민(張喆敏),황희(黃熙),76,56,132,0
41907,장혜영(張惠英),전봉민(田奉珉),1,0,1,1
41908,장혜영(張惠英),전용기(田溶冀),14,26,40,1
41909,장혜영(張惠英),전재수(田載秀),11,9,20,1
41910,장혜영(張惠英),전주혜(全珠惠),8,12,20,1
41911,장혜영(張惠英),전해철(全海澈),11,11,22,1
41912,장혜영(張惠英),전혜숙(全惠淑),16,22,38,1
41913,장혜영(張惠英),정경희(丁慶姬),6,3,9,1
41914,장혜영(張惠英),정동만(鄭東萬),6,4,10,1
41915,장혜영(張惠英),정성호(鄭成湖),19,38,57,1
41916,장혜영(張惠英),정우택(鄭宇澤),2,1,3,1
41917,장혜영(張惠英),정운천(鄭雲天),4,3,7,1
41918,장혜영(張惠英),정일영(鄭日永),11,17,28,1
41919,장혜영(張惠英),정점식(鄭点植),6,2,8,1
41920,장혜영(張惠英),정진석(鄭鎭碩),7,6,13,1
41921,장혜영(張惠英),정청래(鄭淸來),13,16,29,1
41922,장혜영(張惠英),정춘숙(鄭春淑),22,40,62,1
41923,장혜영(張惠英),정태호(鄭泰浩),11,19,30,1
41924,장혜영(張惠英),정필모(鄭必模),13,14,27,1
41925,장혜영(張惠英),정희용(鄭熙溶),7,4,11,1
41926,장혜영(張惠英),조경태(趙慶泰),5,2,7,1
41927,장혜영(張惠英),조명희(曺明姬),5,9,14,1
41928,장혜영(張惠英),조수진(趙修眞),6,3,9,1
41929,장혜영(張惠英),조승래(趙承來),12,14,26,1
41930,장혜영(張惠英),조오섭(曺五燮),29,60,89,1
41931,장혜영(張惠英),조은희(趙恩禧),3,1,4,1
41932,장혜영(張惠英),조응천(趙應天),9,9,18,1
41933,장혜영(張惠英),조정식(趙正湜),8,5,13,1
41934,장혜영(張惠英),조정훈(趙廷訓),8,50,58,1
41935,장혜영(張惠英),조해진(曺海珍),6,4,10,1
41936,장혜영(張惠英),주철현(朱哲鉉),15,16,31,1
41937,장혜영(張惠英),주호영(朱豪英),5,3,8,1
41938,장혜영(張惠英),지성호(池成浩),6,10,16,1
41939,장혜영(張惠英),진선미(陳善美),22,27,49,1
41940,장혜영(張惠英),진성준(陳聲準),20,26,46,1
41941,장혜영(張惠英),천준호(千俊鎬),17,27,44,1
41942,장혜영(張惠英),최기상(崔基相),13,14,27,1
41943,장혜영(張惠英),최승재(崔承宰),7,11,18,1
41944,장혜영(張惠英),최연숙(崔姸淑),6,21,27,1
41945,장혜영(張惠英),최영희(崔英姬),0,0,0,1
41946,장혜영(張惠英),최인호(崔仁昊),10,5,15,1
41947,장혜영(張惠英),최재형(崔在亨),0,0,0,1
41948,장혜영(張惠英),최종윤(崔鍾允),12,14,26,1
41949,장혜영(張惠英),최춘식(崔春植),7,12,19,1
41950,장혜영(張惠英),최형두(崔炯斗),7,5,12,1
41951,장혜영(張惠英),최혜영(崔惠英),38,74,112,1
41952,장혜영(張惠英),추경호(秋慶鎬),7,12,19,1
41953,장혜영(張惠英),태영호(太永浩),7,8,15,1
41954,장혜영(張惠英),하영제(河榮帝),6,2,8,1
41955,장혜영(張惠英),하태경(河泰慶),5,4,9,1
41956,장혜영(張惠英),한기호(韓起鎬),6,2,8,1
41957,장혜영(張惠英),한무경(韓茂景),4,7,11,1
41958,장혜영(張惠英),한병도(韓秉道),12,16,28,1
41959,장혜영(張惠英),한정애(韓貞愛),11,12,23,1
41960,장혜영(張惠英),한준호(韓俊鎬),18,14,32,1
41961,장혜영(張惠英),허숙정(許淑湞),1,1,2,1
41962,장혜영(張惠英),허영(許榮),21,17,38,1
41963,장혜영(張惠英),허은아(許垠娥),4,3,7,1
41964,장혜영(張惠英),허종식(許琮植),20,50,70,1
41965,장혜영(張惠英),홍기원(洪起元),19,13,32,1
41966,장혜영(張惠英),홍문표(洪文杓),5,3,8,1
41967,장혜영(張惠英),홍석준(洪碩晙),7,6,13,1
41968,장혜영(張惠英),홍성국(洪性國),16,25,41,1
41969,장혜영(張惠英),홍영표(洪永杓),14,18,32,1
41970,장혜영(張惠英),홍익표(洪翼杓),14,15,29,1
41971,장혜영(張惠英),홍정민(洪貞敏),20,17,37,1
41972,장혜영(張惠英),황보승희(皇甫承希),8,10,18,1
41973,장혜영(張惠英),황운하(黃雲夏),23,22,45,1
41974,장혜영(張惠英),황희(黃熙),14,4,18,1
41975,전봉민(田奉珉),전용기(田溶冀),34,4,38,1
41976,전봉민(田奉珉),전재수(田載秀),35,6,41,1
41977,전봉민(田奉珉),전주혜(全珠惠),55,62,117,0
41978,전봉민(田奉珉),전해철(全海澈),36,5,41,1
41979,전봉민(田奉珉),전혜숙(全惠淑),35,5,40,1
41980,전봉민(田奉珉),정경희(丁慶姬),53,43,96,0
41981,전봉민(田奉珉),정동만(鄭東萬),100,237,337,0
41982,전봉민(田奉珉),정성호(鄭成湖),37,5,42,1
41983,전봉민(田奉珉),정우택(鄭宇澤),40,66,106,0
41984,전봉민(田奉珉),정운천(鄭雲天),53,117,170,0
41985,전봉민(田奉珉),정일영(鄭日永),35,6,41,1
41986,전봉민(田奉珉),정점식(鄭点植),45,36,81,0
41987,전봉민(田奉珉),정진석(鄭鎭碩),48,44,92,0
41988,전봉민(田奉珉),정청래(鄭淸來),35,5,40,1
41989,전봉민(田奉珉),정춘숙(鄭春淑),35,6,41,1
41990,전봉민(田奉珉),정태호(鄭泰浩),35,5,40,1
41991,전봉민(田奉珉),정필모(鄭必模),35,5,40,1
41992,전봉민(田奉珉),정희용(鄭熙溶),57,72,129,0
41993,전봉민(田奉珉),조경태(趙慶泰),77,119,196,0
41994,전봉민(田奉珉),조명희(曺明姬),64,98,162,0
41995,전봉민(田奉珉),조수진(趙修眞),53,65,118,0
41996,전봉민(田奉珉),조승래(趙承來),35,4,39,1
41997,전봉민(田奉珉),조오섭(曺五燮),35,6,41,1
41998,전봉민(田奉珉),조은희(趙恩禧),35,52,87,0
41999,전봉민(田奉珉),조응천(趙應天),34,4,38,1
42000,전봉민(田奉珉),조정식(趙正湜),35,4,39,1
42001,전봉민(田奉珉),조정훈(趙廷訓),0,12,12,1
42002,전봉민(田奉珉),조해진(曺海珍),47,31,78,0
42003,전봉민(田奉珉),주철현(朱哲鉉),35,5,40,1
42004,전봉민(田奉珉),주호영(朱豪英),44,34,78,0
42005,전봉민(田奉珉),지성호(池成浩),62,77,139,0
42006,전봉민(田奉珉),진선미(陳善美),35,5,40,1
42007,전봉민(田奉珉),진성준(陳聲準),35,5,40,1
42008,전봉민(田奉珉),천준호(千俊鎬),35,4,39,1
42009,전봉민(田奉珉),최기상(崔基相),35,5,40,1
42010,전봉민(田奉珉),최승재(崔承宰),61,68,129,0
42011,전봉민(田奉珉),최연숙(崔姸淑),28,21,49,0
42012,전봉민(田奉珉),최영희(崔英姬),30,49,79,0
42013,전봉민(田奉珉),최인호(崔仁昊),37,7,44,1
42014,전봉민(田奉珉),최재형(崔在亨),26,14,40,0
42015,전봉민(田奉珉),최종윤(崔鍾允),35,6,41,1
42016,전봉민(田奉珉),최춘식(崔春植),52,86,138,0
42017,전봉민(田奉珉),최형두(崔炯斗),65,56,121,0
42018,전봉민(田奉珉),최혜영(崔惠英),35,7,42,1
42019,전봉민(田奉珉),추경호(秋慶鎬),54,64,118,0
42020,전봉민(田奉珉),태영호(太永浩),61,59,120,0
42021,전봉민(田奉珉),하영제(河榮帝),53,89,142,1
42022,전봉민(田奉珉),하태경(河泰慶),51,50,101,0
42023,전봉민(田奉珉),한기호(韓起鎬),46,27,73,0
42024,전봉민(田奉珉),한무경(韓茂景),58,83,141,0
42025,전봉민(田奉珉),한병도(韓秉道),35,5,40,1
42026,전봉민(田奉珉),한정애(韓貞愛),35,5,40,1
42027,전봉민(田奉珉),한준호(韓俊鎬),36,5,41,1
42028,전봉민(田奉珉),허숙정(許淑湞),0,0,0,1
42029,전봉민(田奉珉),허영(許榮),35,6,41,1
42030,전봉민(田奉珉),허은아(許垠娥),51,42,93,0
42031,전봉민(田奉珉),허종식(許琮植),35,6,41,1
42032,전봉민(田奉珉),홍기원(洪起元),35,5,40,1
42033,전봉민(田奉珉),홍문표(洪文杓),47,45,92,0
42034,전봉민(田奉珉),홍석준(洪碩晙),50,66,116,0
42035,전봉민(田奉珉),홍성국(洪性國),35,5,40,1
42036,전봉민(田奉珉),홍영표(洪永杓),35,5,40,1
42037,전봉민(田奉珉),홍익표(洪翼杓),35,5,40,1
42038,전봉민(田奉珉),홍정민(洪貞敏),36,5,41,1
42039,전봉민(田奉珉),황보승희(皇甫承希),93,160,253,1
42040,전봉민(田奉珉),황운하(黃雲夏),36,7,43,1
42041,전봉민(田奉珉),황희(黃熙),35,6,41,1
42042,전용기(田溶冀),전재수(田載秀),105,121,226,0
42043,전용기(田溶冀),전주혜(全珠惠),50,5,55,1
42044,전용기(田溶冀),전해철(全海澈),84,70,154,0
42045,전용기(田溶冀),전혜숙(全惠淑),99,118,217,0
42046,전용기(田溶冀),정경희(丁慶姬),49,4,53,1
42047,전용기(田溶冀),정동만(鄭東萬),49,5,54,1
42048,전용기(田溶冀),정성호(鄭成湖),107,125,232,0
42049,전용기(田溶冀),정우택(鄭宇澤),25,4,29,1
42050,전용기(田溶冀),정운천(鄭雲天),49,5,54,1
42051,전용기(田溶冀),정일영(鄭日永),101,106,207,0
42052,전용기(田溶冀),정점식(鄭点植),51,4,55,1
42053,전용기(田溶冀),정진석(鄭鎭碩),50,5,55,1
42054,전용기(田溶冀),정청래(鄭淸來),116,115,231,0
42055,전용기(田溶冀),정춘숙(鄭春淑),113,138,251,0
42056,전용기(田溶冀),정태호(鄭泰浩),84,91,175,0
42057,전용기(田溶冀),정필모(鄭必模),91,97,188,0
42058,전용기(田溶冀),정희용(鄭熙溶),49,5,54,1
42059,전용기(田溶冀),조경태(趙慶泰),52,8,60,1
42060,전용기(田溶冀),조명희(曺明姬),49,7,56,1
42061,전용기(田溶冀),조수진(趙修眞),49,4,53,1
42062,전용기(田溶冀),조승래(趙承來),101,80,181,0
42063,전용기(田溶冀),조오섭(曺五燮),104,149,253,0
42064,전용기(田溶冀),조은희(趙恩禧),25,4,29,1
42065,전용기(田溶冀),조응천(趙應天),79,55,134,0
42066,전용기(田溶冀),조정식(趙正湜),89,63,152,0
42067,전용기(田溶冀),조정훈(趙廷訓),5,14,19,1
42068,전용기(田溶冀),조해진(曺海珍),50,5,55,1
42069,전용기(田溶冀),주철현(朱哲鉉),102,86,188,0
42070,전용기(田溶冀),주호영(朱豪英),49,5,54,1
42071,전용기(田溶冀),지성호(池成浩),49,5,54,1
42072,전용기(田溶冀),진선미(陳善美),81,54,135,0
42073,전용기(田溶冀),진성준(陳聲準),100,97,197,0
42074,전용기(田溶冀),천준호(千俊鎬),102,72,174,0
42075,전용기(田溶冀),최기상(崔基相),91,98,189,0
42076,전용기(田溶冀),최승재(崔承宰),51,11,62,1
42077,전용기(田溶冀),최연숙(崔姸淑),31,17,48,1
42078,전용기(田溶冀),최영희(崔英姬),25,5,30,1
42079,전용기(田溶冀),최인호(崔仁昊),101,106,207,0
42080,전용기(田溶冀),최재형(崔在亨),25,4,29,1
42081,전용기(田溶冀),최종윤(崔鍾允),106,106,212,0
42082,전용기(田溶冀),최춘식(崔春植),49,5,54,1
42083,전용기(田溶冀),최형두(崔炯斗),51,6,57,1
42084,전용기(田溶冀),최혜영(崔惠英),134,168,302,0
42085,전용기(田溶冀),추경호(秋慶鎬),49,4,53,1
42086,전용기(田溶冀),태영호(太永浩),49,5,54,1
42087,전용기(田溶冀),하영제(河榮帝),42,2,44,1
42088,전용기(田溶冀),하태경(河泰慶),50,5,55,1
42089,전용기(田溶冀),한기호(韓起鎬),51,6,57,1
42090,전용기(田溶冀),한무경(韓茂景),49,6,55,1
42091,전용기(田溶冀),한병도(韓秉道),129,152,281,0
42092,전용기(田溶冀),한정애(韓貞愛),82,64,146,0
42093,전용기(田溶冀),한준호(韓俊鎬),119,152,271,0
42094,전용기(田溶冀),허숙정(許淑湞),1,2,3,0
42095,전용기(田溶冀),허영(許榮),133,159,292,0
42096,전용기(田溶冀),허은아(許垠娥),49,5,54,1
42097,전용기(田溶冀),허종식(許琮植),97,93,190,0
42098,전용기(田溶冀),홍기원(洪起元),101,96,197,0
42099,전용기(田溶冀),홍문표(洪文杓),59,12,71,1
42100,전용기(田溶冀),홍석준(洪碩晙),50,5,55,1
42101,전용기(田溶冀),홍성국(洪性國),134,170,304,0
42102,전용기(田溶冀),홍영표(洪永杓),89,69,158,0
42103,전용기(田溶冀),홍익표(洪翼杓),105,111,216,0
42104,전용기(田溶冀),홍정민(洪貞敏),133,161,294,0
42105,전용기(田溶冀),황보승희(皇甫承希),45,3,48,1
42106,전용기(田溶冀),황운하(黃雲夏),119,134,253,0
42107,전용기(田溶冀),황희(黃熙),84,55,139,0
42108,전재수(田載秀),전주혜(全珠惠),50,4,54,1
42109,전재수(田載秀),전해철(全海澈),80,56,136,0
42110,전재수(田載秀),전혜숙(全惠淑),89,80,169,0
42111,전재수(田載秀),정경희(丁慶姬),49,4,53,1
42112,전재수(田載秀),정동만(鄭東萬),50,6,56,1
42113,전재수(田載秀),정성호(鄭成湖),87,70,157,0
42114,전재수(田載秀),정우택(鄭宇澤),25,5,30,1
42115,전재수(田載秀),정운천(鄭雲天),49,6,55,1
42116,전재수(田載秀),정일영(鄭日永),83,85,168,0
42117,전재수(田載秀),정점식(鄭点植),50,4,54,1
42118,전재수(田載秀),정진석(鄭鎭碩),50,4,54,1
42119,전재수(田載秀),정청래(鄭淸來),83,44,127,0
42120,전재수(田載秀),정춘숙(鄭春淑),107,97,204,0
42121,전재수(田載秀),정태호(鄭泰浩),85,60,145,0
42122,전재수(田載秀),정필모(鄭必模),85,55,140,0
42123,전재수(田載秀),정희용(鄭熙溶),49,6,55,1
42124,전재수(田載秀),조경태(趙慶泰),50,7,57,1
42125,전재수(田載秀),조명희(曺明姬),49,4,53,1
42126,전재수(田載秀),조수진(趙修眞),49,4,53,1
42127,전재수(田載秀),조승래(趙承來),92,68,160,0
42128,전재수(田載秀),조오섭(曺五燮),97,82,179,0
42129,전재수(田載秀),조은희(趙恩禧),25,4,29,1
42130,전재수(田載秀),조응천(趙應天),89,36,125,0
42131,전재수(田載秀),조정식(趙正湜),75,36,111,0
42132,전재수(田載秀),조정훈(趙廷訓),3,11,14,1
42133,전재수(田載秀),조해진(曺海珍),51,4,55,1
42134,전재수(田載秀),주철현(朱哲鉉),79,72,151,0
42135,전재수(田載秀),주호영(朱豪英),49,4,53,1
42136,전재수(田載秀),지성호(池成浩),49,4,53,1
42137,전재수(田載秀),진선미(陳善美),78,30,108,0
42138,전재수(田載秀),진성준(陳聲準),85,61,146,0
42139,전재수(田載秀),천준호(千俊鎬),85,61,146,0
42140,전재수(田載秀),최기상(崔基相),81,47,128,0
42141,전재수(田載秀),최승재(崔承宰),50,10,60,1
42142,전재수(田載秀),최연숙(崔姸淑),30,4,34,1
42143,전재수(田載秀),최영희(崔英姬),25,5,30,1
42144,전재수(田載秀),최인호(崔仁昊),137,179,316,0
42145,전재수(田載秀),최재형(崔在亨),25,4,29,1
42146,전재수(田載秀),최종윤(崔鍾允),82,59,141,0
42147,전재수(田載秀),최춘식(崔春植),49,4,53,1
42148,전재수(田載秀),최형두(崔炯斗),50,5,55,1
42149,전재수(田載秀),최혜영(崔惠英),86,60,146,0
42150,전재수(田載秀),추경호(秋慶鎬),49,4,53,1
42151,전재수(田載秀),태영호(太永浩),49,4,53,1
42152,전재수(田載秀),하영제(河榮帝),42,3,45,1
42153,전재수(田載秀),하태경(河泰慶),50,7,57,1
42154,전재수(田載秀),한기호(韓起鎬),50,6,56,1
42155,전재수(田載秀),한무경(韓茂景),49,4,53,1
42156,전재수(田載秀),한병도(韓秉道),116,119,235,0
42157,전재수(田載秀),한정애(韓貞愛),77,66,143,0
42158,전재수(田載秀),한준호(韓俊鎬),94,107,201,0
42159,전재수(田載秀),허숙정(許淑湞),1,2,3,0
42160,전재수(田載秀),허영(許榮),125,161,286,0
42161,전재수(田載秀),허은아(許垠娥),49,4,53,1
42162,전재수(田載秀),허종식(許琮植),86,79,165,0
42163,전재수(田載秀),홍기원(洪起元),89,65,154,0
42164,전재수(田載秀),홍문표(洪文杓),50,5,55,1
42165,전재수(田載秀),홍석준(洪碩晙),50,4,54,1
42166,전재수(田載秀),홍성국(洪性國),95,97,192,0
42167,전재수(田載秀),홍영표(洪永杓),80,52,132,0
42168,전재수(田載秀),홍익표(洪翼杓),89,57,146,0
42169,전재수(田載秀),홍정민(洪貞敏),87,66,153,0
42170,전재수(田載秀),황보승희(皇甫承希),47,5,52,1
42171,전재수(田載秀),황운하(黃雲夏),90,60,150,0
42172,전재수(田載秀),황희(黃熙),82,40,122,0
42173,전주혜(全珠惠),전해철(全海澈),51,4,55,1
42174,전주혜(全珠惠),전혜숙(全惠淑),51,5,56,1
42175,전주혜(全珠惠),정경희(丁慶姬),77,99,176,0
42176,전주혜(全珠惠),정동만(鄭東萬),66,62,128,0
42177,전주혜(全珠惠),정성호(鄭成湖),55,7,62,1
42178,전주혜(全珠惠),정우택(鄭宇澤),36,34,70,0
42179,전주혜(全珠惠),정운천(鄭雲天),75,66,141,0
42180,전주혜(全珠惠),정일영(鄭日永),51,8,59,1
42181,전주혜(全珠惠),정점식(鄭点植),69,60,129,0
42182,전주혜(全珠惠),정진석(鄭鎭碩),80,90,170,0
42183,전주혜(全珠惠),정청래(鄭淸來),50,4,54,1
42184,전주혜(全珠惠),정춘숙(鄭春淑),51,6,57,1
42185,전주혜(全珠惠),정태호(鄭泰浩),51,4,55,1
42186,전주혜(全珠惠),정필모(鄭必模),51,5,56,1
42187,전주혜(全珠惠),정희용(鄭熙溶),84,97,181,0
42188,전주혜(全珠惠),조경태(趙慶泰),70,55,125,0
42189,전주혜(全珠惠),조명희(曺明姬),84,132,216,0
42190,전주혜(全珠惠),조수진(趙修眞),86,166,252,0
42191,전주혜(全珠惠),조승래(趙承來),51,6,57,1
42192,전주혜(全珠惠),조오섭(曺五燮),52,8,60,1
42193,전주혜(全珠惠),조은희(趙恩禧),38,38,76,0
42194,전주혜(全珠惠),조응천(趙應天),51,5,56,1
42195,전주혜(全珠惠),조정식(趙正湜),50,3,53,1
42196,전주혜(全珠惠),조정훈(趙廷訓),3,21,24,1
42197,전주혜(全珠惠),조해진(曺海珍),69,42,111,0
42198,전주혜(全珠惠),주철현(朱哲鉉),53,5,58,1
42199,전주혜(全珠惠),주호영(朱豪英),62,40,102,0
42200,전주혜(全珠惠),지성호(池成浩),79,110,189,0
42201,전주혜(全珠惠),진선미(陳善美),51,5,56,1
42202,전주혜(全珠惠),진성준(陳聲準),51,4,55,1
42203,전주혜(全珠惠),천준호(千俊鎬),50,3,53,1
42204,전주혜(全珠惠),최기상(崔基相),51,6,57,1
42205,전주혜(全珠惠),최승재(崔承宰),84,143,227,0
42206,전주혜(全珠惠),최연숙(崔姸淑),42,68,110,0
42207,전주혜(全珠惠),최영희(崔英姬),32,23,55,0
42208,전주혜(全珠惠),최인호(崔仁昊),52,4,56,1
42209,전주혜(全珠惠),최재형(崔在亨),28,25,53,0
42210,전주혜(全珠惠),최종윤(崔鍾允),52,4,56,1
42211,전주혜(全珠惠),최춘식(崔春植),68,94,162,0
42212,전주혜(全珠惠),최형두(崔炯斗),87,89,176,0
42213,전주혜(全珠惠),최혜영(崔惠英),51,6,57,1
42214,전주혜(全珠惠),추경호(秋慶鎬),84,137,221,0
42215,전주혜(全珠惠),태영호(太永浩),80,126,206,0
42216,전주혜(全珠惠),하영제(河榮帝),72,90,162,1
42217,전주혜(全珠惠),하태경(河泰慶),70,59,129,0
42218,전주혜(全珠惠),한기호(韓起鎬),71,73,144,0
42219,전주혜(全珠惠),한무경(韓茂景),76,118,194,0
42220,전주혜(全珠惠),한병도(韓秉道),51,4,55,1
42221,전주혜(全珠惠),한정애(韓貞愛),51,6,57,1
42222,전주혜(全珠惠),한준호(韓俊鎬),51,4,55,1
42223,전주혜(全珠惠),허숙정(許淑湞),0,0,0,1
42224,전주혜(全珠惠),허영(許榮),52,5,57,1
42225,전주혜(全珠惠),허은아(許垠娥),80,94,174,0
42226,전주혜(全珠惠),허종식(許琮植),51,8,59,1
42227,전주혜(全珠惠),홍기원(洪起元),51,5,56,1
42228,전주혜(全珠惠),홍문표(洪文杓),60,59,119,0
42229,전주혜(全珠惠),홍석준(洪碩晙),63,77,140,0
42230,전주혜(全珠惠),홍성국(洪性國),51,6,57,1
42231,전주혜(全珠惠),홍영표(洪永杓),51,6,57,1
42232,전주혜(全珠惠),홍익표(洪翼杓),52,5,57,1
42233,전주혜(全珠惠),홍정민(洪貞敏),52,5,57,1
42234,전주혜(全珠惠),황보승희(皇甫承希),83,119,202,1
42235,전주혜(全珠惠),황운하(黃雲夏),51,6,57,1
42236,전주혜(全珠惠),황희(黃熙),50,7,57,1
42237,전해철(全海澈),전혜숙(全惠淑),82,51,133,0
42238,전해철(全海澈),정경희(丁慶姬),50,4,54,1
42239,전해철(全海澈),정동만(鄭東萬),49,4,53,1
42240,전해철(全海澈),정성호(鄭成湖),75,46,121,0
42241,전해철(全海澈),정우택(鄭宇澤),25,5,30,1
42242,전해철(全海澈),정운천(鄭雲天),49,5,54,1
42243,전해철(全海澈),정일영(鄭日永),74,55,129,0
42244,전해철(全海澈),정점식(鄭点植),51,4,55,1
42245,전해철(全海澈),정진석(鄭鎭碩),50,4,54,1
42246,전해철(全海澈),정청래(鄭淸來),83,40,123,0
42247,전해철(全海澈),정춘숙(鄭春淑),77,58,135,0
42248,전해철(全海澈),정태호(鄭泰浩),87,60,147,0
42249,전해철(全海澈),정필모(鄭必模),80,53,133,0
42250,전해철(全海澈),정희용(鄭熙溶),51,5,56,1
42251,전해철(全海澈),조경태(趙慶泰),50,4,54,1
42252,전해철(全海澈),조명희(曺明姬),50,4,54,1
42253,전해철(全海澈),조수진(趙修眞),49,4,53,1
42254,전해철(全海澈),조승래(趙承來),78,55,133,0
42255,전해철(全海澈),조오섭(曺五燮),81,103,184,0
42256,전해철(全海澈),조은희(趙恩禧),25,4,29,1
42257,전해철(全海澈),조응천(趙應天),71,30,101,0
42258,전해철(全海澈),조정식(趙正湜),75,41,116,0
42259,전해철(全海澈),조정훈(趙廷訓),3,4,7,1
42260,전해철(全海澈),조해진(曺海珍),52,5,57,1
42261,전해철(全海澈),주철현(朱哲鉉),76,54,130,0
42262,전해철(全海澈),주호영(朱豪英),49,4,53,1
42263,전해철(全海澈),지성호(池成浩),49,4,53,1
42264,전해철(全海澈),진선미(陳善美),75,38,113,0
42265,전해철(全海澈),진성준(陳聲準),80,56,136,0
42266,전해철(全海澈),천준호(千俊鎬),77,51,128,0
42267,전해철(全海澈),최기상(崔基相),73,50,123,0
42268,전해철(全海澈),최승재(崔承宰),49,5,54,1
42269,전해철(全海澈),최연숙(崔姸淑),31,10,41,1
42270,전해철(全海澈),최영희(崔英姬),26,5,31,1
42271,전해철(全海澈),최인호(崔仁昊),78,69,147,0
42272,전해철(全海澈),최재형(崔在亨),25,4,29,1
42273,전해철(全海澈),최종윤(崔鍾允),80,85,165,0
42274,전해철(全海澈),최춘식(崔春植),49,7,56,1
42275,전해철(全海澈),최형두(崔炯斗),52,4,56,1
42276,전해철(全海澈),최혜영(崔惠英),79,68,147,0
42277,전해철(全海澈),추경호(秋慶鎬),49,3,52,1
42278,전해철(全海澈),태영호(太永浩),49,4,53,1
42279,전해철(全海澈),하영제(河榮帝),43,2,45,1
42280,전해철(全海澈),하태경(河泰慶),50,4,54,1
42281,전해철(全海澈),한기호(韓起鎬),50,4,54,1
42282,전해철(全海澈),한무경(韓茂景),49,4,53,1
42283,전해철(全海澈),한병도(韓秉道),80,48,128,0
42284,전해철(全海澈),한정애(韓貞愛),76,56,132,0
42285,전해철(全海澈),한준호(韓俊鎬),81,80,161,0
42286,전해철(全海澈),허숙정(許淑湞),1,2,3,0
42287,전해철(全海澈),허영(許榮),79,70,149,0
42288,전해철(全海澈),허은아(許垠娥),50,4,54,1
42289,전해철(全海澈),허종식(許琮植),77,64,141,0
42290,전해철(全海澈),홍기원(洪起元),79,61,140,0
42291,전해철(全海澈),홍문표(洪文杓),50,4,54,1
42292,전해철(全海澈),홍석준(洪碩晙),50,4,54,1
42293,전해철(全海澈),홍성국(洪性國),81,70,151,0
42294,전해철(全海澈),홍영표(洪永杓),80,55,135,0
42295,전해철(全海澈),홍익표(洪翼杓),78,64,142,0
42296,전해철(全海澈),홍정민(洪貞敏),79,64,143,0
42297,전해철(全海澈),황보승희(皇甫承希),45,1,46,1
42298,전해철(全海澈),황운하(黃雲夏),79,54,133,0
42299,전해철(全海澈),황희(黃熙),80,69,149,0
42300,전혜숙(全惠淑),정경희(丁慶姬),49,8,57,1
42301,전혜숙(全惠淑),정동만(鄭東萬),49,4,53,1
42302,전혜숙(全惠淑),정성호(鄭成湖),83,83,166,0
42303,전혜숙(全惠淑),정우택(鄭宇澤),25,5,30,1
42304,전혜숙(全惠淑),정운천(鄭雲天),51,6,57,1
42305,전혜숙(全惠淑),정일영(鄭日永),85,71,156,0
42306,전혜숙(全惠淑),정점식(鄭点植),50,4,54,1
42307,전혜숙(全惠淑),정진석(鄭鎭碩),52,6,58,1
42308,전혜숙(全惠淑),정청래(鄭淸來),108,123,231,0
42309,전혜숙(全惠淑),정춘숙(鄭春淑),103,83,186,0
42310,전혜숙(全惠淑),정태호(鄭泰浩),87,92,179,0
42311,전혜숙(全惠淑),정필모(鄭必模),97,91,188,0
42312,전혜숙(全惠淑),정희용(鄭熙溶),51,7,58,1
42313,전혜숙(全惠淑),조경태(趙慶泰),50,6,56,1
42314,전혜숙(全惠淑),조명희(曺明姬),50,12,62,1
42315,전혜숙(全惠淑),조수진(趙修眞),51,5,56,1
42316,전혜숙(全惠淑),조승래(趙承來),105,82,187,0
42317,전혜숙(全惠淑),조오섭(曺五燮),100,105,205,0
42318,전혜숙(全惠淑),조은희(趙恩禧),25,4,29,1
42319,전혜숙(全惠淑),조응천(趙應天),74,44,118,0
42320,전혜숙(全惠淑),조정식(趙正湜),76,43,119,0
42321,전혜숙(全惠淑),조정훈(趙廷訓),7,16,23,1
42322,전혜숙(全惠淑),조해진(曺海珍),51,6,57,1
42323,전혜숙(全惠淑),주철현(朱哲鉉),95,77,172,0
42324,전혜숙(全惠淑),주호영(朱豪英),49,4,53,1
42325,전혜숙(全惠淑),지성호(池成浩),49,4,53,1
42326,전혜숙(全惠淑),진선미(陳善美),93,59,152,0
42327,전혜숙(全惠淑),진성준(陳聲準),103,115,218,0
42328,전혜숙(全惠淑),천준호(千俊鎬),86,66,152,0
42329,전혜숙(全惠淑),최기상(崔基相),80,60,140,0
42330,전혜숙(全惠淑),최승재(崔承宰),49,9,58,1
42331,전혜숙(全惠淑),최연숙(崔姸淑),33,13,46,1
42332,전혜숙(全惠淑),최영희(崔英姬),25,5,30,1
42333,전혜숙(全惠淑),최인호(崔仁昊),91,77,168,0
42334,전혜숙(全惠淑),최재형(崔在亨),25,5,30,1
42335,전혜숙(全惠淑),최종윤(崔鍾允),114,106,220,0
42336,전혜숙(全惠淑),최춘식(崔春植),49,4,53,1
42337,전혜숙(全惠淑),최형두(崔炯斗),52,9,61,1
42338,전혜숙(全惠淑),최혜영(崔惠英),114,108,222,0
42339,전혜숙(全惠淑),추경호(秋慶鎬),49,9,58,1
42340,전혜숙(全惠淑),태영호(太永浩),51,12,63,1
42341,전혜숙(全惠淑),하영제(河榮帝),41,6,47,1
42342,전혜숙(全惠淑),하태경(河泰慶),49,4,53,1
42343,전혜숙(全惠淑),한기호(韓起鎬),50,8,58,1
42344,전혜숙(全惠淑),한무경(韓茂景),50,8,58,1
42345,전혜숙(全惠淑),한병도(韓秉道),99,89,188,0
42346,전혜숙(全惠淑),한정애(韓貞愛),91,81,172,0
42347,전혜숙(全惠淑),한준호(韓俊鎬),97,129,226,0
42348,전혜숙(全惠淑),허숙정(許淑湞),1,3,4,0
42349,전혜숙(全惠淑),허영(許榮),104,104,208,0
42350,전혜숙(全惠淑),허은아(許垠娥),49,6,55,1
42351,전혜숙(全惠淑),허종식(許琮植),102,94,196,0
42352,전혜숙(全惠淑),홍기원(洪起元),86,97,183,0
42353,전혜숙(全惠淑),홍문표(洪文杓),50,8,58,1
42354,전혜숙(全惠淑),홍석준(洪碩晙),50,5,55,1
42355,전혜숙(全惠淑),홍성국(洪性國),128,136,264,0
42356,전혜숙(全惠淑),홍영표(洪永杓),86,66,152,0
42357,전혜숙(全惠淑),홍익표(洪翼杓),87,96,183,0
42358,전혜숙(全惠淑),홍정민(洪貞敏),99,102,201,0
42359,전혜숙(全惠淑),황보승희(皇甫承希),49,4,53,1
42360,전혜숙(全惠淑),황운하(黃雲夏),133,136,269,0
42361,전혜숙(全惠淑),황희(黃熙),81,42,123,0
42362,정경희(丁慶姬),정동만(鄭東萬),71,48,119,0
42363,정경희(丁慶姬),정성호(鄭成湖),51,4,55,1
42364,정경희(丁慶姬),정우택(鄭宇澤),34,22,56,0
42365,정경희(丁慶姬),정운천(鄭雲天),70,54,124,0
42366,정경희(丁慶姬),정일영(鄭日永),49,4,53,1
42367,정경희(丁慶姬),정점식(鄭点植),67,53,120,0
42368,정경희(丁慶姬),정진석(鄭鎭碩),74,66,140,0
42369,정경희(丁慶姬),정청래(鄭淸來),50,4,54,1
42370,정경희(丁慶姬),정춘숙(鄭春淑),49,5,54,1
42371,정경희(丁慶姬),정태호(鄭泰浩),49,4,53,1
42372,정경희(丁慶姬),정필모(鄭必模),49,4,53,1
42373,정경희(丁慶姬),정희용(鄭熙溶),82,88,170,0
42374,정경희(丁慶姬),조경태(趙慶泰),86,71,157,0
42375,정경희(丁慶姬),조명희(曺明姬),88,146,234,0
42376,정경희(丁慶姬),조수진(趙修眞),77,113,190,0
42377,정경희(丁慶姬),조승래(趙承來),50,4,54,1
42378,정경희(丁慶姬),조오섭(曺五燮),52,4,56,1
42379,정경희(丁慶姬),조은희(趙恩禧),34,36,70,0
42380,정경희(丁慶姬),조응천(趙應天),49,3,52,1
42381,정경희(丁慶姬),조정식(趙正湜),49,4,53,1
42382,정경희(丁慶姬),조정훈(趙廷訓),1,7,8,1
42383,정경희(丁慶姬),조해진(曺海珍),66,40,106,0
42384,정경희(丁慶姬),주철현(朱哲鉉),50,4,54,1
42385,정경희(丁慶姬),주호영(朱豪英),62,43,105,0
42386,정경희(丁慶姬),지성호(池成浩),75,107,182,0
42387,정경희(丁慶姬),진선미(陳善美),49,4,53,1
42388,정경희(丁慶姬),진성준(陳聲準),49,4,53,1
42389,정경희(丁慶姬),천준호(千俊鎬),49,3,52,1
42390,정경희(丁慶姬),최기상(崔基相),50,4,54,1
42391,정경희(丁慶姬),최승재(崔承宰),79,100,179,0
42392,정경희(丁慶姬),최연숙(崔姸淑),42,50,92,0
42393,정경희(丁慶姬),최영희(崔英姬),31,28,59,0
42394,정경희(丁慶姬),최인호(崔仁昊),51,4,55,1
42395,정경희(丁慶姬),최재형(崔在亨),30,17,47,0
42396,정경희(丁慶姬),최종윤(崔鍾允),50,4,54,1
42397,정경희(丁慶姬),최춘식(崔春植),74,88,162,0
42398,정경희(丁慶姬),최형두(崔炯斗),75,65,140,0
42399,정경희(丁慶姬),최혜영(崔惠英),50,4,54,1
42400,정경희(丁慶姬),추경호(秋慶鎬),75,85,160,0
42401,정경희(丁慶姬),태영호(太永浩),81,110,191,0
42402,정경희(丁慶姬),하영제(河榮帝),71,81,152,1
42403,정경희(丁慶姬),하태경(河泰慶),66,47,113,0
42404,정경희(丁慶姬),한기호(韓起鎬),65,62,127,0
42405,정경희(丁慶姬),한무경(韓茂景),74,107,181,0
42406,정경희(丁慶姬),한병도(韓秉道),51,4,55,1
42407,정경희(丁慶姬),한정애(韓貞愛),49,5,54,1
42408,정경희(丁慶姬),한준호(韓俊鎬),50,4,54,1
42409,정경희(丁慶姬),허숙정(許淑湞),0,0,0,1
42410,정경희(丁慶姬),허영(許榮),52,4,56,1
42411,정경희(丁慶姬),허은아(許垠娥),69,66,135,0
42412,정경희(丁慶姬),허종식(許琮植),50,18,68,1
42413,정경희(丁慶姬),홍기원(洪起元),49,4,53,1
42414,정경희(丁慶姬),홍문표(洪文杓),71,82,153,0
42415,정경희(丁慶姬),홍석준(洪碩晙),66,78,144,0
42416,정경희(丁慶姬),홍성국(洪性國),49,5,54,1
42417,정경희(丁慶姬),홍영표(洪永杓),49,4,53,1
42418,정경희(丁慶姬),홍익표(洪翼杓),50,4,54,1
42419,정경희(丁慶姬),홍정민(洪貞敏),50,6,56,1
42420,정경희(丁慶姬),황보승희(皇甫承希),78,101,179,1
42421,정경희(丁慶姬),황운하(黃雲夏),49,5,54,1
42422,정경희(丁慶姬),황희(黃熙),49,10,59,1
42423,정동만(鄭東萬),정성호(鄭成湖),50,5,55,1
42424,정동만(鄭東萬),정우택(鄭宇澤),40,60,100,0
42425,정동만(鄭東萬),정운천(鄭雲天),75,108,183,0
42426,정동만(鄭東萬),정일영(鄭日永),49,5,54,1
42427,정동만(鄭東萬),정점식(鄭点植),61,44,105,0
42428,정동만(鄭東萬),정진석(鄭鎭碩),68,50,118,0
42429,정동만(鄭東萬),정청래(鄭淸來),49,4,53,1
42430,정동만(鄭東萬),정춘숙(鄭春淑),49,5,54,1
42431,정동만(鄭東萬),정태호(鄭泰浩),49,4,53,1
42432,정동만(鄭東萬),정필모(鄭必模),49,4,53,1
42433,정동만(鄭東萬),정희용(鄭熙溶),73,112,185,0
42434,정동만(鄭東萬),조경태(趙慶泰),92,128,220,0
42435,정동만(鄭東萬),조명희(曺明姬),87,123,210,0
42436,정동만(鄭東萬),조수진(趙修眞),83,68,151,0
42437,정동만(鄭東萬),조승래(趙承來),49,5,54,1
42438,정동만(鄭東萬),조오섭(曺五燮),50,5,55,1
42439,정동만(鄭東萬),조은희(趙恩禧),33,33,66,0
42440,정동만(鄭東萬),조응천(趙應天),49,4,53,1
42441,정동만(鄭東萬),조정식(趙正湜),49,3,52,1
42442,정동만(鄭東萬),조정훈(趙廷訓),0,5,5,1
42443,정동만(鄭東萬),조해진(曺海珍),61,37,98,0
42444,정동만(鄭東萬),주철현(朱哲鉉),49,5,54,1
42445,정동만(鄭東萬),주호영(朱豪英),64,51,115,0
42446,정동만(鄭東萬),지성호(池成浩),80,73,153,0
42447,정동만(鄭東萬),진선미(陳善美),49,4,53,1
42448,정동만(鄭東萬),진성준(陳聲準),51,4,55,1
42449,정동만(鄭東萬),천준호(千俊鎬),49,3,52,1
42450,정동만(鄭東萬),최기상(崔基相),49,4,53,1
42451,정동만(鄭東萬),최승재(崔承宰),83,86,169,0
42452,정동만(鄭東萬),최연숙(崔姸淑),35,28,63,0
42453,정동만(鄭東萬),최영희(崔英姬),30,54,84,0
42454,정동만(鄭東萬),최인호(崔仁昊),51,6,57,1
42455,정동만(鄭東萬),최재형(崔在亨),26,12,38,0
42456,정동만(鄭東萬),최종윤(崔鍾允),49,4,53,1
42457,정동만(鄭東萬),최춘식(崔春植),77,82,159,0
42458,정동만(鄭東萬),최형두(崔炯斗),68,61,129,0
42459,정동만(鄭東萬),최혜영(崔惠英),49,5,54,1
42460,정동만(鄭東萬),추경호(秋慶鎬),81,73,154,0
42461,정동만(鄭東萬),태영호(太永浩),81,93,174,0
42462,정동만(鄭東萬),하영제(河榮帝),66,78,144,1
42463,정동만(鄭東萬),하태경(河泰慶),70,54,124,0
42464,정동만(鄭東萬),한기호(韓起鎬),63,40,103,0
42465,정동만(鄭東萬),한무경(韓茂景),90,97,187,0
42466,정동만(鄭東萬),한병도(韓秉道),49,5,54,1
42467,정동만(鄭東萬),한정애(韓貞愛),49,4,53,1
42468,정동만(鄭東萬),한준호(韓俊鎬),50,4,54,1
42469,정동만(鄭東萬),허숙정(許淑湞),0,0,0,1
42470,정동만(鄭東萬),허영(許榮),50,4,54,1
42471,정동만(鄭東萬),허은아(許垠娥),77,62,139,0
42472,정동만(鄭東萬),허종식(許琮植),50,5,55,1
42473,정동만(鄭東萬),홍기원(洪起元),49,4,53,1
42474,정동만(鄭東萬),홍문표(洪文杓),70,70,140,0
42475,정동만(鄭東萬),홍석준(洪碩晙),68,52,120,0
42476,정동만(鄭東萬),홍성국(洪性國),49,5,54,1
42477,정동만(鄭東萬),홍영표(洪永杓),49,4,53,1
42478,정동만(鄭東萬),홍익표(洪翼杓),49,4,53,1
42479,정동만(鄭東萬),홍정민(洪貞敏),49,4,53,1
42480,정동만(鄭東萬),황보승희(皇甫承希),116,155,271,1
42481,정동만(鄭東萬),황운하(黃雲夏),50,5,55,1
42482,정동만(鄭東萬),황희(黃熙),49,6,55,1
42483,정성호(鄭成湖),정우택(鄭宇澤),28,4,32,1
42484,정성호(鄭成湖),정운천(鄭雲天),54,6,60,1
42485,정성호(鄭成湖),정일영(鄭日永),99,139,238,0
42486,정성호(鄭成湖),정점식(鄭点植),51,4,55,1
42487,정성호(鄭成湖),정진석(鄭鎭碩),50,5,55,1
42488,정성호(鄭成湖),정청래(鄭淸來),78,60,138,0
42489,정성호(鄭成湖),정춘숙(鄭春淑),96,148,244,0
42490,정성호(鄭成湖),정태호(鄭泰浩),84,87,171,0
42491,정성호(鄭成湖),정필모(鄭必模),81,54,135,0
42492,정성호(鄭成湖),정희용(鄭熙溶),52,7,59,1
42493,정성호(鄭成湖),조경태(趙慶泰),53,4,57,1
42494,정성호(鄭成湖),조명희(曺明姬),54,5,59,1
42495,정성호(鄭成湖),조수진(趙修眞),51,6,57,1
42496,정성호(鄭成湖),조승래(趙承來),82,61,143,0
42497,정성호(鄭成湖),조오섭(曺五燮),93,138,231,0
42498,정성호(鄭成湖),조은희(趙恩禧),29,4,33,1
42499,정성호(鄭成湖),조응천(趙應天),82,49,131,0
42500,정성호(鄭成湖),조정식(趙正湜),78,73,151,0
42501,정성호(鄭成湖),조정훈(趙廷訓),3,12,15,1
42502,정성호(鄭成湖),조해진(曺海珍),52,5,57,1
42503,정성호(鄭成湖),주철현(朱哲鉉),92,105,197,0
42504,정성호(鄭成湖),주호영(朱豪英),51,4,55,1
42505,정성호(鄭成湖),지성호(池成浩),51,5,56,1
42506,정성호(鄭成湖),진선미(陳善美),80,48,128,0
42507,정성호(鄭成湖),진성준(陳聲準),84,81,165,0
42508,정성호(鄭成湖),천준호(千俊鎬),79,62,141,0
42509,정성호(鄭成湖),최기상(崔基相),88,88,176,0
42510,정성호(鄭成湖),최승재(崔承宰),52,5,57,1
42511,정성호(鄭成湖),최연숙(崔姸淑),33,10,43,1
42512,정성호(鄭成湖),최영희(崔英姬),26,5,31,1
42513,정성호(鄭成湖),최인호(崔仁昊),90,105,195,0
42514,정성호(鄭成湖),최재형(崔在亨),25,4,29,1
42515,정성호(鄭成湖),최종윤(崔鍾允),96,121,217,0
42516,정성호(鄭成湖),최춘식(崔春植),49,8,57,1
42517,정성호(鄭成湖),최형두(崔炯斗),54,7,61,1
42518,정성호(鄭成湖),최혜영(崔惠英),92,101,193,0
42519,정성호(鄭成湖),추경호(秋慶鎬),51,5,56,1
42520,정성호(鄭成湖),태영호(太永浩),50,8,58,1
42521,정성호(鄭成湖),하영제(河榮帝),44,2,46,1
42522,정성호(鄭成湖),하태경(河泰慶),50,5,55,1
42523,정성호(鄭成湖),한기호(韓起鎬),54,8,62,1
42524,정성호(鄭成湖),한무경(韓茂景),50,5,55,1
42525,정성호(鄭成湖),한병도(韓秉道),94,95,189,0
42526,정성호(鄭成湖),한정애(韓貞愛),79,56,135,0
42527,정성호(鄭成湖),한준호(韓俊鎬),85,122,207,0
42528,정성호(鄭成湖),허숙정(許淑湞),1,1,2,0
42529,정성호(鄭成湖),허영(許榮),87,107,194,0
42530,정성호(鄭成湖),허은아(許垠娥),50,5,55,1
42531,정성호(鄭成湖),허종식(許琮植),90,127,217,0
42532,정성호(鄭成湖),홍기원(洪起元),83,116,199,0
42533,정성호(鄭成湖),홍문표(洪文杓),50,7,57,1
42534,정성호(鄭成湖),홍석준(洪碩晙),51,4,55,1
42535,정성호(鄭成湖),홍성국(洪性國),98,127,225,0
42536,정성호(鄭成湖),홍영표(洪永杓),83,76,159,0
42537,정성호(鄭成湖),홍익표(洪翼杓),83,81,164,0
42538,정성호(鄭成湖),홍정민(洪貞敏),89,109,198,0
42539,정성호(鄭成湖),황보승희(皇甫承希),49,3,52,1
42540,정성호(鄭成湖),황운하(黃雲夏),91,139,230,0
42541,정성호(鄭成湖),황희(黃熙),75,49,124,0
42542,정우택(鄭宇澤),정운천(鄭雲天),40,52,92,0
42543,정우택(鄭宇澤),정일영(鄭日永),25,4,29,1
42544,정우택(鄭宇澤),정점식(鄭点植),26,14,40,0
42545,정우택(鄭宇澤),정진석(鄭鎭碩),28,13,41,0
42546,정우택(鄭宇澤),정청래(鄭淸來),25,4,29,1
42547,정우택(鄭宇澤),정춘숙(鄭春淑),25,5,30,1
42548,정우택(鄭宇澤),정태호(鄭泰浩),25,4,29,1
42549,정우택(鄭宇澤),정필모(鄭必模),25,4,29,1
42550,정우택(鄭宇澤),정희용(鄭熙溶),33,60,93,0
42551,정우택(鄭宇澤),조경태(趙慶泰),37,69,106,0
42552,정우택(鄭宇澤),조명희(曺明姬),64,101,165,0
42553,정우택(鄭宇澤),조수진(趙修眞),36,40,76,0
42554,정우택(鄭宇澤),조승래(趙承來),25,5,30,1
42555,정우택(鄭宇澤),조오섭(曺五燮),26,5,31,1
42556,정우택(鄭宇澤),조은희(趙恩禧),39,53,92,0
42557,정우택(鄭宇澤),조응천(趙應天),25,3,28,1
42558,정우택(鄭宇澤),조정식(趙正湜),25,4,29,1
42559,정우택(鄭宇澤),조정훈(趙廷訓),0,8,8,1
42560,정우택(鄭宇澤),조해진(曺海珍),29,29,58,0
42561,정우택(鄭宇澤),주철현(朱哲鉉),26,5,31,1
42562,정우택(鄭宇澤),주호영(朱豪英),29,24,53,0
42563,정우택(鄭宇澤),지성호(池成浩),47,119,166,0
42564,정우택(鄭宇澤),진선미(陳善美),25,4,29,1
42565,정우택(鄭宇澤),진성준(陳聲準),25,4,29,1
42566,정우택(鄭宇澤),천준호(千俊鎬),25,3,28,1
42567,정우택(鄭宇澤),최기상(崔基相),26,4,30,1
42568,정우택(鄭宇澤),최승재(崔承宰),39,52,91,0
42569,정우택(鄭宇澤),최연숙(崔姸淑),29,27,56,0
42570,정우택(鄭宇澤),최영희(崔英姬),36,87,123,0
42571,정우택(鄭宇澤),최인호(崔仁昊),26,5,31,1
42572,정우택(鄭宇澤),최재형(崔在亨),31,25,56,0
42573,정우택(鄭宇澤),최종윤(崔鍾允),26,4,30,1
42574,정우택(鄭宇澤),최춘식(崔春植),42,110,152,0
42575,정우택(鄭宇澤),최형두(崔炯斗),29,31,60,0
42576,정우택(鄭宇澤),최혜영(崔惠英),26,6,32,1
42577,정우택(鄭宇澤),추경호(秋慶鎬),27,12,39,0
42578,정우택(鄭宇澤),태영호(太永浩),54,134,188,0
42579,정우택(鄭宇澤),하영제(河榮帝),32,89,121,1
42580,정우택(鄭宇澤),하태경(河泰慶),27,27,54,0
42581,정우택(鄭宇澤),한기호(韓起鎬),29,17,46,0
42582,정우택(鄭宇澤),한무경(韓茂景),35,44,79,0
42583,정우택(鄭宇澤),한병도(韓秉道),26,5,31,1
42584,정우택(鄭宇澤),한정애(韓貞愛),25,4,29,1
42585,정우택(鄭宇澤),한준호(韓俊鎬),26,5,31,1
42586,정우택(鄭宇澤),허숙정(許淑湞),0,0,0,1
42587,정우택(鄭宇澤),허영(許榮),27,5,32,1
42588,정우택(鄭宇澤),허은아(許垠娥),27,26,53,0
42589,정우택(鄭宇澤),허종식(許琮植),27,7,34,1
42590,정우택(鄭宇澤),홍기원(洪起元),25,5,30,1
42591,정우택(鄭宇澤),홍문표(洪文杓),35,81,116,0
42592,정우택(鄭宇澤),홍석준(洪碩晙),31,34,65,0
42593,정우택(鄭宇澤),홍성국(洪性國),25,5,30,1
42594,정우택(鄭宇澤),홍영표(洪永杓),25,4,29,1
42595,정우택(鄭宇澤),홍익표(洪翼杓),26,4,30,1
42596,정우택(鄭宇澤),홍정민(洪貞敏),26,4,30,1
42597,정우택(鄭宇澤),황보승희(皇甫承希),38,74,112,1
42598,정우택(鄭宇澤),황운하(黃雲夏),25,5,30,1
42599,정우택(鄭宇澤),황희(黃熙),25,5,30,1
42600,정운천(鄭雲天),정일영(鄭日永),51,6,57,1
42601,정운천(鄭雲天),정점식(鄭点植),71,69,140,0
42602,정운천(鄭雲天),정진석(鄭鎭碩),102,96,198,0
42603,정운천(鄭雲天),정청래(鄭淸來),49,4,53,1
42604,정운천(鄭雲天),정춘숙(鄭春淑),49,4,53,1
42605,정운천(鄭雲天),정태호(鄭泰浩),49,4,53,1
42606,정운천(鄭雲天),정필모(鄭必模),49,4,53,1
42607,정운천(鄭雲天),정희용(鄭熙溶),88,92,180,0
42608,정운천(鄭雲天),조경태(趙慶泰),78,78,156,0
42609,정운천(鄭雲天),조명희(曺明姬),95,137,232,0
42610,정운천(鄭雲天),조수진(趙修眞),73,90,163,0
42611,정운천(鄭雲天),조승래(趙承來),50,7,57,1
42612,정운천(鄭雲天),조오섭(曺五燮),51,7,58,1
42613,정운천(鄭雲天),조은희(趙恩禧),39,24,63,0
42614,정운천(鄭雲天),조응천(趙應天),50,4,54,1
42615,정운천(鄭雲天),조정식(趙正湜),49,3,52,1
42616,정운천(鄭雲天),조정훈(趙廷訓),0,2,2,1
42617,정운천(鄭雲天),조해진(曺海珍),67,51,118,0
42618,정운천(鄭雲天),주철현(朱哲鉉),57,6,63,1
42619,정운천(鄭雲天),주호영(朱豪英),80,80,160,0
42620,정운천(鄭雲天),지성호(池成浩),85,101,186,0
42621,정운천(鄭雲天),진선미(陳善美),49,5,54,1
42622,정운천(鄭雲天),진성준(陳聲準),50,7,57,1
42623,정운천(鄭雲天),천준호(千俊鎬),49,3,52,1
42624,정운천(鄭雲天),최기상(崔基相),50,4,54,1
42625,정운천(鄭雲天),최승재(崔承宰),90,70,160,0
42626,정운천(鄭雲天),최연숙(崔姸淑),41,49,90,0
42627,정운천(鄭雲天),최영희(崔英姬),37,70,107,0
42628,정운천(鄭雲天),최인호(崔仁昊),51,5,56,1
42629,정운천(鄭雲天),최재형(崔在亨),29,20,49,0
42630,정운천(鄭雲天),최종윤(崔鍾允),50,6,56,1
42631,정운천(鄭雲天),최춘식(崔春植),92,146,238,0
42632,정운천(鄭雲天),최형두(崔炯斗),107,130,237,0
42633,정운천(鄭雲天),최혜영(崔惠英),51,4,55,1
42634,정운천(鄭雲天),추경호(秋慶鎬),104,123,227,0
42635,정운천(鄭雲天),태영호(太永浩),103,126,229,0
42636,정운천(鄭雲天),하영제(河榮帝),75,124,199,1
42637,정운천(鄭雲天),하태경(河泰慶),68,56,124,0
42638,정운천(鄭雲天),한기호(韓起鎬),70,66,136,0
42639,정운천(鄭雲天),한무경(韓茂景),99,108,207,0
42640,정운천(鄭雲天),한병도(韓秉道),52,11,63,1
42641,정운천(鄭雲天),한정애(韓貞愛),50,5,55,1
42642,정운천(鄭雲天),한준호(韓俊鎬),49,4,53,1
42643,정운천(鄭雲天),허숙정(許淑湞),0,0,0,1
42644,정운천(鄭雲天),허영(許榮),51,8,59,1
42645,정운천(鄭雲天),허은아(許垠娥),84,73,157,0
42646,정운천(鄭雲天),허종식(許琮植),52,7,59,1
42647,정운천(鄭雲天),홍기원(洪起元),49,4,53,1
42648,정운천(鄭雲天),홍문표(洪文杓),88,102,190,0
42649,정운천(鄭雲天),홍석준(洪碩晙),72,58,130,0
42650,정운천(鄭雲天),홍성국(洪性國),50,4,54,1
42651,정운천(鄭雲天),홍영표(洪永杓),51,6,57,1
42652,정운천(鄭雲天),홍익표(洪翼杓),50,4,54,1
42653,정운천(鄭雲天),홍정민(洪貞敏),51,4,55,1
42654,정운천(鄭雲天),황보승희(皇甫承希),73,92,165,1
42655,정운천(鄭雲天),황운하(黃雲夏),50,5,55,1
42656,정운천(鄭雲天),황희(黃熙),49,5,54,1
42657,정일영(鄭日永),정점식(鄭点植),49,5,54,1
42658,정일영(鄭日永),정진석(鄭鎭碩),49,5,54,1
42659,정일영(鄭日永),정청래(鄭淸來),82,47,129,0
42660,정일영(鄭日永),정춘숙(鄭春淑),88,59,147,0
42661,정일영(鄭日永),정태호(鄭泰浩),89,109,198,0
42662,정일영(鄭日永),정필모(鄭必模),93,98,191,0
42663,정일영(鄭日永),정희용(鄭熙溶),50,6,56,1
42664,정일영(鄭日永),조경태(趙慶泰),49,7,56,1
42665,정일영(鄭日永),조명희(曺明姬),49,12,61,1
42666,정일영(鄭日永),조수진(趙修眞),49,4,53,1
42667,정일영(鄭日永),조승래(趙承來),107,131,238,0
42668,정일영(鄭日永),조오섭(曺五燮),96,156,252,0
42669,정일영(鄭日永),조은희(趙恩禧),25,4,29,1
42670,정일영(鄭日永),조응천(趙應天),98,63,161,0
42671,정일영(鄭日永),조정식(趙正湜),91,74,165,0
42672,정일영(鄭日永),조정훈(趙廷訓),2,13,15,1
42673,정일영(鄭日永),조해진(曺海珍),51,7,58,1
42674,정일영(鄭日永),주철현(朱哲鉉),102,129,231,0
42675,정일영(鄭日永),주호영(朱豪英),50,4,54,1
42676,정일영(鄭日永),지성호(池成浩),50,7,57,1
42677,정일영(鄭日永),진선미(陳善美),86,50,136,0
42678,정일영(鄭日永),진성준(陳聲準),101,112,213,0
42679,정일영(鄭日永),천준호(千俊鎬),102,78,180,0
42680,정일영(鄭日永),최기상(崔基相),100,85,185,0
42681,정일영(鄭日永),최승재(崔承宰),49,6,55,1
42682,정일영(鄭日永),최연숙(崔姸淑),30,12,42,1
42683,정일영(鄭日永),최영희(崔英姬),25,4,29,1
42684,정일영(鄭日永),최인호(崔仁昊),112,126,238,0
42685,정일영(鄭日永),최재형(崔在亨),25,4,29,1
42686,정일영(鄭日永),최종윤(崔鍾允),104,160,264,0
42687,정일영(鄭日永),최춘식(崔春植),49,5,54,1
42688,정일영(鄭日永),최형두(崔炯斗),49,10,59,1
42689,정일영(鄭日永),최혜영(崔惠英),95,110,205,0
42690,정일영(鄭日永),추경호(秋慶鎬),49,4,53,1
42691,정일영(鄭日永),태영호(太永浩),50,7,57,1
42692,정일영(鄭日永),하영제(河榮帝),42,5,47,1
42693,정일영(鄭日永),하태경(河泰慶),49,4,53,1
42694,정일영(鄭日永),한기호(韓起鎬),50,4,54,1
42695,정일영(鄭日永),한무경(韓茂景),49,8,57,1
42696,정일영(鄭日永),한병도(韓秉道),129,150,279,0
42697,정일영(鄭日永),한정애(韓貞愛),83,63,146,0
42698,정일영(鄭日永),한준호(韓俊鎬),107,195,302,0
42699,정일영(鄭日永),허숙정(許淑湞),1,2,3,0
42700,정일영(鄭日永),허영(許榮),131,144,275,0
42701,정일영(鄭日永),허은아(許垠娥),49,5,54,1
42702,정일영(鄭日永),허종식(許琮植),159,211,370,0
42703,정일영(鄭日永),홍기원(洪起元),105,165,270,0
42704,정일영(鄭日永),홍문표(洪文杓),50,6,56,1
42705,정일영(鄭日永),홍석준(洪碩晙),49,4,53,1
42706,정일영(鄭日永),홍성국(洪性國),112,167,279,0
42707,정일영(鄭日永),홍영표(洪永杓),101,108,209,0
42708,정일영(鄭日永),홍익표(洪翼杓),88,77,165,0
42709,정일영(鄭日永),홍정민(洪貞敏),108,139,247,0
42710,정일영(鄭日永),황보승희(皇甫承希),46,4,50,1
42711,정일영(鄭日永),황운하(黃雲夏),115,166,281,0
42712,정일영(鄭日永),황희(黃熙),81,43,124,0
42713,정점식(鄭点植),정진석(鄭鎭碩),70,53,123,0
42714,정점식(鄭点植),정청래(鄭淸來),49,4,53,1
42715,정점식(鄭点植),정춘숙(鄭春淑),51,4,55,1
42716,정점식(鄭点植),정태호(鄭泰浩),50,5,55,1
42717,정점식(鄭点植),정필모(鄭必模),50,4,54,1
42718,정점식(鄭点植),정희용(鄭熙溶),82,58,140,0
42719,정점식(鄭点植),조경태(趙慶泰),66,48,114,0
42720,정점식(鄭点植),조명희(曺明姬),81,64,145,0
42721,정점식(鄭点植),조수진(趙修眞),87,107,194,0
42722,정점식(鄭点植),조승래(趙承來),50,4,54,1
42723,정점식(鄭点植),조오섭(曺五燮),51,4,55,1
42724,정점식(鄭点植),조은희(趙恩禧),26,15,41,0
42725,정점식(鄭点植),조응천(趙應天),50,4,54,1
42726,정점식(鄭点植),조정식(趙正湜),49,3,52,1
42727,정점식(鄭点植),조정훈(趙廷訓),2,9,11,1
42728,정점식(鄭点植),조해진(曺海珍),67,48,115,0
42729,정점식(鄭点植),주철현(朱哲鉉),50,5,55,1
42730,정점식(鄭点植),주호영(朱豪英),63,40,103,0
42731,정점식(鄭点植),지성호(池成浩),70,60,130,0
42732,정점식(鄭点植),진선미(陳善美),50,4,54,1
42733,정점식(鄭点植),진성준(陳聲準),50,4,54,1
42734,정점식(鄭点植),천준호(千俊鎬),49,3,52,1
42735,정점식(鄭点植),최기상(崔基相),49,4,53,1
42736,정점식(鄭点植),최승재(崔承宰),69,53,122,0
42737,정점식(鄭点植),최연숙(崔姸淑),34,21,55,0
42738,정점식(鄭点植),최영희(崔英姬),25,27,52,0
42739,정점식(鄭点植),최인호(崔仁昊),51,4,55,1
42740,정점식(鄭点植),최재형(崔在亨),28,11,39,0
42741,정점식(鄭点植),최종윤(崔鍾允),50,4,54,1
42742,정점식(鄭点植),최춘식(崔春植),67,48,115,0
42743,정점식(鄭点植),최형두(崔炯斗),86,58,144,0
42744,정점식(鄭点植),최혜영(崔惠英),50,4,54,1
42745,정점식(鄭点植),추경호(秋慶鎬),79,66,145,0
42746,정점식(鄭点植),태영호(太永浩),67,62,129,0
42747,정점식(鄭点植),하영제(河榮帝),80,74,154,1
42748,정점식(鄭点植),하태경(河泰慶),62,41,103,0
42749,정점식(鄭点植),한기호(韓起鎬),64,44,108,0
42750,정점식(鄭点植),한무경(韓茂景),77,67,144,0
42751,정점식(鄭点植),한병도(韓秉道),50,4,54,1
42752,정점식(鄭点植),한정애(韓貞愛),50,4,54,1
42753,정점식(鄭点植),한준호(韓俊鎬),50,4,54,1
42754,정점식(鄭点植),허숙정(許淑湞),0,0,0,1
42755,정점식(鄭点植),허영(許榮),52,4,56,1
42756,정점식(鄭点植),허은아(許垠娥),64,47,111,0
42757,정점식(鄭点植),허종식(許琮植),51,5,56,1
42758,정점식(鄭点植),홍기원(洪起元),50,4,54,1
42759,정점식(鄭点植),홍문표(洪文杓),67,53,120,0
42760,정점식(鄭点植),홍석준(洪碩晙),63,40,103,0
42761,정점식(鄭点植),홍성국(洪性國),50,4,54,1
42762,정점식(鄭点植),홍영표(洪永杓),51,4,55,1
42763,정점식(鄭点植),홍익표(洪翼杓),50,4,54,1
42764,정점식(鄭点植),홍정민(洪貞敏),51,4,55,1
42765,정점식(鄭点植),황보승희(皇甫承希),73,53,126,1
42766,정점식(鄭点植),황운하(黃雲夏),50,4,54,1
42767,정점식(鄭点植),황희(黃熙),49,4,53,1
42768,정진석(鄭鎭碩),정청래(鄭淸來),49,6,55,1
42769,정진석(鄭鎭碩),정춘숙(鄭春淑),50,5,55,1
42770,정진석(鄭鎭碩),정태호(鄭泰浩),50,7,57,1
42771,정진석(鄭鎭碩),정필모(鄭必模),50,5,55,1
42772,정진석(鄭鎭碩),정희용(鄭熙溶),114,138,252,0
42773,정진석(鄭鎭碩),조경태(趙慶泰),73,47,120,0
42774,정진석(鄭鎭碩),조명희(曺明姬),77,105,182,0
42775,정진석(鄭鎭碩),조수진(趙修眞),87,104,191,0
42776,정진석(鄭鎭碩),조승래(趙承來),53,7,60,1
42777,정진석(鄭鎭碩),조오섭(曺五燮),51,6,57,1
42778,정진석(鄭鎭碩),조은희(趙恩禧),30,16,46,0
42779,정진석(鄭鎭碩),조응천(趙應天),51,5,56,1
42780,정진석(鄭鎭碩),조정식(趙正湜),49,3,52,1
42781,정진석(鄭鎭碩),조정훈(趙廷訓),2,1,3,1
42782,정진석(鄭鎭碩),조해진(曺海珍),66,38,104,0
42783,정진석(鄭鎭碩),주철현(朱哲鉉),51,9,60,1
42784,정진석(鄭鎭碩),주호영(朱豪英),69,42,111,0
42785,정진석(鄭鎭碩),지성호(池成浩),96,131,227,0
42786,정진석(鄭鎭碩),진선미(陳善美),50,5,55,1
42787,정진석(鄭鎭碩),진성준(陳聲準),50,5,55,1
42788,정진석(鄭鎭碩),천준호(千俊鎬),49,4,53,1
42789,정진석(鄭鎭碩),최기상(崔基相),49,6,55,1
42790,정진석(鄭鎭碩),최승재(崔承宰),74,92,166,0
42791,정진석(鄭鎭碩),최연숙(崔姸淑),38,28,66,0
42792,정진석(鄭鎭碩),최영희(崔英姬),26,11,37,0
42793,정진석(鄭鎭碩),최인호(崔仁昊),50,6,56,1
42794,정진석(鄭鎭碩),최재형(崔在亨),26,11,37,0
42795,정진석(鄭鎭碩),최종윤(崔鍾允),50,6,56,1
42796,정진석(鄭鎭碩),최춘식(崔春植),84,80,164,0
42797,정진석(鄭鎭碩),최형두(崔炯斗),77,67,144,0
42798,정진석(鄭鎭碩),최혜영(崔惠英),50,5,55,1
42799,정진석(鄭鎭碩),추경호(秋慶鎬),118,173,291,0
42800,정진석(鄭鎭碩),태영호(太永浩),103,166,269,0
42801,정진석(鄭鎭碩),하영제(河榮帝),66,60,126,1
42802,정진석(鄭鎭碩),하태경(河泰慶),69,68,137,0
42803,정진석(鄭鎭碩),한기호(韓起鎬),71,73,144,0
42804,정진석(鄭鎭碩),한무경(韓茂景),90,93,183,0
42805,정진석(鄭鎭碩),한병도(韓秉道),49,6,55,1
42806,정진석(鄭鎭碩),한정애(韓貞愛),52,5,57,1
42807,정진석(鄭鎭碩),한준호(韓俊鎬),51,5,56,1
42808,정진석(鄭鎭碩),허숙정(許淑湞),0,0,0,1
42809,정진석(鄭鎭碩),허영(許榮),51,8,59,1
42810,정진석(鄭鎭碩),허은아(許垠娥),78,71,149,0
42811,정진석(鄭鎭碩),허종식(許琮植),50,5,55,1
42812,정진석(鄭鎭碩),홍기원(洪起元),51,7,58,1
42813,정진석(鄭鎭碩),홍문표(洪文杓),81,80,161,0
42814,정진석(鄭鎭碩),홍석준(洪碩晙),71,56,127,0
42815,정진석(鄭鎭碩),홍성국(洪性國),50,8,58,1
42816,정진석(鄭鎭碩),홍영표(洪永杓),51,5,56,1
42817,정진석(鄭鎭碩),홍익표(洪翼杓),50,5,55,1
42818,정진석(鄭鎭碩),홍정민(洪貞敏),51,6,57,1
42819,정진석(鄭鎭碩),황보승희(皇甫承希),74,98,172,1
42820,정진석(鄭鎭碩),황운하(黃雲夏),50,8,58,1
42821,정진석(鄭鎭碩),황희(黃熙),49,5,54,1
42822,정청래(鄭淸來),정춘숙(鄭春淑),86,62,148,0
42823,정청래(鄭淸來),정태호(鄭泰浩),83,45,128,0
42824,정청래(鄭淸來),정필모(鄭必模),83,52,135,0
42825,정청래(鄭淸來),정희용(鄭熙溶),51,5,56,1
42826,정청래(鄭淸來),조경태(趙慶泰),49,5,54,1
42827,정청래(鄭淸來),조명희(曺明姬),49,5,54,1
42828,정청래(鄭淸來),조수진(趙修眞),49,4,53,1
42829,정청래(鄭淸來),조승래(趙承來),84,34,118,0
42830,정청래(鄭淸來),조오섭(曺五燮),102,84,186,0
42831,정청래(鄭淸來),조은희(趙恩禧),25,4,29,1
42832,정청래(鄭淸來),조응천(趙應天),72,32,104,0
42833,정청래(鄭淸來),조정식(趙正湜),77,30,107,0
42834,정청래(鄭淸來),조정훈(趙廷訓),5,5,10,1
42835,정청래(鄭淸來),조해진(曺海珍),50,5,55,1
42836,정청래(鄭淸來),주철현(朱哲鉉),142,133,275,0
42837,정청래(鄭淸來),주호영(朱豪英),49,4,53,1
42838,정청래(鄭淸來),지성호(池成浩),49,4,53,1
42839,정청래(鄭淸來),진선미(陳善美),83,48,131,0
42840,정청래(鄭淸來),진성준(陳聲準),92,77,169,0
42841,정청래(鄭淸來),천준호(千俊鎬),84,59,143,0
42842,정청래(鄭淸來),최기상(崔基相),82,41,123,0
42843,정청래(鄭淸來),최승재(崔承宰),49,4,53,1
42844,정청래(鄭淸來),최연숙(崔姸淑),31,12,43,1
42845,정청래(鄭淸來),최영희(崔英姬),25,4,29,1
42846,정청래(鄭淸來),최인호(崔仁昊),80,41,121,0
42847,정청래(鄭淸來),최재형(崔在亨),25,4,29,1
42848,정청래(鄭淸來),최종윤(崔鍾允),105,67,172,0
42849,정청래(鄭淸來),최춘식(崔春植),49,4,53,1
42850,정청래(鄭淸來),최형두(崔炯斗),49,5,54,1
42851,정청래(鄭淸來),최혜영(崔惠英),169,187,356,0
42852,정청래(鄭淸來),추경호(秋慶鎬),50,3,53,1
42853,정청래(鄭淸來),태영호(太永浩),51,4,55,1
42854,정청래(鄭淸來),하영제(河榮帝),40,1,41,1
42855,정청래(鄭淸來),하태경(河泰慶),51,4,55,1
42856,정청래(鄭淸來),한기호(韓起鎬),51,5,56,1
42857,정청래(鄭淸來),한무경(韓茂景),49,4,53,1
42858,정청래(鄭淸來),한병도(韓秉道),102,60,162,0
42859,정청래(鄭淸來),한정애(韓貞愛),78,47,125,0
42860,정청래(鄭淸來),한준호(韓俊鎬),123,110,233,0
42861,정청래(鄭淸來),허숙정(許淑湞),1,1,2,0
42862,정청래(鄭淸來),허영(許榮),97,56,153,0
42863,정청래(鄭淸來),허은아(許垠娥),49,4,53,1
42864,정청래(鄭淸來),허종식(許琮植),86,52,138,0
42865,정청래(鄭淸來),홍기원(洪起元),90,53,143,0
42866,정청래(鄭淸來),홍문표(洪文杓),49,5,54,1
42867,정청래(鄭淸來),홍석준(洪碩晙),49,4,53,1
42868,정청래(鄭淸來),홍성국(洪性國),150,152,302,0
42869,정청래(鄭淸來),홍영표(洪永杓),82,48,130,0
42870,정청래(鄭淸來),홍익표(洪翼杓),87,60,147,0
42871,정청래(鄭淸來),홍정민(洪貞敏),100,81,181,0
42872,정청래(鄭淸來),황보승희(皇甫承希),46,1,47,1
42873,정청래(鄭淸來),황운하(黃雲夏),99,108,207,0
42874,정청래(鄭淸來),황희(黃熙),80,38,118,0
42875,정춘숙(鄭春淑),정태호(鄭泰浩),92,96,188,0
42876,정춘숙(鄭春淑),정필모(鄭必模),98,68,166,0
42877,정춘숙(鄭春淑),정희용(鄭熙溶),50,6,56,1
42878,정춘숙(鄭春淑),조경태(趙慶泰),49,4,53,1
42879,정춘숙(鄭春淑),조명희(曺明姬),49,6,55,1
42880,정춘숙(鄭春淑),조수진(趙修眞),49,4,53,1
42881,정춘숙(鄭春淑),조승래(趙承來),103,74,177,0
42882,정춘숙(鄭春淑),조오섭(曺五燮),110,153,263,0
42883,정춘숙(鄭春淑),조은희(趙恩禧),25,4,29,1
42884,정춘숙(鄭春淑),조응천(趙應天),77,33,110,0
42885,정춘숙(鄭春淑),조정식(趙正湜),89,70,159,0
42886,정춘숙(鄭春淑),조정훈(趙廷訓),3,19,22,1
42887,정춘숙(鄭春淑),조해진(曺海珍),53,5,58,1
42888,정춘숙(鄭春淑),주철현(朱哲鉉),100,86,186,0
42889,정춘숙(鄭春淑),주호영(朱豪英),50,4,54,1
42890,정춘숙(鄭春淑),지성호(池成浩),49,4,53,1
42891,정춘숙(鄭春淑),진선미(陳善美),82,71,153,0
42892,정춘숙(鄭春淑),진성준(陳聲準),91,76,167,0
42893,정춘숙(鄭春淑),천준호(千俊鎬),86,73,159,0
42894,정춘숙(鄭春淑),최기상(崔基相),80,49,129,0
42895,정춘숙(鄭春淑),최승재(崔承宰),49,5,54,1
42896,정춘숙(鄭春淑),최연숙(崔姸淑),34,23,57,1
42897,정춘숙(鄭春淑),최영희(崔英姬),25,6,31,1
42898,정춘숙(鄭春淑),최인호(崔仁昊),102,88,190,0
42899,정춘숙(鄭春淑),최재형(崔在亨),25,5,30,1
42900,정춘숙(鄭春淑),최종윤(崔鍾允),125,132,257,0
42901,정춘숙(鄭春淑),최춘식(崔春植),49,6,55,1
42902,정춘숙(鄭春淑),최형두(崔炯斗),51,5,56,1
42903,정춘숙(鄭春淑),최혜영(崔惠英),137,222,359,0
42904,정춘숙(鄭春淑),추경호(秋慶鎬),50,4,54,1
42905,정춘숙(鄭春淑),태영호(太永浩),49,4,53,1
42906,정춘숙(鄭春淑),하영제(河榮帝),42,1,43,1
42907,정춘숙(鄭春淑),하태경(河泰慶),49,5,54,1
42908,정춘숙(鄭春淑),한기호(韓起鎬),50,5,55,1
42909,정춘숙(鄭春淑),한무경(韓茂景),49,5,54,1
42910,정춘숙(鄭春淑),한병도(韓秉道),112,103,215,0
42911,정춘숙(鄭春淑),한정애(韓貞愛),86,88,174,0
42912,정춘숙(鄭春淑),한준호(韓俊鎬),104,100,204,0
42913,정춘숙(鄭春淑),허숙정(許淑湞),1,1,2,0
42914,정춘숙(鄭春淑),허영(許榮),124,121,245,0
42915,정춘숙(鄭春淑),허은아(許垠娥),49,4,53,1
42916,정춘숙(鄭春淑),허종식(許琮植),148,198,346,0
42917,정춘숙(鄭春淑),홍기원(洪起元),95,77,172,0
42918,정춘숙(鄭春淑),홍문표(洪文杓),50,6,56,1
42919,정춘숙(鄭春淑),홍석준(洪碩晙),50,4,54,1
42920,정춘숙(鄭春淑),홍성국(洪性國),125,143,268,0
42921,정춘숙(鄭春淑),홍영표(洪永杓),82,75,157,0
42922,정춘숙(鄭春淑),홍익표(洪翼杓),88,83,171,0
42923,정춘숙(鄭春淑),홍정민(洪貞敏),109,121,230,0
42924,정춘숙(鄭春淑),황보승희(皇甫承希),46,2,48,1
42925,정춘숙(鄭春淑),황운하(黃雲夏),120,122,242,0
42926,정춘숙(鄭春淑),황희(黃熙),83,47,130,0
42927,정태호(鄭泰浩),정필모(鄭必模),88,85,173,0
42928,정태호(鄭泰浩),정희용(鄭熙溶),50,5,55,1
42929,정태호(鄭泰浩),조경태(趙慶泰),49,4,53,1
42930,정태호(鄭泰浩),조명희(曺明姬),49,7,56,1
42931,정태호(鄭泰浩),조수진(趙修眞),49,5,54,1
42932,정태호(鄭泰浩),조승래(趙承來),98,78,176,0
42933,정태호(鄭泰浩),조오섭(曺五燮),90,160,250,0
42934,정태호(鄭泰浩),조은희(趙恩禧),25,6,31,1
42935,정태호(鄭泰浩),조응천(趙應天),74,43,117,0
42936,정태호(鄭泰浩),조정식(趙正湜),80,47,127,0
42937,정태호(鄭泰浩),조정훈(趙廷訓),6,10,16,1
42938,정태호(鄭泰浩),조해진(曺海珍),52,6,58,1
42939,정태호(鄭泰浩),주철현(朱哲鉉),88,97,185,0
42940,정태호(鄭泰浩),주호영(朱豪英),49,4,53,1
42941,정태호(鄭泰浩),지성호(池成浩),49,4,53,1
42942,정태호(鄭泰浩),진선미(陳善美),78,84,162,0
42943,정태호(鄭泰浩),진성준(陳聲準),93,73,166,0
42944,정태호(鄭泰浩),천준호(千俊鎬),81,59,140,0
42945,정태호(鄭泰浩),최기상(崔基相),85,72,157,0
42946,정태호(鄭泰浩),최승재(崔承宰),49,5,54,1
42947,정태호(鄭泰浩),최연숙(崔姸淑),32,13,45,1
42948,정태호(鄭泰浩),최영희(崔英姬),25,7,32,1
42949,정태호(鄭泰浩),최인호(崔仁昊),85,82,167,0
42950,정태호(鄭泰浩),최재형(崔在亨),25,4,29,1
42951,정태호(鄭泰浩),최종윤(崔鍾允),96,144,240,0
42952,정태호(鄭泰浩),최춘식(崔春植),49,6,55,1
42953,정태호(鄭泰浩),최형두(崔炯斗),50,11,61,1
42954,정태호(鄭泰浩),최혜영(崔惠英),86,164,250,0
42955,정태호(鄭泰浩),추경호(秋慶鎬),49,3,52,1
42956,정태호(鄭泰浩),태영호(太永浩),49,5,54,1
42957,정태호(鄭泰浩),하영제(河榮帝),41,3,44,1
42958,정태호(鄭泰浩),하태경(河泰慶),50,5,55,1
42959,정태호(鄭泰浩),한기호(韓起鎬),50,4,54,1
42960,정태호(鄭泰浩),한무경(韓茂景),49,4,53,1
42961,정태호(鄭泰浩),한병도(韓秉道),106,110,216,0
42962,정태호(鄭泰浩),한정애(韓貞愛),82,77,159,0
42963,정태호(鄭泰浩),한준호(韓俊鎬),96,115,211,0
42964,정태호(鄭泰浩),허숙정(許淑湞),1,1,2,0
42965,정태호(鄭泰浩),허영(許榮),101,128,229,0
42966,정태호(鄭泰浩),허은아(許垠娥),49,4,53,1
42967,정태호(鄭泰浩),허종식(許琮植),92,97,189,0
42968,정태호(鄭泰浩),홍기원(洪起元),91,98,189,0
42969,정태호(鄭泰浩),홍문표(洪文杓),51,9,60,1
42970,정태호(鄭泰浩),홍석준(洪碩晙),50,4,54,1
42971,정태호(鄭泰浩),홍성국(洪性國),118,184,302,0
42972,정태호(鄭泰浩),홍영표(洪永杓),82,98,180,0
42973,정태호(鄭泰浩),홍익표(洪翼杓),95,90,185,0
42974,정태호(鄭泰浩),홍정민(洪貞敏),100,116,216,0
42975,정태호(鄭泰浩),황보승희(皇甫承希),45,1,46,1
42976,정태호(鄭泰浩),황운하(黃雲夏),98,107,205,0
42977,정태호(鄭泰浩),황희(黃熙),87,50,137,0
42978,정필모(鄭必模),정희용(鄭熙溶),50,6,56,1
42979,정필모(鄭必模),조경태(趙慶泰),49,4,53,1
42980,정필모(鄭必模),조명희(曺明姬),49,7,56,1
42981,정필모(鄭必模),조수진(趙修眞),49,4,53,1
42982,정필모(鄭必模),조승래(趙承來),100,80,180,0
42983,정필모(鄭必模),조오섭(曺五燮),96,135,231,0
42984,정필모(鄭必模),조은희(趙恩禧),25,4,29,1
42985,정필모(鄭必模),조응천(趙應天),74,36,110,0
42986,정필모(鄭必模),조정식(趙正湜),78,49,127,0
42987,정필모(鄭必模),조정훈(趙廷訓),6,12,18,1
42988,정필모(鄭必模),조해진(曺海珍),52,5,57,1
42989,정필모(鄭必模),주철현(朱哲鉉),95,105,200,0
42990,정필모(鄭必模),주호영(朱豪英),49,4,53,1
42991,정필모(鄭必模),지성호(池成浩),49,4,53,1
42992,정필모(鄭必模),진선미(陳善美),82,53,135,0
42993,정필모(鄭必模),진성준(陳聲準),105,97,202,0
42994,정필모(鄭必模),천준호(千俊鎬),96,58,154,0
42995,정필모(鄭必模),최기상(崔基相),88,66,154,0
42996,정필모(鄭必模),최승재(崔承宰),49,6,55,1
42997,정필모(鄭必模),최연숙(崔姸淑),32,7,39,1
42998,정필모(鄭必模),최영희(崔英姬),25,4,29,1
42999,정필모(鄭必模),최인호(崔仁昊),82,73,155,0
43000,정필모(鄭必模),최재형(崔在亨),25,4,29,1
43001,정필모(鄭必模),최종윤(崔鍾允),99,103,202,0
43002,정필모(鄭必模),최춘식(崔春植),49,4,53,1
43003,정필모(鄭必模),최형두(崔炯斗),51,5,56,1
43004,정필모(鄭必模),최혜영(崔惠英),94,100,194,0
43005,정필모(鄭必模),추경호(秋慶鎬),49,3,52,1
43006,정필모(鄭必模),태영호(太永浩),49,5,54,1
43007,정필모(鄭必模),하영제(河榮帝),41,3,44,1
43008,정필모(鄭必模),하태경(河泰慶),50,5,55,1
43009,정필모(鄭必模),한기호(韓起鎬),50,4,54,1
43010,정필모(鄭必模),한무경(韓茂景),49,5,54,1
43011,정필모(鄭必模),한병도(韓秉道),89,100,189,0
43012,정필모(鄭必模),한정애(韓貞愛),78,51,129,0
43013,정필모(鄭必模),한준호(韓俊鎬),119,124,243,0
43014,정필모(鄭必模),허숙정(許淑湞),1,2,3,0
43015,정필모(鄭必模),허영(許榮),127,138,265,0
43016,정필모(鄭必模),허은아(許垠娥),49,5,54,1
43017,정필모(鄭必模),허종식(許琮植),110,108,218,0
43018,정필모(鄭必模),홍기원(洪起元),103,108,211,0
43019,정필모(鄭必模),홍문표(洪文杓),50,5,55,1
43020,정필모(鄭必模),홍석준(洪碩晙),50,4,54,1
43021,정필모(鄭必模),홍성국(洪性國),118,140,258,0
43022,정필모(鄭必模),홍영표(洪永杓),87,57,144,0
43023,정필모(鄭必模),홍익표(洪翼杓),94,77,171,0
43024,정필모(鄭必模),홍정민(洪貞敏),110,136,246,0
43025,정필모(鄭必模),황보승희(皇甫承希),46,2,48,1
43026,정필모(鄭必模),황운하(黃雲夏),118,152,270,0
43027,정필모(鄭必模),황희(黃熙),82,39,121,0
43028,정희용(鄭熙溶),조경태(趙慶泰),90,98,188,0
43029,정희용(鄭熙溶),조명희(曺明姬),102,118,220,0
43030,정희용(鄭熙溶),조수진(趙修眞),90,118,208,0
43031,정희용(鄭熙溶),조승래(趙承來),50,7,57,1
43032,정희용(鄭熙溶),조오섭(曺五燮),51,7,58,1
43033,정희용(鄭熙溶),조은희(趙恩禧),35,49,84,0
43034,정희용(鄭熙溶),조응천(趙應天),49,4,53,1
43035,정희용(鄭熙溶),조정식(趙正湜),50,4,54,1
43036,정희용(鄭熙溶),조정훈(趙廷訓),4,9,13,1
43037,정희용(鄭熙溶),조해진(曺海珍),67,44,111,0
43038,정희용(鄭熙溶),주철현(朱哲鉉),56,6,62,1
43039,정희용(鄭熙溶),주호영(朱豪英),77,94,171,0
43040,정희용(鄭熙溶),지성호(池成浩),107,198,305,0
43041,정희용(鄭熙溶),진선미(陳善美),50,6,56,1
43042,정희용(鄭熙溶),진성준(陳聲準),50,5,55,1
43043,정희용(鄭熙溶),천준호(千俊鎬),50,4,54,1
43044,정희용(鄭熙溶),최기상(崔基相),50,6,56,1
43045,정희용(鄭熙溶),최승재(崔承宰),91,122,213,0
43046,정희용(鄭熙溶),최연숙(崔姸淑),40,41,81,0
43047,정희용(鄭熙溶),최영희(崔英姬),33,71,104,0
43048,정희용(鄭熙溶),최인호(崔仁昊),51,5,56,1
43049,정희용(鄭熙溶),최재형(崔在亨),27,15,42,0
43050,정희용(鄭熙溶),최종윤(崔鍾允),50,5,55,1
43051,정희용(鄭熙溶),최춘식(崔春植),117,170,287,0
43052,정희용(鄭熙溶),최형두(崔炯斗),102,114,216,0
43053,정희용(鄭熙溶),최혜영(崔惠英),52,6,58,1
43054,정희용(鄭熙溶),추경호(秋慶鎬),139,168,307,0
43055,정희용(鄭熙溶),태영호(太永浩),128,215,343,0
43056,정희용(鄭熙溶),하영제(河榮帝),83,81,164,1
43057,정희용(鄭熙溶),하태경(河泰慶),67,48,115,0
43058,정희용(鄭熙溶),한기호(韓起鎬),75,76,151,0
43059,정희용(鄭熙溶),한무경(韓茂景),89,151,240,0
43060,정희용(鄭熙溶),한병도(韓秉道),50,5,55,1
43061,정희용(鄭熙溶),한정애(韓貞愛),50,6,56,1
43062,정희용(鄭熙溶),한준호(韓俊鎬),51,5,56,1
43063,정희용(鄭熙溶),허숙정(許淑湞),0,0,0,1
43064,정희용(鄭熙溶),허영(許榮),51,6,57,1
43065,정희용(鄭熙溶),허은아(許垠娥),87,118,205,0
43066,정희용(鄭熙溶),허종식(許琮植),51,9,60,1
43067,정희용(鄭熙溶),홍기원(洪起元),50,6,56,1
43068,정희용(鄭熙溶),홍문표(洪文杓),85,93,178,0
43069,정희용(鄭熙溶),홍석준(洪碩晙),86,88,174,0
43070,정희용(鄭熙溶),홍성국(洪性國),50,6,56,1
43071,정희용(鄭熙溶),홍영표(洪永杓),50,6,56,1
43072,정희용(鄭熙溶),홍익표(洪翼杓),50,6,56,1
43073,정희용(鄭熙溶),홍정민(洪貞敏),51,7,58,1
43074,정희용(鄭熙溶),황보승희(皇甫承希),92,128,220,1
43075,정희용(鄭熙溶),황운하(黃雲夏),51,8,59,1
43076,정희용(鄭熙溶),황희(黃熙),50,6,56,1
43077,조경태(趙慶泰),조명희(曺明姬),94,140,234,0
43078,조경태(趙慶泰),조수진(趙修眞),90,62,152,0
43079,조경태(趙慶泰),조승래(趙承來),49,3,52,1
43080,조경태(趙慶泰),조오섭(曺五燮),49,5,54,1
43081,조경태(趙慶泰),조은희(趙恩禧),33,27,60,0
43082,조경태(趙慶泰),조응천(趙應天),49,4,53,1
43083,조경태(趙慶泰),조정식(趙正湜),49,3,52,1
43084,조경태(趙慶泰),조정훈(趙廷訓),2,6,8,1
43085,조경태(趙慶泰),조해진(曺海珍),65,42,107,0
43086,조경태(趙慶泰),주철현(朱哲鉉),52,10,62,1
43087,조경태(趙慶泰),주호영(朱豪英),64,49,113,0
43088,조경태(趙慶泰),지성호(池成浩),82,98,180,0
43089,조경태(趙慶泰),진선미(陳善美),49,4,53,1
43090,조경태(趙慶泰),진성준(陳聲準),49,4,53,1
43091,조경태(趙慶泰),천준호(千俊鎬),49,3,52,1
43092,조경태(趙慶泰),최기상(崔基相),50,4,54,1
43093,조경태(趙慶泰),최승재(崔承宰),79,69,148,0
43094,조경태(趙慶泰),최연숙(崔姸淑),37,27,64,0
43095,조경태(趙慶泰),최영희(崔英姬),28,45,73,0
43096,조경태(趙慶泰),최인호(崔仁昊),52,8,60,1
43097,조경태(趙慶泰),최재형(崔在亨),28,12,40,0
43098,조경태(趙慶泰),최종윤(崔鍾允),50,4,54,1
43099,조경태(趙慶泰),최춘식(崔春植),78,86,164,0
43100,조경태(趙慶泰),최형두(崔炯斗),89,87,176,0
43101,조경태(趙慶泰),최혜영(崔惠英),51,4,55,1
43102,조경태(趙慶泰),추경호(秋慶鎬),106,113,219,0
43103,조경태(趙慶泰),태영호(太永浩),105,143,248,0
43104,조경태(趙慶泰),하영제(河榮帝),91,140,231,1
43105,조경태(趙慶泰),하태경(河泰慶),68,59,127,0
43106,조경태(趙慶泰),한기호(韓起鎬),67,50,117,0
43107,조경태(趙慶泰),한무경(韓茂景),83,104,187,0
43108,조경태(趙慶泰),한병도(韓秉道),50,6,56,1
43109,조경태(趙慶泰),한정애(韓貞愛),49,4,53,1
43110,조경태(趙慶泰),한준호(韓俊鎬),49,5,54,1
43111,조경태(趙慶泰),허숙정(許淑湞),0,0,0,1
43112,조경태(趙慶泰),허영(許榮),50,4,54,1
43113,조경태(趙慶泰),허은아(許垠娥),76,62,138,0
43114,조경태(趙慶泰),허종식(許琮植),49,4,53,1
43115,조경태(趙慶泰),홍기원(洪起元),49,4,53,1
43116,조경태(趙慶泰),홍문표(洪文杓),102,128,230,0
43117,조경태(趙慶泰),홍석준(洪碩晙),67,65,132,0
43118,조경태(趙慶泰),홍성국(洪性國),50,5,55,1
43119,조경태(趙慶泰),홍영표(洪永杓),49,5,54,1
43120,조경태(趙慶泰),홍익표(洪翼杓),50,4,54,1
43121,조경태(趙慶泰),홍정민(洪貞敏),51,4,55,1
43122,조경태(趙慶泰),황보승희(皇甫承希),91,124,215,1
43123,조경태(趙慶泰),황운하(黃雲夏),50,4,54,1
43124,조경태(趙慶泰),황희(黃熙),49,4,53,1
43125,조명희(曺明姬),조수진(趙修眞),87,137,224,0
43126,조명희(曺明姬),조승래(趙承來),49,7,56,1
43127,조명희(曺明姬),조오섭(曺五燮),53,7,60,1
43128,조명희(曺明姬),조은희(趙恩禧),43,57,100,0
43129,조명희(曺明姬),조응천(趙應天),49,5,54,1
43130,조명희(曺明姬),조정식(趙正湜),49,3,52,1
43131,조명희(曺明姬),조정훈(趙廷訓),1,18,19,1
43132,조명희(曺明姬),조해진(曺海珍),64,53,117,0
43133,조명희(曺明姬),주철현(朱哲鉉),51,7,58,1
43134,조명희(曺明姬),주호영(朱豪英),74,73,147,0
43135,조명희(曺明姬),지성호(池成浩),107,161,268,0
43136,조명희(曺明姬),진선미(陳善美),49,7,56,1
43137,조명희(曺明姬),진성준(陳聲準),49,6,55,1
43138,조명희(曺明姬),천준호(千俊鎬),49,5,54,1
43139,조명희(曺明姬),최기상(崔基相),50,5,55,1
43140,조명희(曺明姬),최승재(崔承宰),95,139,234,0
43141,조명희(曺明姬),최연숙(崔姸淑),44,82,126,0
43142,조명희(曺明姬),최영희(崔英姬),38,75,113,0
43143,조명희(曺明姬),최인호(崔仁昊),50,6,56,1
43144,조명희(曺明姬),최재형(崔在亨),40,30,70,0
43145,조명희(曺明姬),최종윤(崔鍾允),50,6,56,1
43146,조명희(曺明姬),최춘식(崔春植),94,184,278,0
43147,조명희(曺明姬),최형두(崔炯斗),107,131,238,0
43148,조명희(曺明姬),최혜영(崔惠英),50,7,57,1
43149,조명희(曺明姬),추경호(秋慶鎬),158,253,411,0
43150,조명희(曺明姬),태영호(太永浩),105,265,370,0
43151,조명희(曺明姬),하영제(河榮帝),115,258,373,1
43152,조명희(曺明姬),하태경(河泰慶),69,62,131,0
43153,조명희(曺明姬),한기호(韓起鎬),71,81,152,0
43154,조명희(曺明姬),한무경(韓茂景),102,196,298,0
43155,조명희(曺明姬),한병도(韓秉道),50,6,56,1
43156,조명희(曺明姬),한정애(韓貞愛),49,5,54,1
43157,조명희(曺明姬),한준호(韓俊鎬),49,6,55,1
43158,조명희(曺明姬),허숙정(許淑湞),0,0,0,1
43159,조명희(曺明姬),허영(許榮),50,7,57,1
43160,조명희(曺明姬),허은아(許垠娥),79,103,182,0
43161,조명희(曺明姬),허종식(許琮植),52,7,59,1
43162,조명희(曺明姬),홍기원(洪起元),49,7,56,1
43163,조명희(曺明姬),홍문표(洪文杓),109,197,306,0
43164,조명희(曺明姬),홍석준(洪碩晙),84,90,174,0
43165,조명희(曺明姬),홍성국(洪性國),49,8,57,1
43166,조명희(曺明姬),홍영표(洪永杓),50,6,56,1
43167,조명희(曺明姬),홍익표(洪翼杓),50,7,57,1
43168,조명희(曺明姬),홍정민(洪貞敏),50,9,59,1
43169,조명희(曺明姬),황보승희(皇甫承希),122,188,310,1
43170,조명희(曺明姬),황운하(黃雲夏),49,5,54,1
43171,조명희(曺明姬),황희(黃熙),49,10,59,1
43172,조수진(趙修眞),조승래(趙承來),51,4,55,1
43173,조수진(趙修眞),조오섭(曺五燮),51,6,57,1
43174,조수진(趙修眞),조은희(趙恩禧),35,34,69,0
43175,조수진(趙修眞),조응천(趙應天),50,3,53,1
43176,조수진(趙修眞),조정식(趙正湜),49,3,52,1
43177,조수진(趙修眞),조정훈(趙廷訓),3,18,21,1
43178,조수진(趙修眞),조해진(曺海珍),68,48,116,0
43179,조수진(趙修眞),주철현(朱哲鉉),56,7,63,1
43180,조수진(趙修眞),주호영(朱豪英),67,52,119,0
43181,조수진(趙修眞),지성호(池成浩),86,150,236,0
43182,조수진(趙修眞),진선미(陳善美),49,4,53,1
43183,조수진(趙修眞),진성준(陳聲準),49,4,53,1
43184,조수진(趙修眞),천준호(千俊鎬),49,3,52,1
43185,조수진(趙修眞),최기상(崔基相),50,4,54,1
43186,조수진(趙修眞),최승재(崔承宰),77,125,202,0
43187,조수진(趙修眞),최연숙(崔姸淑),44,60,104,0
43188,조수진(趙修眞),최영희(崔英姬),27,47,74,0
43189,조수진(趙修眞),최인호(崔仁昊),50,4,54,1
43190,조수진(趙修眞),최재형(崔在亨),27,21,48,0
43191,조수진(趙修眞),최종윤(崔鍾允),50,4,54,1
43192,조수진(趙修眞),최춘식(崔春植),82,130,212,0
43193,조수진(趙修眞),최형두(崔炯斗),76,80,156,0
43194,조수진(趙修眞),최혜영(崔惠英),49,4,53,1
43195,조수진(趙修眞),추경호(秋慶鎬),120,169,289,0
43196,조수진(趙修眞),태영호(太永浩),114,215,329,0
43197,조수진(趙修眞),하영제(河榮帝),75,97,172,1
43198,조수진(趙修眞),하태경(河泰慶),64,63,127,0
43199,조수진(趙修眞),한기호(韓起鎬),75,79,154,0
43200,조수진(趙修眞),한무경(韓茂景),94,143,237,0
43201,조수진(趙修眞),한병도(韓秉道),51,7,58,1
43202,조수진(趙修眞),한정애(韓貞愛),51,4,55,1
43203,조수진(趙修眞),한준호(韓俊鎬),50,4,54,1
43204,조수진(趙修眞),허숙정(許淑湞),0,0,0,1
43205,조수진(趙修眞),허영(許榮),52,5,57,1
43206,조수진(趙修眞),허은아(許垠娥),72,88,160,0
43207,조수진(趙修眞),허종식(許琮植),51,7,58,1
43208,조수진(趙修眞),홍기원(洪起元),49,4,53,1
43209,조수진(趙修眞),홍문표(洪文杓),79,92,171,0
43210,조수진(趙修眞),홍석준(洪碩晙),72,88,160,0
43211,조수진(趙修眞),홍성국(洪性國),51,4,55,1
43212,조수진(趙修眞),홍영표(洪永杓),50,4,54,1
43213,조수진(趙修眞),홍익표(洪翼杓),50,4,54,1
43214,조수진(趙修眞),홍정민(洪貞敏),51,4,55,1
43215,조수진(趙修眞),황보승희(皇甫承希),83,135,218,1
43216,조수진(趙修眞),황운하(黃雲夏),49,5,54,1
43217,조수진(趙修眞),황희(黃熙),49,10,59,1
43218,조승래(趙承來),조오섭(曺五燮),100,117,217,0
43219,조승래(趙承來),조은희(趙恩禧),25,3,28,1
43220,조승래(趙承來),조응천(趙應天),82,56,138,0
43221,조승래(趙承來),조정식(趙正湜),86,58,144,0
43222,조승래(趙承來),조정훈(趙廷訓),7,14,21,1
43223,조승래(趙承來),조해진(曺海珍),52,4,56,1
43224,조승래(趙承來),주철현(朱哲鉉),92,64,156,0
43225,조승래(趙承來),주호영(朱豪英),50,4,54,1
43226,조승래(趙承來),지성호(池成浩),49,5,54,1
43227,조승래(趙承來),진선미(陳善美),84,47,131,0
43228,조승래(趙承來),진성준(陳聲準),94,55,149,0
43229,조승래(趙承來),천준호(千俊鎬),84,49,133,0
43230,조승래(趙承來),최기상(崔基相),87,62,149,0
43231,조승래(趙承來),최승재(崔承宰),49,6,55,1
43232,조승래(趙承來),최연숙(崔姸淑),31,7,38,1
43233,조승래(趙承來),최영희(崔英姬),25,4,29,1
43234,조승래(趙承來),최인호(崔仁昊),105,101,206,0
43235,조승래(趙承來),최재형(崔在亨),25,4,29,1
43236,조승래(趙承來),최종윤(崔鍾允),140,216,356,0
43237,조승래(趙承來),최춘식(崔春植),49,6,55,1
43238,조승래(趙承來),최형두(崔炯斗),50,7,57,1
43239,조승래(趙承來),최혜영(崔惠英),105,81,186,0
43240,조승래(趙承來),추경호(秋慶鎬),49,4,53,1
43241,조승래(趙承來),태영호(太永浩),49,5,54,1
43242,조승래(趙承來),하영제(河榮帝),41,3,44,1
43243,조승래(趙承來),하태경(河泰慶),50,4,54,1
43244,조승래(趙承來),한기호(韓起鎬),50,6,56,1
43245,조승래(趙承來),한무경(韓茂景),49,7,56,1
43246,조승래(趙承來),한병도(韓秉道),109,107,216,0
43247,조승래(趙承來),한정애(韓貞愛),84,65,149,0
43248,조승래(趙承來),한준호(韓俊鎬),125,208,333,0
43249,조승래(趙承來),허숙정(許淑湞),1,2,3,0
43250,조승래(趙承來),허영(許榮),117,80,197,0
43251,조승래(趙承來),허은아(許垠娥),50,5,55,1
43252,조승래(趙承來),허종식(許琮植),115,71,186,0
43253,조승래(趙承來),홍기원(洪起元),106,69,175,0
43254,조승래(趙承來),홍문표(洪文杓),52,10,62,1
43255,조승래(趙承來),홍석준(洪碩晙),50,5,55,1
43256,조승래(趙承來),홍성국(洪性國),127,133,260,0
43257,조승래(趙承來),홍영표(洪永杓),84,63,147,0
43258,조승래(趙承來),홍익표(洪翼杓),100,69,169,0
43259,조승래(趙承來),홍정민(洪貞敏),122,129,251,0
43260,조승래(趙承來),황보승희(皇甫承希),50,3,53,1
43261,조승래(趙承來),황운하(黃雲夏),122,142,264,0
43262,조승래(趙承來),황희(黃熙),83,45,128,0
43263,조오섭(曺五燮),조은희(趙恩禧),26,6,32,1
43264,조오섭(曺五燮),조응천(趙應天),101,59,160,0
43265,조오섭(曺五燮),조정식(趙正湜),78,79,157,0
43266,조오섭(曺五燮),조정훈(趙廷訓),7,20,27,1
43267,조오섭(曺五燮),조해진(曺海珍),52,6,58,1
43268,조오섭(曺五燮),주철현(朱哲鉉),136,228,364,0
43269,조오섭(曺五燮),주호영(朱豪英),51,4,55,1
43270,조오섭(曺五燮),지성호(池成浩),50,4,54,1
43271,조오섭(曺五燮),진선미(陳善美),109,108,217,0
43272,조오섭(曺五燮),진성준(陳聲準),128,168,296,0
43273,조오섭(曺五燮),천준호(千俊鎬),107,100,207,0
43274,조오섭(曺五燮),최기상(崔基相),85,144,229,0
43275,조오섭(曺五燮),최승재(崔承宰),53,7,60,1
43276,조오섭(曺五燮),최연숙(崔姸淑),37,22,59,1
43277,조오섭(曺五燮),최영희(崔英姬),25,6,31,1
43278,조오섭(曺五燮),최인호(崔仁昊),88,146,234,0
43279,조오섭(曺五燮),최재형(崔在亨),28,5,33,1
43280,조오섭(曺五燮),최종윤(崔鍾允),143,304,447,0
43281,조오섭(曺五燮),최춘식(崔春植),51,4,55,1
43282,조오섭(曺五燮),최형두(崔炯斗),51,8,59,1
43283,조오섭(曺五燮),최혜영(崔惠英),123,255,378,0
43284,조오섭(曺五燮),추경호(秋慶鎬),50,5,55,1
43285,조오섭(曺五燮),태영호(太永浩),52,6,58,1
43286,조오섭(曺五燮),하영제(河榮帝),42,4,46,1
43287,조오섭(曺五燮),하태경(河泰慶),54,4,58,1
43288,조오섭(曺五燮),한기호(韓起鎬),51,4,55,1
43289,조오섭(曺五燮),한무경(韓茂景),51,8,59,1
43290,조오섭(曺五燮),한병도(韓秉道),119,158,277,0
43291,조오섭(曺五燮),한정애(韓貞愛),83,102,185,0
43292,조오섭(曺五燮),한준호(韓俊鎬),119,238,357,0
43293,조오섭(曺五燮),허숙정(許淑湞),1,2,3,0
43294,조오섭(曺五燮),허영(許榮),152,256,408,0
43295,조오섭(曺五燮),허은아(許垠娥),49,6,55,1
43296,조오섭(曺五燮),허종식(許琮植),106,196,302,0
43297,조오섭(曺五燮),홍기원(洪起元),107,146,253,0
43298,조오섭(曺五燮),홍문표(洪文杓),50,16,66,1
43299,조오섭(曺五燮),홍석준(洪碩晙),52,5,57,1
43300,조오섭(曺五燮),홍성국(洪性國),141,211,352,0
43301,조오섭(曺五燮),홍영표(洪永杓),86,97,183,0
43302,조오섭(曺五燮),홍익표(洪翼杓),109,107,216,0
43303,조오섭(曺五燮),홍정민(洪貞敏),116,163,279,0
43304,조오섭(曺五燮),황보승희(皇甫承希),50,5,55,1
43305,조오섭(曺五燮),황운하(黃雲夏),140,232,372,0
43306,조오섭(曺五燮),황희(黃熙),79,80,159,0
43307,조은희(趙恩禧),조응천(趙應天),25,3,28,1
43308,조은희(趙恩禧),조정식(趙正湜),26,4,30,1
43309,조은희(趙恩禧),조정훈(趙廷訓),2,5,7,1
43310,조은희(趙恩禧),조해진(曺海珍),29,14,43,0
43311,조은희(趙恩禧),주철현(朱哲鉉),27,4,31,1
43312,조은희(趙恩禧),주호영(朱豪英),35,23,58,0
43313,조은희(趙恩禧),지성호(池成浩),36,59,95,0
43314,조은희(趙恩禧),진선미(陳善美),25,4,29,1
43315,조은희(趙恩禧),진성준(陳聲準),25,4,29,1
43316,조은희(趙恩禧),천준호(千俊鎬),25,3,28,1
43317,조은희(趙恩禧),최기상(崔基相),26,4,30,1
43318,조은희(趙恩禧),최승재(崔承宰),39,36,75,0
43319,조은희(趙恩禧),최연숙(崔姸淑),30,29,59,0
43320,조은희(趙恩禧),최영희(崔英姬),34,35,69,0
43321,조은희(趙恩禧),최인호(崔仁昊),26,4,30,1
43322,조은희(趙恩禧),최재형(崔在亨),28,20,48,0
43323,조은희(趙恩禧),최종윤(崔鍾允),26,4,30,1
43324,조은희(趙恩禧),최춘식(崔春植),34,35,69,0
43325,조은희(趙恩禧),최형두(崔炯斗),32,23,55,0
43326,조은희(趙恩禧),최혜영(崔惠英),27,4,31,1
43327,조은희(趙恩禧),추경호(秋慶鎬),26,11,37,0
43328,조은희(趙恩禧),태영호(太永浩),35,64,99,0
43329,조은희(趙恩禧),하영제(河榮帝),24,29,53,1
43330,조은희(趙恩禧),하태경(河泰慶),28,27,55,0
43331,조은희(趙恩禧),한기호(韓起鎬),29,19,48,0
43332,조은희(趙恩禧),한무경(韓茂景),33,81,114,0
43333,조은희(趙恩禧),한병도(韓秉道),26,4,30,1
43334,조은희(趙恩禧),한정애(韓貞愛),25,5,30,1
43335,조은희(趙恩禧),한준호(韓俊鎬),26,4,30,1
43336,조은희(趙恩禧),허숙정(許淑湞),0,0,0,1
43337,조은희(趙恩禧),허영(許榮),27,4,31,1
43338,조은희(趙恩禧),허은아(許垠娥),26,25,51,0
43339,조은희(趙恩禧),허종식(許琮植),25,9,34,1
43340,조은희(趙恩禧),홍기원(洪起元),25,5,30,1
43341,조은희(趙恩禧),홍문표(洪文杓),27,25,52,0
43342,조은희(趙恩禧),홍석준(洪碩晙),32,43,75,0
43343,조은희(趙恩禧),홍성국(洪性國),25,4,29,1
43344,조은희(趙恩禧),홍영표(洪永杓),25,4,29,1
43345,조은희(趙恩禧),홍익표(洪翼杓),26,4,30,1
43346,조은희(趙恩禧),홍정민(洪貞敏),27,4,31,1
43347,조은희(趙恩禧),황보승희(皇甫承希),32,41,73,1
43348,조은희(趙恩禧),황운하(黃雲夏),25,4,29,1
43349,조은희(趙恩禧),황희(黃熙),25,5,30,1
43350,조응천(趙應天),조정식(趙正湜),73,31,104,0
43351,조응천(趙應天),조정훈(趙廷訓),0,11,11,1
43352,조응천(趙應天),조해진(曺海珍),50,3,53,1
43353,조응천(趙應天),주철현(朱哲鉉),77,37,114,0
43354,조응천(趙應天),주호영(朱豪英),49,3,52,1
43355,조응천(趙應天),지성호(池成浩),50,4,54,1
43356,조응천(趙應天),진선미(陳善美),88,32,120,0
43357,조응천(趙應天),진성준(陳聲準),93,38,131,0
43358,조응천(趙應天),천준호(千俊鎬),88,36,124,0
43359,조응천(趙應天),최기상(崔基相),86,62,148,0
43360,조응천(趙應天),최승재(崔承宰),49,5,54,1
43361,조응천(趙應天),최연숙(崔姸淑),29,4,33,1
43362,조응천(趙應天),최영희(崔英姬),25,4,29,1
43363,조응천(趙應天),최인호(崔仁昊),109,70,179,0
43364,조응천(趙應天),최재형(崔在亨),25,3,28,1
43365,조응천(趙應天),최종윤(崔鍾允),79,54,133,0
43366,조응천(趙應天),최춘식(崔春植),49,4,53,1
43367,조응천(趙應天),최형두(崔炯斗),51,6,57,1
43368,조응천(趙應天),최혜영(崔惠英),78,46,124,0
43369,조응천(趙應天),추경호(秋慶鎬),49,3,52,1
43370,조응천(趙應天),태영호(太永浩),51,5,56,1
43371,조응천(趙應天),하영제(河榮帝),42,3,45,1
43372,조응천(趙應天),하태경(河泰慶),49,3,52,1
43373,조응천(趙應天),한기호(韓起鎬),50,3,53,1
43374,조응천(趙應天),한무경(韓茂景),49,4,53,1
43375,조응천(趙應天),한병도(韓秉道),87,76,163,0
43376,조응천(趙應天),한정애(韓貞愛),75,36,111,0
43377,조응천(趙應天),한준호(韓俊鎬),93,65,158,0
43378,조응천(趙應天),허숙정(許淑湞),1,1,2,0
43379,조응천(趙應天),허영(許榮),101,48,149,0
43380,조응천(趙應天),허은아(許垠娥),49,4,53,1
43381,조응천(趙應天),허종식(許琮植),86,36,122,0
43382,조응천(趙應天),홍기원(洪起元),110,49,159,0
43383,조응천(趙應天),홍문표(洪文杓),50,3,53,1
43384,조응천(趙應天),홍석준(洪碩晙),50,3,53,1
43385,조응천(趙應天),홍성국(洪性國),80,47,127,0
43386,조응천(趙應天),홍영표(洪永杓),75,38,113,0
43387,조응천(趙應天),홍익표(洪翼杓),73,33,106,0
43388,조응천(趙應天),홍정민(洪貞敏),83,42,125,0
43389,조응천(趙應天),황보승희(皇甫承希),46,2,48,1
43390,조응천(趙應天),황운하(黃雲夏),79,35,114,0
43391,조응천(趙應天),황희(黃熙),71,32,103,0
43392,조정식(趙正湜),조정훈(趙廷訓),0,2,2,1
43393,조정식(趙正湜),조해진(曺海珍),50,4,54,1
43394,조정식(趙正湜),주철현(朱哲鉉),76,48,124,0
43395,조정식(趙正湜),주호영(朱豪英),49,3,52,1
43396,조정식(趙正湜),지성호(池成浩),49,3,52,1
43397,조정식(趙正湜),진선미(陳善美),73,39,112,0
43398,조정식(趙正湜),진성준(陳聲準),80,44,124,0
43399,조정식(趙正湜),천준호(千俊鎬),78,36,114,0
43400,조정식(趙正湜),최기상(崔基相),77,37,114,0
43401,조정식(趙正湜),최승재(崔承宰),49,4,53,1
43402,조정식(趙正湜),최연숙(崔姸淑),30,5,35,1
43403,조정식(趙正湜),최영희(崔英姬),25,5,30,1
43404,조정식(趙正湜),최인호(崔仁昊),81,78,159,0
43405,조정식(趙正湜),최재형(崔在亨),25,5,30,1
43406,조정식(趙正湜),최종윤(崔鍾允),88,52,140,0
43407,조정식(趙正湜),최춘식(崔春植),49,3,52,1
43408,조정식(趙正湜),최형두(崔炯斗),49,3,52,1
43409,조정식(趙正湜),최혜영(崔惠英),79,58,137,0
43410,조정식(趙正湜),추경호(秋慶鎬),49,3,52,1
43411,조정식(趙正湜),태영호(太永浩),49,4,53,1
43412,조정식(趙正湜),하영제(河榮帝),40,0,40,1
43413,조정식(趙正湜),하태경(河泰慶),49,3,52,1
43414,조정식(趙正湜),한기호(韓起鎬),49,5,54,1
43415,조정식(趙正湜),한무경(韓茂景),49,3,52,1
43416,조정식(趙正湜),한병도(韓秉道),86,58,144,0
43417,조정식(趙正湜),한정애(韓貞愛),74,44,118,0
43418,조정식(趙正湜),한준호(韓俊鎬),83,53,136,0
43419,조정식(趙正湜),허숙정(許淑湞),1,1,2,0
43420,조정식(趙正湜),허영(許榮),88,60,148,0
43421,조정식(趙正湜),허은아(許垠娥),49,3,52,1
43422,조정식(趙正湜),허종식(許琮植),83,46,129,0
43423,조정식(趙正湜),홍기원(洪起元),79,45,124,0
43424,조정식(趙正湜),홍문표(洪文杓),49,3,52,1
43425,조정식(趙正湜),홍석준(洪碩晙),49,3,52,1
43426,조정식(趙正湜),홍성국(洪性國),87,73,160,0
43427,조정식(趙正湜),홍영표(洪永杓),79,65,144,0
43428,조정식(趙正湜),홍익표(洪翼杓),74,45,119,0
43429,조정식(趙正湜),홍정민(洪貞敏),83,47,130,0
43430,조정식(趙正湜),황보승희(皇甫承希),44,0,44,1
43431,조정식(趙正湜),황운하(黃雲夏),76,49,125,0
43432,조정식(趙正湜),황희(黃熙),75,44,119,0
43433,조정훈(趙廷訓),조해진(曺海珍),0,4,4,1
43434,조정훈(趙廷訓),주철현(朱哲鉉),4,7,11,1
43435,조정훈(趙廷訓),주호영(朱豪英),0,1,1,1
43436,조정훈(趙廷訓),지성호(池成浩),1,21,22,1
43437,조정훈(趙廷訓),진선미(陳善美),2,7,9,1
43438,조정훈(趙廷訓),진성준(陳聲準),5,13,18,1
43439,조정훈(趙廷訓),천준호(千俊鎬),3,4,7,1
43440,조정훈(趙廷訓),최기상(崔基相),2,9,11,1
43441,조정훈(趙廷訓),최승재(崔承宰),2,40,42,1
43442,조정훈(趙廷訓),최연숙(崔姸淑),5,12,17,1
43443,조정훈(趙廷訓),최영희(崔英姬),0,9,9,1
43444,조정훈(趙廷訓),최인호(崔仁昊),1,7,8,1
43445,조정훈(趙廷訓),최재형(崔在亨),0,8,8,1
43446,조정훈(趙廷訓),최종윤(崔鍾允),7,17,24,1
43447,조정훈(趙廷訓),최춘식(崔春植),0,14,14,1
43448,조정훈(趙廷訓),최형두(崔炯斗),1,17,18,1
43449,조정훈(趙廷訓),최혜영(崔惠英),5,13,18,1
43450,조정훈(趙廷訓),추경호(秋慶鎬),1,6,7,1
43451,조정훈(趙廷訓),태영호(太永浩),2,43,45,1
43452,조정훈(趙廷訓),하영제(河榮帝),2,9,11,1
43453,조정훈(趙廷訓),하태경(河泰慶),1,4,5,1
43454,조정훈(趙廷訓),한기호(韓起鎬),0,4,4,1
43455,조정훈(趙廷訓),한무경(韓茂景),1,8,9,1
43456,조정훈(趙廷訓),한병도(韓秉道),10,5,15,1
43457,조정훈(趙廷訓),한정애(韓貞愛),2,7,9,1
43458,조정훈(趙廷訓),한준호(韓俊鎬),6,18,24,1
43459,조정훈(趙廷訓),허숙정(許淑湞),0,0,0,1
43460,조정훈(趙廷訓),허영(許榮),6,9,15,1
43461,조정훈(趙廷訓),허은아(許垠娥),2,4,6,1
43462,조정훈(趙廷訓),허종식(許琮植),4,14,18,1
43463,조정훈(趙廷訓),홍기원(洪起元),4,12,16,1
43464,조정훈(趙廷訓),홍문표(洪文杓),0,4,4,1
43465,조정훈(趙廷訓),홍석준(洪碩晙),0,6,6,1
43466,조정훈(趙廷訓),홍성국(洪性國),4,15,19,1
43467,조정훈(趙廷訓),홍영표(洪永杓),2,12,14,1
43468,조정훈(趙廷訓),홍익표(洪翼杓),5,8,13,1
43469,조정훈(趙廷訓),홍정민(洪貞敏),4,29,33,1
43470,조정훈(趙廷訓),황보승희(皇甫承希),1,15,16,1
43471,조정훈(趙廷訓),황운하(黃雲夏),7,14,21,1
43472,조정훈(趙廷訓),황희(黃熙),2,4,6,1
43473,조해진(曺海珍),주철현(朱哲鉉),52,6,58,1
43474,조해진(曺海珍),주호영(朱豪英),61,42,103,0
43475,조해진(曺海珍),지성호(池成浩),69,45,114,0
43476,조해진(曺海珍),진선미(陳善美),52,5,57,1
43477,조해진(曺海珍),진성준(陳聲準),51,5,56,1
43478,조해진(曺海珍),천준호(千俊鎬),50,5,55,1
43479,조해진(曺海珍),최기상(崔基相),51,5,56,1
43480,조해진(曺海珍),최승재(崔承宰),62,39,101,0
43481,조해진(曺海珍),최연숙(崔姸淑),34,34,68,0
43482,조해진(曺海珍),최영희(崔英姬),30,18,48,0
43483,조해진(曺海珍),최인호(崔仁昊),52,5,57,1
43484,조해진(曺海珍),최재형(崔在亨),27,14,41,0
43485,조해진(曺海珍),최종윤(崔鍾允),52,5,57,1
43486,조해진(曺海珍),최춘식(崔春植),62,58,120,0
43487,조해진(曺海珍),최형두(崔炯斗),72,66,138,0
43488,조해진(曺海珍),최혜영(崔惠英),50,7,57,1
43489,조해진(曺海珍),추경호(秋慶鎬),71,45,116,0
43490,조해진(曺海珍),태영호(太永浩),67,57,124,0
43491,조해진(曺海珍),하영제(河榮帝),62,52,114,1
43492,조해진(曺海珍),하태경(河泰慶),64,45,109,0
43493,조해진(曺海珍),한기호(韓起鎬),64,56,120,0
43494,조해진(曺海珍),한무경(韓茂景),62,42,104,0
43495,조해진(曺海珍),한병도(韓秉道),50,5,55,1
43496,조해진(曺海珍),한정애(韓貞愛),51,5,56,1
43497,조해진(曺海珍),한준호(韓俊鎬),52,5,57,1
43498,조해진(曺海珍),허숙정(許淑湞),0,0,0,1
43499,조해진(曺海珍),허영(許榮),52,5,57,1
43500,조해진(曺海珍),허은아(許垠娥),63,37,100,0
43501,조해진(曺海珍),허종식(許琮植),51,5,56,1
43502,조해진(曺海珍),홍기원(洪起元),52,7,59,1
43503,조해진(曺海珍),홍문표(洪文杓),62,43,105,0
43504,조해진(曺海珍),홍석준(洪碩晙),60,39,99,0
43505,조해진(曺海珍),홍성국(洪性國),52,6,58,1
43506,조해진(曺海珍),홍영표(洪永杓),51,6,57,1
43507,조해진(曺海珍),홍익표(洪翼杓),52,5,57,1
43508,조해진(曺海珍),홍정민(洪貞敏),53,5,58,1
43509,조해진(曺海珍),황보승희(皇甫承希),59,55,114,1
43510,조해진(曺海珍),황운하(黃雲夏),52,5,57,1
43511,조해진(曺海珍),황희(黃熙),51,5,56,1
43512,주철현(朱哲鉉),주호영(朱豪英),50,4,54,1
43513,주철현(朱哲鉉),지성호(池成浩),51,5,56,1
43514,주철현(朱哲鉉),진선미(陳善美),82,58,140,0
43515,주철현(朱哲鉉),진성준(陳聲準),105,123,228,0
43516,주철현(朱哲鉉),천준호(千俊鎬),89,65,154,0
43517,주철현(朱哲鉉),최기상(崔基相),87,75,162,0
43518,주철현(朱哲鉉),최승재(崔承宰),51,6,57,1
43519,주철현(朱哲鉉),최연숙(崔姸淑),33,7,40,1
43520,주철현(朱哲鉉),최영희(崔英姬),26,5,31,1
43521,주철현(朱哲鉉),최인호(崔仁昊),91,82,173,0
43522,주철현(朱哲鉉),최재형(崔在亨),26,5,31,1
43523,주철현(朱哲鉉),최종윤(崔鍾允),123,142,265,0
43524,주철현(朱哲鉉),최춘식(崔春植),54,5,59,1
43525,주철현(朱哲鉉),최형두(崔炯斗),51,10,61,1
43526,주철현(朱哲鉉),최혜영(崔惠英),151,160,311,0
43527,주철현(朱哲鉉),추경호(秋慶鎬),54,3,57,1
43528,주철현(朱哲鉉),태영호(太永浩),50,4,54,1
43529,주철현(朱哲鉉),하영제(河榮帝),43,4,47,1
43530,주철현(朱哲鉉),하태경(河泰慶),51,5,56,1
43531,주철현(朱哲鉉),한기호(韓起鎬),53,4,57,1
43532,주철현(朱哲鉉),한무경(韓茂景),50,5,55,1
43533,주철현(朱哲鉉),한병도(韓秉道),110,116,226,0
43534,주철현(朱哲鉉),한정애(韓貞愛),82,51,133,0
43535,주철현(朱哲鉉),한준호(韓俊鎬),130,139,269,0
43536,주철현(朱哲鉉),허숙정(許淑湞),1,2,3,0
43537,주철현(朱哲鉉),허영(許榮),114,144,258,0
43538,주철현(朱哲鉉),허은아(許垠娥),50,4,54,1
43539,주철현(朱哲鉉),허종식(許琮植),102,113,215,0
43540,주철현(朱哲鉉),홍기원(洪起元),95,90,185,0
43541,주철현(朱哲鉉),홍문표(洪文杓),55,30,85,1
43542,주철현(朱哲鉉),홍석준(洪碩晙),52,4,56,1
43543,주철현(朱哲鉉),홍성국(洪性國),170,219,389,0
43544,주철현(朱哲鉉),홍영표(洪永杓),83,44,127,0
43545,주철현(朱哲鉉),홍익표(洪翼杓),99,87,186,0
43546,주철현(朱哲鉉),홍정민(洪貞敏),123,136,259,0
43547,주철현(朱哲鉉),황보승희(皇甫承希),46,3,49,1
43548,주철현(朱哲鉉),황운하(黃雲夏),124,140,264,0
43549,주철현(朱哲鉉),황희(黃熙),82,38,120,0
43550,주호영(朱豪英),지성호(池成浩),67,62,129,0
43551,주호영(朱豪英),진선미(陳善美),49,4,53,1
43552,주호영(朱豪英),진성준(陳聲準),49,4,53,1
43553,주호영(朱豪英),천준호(千俊鎬),49,3,52,1
43554,주호영(朱豪英),최기상(崔基相),49,4,53,1
43555,주호영(朱豪英),최승재(崔承宰),74,46,120,0
43556,주호영(朱豪英),최연숙(崔姸淑),34,26,60,0
43557,주호영(朱豪英),최영희(崔英姬),27,39,66,0
43558,주호영(朱豪英),최인호(崔仁昊),50,4,54,1
43559,주호영(朱豪英),최재형(崔在亨),27,10,37,0
43560,주호영(朱豪英),최종윤(崔鍾允),49,4,53,1
43561,주호영(朱豪英),최춘식(崔春植),75,58,133,0
43562,주호영(朱豪英),최형두(崔炯斗),70,38,108,0
43563,주호영(朱豪英),최혜영(崔惠英),49,5,54,1
43564,주호영(朱豪英),추경호(秋慶鎬),75,69,144,0
43565,주호영(朱豪英),태영호(太永浩),70,91,161,0
43566,주호영(朱豪英),하영제(河榮帝),59,54,113,1
43567,주호영(朱豪英),하태경(河泰慶),63,41,104,0
43568,주호영(朱豪英),한기호(韓起鎬),63,34,97,0
43569,주호영(朱豪英),한무경(韓茂景),71,72,143,0
43570,주호영(朱豪英),한병도(韓秉道),49,4,53,1
43571,주호영(朱豪英),한정애(韓貞愛),49,6,55,1
43572,주호영(朱豪英),한준호(韓俊鎬),50,4,54,1
43573,주호영(朱豪英),허숙정(許淑湞),0,0,0,1
43574,주호영(朱豪英),허영(許榮),51,4,55,1
43575,주호영(朱豪英),허은아(許垠娥),68,42,110,0
43576,주호영(朱豪英),허종식(許琮植),51,4,55,1
43577,주호영(朱豪英),홍기원(洪起元),49,4,53,1
43578,주호영(朱豪英),홍문표(洪文杓),67,53,120,0
43579,주호영(朱豪英),홍석준(洪碩晙),65,43,108,0
43580,주호영(朱豪英),홍성국(洪性國),50,4,54,1
43581,주호영(朱豪英),홍영표(洪永杓),50,4,54,1
43582,주호영(朱豪英),홍익표(洪翼杓),49,4,53,1
43583,주호영(朱豪英),홍정민(洪貞敏),51,4,55,1
43584,주호영(朱豪英),황보승희(皇甫承希),69,52,121,1
43585,주호영(朱豪英),황운하(黃雲夏),50,4,54,1
43586,주호영(朱豪英),황희(黃熙),49,4,53,1
43587,지성호(池成浩),진선미(陳善美),49,4,53,1
43588,지성호(池成浩),진성준(陳聲準),49,4,53,1
43589,지성호(池成浩),천준호(千俊鎬),49,3,52,1
43590,지성호(池成浩),최기상(崔基相),50,4,54,1
43591,지성호(池成浩),최승재(崔承宰),96,128,224,0
43592,지성호(池成浩),최연숙(崔姸淑),41,60,101,0
43593,지성호(池成浩),최영희(崔英姬),35,111,146,0
43594,지성호(池成浩),최인호(崔仁昊),50,4,54,1
43595,지성호(池成浩),최재형(崔在亨),28,32,60,0
43596,지성호(池成浩),최종윤(崔鍾允),50,4,54,1
43597,지성호(池成浩),최춘식(崔春植),102,169,271,0
43598,지성호(池成浩),최형두(崔炯斗),77,104,181,0
43599,지성호(池成浩),최혜영(崔惠英),51,7,58,1
43600,지성호(池成浩),추경호(秋慶鎬),111,150,261,0
43601,지성호(池成浩),태영호(太永浩),140,280,420,0
43602,지성호(池成浩),하영제(河榮帝),93,150,243,1
43603,지성호(池成浩),하태경(河泰慶),64,78,142,0
43604,지성호(池成浩),한기호(韓起鎬),79,94,173,0
43605,지성호(池成浩),한무경(韓茂景),110,200,310,0
43606,지성호(池成浩),한병도(韓秉道),50,6,56,1
43607,지성호(池成浩),한정애(韓貞愛),49,4,53,1
43608,지성호(池成浩),한준호(韓俊鎬),49,4,53,1
43609,지성호(池成浩),허숙정(許淑湞),0,0,0,1
43610,지성호(池成浩),허영(許榮),50,4,54,1
43611,지성호(池成浩),허은아(許垠娥),83,113,196,0
43612,지성호(池成浩),허종식(許琮植),50,7,57,1
43613,지성호(池成浩),홍기원(洪起元),49,4,53,1
43614,지성호(池成浩),홍문표(洪文杓),81,93,174,0
43615,지성호(池成浩),홍석준(洪碩晙),81,133,214,0
43616,지성호(池成浩),홍성국(洪性國),49,4,53,1
43617,지성호(池成浩),홍영표(洪永杓),50,4,54,1
43618,지성호(池成浩),홍익표(洪翼杓),50,4,54,1
43619,지성호(池成浩),홍정민(洪貞敏),50,5,55,1
43620,지성호(池成浩),황보승희(皇甫承希),83,110,193,1
43621,지성호(池成浩),황운하(黃雲夏),49,5,54,1
43622,지성호(池成浩),황희(黃熙),49,5,54,1
43623,진선미(陳善美),진성준(陳聲準),109,90,199,0
43624,진선미(陳善美),천준호(千俊鎬),98,51,149,0
43625,진선미(陳善美),최기상(崔基相),77,54,131,0
43626,진선미(陳善美),최승재(崔承宰),49,5,54,1
43627,진선미(陳善美),최연숙(崔姸淑),30,12,42,1
43628,진선미(陳善美),최영희(崔英姬),25,4,29,1
43629,진선미(陳善美),최인호(崔仁昊),82,55,137,0
43630,진선미(陳善美),최재형(崔在亨),25,4,29,1
43631,진선미(陳善美),최종윤(崔鍾允),89,55,144,0
43632,진선미(陳善美),최춘식(崔春植),49,4,53,1
43633,진선미(陳善美),최형두(崔炯斗),50,5,55,1
43634,진선미(陳善美),최혜영(崔惠英),91,95,186,0
43635,진선미(陳善美),추경호(秋慶鎬),49,3,52,1
43636,진선미(陳善美),태영호(太永浩),49,5,54,1
43637,진선미(陳善美),하영제(河榮帝),41,1,42,1
43638,진선미(陳善美),하태경(河泰慶),49,4,53,1
43639,진선미(陳善美),한기호(韓起鎬),50,4,54,1
43640,진선미(陳善美),한무경(韓茂景),49,5,54,1
43641,진선미(陳善美),한병도(韓秉道),94,63,157,0
43642,진선미(陳善美),한정애(韓貞愛),86,54,140,0
43643,진선미(陳善美),한준호(韓俊鎬),90,83,173,0
43644,진선미(陳善美),허숙정(許淑湞),1,1,2,0
43645,진선미(陳善美),허영(許榮),114,70,184,0
43646,진선미(陳善美),허은아(許垠娥),49,5,54,1
43647,진선미(陳善美),허종식(許琮植),85,53,138,0
43648,진선미(陳善美),홍기원(洪起元),97,57,154,0
43649,진선미(陳善美),홍문표(洪文杓),50,5,55,1
43650,진선미(陳善美),홍석준(洪碩晙),50,4,54,1
43651,진선미(陳善美),홍성국(洪性國),102,102,204,0
43652,진선미(陳善美),홍영표(洪永杓),80,58,138,0
43653,진선미(陳善美),홍익표(洪翼杓),87,54,141,0
43654,진선미(陳善美),홍정민(洪貞敏),88,56,144,0
43655,진선미(陳善美),황보승희(皇甫承希),48,2,50,1
43656,진선미(陳善美),황운하(黃雲夏),102,95,197,0
43657,진선미(陳善美),황희(黃熙),77,40,117,0
43658,진성준(陳聲準),천준호(千俊鎬),125,112,237,0
43659,진성준(陳聲準),최기상(崔基相),96,82,178,0
43660,진성준(陳聲準),최승재(崔承宰),49,6,55,1
43661,진성준(陳聲準),최연숙(崔姸淑),32,11,43,1
43662,진성준(陳聲準),최영희(崔英姬),25,4,29,1
43663,진성준(陳聲準),최인호(崔仁昊),96,89,185,0
43664,진성준(陳聲準),최재형(崔在亨),25,4,29,1
43665,진성준(陳聲準),최종윤(崔鍾允),103,111,214,0
43666,진성준(陳聲準),최춘식(崔春植),49,13,62,1
43667,진성준(陳聲準),최형두(崔炯斗),50,9,59,1
43668,진성준(陳聲準),최혜영(崔惠英),115,97,212,0
43669,진성준(陳聲準),추경호(秋慶鎬),49,3,52,1
43670,진성준(陳聲準),태영호(太永浩),49,5,54,1
43671,진성준(陳聲準),하영제(河榮帝),43,2,45,1
43672,진성준(陳聲準),하태경(河泰慶),49,5,54,1
43673,진성준(陳聲準),한기호(韓起鎬),51,4,55,1
43674,진성준(陳聲準),한무경(韓茂景),51,6,57,1
43675,진성준(陳聲準),한병도(韓秉道),109,85,194,0
43676,진성준(陳聲準),한정애(韓貞愛),80,56,136,0
43677,진성준(陳聲準),한준호(韓俊鎬),110,107,217,0
43678,진성준(陳聲準),허숙정(許淑湞),1,2,3,0
43679,진성준(陳聲準),허영(許榮),153,172,325,0
43680,진성준(陳聲準),허은아(許垠娥),49,4,53,1
43681,진성준(陳聲準),허종식(許琮植),102,98,200,0
43682,진성준(陳聲準),홍기원(洪起元),129,121,250,0
43683,진성준(陳聲準),홍문표(洪文杓),51,10,61,1
43684,진성준(陳聲準),홍석준(洪碩晙),50,4,54,1
43685,진성준(陳聲準),홍성국(洪性國),121,146,267,0
43686,진성준(陳聲準),홍영표(洪永杓),81,61,142,0
43687,진성준(陳聲準),홍익표(洪翼杓),101,76,177,0
43688,진성준(陳聲準),홍정민(洪貞敏),143,132,275,0
43689,진성준(陳聲準),황보승희(皇甫承希),46,2,48,1
43690,진성준(陳聲準),황운하(黃雲夏),117,112,229,0
43691,진성준(陳聲準),황희(黃熙),86,53,139,0
43692,천준호(千俊鎬),최기상(崔基相),88,54,142,0
43693,천준호(千俊鎬),최승재(崔承宰),49,4,53,1
43694,천준호(千俊鎬),최연숙(崔姸淑),33,10,43,1
43695,천준호(千俊鎬),최영희(崔英姬),25,3,28,1
43696,천준호(千俊鎬),최인호(崔仁昊),86,60,146,0
43697,천준호(千俊鎬),최재형(崔在亨),25,3,28,1
43698,천준호(千俊鎬),최종윤(崔鍾允),95,85,180,0
43699,천준호(千俊鎬),최춘식(崔春植),49,12,61,1
43700,천준호(千俊鎬),최형두(崔炯斗),50,4,54,1
43701,천준호(千俊鎬),최혜영(崔惠英),98,78,176,0
43702,천준호(千俊鎬),추경호(秋慶鎬),49,3,52,1
43703,천준호(千俊鎬),태영호(太永浩),49,3,52,1
43704,천준호(千俊鎬),하영제(河榮帝),40,2,42,1
43705,천준호(千俊鎬),하태경(河泰慶),49,4,53,1
43706,천준호(千俊鎬),한기호(韓起鎬),50,3,53,1
43707,천준호(千俊鎬),한무경(韓茂景),49,3,52,1
43708,천준호(千俊鎬),한병도(韓秉道),94,57,151,0
43709,천준호(千俊鎬),한정애(韓貞愛),79,46,125,0
43710,천준호(千俊鎬),한준호(韓俊鎬),95,84,179,0
43711,천준호(千俊鎬),허숙정(許淑湞),1,1,2,0
43712,천준호(千俊鎬),허영(許榮),145,118,263,0
43713,천준호(千俊鎬),허은아(許垠娥),49,3,52,1
43714,천준호(千俊鎬),허종식(許琮植),98,89,187,0
43715,천준호(千俊鎬),홍기원(洪起元),126,99,225,0
43716,천준호(千俊鎬),홍문표(洪文杓),49,3,52,1
43717,천준호(千俊鎬),홍석준(洪碩晙),49,3,52,1
43718,천준호(千俊鎬),홍성국(洪性國),97,86,183,0
43719,천준호(千俊鎬),홍영표(洪永杓),83,54,137,0
43720,천준호(千俊鎬),홍익표(洪翼杓),82,63,145,0
43721,천준호(千俊鎬),홍정민(洪貞敏),98,71,169,0
43722,천준호(千俊鎬),황보승희(皇甫承希),44,0,44,1
43723,천준호(千俊鎬),황운하(黃雲夏),100,77,177,0
43724,천준호(千俊鎬),황희(黃熙),80,40,120,0
43725,최기상(崔基相),최승재(崔承宰),50,5,55,1
43726,최기상(崔基相),최연숙(崔姸淑),30,8,38,1
43727,최기상(崔基相),최영희(崔英姬),25,4,29,1
43728,최기상(崔基相),최인호(崔仁昊),95,86,181,0
43729,최기상(崔基相),최재형(崔在亨),25,4,29,1
43730,최기상(崔基相),최종윤(崔鍾允),83,78,161,0
43731,최기상(崔基相),최춘식(崔春植),49,4,53,1
43732,최기상(崔基相),최형두(崔炯斗),50,6,56,1
43733,최기상(崔基相),최혜영(崔惠英),90,100,190,0
43734,최기상(崔基相),추경호(秋慶鎬),49,3,52,1
43735,최기상(崔基相),태영호(太永浩),49,5,54,1
43736,최기상(崔基相),하영제(河榮帝),41,3,44,1
43737,최기상(崔基相),하태경(河泰慶),49,4,53,1
43738,최기상(崔基相),한기호(韓起鎬),51,4,55,1
43739,최기상(崔基相),한무경(韓茂景),49,5,54,1
43740,최기상(崔基相),한병도(韓秉道),97,90,187,0
43741,최기상(崔基相),한정애(韓貞愛),80,63,143,0
43742,최기상(崔基相),한준호(韓俊鎬),90,83,173,0
43743,최기상(崔基相),허숙정(許淑湞),1,2,3,0
43744,최기상(崔基相),허영(許榮),103,92,195,0
43745,최기상(崔基相),허은아(許垠娥),49,5,54,1
43746,최기상(崔基相),허종식(許琮植),88,104,192,0
43747,최기상(崔基相),홍기원(洪起元),98,60,158,0
43748,최기상(崔基相),홍문표(洪文杓),50,6,56,1
43749,최기상(崔基相),홍석준(洪碩晙),49,4,53,1
43750,최기상(崔基相),홍성국(洪性國),95,100,195,0
43751,최기상(崔基相),홍영표(洪永杓),81,45,126,0
43752,최기상(崔基相),홍익표(洪翼杓),89,74,163,0
43753,최기상(崔基相),홍정민(洪貞敏),87,100,187,0
43754,최기상(崔基相),황보승희(皇甫承希),45,2,47,1
43755,최기상(崔基相),황운하(黃雲夏),93,76,169,0
43756,최기상(崔基相),황희(黃熙),75,48,123,0
43757,최승재(崔承宰),최연숙(崔姸淑),40,70,110,0
43758,최승재(崔承宰),최영희(崔英姬),30,34,64,0
43759,최승재(崔承宰),최인호(崔仁昊),52,5,57,1
43760,최승재(崔承宰),최재형(崔在亨),32,31,63,0
43761,최승재(崔承宰),최종윤(崔鍾允),50,4,54,1
43762,최승재(崔承宰),최춘식(崔春植),81,101,182,0
43763,최승재(崔承宰),최형두(崔炯斗),77,87,164,0
43764,최승재(崔承宰),최혜영(崔惠英),53,13,66,1
43765,최승재(崔承宰),추경호(秋慶鎬),102,134,236,0
43766,최승재(崔承宰),태영호(太永浩),93,162,255,0
43767,최승재(崔承宰),하영제(河榮帝),74,94,168,1
43768,최승재(崔承宰),하태경(河泰慶),70,55,125,0
43769,최승재(崔承宰),한기호(韓起鎬),74,66,140,0
43770,최승재(崔承宰),한무경(韓茂景),97,145,242,0
43771,최승재(崔承宰),한병도(韓秉道),53,11,64,1
43772,최승재(崔承宰),한정애(韓貞愛),49,4,53,1
43773,최승재(崔承宰),한준호(韓俊鎬),49,5,54,1
43774,최승재(崔承宰),허숙정(許淑湞),0,0,0,1
43775,최승재(崔承宰),허영(許榮),54,12,66,1
43776,최승재(崔承宰),허은아(許垠娥),80,86,166,0
43777,최승재(崔承宰),허종식(許琮植),50,5,55,1
43778,최승재(崔承宰),홍기원(洪起元),49,5,54,1
43779,최승재(崔承宰),홍문표(洪文杓),82,104,186,0
43780,최승재(崔承宰),홍석준(洪碩晙),77,74,151,0
43781,최승재(崔承宰),홍성국(洪性國),49,6,55,1
43782,최승재(崔承宰),홍영표(洪永杓),50,7,57,1
43783,최승재(崔承宰),홍익표(洪翼杓),51,5,56,1
43784,최승재(崔承宰),홍정민(洪貞敏),50,9,59,1
43785,최승재(崔承宰),황보승희(皇甫承希),88,113,201,1
43786,최승재(崔承宰),황운하(黃雲夏),49,12,61,1
43787,최승재(崔承宰),황희(黃熙),50,13,63,1
43788,최연숙(崔姸淑),최영희(崔英姬),28,42,70,0
43789,최연숙(崔姸淑),최인호(崔仁昊),29,8,37,1
43790,최연숙(崔姸淑),최재형(崔在亨),28,26,54,0
43791,최연숙(崔姸淑),최종윤(崔鍾允),35,17,52,1
43792,최연숙(崔姸淑),최춘식(崔春植),44,50,94,0
43793,최연숙(崔姸淑),최형두(崔炯斗),43,34,77,0
43794,최연숙(崔姸淑),최혜영(崔惠英),42,32,74,1
43795,최연숙(崔姸淑),추경호(秋慶鎬),39,39,78,0
43796,최연숙(崔姸淑),태영호(太永浩),45,72,117,0
43797,최연숙(崔姸淑),하영제(河榮帝),34,33,67,1
43798,최연숙(崔姸淑),하태경(河泰慶),37,40,77,0
43799,최연숙(崔姸淑),한기호(韓起鎬),33,38,71,0
43800,최연숙(崔姸淑),한무경(韓茂景),42,57,99,0
43801,최연숙(崔姸淑),한병도(韓秉道),33,14,47,1
43802,최연숙(崔姸淑),한정애(韓貞愛),30,15,45,1
43803,최연숙(崔姸淑),한준호(韓俊鎬),31,14,45,1
43804,최연숙(崔姸淑),허숙정(許淑湞),0,0,0,1
43805,최연숙(崔姸淑),허영(許榮),34,13,47,1
43806,최연숙(崔姸淑),허은아(許垠娥),41,51,92,0
43807,최연숙(崔姸淑),허종식(許琮植),37,18,55,1
43808,최연숙(崔姸淑),홍기원(洪起元),33,13,46,1
43809,최연숙(崔姸淑),홍문표(洪文杓),33,30,63,0
43810,최연숙(崔姸淑),홍석준(洪碩晙),40,43,83,0
43811,최연숙(崔姸淑),홍성국(洪性國),34,19,53,1
43812,최연숙(崔姸淑),홍영표(洪永杓),32,13,45,1
43813,최연숙(崔姸淑),홍익표(洪翼杓),31,14,45,1
43814,최연숙(崔姸淑),홍정민(洪貞敏),33,14,47,1
43815,최연숙(崔姸淑),황보승희(皇甫承希),34,43,77,1
43816,최연숙(崔姸淑),황운하(黃雲夏),31,26,57,1
43817,최연숙(崔姸淑),황희(黃熙),31,15,46,1
43818,최영희(崔英姬),최인호(崔仁昊),25,5,30,1
43819,최영희(崔英姬),최재형(崔在亨),27,21,48,0
43820,최영희(崔英姬),최종윤(崔鍾允),25,6,31,1
43821,최영희(崔英姬),최춘식(崔春植),38,83,121,0
43822,최영희(崔英姬),최형두(崔炯斗),31,23,54,0
43823,최영희(崔英姬),최혜영(崔惠英),25,5,30,1
43824,최영희(崔英姬),추경호(秋慶鎬),25,8,33,0
43825,최영희(崔英姬),태영호(太永浩),48,116,164,0
43826,최영희(崔英姬),하영제(河榮帝),23,60,83,1
43827,최영희(崔英姬),하태경(河泰慶),29,23,52,0
43828,최영희(崔英姬),한기호(韓起鎬),29,28,57,0
43829,최영희(崔英姬),한무경(韓茂景),34,81,115,0
43830,최영희(崔英姬),한병도(韓秉道),25,5,30,1
43831,최영희(崔英姬),한정애(韓貞愛),25,4,29,1
43832,최영희(崔英姬),한준호(韓俊鎬),25,6,31,1
43833,최영희(崔英姬),허숙정(許淑湞),0,0,0,1
43834,최영희(崔英姬),허영(許榮),25,6,31,1
43835,최영희(崔英姬),허은아(許垠娥),30,27,57,0
43836,최영희(崔英姬),허종식(許琮植),25,8,33,1
43837,최영희(崔英姬),홍기원(洪起元),25,6,31,1
43838,최영희(崔英姬),홍문표(洪文杓),27,62,89,0
43839,최영희(崔英姬),홍석준(洪碩晙),29,28,57,0
43840,최영희(崔英姬),홍성국(洪性國),25,5,30,1
43841,최영희(崔英姬),홍영표(洪永杓),25,5,30,1
43842,최영희(崔英姬),홍익표(洪翼杓),25,4,29,1
43843,최영희(崔英姬),홍정민(洪貞敏),25,6,31,1
43844,최영희(崔英姬),황보승희(皇甫承希),31,58,89,1
43845,최영희(崔英姬),황운하(黃雲夏),25,5,30,1
43846,최영희(崔英姬),황희(黃熙),25,5,30,1
43847,최인호(崔仁昊),최재형(崔在亨),25,5,30,1
43848,최인호(崔仁昊),최종윤(崔鍾允),93,118,211,0
43849,최인호(崔仁昊),최춘식(崔春植),50,5,55,1
43850,최인호(崔仁昊),최형두(崔炯斗),51,5,56,1
43851,최인호(崔仁昊),최혜영(崔惠英),83,81,164,0
43852,최인호(崔仁昊),추경호(秋慶鎬),50,3,53,1
43853,최인호(崔仁昊),태영호(太永浩),49,6,55,1
43854,최인호(崔仁昊),하영제(河榮帝),44,1,45,1
43855,최인호(崔仁昊),하태경(河泰慶),51,8,59,1
43856,최인호(崔仁昊),한기호(韓起鎬),52,4,56,1
43857,최인호(崔仁昊),한무경(韓茂景),49,4,53,1
43858,최인호(崔仁昊),한병도(韓秉道),115,111,226,0
43859,최인호(崔仁昊),한정애(韓貞愛),82,73,155,0
43860,최인호(崔仁昊),한준호(韓俊鎬),108,181,289,0
43861,최인호(崔仁昊),허숙정(許淑湞),1,1,2,0
43862,최인호(崔仁昊),허영(許榮),137,174,311,0
43863,최인호(崔仁昊),허은아(許垠娥),51,4,55,1
43864,최인호(崔仁昊),허종식(許琮植),86,121,207,0
43865,최인호(崔仁昊),홍기원(洪起元),102,118,220,0
43866,최인호(崔仁昊),홍문표(洪文杓),54,5,59,1
43867,최인호(崔仁昊),홍석준(洪碩晙),50,4,54,1
43868,최인호(崔仁昊),홍성국(洪性國),90,134,224,0
43869,최인호(崔仁昊),홍영표(洪永杓),79,65,144,0
43870,최인호(崔仁昊),홍익표(洪翼杓),88,76,164,0
43871,최인호(崔仁昊),홍정민(洪貞敏),97,91,188,0
43872,최인호(崔仁昊),황보승희(皇甫承希),50,3,53,1
43873,최인호(崔仁昊),황운하(黃雲夏),95,83,178,0
43874,최인호(崔仁昊),황희(黃熙),78,66,144,0
43875,최재형(崔在亨),최종윤(崔鍾允),25,4,29,1
43876,최재형(崔在亨),최춘식(崔春植),30,24,54,0
43877,최재형(崔在亨),최형두(崔炯斗),27,15,42,0
43878,최재형(崔在亨),최혜영(崔惠英),25,6,31,1
43879,최재형(崔在亨),추경호(秋慶鎬),25,9,34,0
43880,최재형(崔在亨),태영호(太永浩),31,25,56,0
43881,최재형(崔在亨),하영제(河榮帝),20,16,36,1
43882,최재형(崔在亨),하태경(河泰慶),29,18,47,0
43883,최재형(崔在亨),한기호(韓起鎬),27,16,43,0
43884,최재형(崔在亨),한무경(韓茂景),29,23,52,0
43885,최재형(崔在亨),한병도(韓秉道),25,5,30,1
43886,최재형(崔在亨),한정애(韓貞愛),25,4,29,1
43887,최재형(崔在亨),한준호(韓俊鎬),25,5,30,1
43888,최재형(崔在亨),허숙정(許淑湞),0,0,0,1
43889,최재형(崔在亨),허영(許榮),25,5,30,1
43890,최재형(崔在亨),허은아(許垠娥),28,15,43,0
43891,최재형(崔在亨),허종식(許琮植),26,6,32,1
43892,최재형(崔在亨),홍기원(洪起元),25,5,30,1
43893,최재형(崔在亨),홍문표(洪文杓),25,15,40,0
43894,최재형(崔在亨),홍석준(洪碩晙),29,20,49,0
43895,최재형(崔在亨),홍성국(洪性國),25,5,30,1
43896,최재형(崔在亨),홍영표(洪永杓),26,4,30,1
43897,최재형(崔在亨),홍익표(洪翼杓),25,4,29,1
43898,최재형(崔在亨),홍정민(洪貞敏),25,4,29,1
43899,최재형(崔在亨),황보승희(皇甫承希),25,23,48,1
43900,최재형(崔在亨),황운하(黃雲夏),25,5,30,1
43901,최재형(崔在亨),황희(黃熙),25,5,30,1
43902,최종윤(崔鍾允),최춘식(崔春植),49,11,60,1
43903,최종윤(崔鍾允),최형두(崔炯斗),50,4,54,1
43904,최종윤(崔鍾允),최혜영(崔惠英),152,239,391,0
43905,최종윤(崔鍾允),추경호(秋慶鎬),49,4,53,1
43906,최종윤(崔鍾允),태영호(太永浩),49,4,53,1
43907,최종윤(崔鍾允),하영제(河榮帝),42,2,44,1
43908,최종윤(崔鍾允),하태경(河泰慶),50,6,56,1
43909,최종윤(崔鍾允),한기호(韓起鎬),52,5,57,1
43910,최종윤(崔鍾允),한무경(韓茂景),50,5,55,1
43911,최종윤(崔鍾允),한병도(韓秉道),117,135,252,0
43912,최종윤(崔鍾允),한정애(韓貞愛),80,84,164,0
43913,최종윤(崔鍾允),한준호(韓俊鎬),112,257,369,0
43914,최종윤(崔鍾允),허숙정(許淑湞),1,2,3,0
43915,최종윤(崔鍾允),허영(許榮),137,190,327,0
43916,최종윤(崔鍾允),허은아(許垠娥),49,4,53,1
43917,최종윤(崔鍾允),허종식(許琮植),151,198,349,0
43918,최종윤(崔鍾允),홍기원(洪起元),109,147,256,0
43919,최종윤(崔鍾允),홍문표(洪文杓),51,6,57,1
43920,최종윤(崔鍾允),홍석준(洪碩晙),50,5,55,1
43921,최종윤(崔鍾允),홍성국(洪性國),140,226,366,0
43922,최종윤(崔鍾允),홍영표(洪永杓),96,92,188,0
43923,최종윤(崔鍾允),홍익표(洪翼杓),90,89,179,0
43924,최종윤(崔鍾允),홍정민(洪貞敏),116,144,260,0
43925,최종윤(崔鍾允),황보승희(皇甫承希),46,2,48,1
43926,최종윤(崔鍾允),황운하(黃雲夏),121,194,315,0
43927,최종윤(崔鍾允),황희(黃熙),79,70,149,0
43928,최춘식(崔春植),최형두(崔炯斗),101,143,244,0
43929,최춘식(崔春植),최혜영(崔惠英),49,7,56,1
43930,최춘식(崔春植),추경호(秋慶鎬),104,124,228,0
43931,최춘식(崔春植),태영호(太永浩),102,208,310,0
43932,최춘식(崔春植),하영제(河榮帝),82,173,255,1
43933,최춘식(崔春植),하태경(河泰慶),72,51,123,0
43934,최춘식(崔春植),한기호(韓起鎬),80,76,156,0
43935,최춘식(崔春植),한무경(韓茂景),78,110,188,0
43936,최춘식(崔春植),한병도(韓秉道),50,6,56,1
43937,최춘식(崔春植),한정애(韓貞愛),49,4,53,1
43938,최춘식(崔春植),한준호(韓俊鎬),50,9,59,1
43939,최춘식(崔春植),허숙정(許淑湞),0,0,0,1
43940,최춘식(崔春植),허영(許榮),52,10,62,1
43941,최춘식(崔春植),허은아(許垠娥),80,80,160,0
43942,최춘식(崔春植),허종식(許琮植),52,11,63,1
43943,최춘식(崔春植),홍기원(洪起元),49,5,54,1
43944,최춘식(崔春植),홍문표(洪文杓),94,102,196,0
43945,최춘식(崔春植),홍석준(洪碩晙),75,94,169,0
43946,최춘식(崔春植),홍성국(洪性國),50,5,55,1
43947,최춘식(崔春植),홍영표(洪永杓),50,6,56,1
43948,최춘식(崔春植),홍익표(洪翼杓),49,4,53,1
43949,최춘식(崔春植),홍정민(洪貞敏),49,13,62,1
43950,최춘식(崔春植),황보승희(皇甫承希),76,113,189,1
43951,최춘식(崔春植),황운하(黃雲夏),49,5,54,1
43952,최춘식(崔春植),황희(黃熙),49,11,60,1
43953,최형두(崔炯斗),최혜영(崔惠英),50,10,60,1
43954,최형두(崔炯斗),추경호(秋慶鎬),127,173,300,0
43955,최형두(崔炯斗),태영호(太永浩),107,170,277,0
43956,최형두(崔炯斗),하영제(河榮帝),91,120,211,1
43957,최형두(崔炯斗),하태경(河泰慶),69,48,117,0
43958,최형두(崔炯斗),한기호(韓起鎬),68,65,133,0
43959,최형두(崔炯斗),한무경(韓茂景),80,104,184,0
43960,최형두(崔炯斗),한병도(韓秉道),49,5,54,1
43961,최형두(崔炯斗),한정애(韓貞愛),51,5,56,1
43962,최형두(崔炯斗),한준호(韓俊鎬),54,7,61,1
43963,최형두(崔炯斗),허숙정(許淑湞),0,0,0,1
43964,최형두(崔炯斗),허영(許榮),51,10,61,1
43965,최형두(崔炯斗),허은아(許垠娥),75,66,141,0
43966,최형두(崔炯斗),허종식(許琮植),51,10,61,1
43967,최형두(崔炯斗),홍기원(洪起元),51,6,57,1
43968,최형두(崔炯斗),홍문표(洪文杓),92,118,210,0
43969,최형두(崔炯斗),홍석준(洪碩晙),78,53,131,0
43970,최형두(崔炯斗),홍성국(洪性國),50,8,58,1
43971,최형두(崔炯斗),홍영표(洪永杓),50,6,56,1
43972,최형두(崔炯斗),홍익표(洪翼杓),50,5,55,1
43973,최형두(崔炯斗),홍정민(洪貞敏),53,6,59,1
43974,최형두(崔炯斗),황보승희(皇甫承希),81,77,158,1
43975,최형두(崔炯斗),황운하(黃雲夏),52,9,61,1
43976,최형두(崔炯斗),황희(黃熙),49,6,55,1
43977,최혜영(崔惠英),추경호(秋慶鎬),50,7,57,1
43978,최혜영(崔惠英),태영호(太永浩),52,13,65,1
43979,최혜영(崔惠英),하영제(河榮帝),41,2,43,1
43980,최혜영(崔惠英),하태경(河泰慶),53,7,60,1
43981,최혜영(崔惠英),한기호(韓起鎬),50,4,54,1
43982,최혜영(崔惠英),한무경(韓茂景),49,6,55,1
43983,최혜영(崔惠英),한병도(韓秉道),119,118,237,0
43984,최혜영(崔惠英),한정애(韓貞愛),87,109,196,0
43985,최혜영(崔惠英),한준호(韓俊鎬),149,220,369,0
43986,최혜영(崔惠英),허숙정(許淑湞),1,2,3,0
43987,최혜영(崔惠英),허영(許榮),125,109,234,0
43988,최혜영(崔惠英),허은아(許垠娥),49,7,56,1
43989,최혜영(崔惠英),허종식(許琮植),160,188,348,0
43990,최혜영(崔惠英),홍기원(洪起元),99,109,208,0
43991,최혜영(崔惠英),홍문표(洪文杓),49,4,53,1
43992,최혜영(崔惠英),홍석준(洪碩晙),49,8,57,1
43993,최혜영(崔惠英),홍성국(洪性國),215,314,529,0
43994,최혜영(崔惠英),홍영표(洪永杓),86,85,171,0
43995,최혜영(崔惠英),홍익표(洪翼杓),95,106,201,0
43996,최혜영(崔惠英),홍정민(洪貞敏),137,162,299,0
43997,최혜영(崔惠英),황보승희(皇甫承希),45,4,49,1
43998,최혜영(崔惠英),황운하(黃雲夏),138,171,309,0
43999,최혜영(崔惠英),황희(黃熙),81,46,127,0
44000,추경호(秋慶鎬),태영호(太永浩),148,255,403,0
44001,추경호(秋慶鎬),하영제(河榮帝),120,141,261,1
44002,추경호(秋慶鎬),하태경(河泰慶),69,50,119,0
44003,추경호(秋慶鎬),한기호(韓起鎬),84,73,157,0
44004,추경호(秋慶鎬),한무경(韓茂景),135,178,313,0
44005,추경호(秋慶鎬),한병도(韓秉道),51,5,56,1
44006,추경호(秋慶鎬),한정애(韓貞愛),49,3,52,1
44007,추경호(秋慶鎬),한준호(韓俊鎬),49,3,52,1
44008,추경호(秋慶鎬),허숙정(許淑湞),0,0,0,1
44009,추경호(秋慶鎬),허영(許榮),51,5,56,1
44010,추경호(秋慶鎬),허은아(許垠娥),106,103,209,0
44011,추경호(秋慶鎬),허종식(許琮植),50,4,54,1
44012,추경호(秋慶鎬),홍기원(洪起元),49,4,53,1
44013,추경호(秋慶鎬),홍문표(洪文杓),135,172,307,0
44014,추경호(秋慶鎬),홍석준(洪碩晙),93,121,214,0
44015,추경호(秋慶鎬),홍성국(洪性國),49,4,53,1
44016,추경호(秋慶鎬),홍영표(洪永杓),49,5,54,1
44017,추경호(秋慶鎬),홍익표(洪翼杓),49,4,53,1
44018,추경호(秋慶鎬),홍정민(洪貞敏),50,6,56,1
44019,추경호(秋慶鎬),황보승희(皇甫承希),96,138,234,1
44020,추경호(秋慶鎬),황운하(黃雲夏),49,5,54,1
44021,추경호(秋慶鎬),황희(黃熙),49,4,53,1
44022,태영호(太永浩),하영제(河榮帝),91,128,219,1
44023,태영호(太永浩),하태경(河泰慶),69,94,163,0
44024,태영호(太永浩),한기호(韓起鎬),79,112,191,0
44025,태영호(太永浩),한무경(韓茂景),130,196,326,0
44026,태영호(太永浩),한병도(韓秉道),52,9,61,1
44027,태영호(太永浩),한정애(韓貞愛),49,5,54,1
44028,태영호(太永浩),한준호(韓俊鎬),49,5,54,1
44029,태영호(太永浩),허숙정(許淑湞),0,0,0,1
44030,태영호(太永浩),허영(許榮),50,5,55,1
44031,태영호(太永浩),허은아(許垠娥),106,147,253,0
44032,태영호(太永浩),허종식(許琮植),50,6,56,1
44033,태영호(太永浩),홍기원(洪起元),49,5,54,1
44034,태영호(太永浩),홍문표(洪文杓),97,151,248,0
44035,태영호(太永浩),홍석준(洪碩晙),75,85,160,0
44036,태영호(太永浩),홍성국(洪性國),49,5,54,1
44037,태영호(太永浩),홍영표(洪永杓),50,5,55,1
44038,태영호(太永浩),홍익표(洪翼杓),49,5,54,1
44039,태영호(太永浩),홍정민(洪貞敏),50,9,59,1
44040,태영호(太永浩),황보승희(皇甫承希),93,175,268,1
44041,태영호(太永浩),황운하(黃雲夏),49,5,54,1
44042,태영호(太永浩),황희(黃熙),49,6,55,1
44043,하영제(河榮帝),하태경(河泰慶),64,66,130,1
44044,하영제(河榮帝),한기호(韓起鎬),65,64,129,1
44045,하영제(河榮帝),한무경(韓茂景),92,147,239,1
44046,하영제(河榮帝),한병도(韓秉道),41,3,44,1
44047,하영제(河榮帝),한정애(韓貞愛),41,2,43,1
44048,하영제(河榮帝),한준호(韓俊鎬),41,1,42,1
44049,하영제(河榮帝),허숙정(許淑湞),0,0,0,1
44050,하영제(河榮帝),허영(許榮),44,4,48,1
44051,하영제(河榮帝),허은아(許垠娥),70,83,153,1
44052,하영제(河榮帝),허종식(許琮植),42,3,45,1
44053,하영제(河榮帝),홍기원(洪起元),41,3,44,1
44054,하영제(河榮帝),홍문표(洪文杓),88,143,231,1
44055,하영제(河榮帝),홍석준(洪碩晙),67,100,167,1
44056,하영제(河榮帝),홍성국(洪性國),42,2,44,1
44057,하영제(河榮帝),홍영표(洪永杓),41,2,43,1
44058,하영제(河榮帝),홍익표(洪翼杓),42,1,43,1
44059,하영제(河榮帝),홍정민(洪貞敏),42,3,45,1
44060,하영제(河榮帝),황보승희(皇甫承希),83,134,217,0
44061,하영제(河榮帝),황운하(黃雲夏),41,2,43,1
44062,하영제(河榮帝),황희(黃熙),40,2,42,1
44063,하태경(河泰慶),한기호(韓起鎬),70,69,139,0
44064,하태경(河泰慶),한무경(韓茂景),71,68,139,0
44065,하태경(河泰慶),한병도(韓秉道),49,5,54,1
44066,하태경(河泰慶),한정애(韓貞愛),49,4,53,1
44067,하태경(河泰慶),한준호(韓俊鎬),50,5,55,1
44068,하태경(河泰慶),허숙정(許淑湞),0,0,0,1
44069,하태경(河泰慶),허영(許榮),51,5,56,1
44070,하태경(河泰慶),허은아(許垠娥),69,52,121,0
44071,하태경(河泰慶),허종식(許琮植),51,6,57,1
44072,하태경(河泰慶),홍기원(洪起元),52,5,57,1
44073,하태경(河泰慶),홍문표(洪文杓),66,55,121,0
44074,하태경(河泰慶),홍석준(洪碩晙),65,52,117,0
44075,하태경(河泰慶),홍성국(洪性國),51,5,56,1
44076,하태경(河泰慶),홍영표(洪永杓),51,4,55,1
44077,하태경(河泰慶),홍익표(洪翼杓),50,4,54,1
44078,하태경(河泰慶),홍정민(洪貞敏),51,4,55,1
44079,하태경(河泰慶),황보승희(皇甫承希),79,85,164,1
44080,하태경(河泰慶),황운하(黃雲夏),51,5,56,1
44081,하태경(河泰慶),황희(黃熙),49,6,55,1
44082,한기호(韓起鎬),한무경(韓茂景),69,71,140,0
44083,한기호(韓起鎬),한병도(韓秉道),51,8,59,1
44084,한기호(韓起鎬),한정애(韓貞愛),50,5,55,1
44085,한기호(韓起鎬),한준호(韓俊鎬),50,7,57,1
44086,한기호(韓起鎬),허숙정(許淑湞),0,0,0,1
44087,한기호(韓起鎬),허영(許榮),55,15,70,1
44088,한기호(韓起鎬),허은아(許垠娥),64,46,110,0
44089,한기호(韓起鎬),허종식(許琮植),51,5,56,1
44090,한기호(韓起鎬),홍기원(洪起元),50,6,56,1
44091,한기호(韓起鎬),홍문표(洪文杓),64,52,116,0
44092,한기호(韓起鎬),홍석준(洪碩晙),64,51,115,0
44093,한기호(韓起鎬),홍성국(洪性國),51,6,57,1
44094,한기호(韓起鎬),홍영표(洪永杓),51,7,58,1
44095,한기호(韓起鎬),홍익표(洪翼杓),51,4,55,1
44096,한기호(韓起鎬),홍정민(洪貞敏),51,7,58,1
44097,한기호(韓起鎬),황보승희(皇甫承希),66,67,133,1
44098,한기호(韓起鎬),황운하(黃雲夏),50,6,56,1
44099,한기호(韓起鎬),황희(黃熙),49,6,55,1
44100,한무경(韓茂景),한병도(韓秉道),49,4,53,1
44101,한무경(韓茂景),한정애(韓貞愛),49,4,53,1
44102,한무경(韓茂景),한준호(韓俊鎬),49,4,53,1
44103,한무경(韓茂景),허숙정(許淑湞),0,0,0,1
44104,한무경(韓茂景),허영(許榮),50,5,55,1
44105,한무경(韓茂景),허은아(許垠娥),107,148,255,0
44106,한무경(韓茂景),허종식(許琮植),49,7,56,1
44107,한무경(韓茂景),홍기원(洪起元),49,6,55,1
44108,한무경(韓茂景),홍문표(洪文杓),75,111,186,0
44109,한무경(韓茂景),홍석준(洪碩晙),76,107,183,0
44110,한무경(韓茂景),홍성국(洪性國),49,7,56,1
44111,한무경(韓茂景),홍영표(洪永杓),49,5,54,1
44112,한무경(韓茂景),홍익표(洪翼杓),49,5,54,1
44113,한무경(韓茂景),홍정민(洪貞敏),49,8,57,1
44114,한무경(韓茂景),황보승희(皇甫承希),82,113,195,1
44115,한무경(韓茂景),황운하(黃雲夏),49,7,56,1
44116,한무경(韓茂景),황희(黃熙),49,7,56,1
44117,한병도(韓秉道),한정애(韓貞愛),79,58,137,0
44118,한병도(韓秉道),한준호(韓俊鎬),93,112,205,0
44119,한병도(韓秉道),허숙정(許淑湞),1,1,2,0
44120,한병도(韓秉道),허영(許榮),161,155,316,0
44121,한병도(韓秉道),허은아(許垠娥),49,4,53,1
44122,한병도(韓秉道),허종식(許琮植),99,106,205,0
44123,한병도(韓秉道),홍기원(洪起元),101,81,182,0
44124,한병도(韓秉道),홍문표(洪文杓),49,5,54,1
44125,한병도(韓秉道),홍석준(洪碩晙),49,4,53,1
44126,한병도(韓秉道),홍성국(洪性國),128,176,304,0
44127,한병도(韓秉道),홍영표(洪永杓),91,78,169,0
44128,한병도(韓秉道),홍익표(洪翼杓),110,85,195,0
44129,한병도(韓秉道),홍정민(洪貞敏),114,126,240,0
44130,한병도(韓秉道),황보승희(皇甫承希),46,1,47,1
44131,한병도(韓秉道),황운하(黃雲夏),113,142,255,0
44132,한병도(韓秉道),황희(黃熙),89,60,149,0
44133,한정애(韓貞愛),한준호(韓俊鎬),87,108,195,0
44134,한정애(韓貞愛),허숙정(許淑湞),1,3,4,0
44135,한정애(韓貞愛),허영(許榮),90,80,170,0
44136,한정애(韓貞愛),허은아(許垠娥),49,4,53,1
44137,한정애(韓貞愛),허종식(許琮植),96,78,174,0
44138,한정애(韓貞愛),홍기원(洪起元),78,51,129,0
44139,한정애(韓貞愛),홍문표(洪文杓),50,4,54,1
44140,한정애(韓貞愛),홍석준(洪碩晙),50,5,55,1
44141,한정애(韓貞愛),홍성국(洪性國),85,84,169,0
44142,한정애(韓貞愛),홍영표(洪永杓),82,50,132,0
44143,한정애(韓貞愛),홍익표(洪翼杓),81,49,130,0
44144,한정애(韓貞愛),홍정민(洪貞敏),86,68,154,0
44145,한정애(韓貞愛),황보승희(皇甫承希),49,3,52,1
44146,한정애(韓貞愛),황운하(黃雲夏),92,72,164,0
44147,한정애(韓貞愛),황희(黃熙),73,37,110,0
44148,한준호(韓俊鎬),허숙정(許淑湞),1,1,2,0
44149,한준호(韓俊鎬),허영(許榮),127,156,283,0
44150,한준호(韓俊鎬),허은아(許垠娥),50,4,54,1
44151,한준호(韓俊鎬),허종식(許琮植),103,128,231,0
44152,한준호(韓俊鎬),홍기원(洪起元),111,149,260,0
44153,한준호(韓俊鎬),홍문표(洪文杓),51,5,56,1
44154,한준호(韓俊鎬),홍석준(洪碩晙),52,4,56,1
44155,한준호(韓俊鎬),홍성국(洪性國),177,266,443,0
44156,한준호(韓俊鎬),홍영표(洪永杓),85,72,157,0
44157,한준호(韓俊鎬),홍익표(洪翼杓),120,123,243,0
44158,한준호(韓俊鎬),홍정민(洪貞敏),133,217,350,0
44159,한준호(韓俊鎬),황보승희(皇甫承希),47,1,48,1
44160,한준호(韓俊鎬),황운하(黃雲夏),132,214,346,0
44161,한준호(韓俊鎬),황희(黃熙),82,54,136,0
44162,허숙정(許淑湞),허영(許榮),1,2,3,0
44163,허숙정(許淑湞),허은아(許垠娥),0,0,0,1
44164,허숙정(許淑湞),허종식(許琮植),1,2,3,0
44165,허숙정(許淑湞),홍기원(洪起元),1,1,2,0
44166,허숙정(許淑湞),홍문표(洪文杓),0,0,0,1
44167,허숙정(許淑湞),홍석준(洪碩晙),0,0,0,1
44168,허숙정(許淑湞),홍성국(洪性國),1,2,3,0
44169,허숙정(許淑湞),홍영표(洪永杓),1,1,2,0
44170,허숙정(許淑湞),홍익표(洪翼杓),1,1,2,0
44171,허숙정(許淑湞),홍정민(洪貞敏),1,2,3,0
44172,허숙정(許淑湞),황보승희(皇甫承希),0,0,0,1
44173,허숙정(許淑湞),황운하(黃雲夏),1,2,3,0
44174,허숙정(許淑湞),황희(黃熙),1,2,3,0
44175,허영(許榮),허은아(許垠娥),49,6,55,1
44176,허영(許榮),허종식(許琮植),132,202,334,0
44177,허영(許榮),홍기원(洪起元),140,193,333,0
44178,허영(許榮),홍문표(洪文杓),55,13,68,1
44179,허영(許榮),홍석준(洪碩晙),51,4,55,1
44180,허영(許榮),홍성국(洪性國),165,223,388,0
44181,허영(許榮),홍영표(洪永杓),87,73,160,0
44182,허영(許榮),홍익표(洪翼杓),112,97,209,0
44183,허영(許榮),홍정민(洪貞敏),123,165,288,0
44184,허영(許榮),황보승희(皇甫承希),50,3,53,1
44185,허영(許榮),황운하(黃雲夏),141,135,276,0
44186,허영(許榮),황희(黃熙),94,75,169,0
44187,허은아(許垠娥),허종식(許琮植),49,4,53,1
44188,허은아(許垠娥),홍기원(洪起元),49,5,54,1
44189,허은아(許垠娥),홍문표(洪文杓),70,74,144,0
44190,허은아(許垠娥),홍석준(洪碩晙),78,70,148,0
44191,허은아(許垠娥),홍성국(洪性國),49,5,54,1
44192,허은아(許垠娥),홍영표(洪永杓),49,5,54,1
44193,허은아(許垠娥),홍익표(洪翼杓),49,5,54,1
44194,허은아(許垠娥),홍정민(洪貞敏),50,6,56,1
44195,허은아(許垠娥),황보승희(皇甫承希),94,106,200,1
44196,허은아(許垠娥),황운하(黃雲夏),49,4,53,1
44197,허은아(許垠娥),황희(黃熙),49,6,55,1
44198,허종식(許琮植),홍기원(洪起元),111,119,230,0
44199,허종식(許琮植),홍문표(洪文杓),51,11,62,1
44200,허종식(許琮植),홍석준(洪碩晙),50,4,54,1
44201,허종식(許琮植),홍성국(洪性國),139,147,286,0
44202,허종식(許琮植),홍영표(洪永杓),106,104,210,0
44203,허종식(許琮植),홍익표(洪翼杓),82,84,166,0
44204,허종식(許琮植),홍정민(洪貞敏),113,121,234,0
44205,허종식(許琮植),황보승희(皇甫承希),46,2,48,1
44206,허종식(許琮植),황운하(黃雲夏),136,122,258,0
44207,허종식(許琮植),황희(黃熙),80,82,162,0
44208,홍기원(洪起元),홍문표(洪文杓),50,5,55,1
44209,홍기원(洪起元),홍석준(洪碩晙),50,4,54,1
44210,홍기원(洪起元),홍성국(洪性國),117,171,288,0
44211,홍기원(洪起元),홍영표(洪永杓),89,80,169,0
44212,홍기원(洪起元),홍익표(洪翼杓),94,92,186,0
44213,홍기원(洪起元),홍정민(洪貞敏),119,118,237,0
44214,홍기원(洪起元),황보승희(皇甫承希),46,3,49,1
44215,홍기원(洪起元),황운하(黃雲夏),121,125,246,0
44216,홍기원(洪起元),황희(黃熙),85,67,152,0
44217,홍문표(洪文杓),홍석준(洪碩晙),67,58,125,0
44218,홍문표(洪文杓),홍성국(洪性國),59,7,66,1
44219,홍문표(洪文杓),홍영표(洪永杓),50,5,55,1
44220,홍문표(洪文杓),홍익표(洪翼杓),50,4,54,1
44221,홍문표(洪文杓),홍정민(洪貞敏),51,8,59,1
44222,홍문표(洪文杓),황보승희(皇甫承希),78,107,185,1
44223,홍문표(洪文杓),황운하(黃雲夏),50,4,54,1
44224,홍문표(洪文杓),황희(黃熙),49,6,55,1
44225,홍석준(洪碩晙),홍성국(洪性國),50,4,54,1
44226,홍석준(洪碩晙),홍영표(洪永杓),50,4,54,1
44227,홍석준(洪碩晙),홍익표(洪翼杓),50,4,54,1
44228,홍석준(洪碩晙),홍정민(洪貞敏),50,4,54,1
44229,홍석준(洪碩晙),황보승희(皇甫承希),68,74,142,1
44230,홍석준(洪碩晙),황운하(黃雲夏),51,4,55,1
44231,홍석준(洪碩晙),황희(黃熙),49,4,53,1
44232,홍성국(洪性國),홍영표(洪永杓),89,117,206,0
44233,홍성국(洪性國),홍익표(洪翼杓),132,173,305,0
44234,홍성국(洪性國),홍정민(洪貞敏),146,188,334,0
44235,홍성국(洪性國),황보승희(皇甫承希),48,3,51,1
44236,홍성국(洪性國),황운하(黃雲夏),159,195,354,0
44237,홍성국(洪性國),황희(黃熙),86,70,156,0
44238,홍영표(洪永杓),홍익표(洪翼杓),81,52,133,0
44239,홍영표(洪永杓),홍정민(洪貞敏),83,56,139,0
44240,홍영표(洪永杓),황보승희(皇甫承希),47,2,49,1
44241,홍영표(洪永杓),황운하(黃雲夏),91,78,169,0
44242,홍영표(洪永杓),황희(黃熙),79,39,118,0
44243,홍익표(洪翼杓),홍정민(洪貞敏),93,96,189,0
44244,홍익표(洪翼杓),황보승희(皇甫承希),47,2,49,1
44245,홍익표(洪翼杓),황운하(黃雲夏),93,90,183,0
44246,홍익표(洪翼杓),황희(黃熙),82,55,137,0
44247,홍정민(洪貞敏),황보승희(皇甫承希),49,3,52,1
44248,홍정민(洪貞敏),황운하(黃雲夏),139,190,329,0
44249,홍정민(洪貞敏),황희(黃熙),87,75,162,0
44250,황보승희(皇甫承希),황운하(黃雲夏),46,3,49,1
44251,황보승희(皇甫承希),황희(黃熙),45,8,53,1
44252,황운하(黃雲夏),황희(黃熙),89,48,137,0
